unknown	不知名的
diorama	立体模型
oxybenzene	苯酚
calvados	苹果白兰地酒
monospermous	单种子
unmixed	未混杂他物的
dartle	反复
elide	省略发音
kook	疯狂
unornamented	无装饰
cerography	蜡写法
contrail	凝结尾
chipper	吱吱叫
gelidity	冰冷
reichspfennig	旧时德国铜币
spiky	装有大钉的
mellophone	美乐号
apostatize	脱党
dudish	纨裤子弟
infusive	令人兴奋的
chimpanzee	非洲的小人猿
mound	垛
nongrammatical	不合乎文法的
evalina	伊夫林娜
hurt	损害
fiddler	拉提琴的人
oleandomycin	竹桃霉素
govern	统治
ass	臀部
monetary	货币
adonis	美少年
infant	幼稚的
gabardine	华达呢
benchman	在工作台旁工作的人
arcaded	成为拱廊街道的
jockey	操作员
plumulate	羽毛华丽
stearine	硬脂酸
insouciant	漫不经心的
topographer	地志学者
junta	派别
thumper	击键声检测器
depressible	消沉的
chunderous	令人厌恶的
biradial	两侧辐射对称的
upstairs	在楼上
weird	神秘的
nagged	感到厌烦
ultramundane	太阳系之外
phonetically	语音学上
schimpfwort	骂人的话
nicety	精密
burleigh	伯利
submillimetre	亚毫米
nongovernment	非政府
brachiate	十字对生的
fix	困境
abuliding	兴建中
stilt	跷
geocentric	以地球为中心的
tolerable	可以的
mendacious	虚假
montage	文学音乐或美术的组合体
naughty	不适当
carbonaceous	含碳
accurst	讨厌
rebaptize	为……再施洗
osteologist	骨学家
podalgia	脚痛
such	这样的
vindicability	可辩护性
official	职务上
hotspur	鲁莽的人
systematise	=systematize
catalonian	加泰罗尼亚
jazzily	有爵士特点地
aestidurilignosa	夏绿硬叶木本群落
banefully	有毒
photorealism	照相现实主义
bundobust	组织
grantee	受让人
unsex	使失去性征
mention	说起
nephrectomy	肾切除术
byzantinism	拜占庭风格
flummery	布丁
veiling	面纱
notochord	脊索
barricade	设路障
convincible	可说服
sixty	六十
raid	奇袭
shillelagh	橡木棍
horsefeathers	梦话
tappit	有冠
nasdaq	全国证券交易商自动报价系统协会
square	直角
disclose	揭露
platband	嵌条
bioelectrogenesis	生物电发生
sparable	无头小钉子
recent	新近
platband	扁突线条
interuniversity	大学间的
viremia	=viraemia
he	雄
outlier	局外人
pimply	肿泡的
transpositive	互换位置
unambiguous	明确
rotatory	轮流的
malfeasant	行为不正的
cephaloid	头状花
unprofitable	无利益
sensitizer	感光剂
latifoliate	阔叶的
exultant	非常高兴的
state	典礼用的
cavern	挖空
cheyenne	夏安族
legatary	受遗赠人
make	获
tasmanian	塔斯马尼亚的
abruptly	突然地
be	Be
durance	禁锢
refinance	再供……资金
quiescent	静止的
echoencephalography	脑回波描记术
organizational	组织
jactitation	辗转不安
inventroy	清点存货
traceableness	可描画
usphs	美国公共卫生署
superposition	叠合
ornl	国立橡树岭实验所
yamato	大和民族
shunless	避不开的
pumpman	泵管理员
changemaker	换零钱机
rapper	叩击者
deadness	无生气
unfenced	没有篱笆的
isogyre	等施干涉条纹
petrologic	岩石学
omophagy	生食
ebb	退
rarer	更稀罕的
froggish	蛙状的
raid	搜捕
bulrush	芦苇
macrencephaly	巨脑
modularize	模块化
bookworm	蛀书虫
amphichroic	双变色的
togae	官服
indetermination	无法断定
dislikeful	令人嫌恶
swim	游过
exsertile	可伸出
fadedly	色彩已褪
rubella	风疹
telewriter	电传书写机
annulate	由环组成
regular	经常地
uba	Union
criticality	危险程度
aforehand	预先
hazchem	危险化学品标签系统
ululant	呜呜叫的
weight	分量
clatter	发出哗啦声
declutch	分开离合器
hellyon	=hellion
sargassumfish	裸襞鱼
dacca	达卡
fluoroscope	用荧光镜检查
displace	转移
peruvian	秘鲁人
lindy	跳林迪舞
eternal	不灭
trough	槽
chief	主要部分
freemason	共济会会员
damned	该死
abyssal	深渊
unmentionable	不宜说出口的
flexibly	柔软地
caller	呼叫者
deliberate	故意的
muffle	压抑
potass	苛性钾
unfaithful	不忠实的
notably	特别地
fit	恰当
wonder	惊奇
hade	伸角
pendulous	下垂
ichthyolatry	鱼类崇拜
hazy	烟雾弥漫的
liposoluble	脂溶的
scatty	低能的
clocker	计时员
weakly	有病的
airburst	炸弹在空中的爆炸
belowdecks	在船舱内
overlook	眺望
psid	pounds
anzuk	澳新英
unriddle	解
project	投射
neanic	青年期
ministrable	适合
coalport	煤港瓷器
nobleness	高贵
hypsometrical	测高术的
secularize	改作俗用
poole	普尔
bonded	抵押的
remorselessly	冷酷
lilacky	淡雪青的
gin	轧棉机
justiciable	可在法庭裁决的
plotinism	柏罗丁的哲学体系
steep	不合理
brazen	黄铜制
overlook	俯瞰中的景色
germanophil	崇拜德国的人
blepharoplast	生毛体
flowery	多花
anemometric	测定风力的
unperceptive	无识别力的
blubber	鲸脂
steady	坚定不移的
wats	Telephone
cyclostomous	圆口动物的
intolerable	难耐
indent	缩进
blah	乏味
limb	肢
behove	理应
latifundio	大领地
isogony	等称发育
broking	做经纪
baee	elementary
object	反对
bibliophile	藏书家
endosteal	位于骨内
rinforzando	突然增强的
underdraw	不充分地描写或叙述
antependium	帷幔
actinomorphous	幅射量的
ethicals	凭处方出售的药品
aeromagnetics	航空磁测学
err	犯罪
spaz	怪人
careful	小心的
temple	礼拜堂
undecided	不稳定的
ravishment	销魂
sanskritist	利用梵文神话支持自己之见解者
spurtle	拌粥木棒
linen	亚麻布制的
yawny	打呵欠的
satai	加香烤肉
highroad	公路
flurr	撒开
curate	助理牧师
osteosarcoma	骨肉瘤
inguinal	腹股沟的
ruddock	知更鸟
millilambert	毫朗伯
canaliculus	小管
superordination	上位
christopher	克里斯多佛
eidos	文化表相
conversation	会话
vein	性情
frutescose	灌木的
faa	Federal
speak	发言
openmouthed	惊讶
bullwork	牛马活
transnature	改变本质
decahedral	十面体的
drink	饮料
icky	过分甜的
stumble	踌躇
half	一半的
jettison	投弃
domestically	合乎国内地
honorable	荣誉
slovakian	斯洛伐克人的
epiphanic	顿时领悟的
expectancy	期待
encomiast	赞美者
sequel	结局
lockpick	=picklock
quibbling	找碴子
idiolectal	个人习语
coagulative	凝结物的
topocentric	面点
msls	in
serioso	严肃
sabian	拜星者
attachable	可连接
rubbery	有弹力的
specially	特别
waspy	似黄蜂的
defecator	澄清者
achaean	希腊
pander	勾引者
broiling	酷热
baccy	烟草
imperator	最高统治者
tchad	=Chad
unhasty	从容的
kept	受人资助控制的
exfiltrate	溜出敌军阵地
supernal	天上
suppliantly	恳求着
would	will的过去式
lumberly	笨重
westing	西距
tongueless	无舌头的
possible	可能存在或发生
inoculation	接木
thin	使淡
scrooch	蜷缩
semicylindric	半柱面形的
merseyside	默西塞德郡
reign	盛行
postmortem	死后
israelitic	古以色列
zooxanthella	动物黄藻
moderato	中等速度地
evaporative	蒸发
pseudosalt	假盐
contempt	轻视
flambe	燃烧着
infructuous	徒劳的
omphalos	星
equipartition	均分
photobiologic	光生物学
taurine	象公牛
encrinite	海百合
xerothermic	干热的
nccw	全国女天主教徒理事会
thrust	插入
time	打拍子
hellery	撒野
sampler	样品检验员
possibly	可能地
ashcan	深水炸弹
punctulated	有小点的
despiritualize	使世俗化:
stereograph	立体照片
sensate	知觉
dinkum	诚实
qos	服务级质量
aneurysmal	动脉瘤的
chordee	阴茎痛性勃起
avitrice	女飞行家
rct	Royal
candied	甜蜜
supportless	无支撑的
cyanite	蓝晶石
primigenial	原始型
count	认为
weasel	含糊话
compline	晚祷
nonproletarian	非无产阶级
antifertility	抗生育
zoomorphosed	似动物造型
jelab	带风帽的外衣
bedmaker	寝室管理员
approximatively	近似地
zonerefine	用区域熔炼法生产
phoenix	凤凰
dumpishly	忧郁地
incontinent	无节制的
fop	过分讲究衣饰或举动的人
lustreless	无光泽
colporrhaphy	阴道缝术
rexine	仿造皮
astraddle	跨着
leisurable	从容的
acetarious	拌生菜食用的
coterminous	相连
origin	起因
wats	大地区长途电话服务
xystarch	竞技场监守官
barracuda	梭鱼类
torii	牌坊
octonarian	八韵脚的
noncom	未受任命的士官
buckler	防卫
erberry	接骨木之果实
carneous	肉色
chemically	以化学方法
horseless	不用马
history	过去的事
zebeck	小型三桅船
puppyish	小狗
hetman	哥萨克人的酋长波兰军事指挥官
schoolman	教授
quadripartition	一分为四
skimming	撇取浮沫
leaden	铅灰色
metallide	使起金属间化合
dibromide	二溴化物
fornicate	通奸
prealtar	祭坛前的
baudelairean	关于波德莱尔的
bacchii	短长长格
attemper	调和
recover	胜诉
acutilingual	尖嘴的
yard	院子
repower	再向……提供动力
lattermost	排在最后
vaticanist	梵蒂冈主义者
tendinitis	腱炎
psychon	心灵粒子
exemplary	惩戒性的
underproduce	减产
leguminous	豆科的
symplectic	偶对的
sniffish	轻蔑
advanced	先进的
inc	公司
toothlet	小齿
wittily	机智地
aristotelean	亚里斯多德派之学者
dentulous	有牙齿
midianite	米甸人
giro	旋翼机
cylindromatous	圆柱瘤的
dovish	鸽派
disimprison	使出狱
sanctified	认可
tribune	讲坛
unphysiological	不符合生理规律
diagrid	堆芯栅板
nom	nominal名义上的
imido	酰亚胺的
tergiant	作拱背状
pale	栅栏
plaintive	哀伤
foundry	铸工厂
spoony	痴情的
walhalla	=Valhalla
fibula	搭扣
down	向下
cohere	粘着
unfished	非钓鱼用
carnitine	肉碱
reune	重新聚会
cowcatcher	广告
washing	洗涤物
jamaican	牙买加人
begirt	被围
unhesitatingly	迅速
dewy	露湿
preconcerted	事先计划的
rama	最高神毗湿奴
adumbrate	预示
shirttail	社论栏
malleable	可锻
pushbutton	按钮
carrion	令人作呕
autofilter	自动筛选
blusterous	夸大
arrow	箭头记号
finagle	哄骗
hercules	力士
polymorphous	多形
segregable	可分离的
multiloquence	多嘴多舌
throughput	生产能力
hilarity	欢闹
anthill	人群密集的地方
stanchly	忠实
homeliness	朴素
animated	活生生
trichord	三弦琴
psalmodic	唱赞美诗
vesiculate	小泡状的
insalivate	使混涎
circulative	促进循环的
undreaded	不被惧怕
gourbi	简陋的住处
inhumanly	残忍
pyrenoid	蛋白核
hbms	HisBritannic
cumulative	累积
disoriented	分不清方向或目标
telescreen	电视屏幕
selenium	硒
usis	Service
gallo	法国
goitre	甲状腺肿
tamp	夯实
epulotic	结瘢的
gemmaceous	像芽体的
cucullus	修士之兜帽
sibilant	咝咝作声
willowy	易弯曲
solecize	犯语法错误
snowcap	山顶的积雪
suberect	几乎笔直向上长
burp	打嗝
frank	坦白的
intranet	企业内部互联网
jazziness	喧闹
trench	沟渠
imaginatively	想象上
crystallogeny	结晶发生学
scrollwork	漩涡形装饰
longtime	为时甚久的
xpvm	Monitor
interlacement	交错
sacrament	基督教圣餐
dc	数字认证
damfool	非常愚蠢
visibility	明显度
necrology	死者名册
meerschaum	海泡石
cavate	挖空岩石而形成的
nutted	用螺帽固定的
redefect	再逃跑
nls	natural
unsevered	未切断
burden	担子
eclat	显赫之成功
ablare	喧闹
saltern	盐田
denaturation	使变性
breakup	崩溃
tympanic	鼓室
interrelated	相关
vegetation	植被
uscf	Chess
uncomfortable	不合意
elamitic	埃兰人
edi	Interchange
sylvicultural	造林
dismoded	过时
disclaim	拒绝
rumbustious	喧闹
prosect	解剖
asphaltite	沥青岩
misbecome	不适宜于
secretarial	秘书
traction	牵引
killick	小锚
peremptorily	不容分说地
immanent	内在
garonne	加伦河
gaul	高卢
edible	可食用的
pedestrian	呆板
pinteresque	品特派戏剧
stunt	发育迟缓
cephalization	头部集中化
pleuroperitoneal	胸膜腹膜
northmost	最北部
inopportune	不合适
sideward	向侧面
feather	轻的东西
sulphuret	硫化物
crampon	鞋底钉
litten	点燃
desiderative	愿望
phase	定相
prau	马来人所用的细长快速帆船
dqdb	Dual
extemporaneous	临时的
prepsychotic	精神病前的
unemotionality	客观
incoagulable	无法凝固
xanthin	叶黄素
unhorse	从……卸下马来
mshe	Master
jacinth	风信子石
betony	石蚕
peck	啄
nonetheless	但是
wourali	=curare
ufology	不明飞行物学
nomenclative	命名
imperialize	帝国主义化
comprisal	包容
harleian	哈利父子搜集的文稿及图书
think	思索
objectionable	讨厌的
languidly	疲倦
crenulated	小圆齿状
fixture	比赛时间
biyearly	每年两次的
rubbery	橡胶似
popery	教皇制度
unbearded	无胡须的
apartment	房间
woman	女性
retral	在后面
countermine	用候敌地道防卫
voguey	风行一时
acknowiedged	被普遍认可的
symptomatic	征兆的
linenfold	折布式的
swirl	打漩
biparty	两党连合
fortnightly	每两周
manufactory	工厂
heterotopia	异位移植
conto	货币计算单位
limnological	湖泊学
inquietness	不安
helpless	没用的
cagey	谨慎小心
feverous	热病
calcinator	锻烧器
crossable	可交配的
touchable	可触
caravaggesque	卡拉瓦乔作品的
abyssal	深海的
atavistic	返祖性
semitic	闪族人
cavelike	似穴的
isochar	等特性线
leprose	鳞状的
kashruth	犹太教的饮食教规
correct	恰当
singly	单独地
noisemaker	会高声喧闹的人
lacw	Leading
pictish	皮克特族的
nutrimental	有营养的
gooky	滑腻
incisory	门牙的
lymphangitis	淋巴管炎
blazing	闪耀
underhand	下投
galago	夜猴
lavatory	洗脸盆
dehydroepiandrosterone	脱氢表雄酮
exsanguinate	使无血
omit	遗漏
frequenter	常客
transformation	变化
lydian	吕底亚人
pecuniary	应罚款
crazed	疯狂
favourite	特别喜爱
trinary	三重
subornative	教唆伪证罪的
counterdevice	反飞弹装置
magnoliaceous	木兰科的
distasteful	讨厌的
playa	沙漠中的盆
flaringly	华丽而俗地
macedonia	马其顿王国
pose	造成
eunomic	井井有条的
take	获得
foretoken	预兆
apb	bulletin
skive	把……割成薄片
ptolemaist	天动说信徒
ipts	Temperature
sledgemeter	雪橇里程计
fellow	同事
microgramme	微克
steamer	蒸汽机
caspian	里海
tabi	日本式厚底短袜
plastral	腹甲
perplexity	困惑混乱
confederation	联邦
ultrafine	非常细微的
gondolet	小型凤尾船
pluviograph	自记录雨量计
biting	尖锐的
sunk	sink的过去分词和过去式
haplopia	单视
dnf	finish
nemacide	杀虫剂
speeding	超速行驶
foregoing	前述的
nocardia	诺卡氏菌属
autoaggressive	disease
shortcut	捷径
ruffe	梅花鲈
jackstaff	舰首旗杆
tinty	色彩不调和
kilted	打褶
modulate	调节
unfinished	未完成
windup	装有发条的
crescive	增加的
mystique	奥秘
dainty	优美的
contradictorily	反驳地
decimalization	十进制
fucked	受骗的
wootz	伍兹钢
engagement	接合
vascar	Recorder电脑平均车速记录器
nazify	使纳粹化
bustling	忙乱的
descendant	子孙
crowfoot	吊索
hyfil	海菲尔
celsius	摄氏
aep	AppleTalk回应协议
routinier	正统派乐队指挥
rubbish	废物
trigoneutic	一年三化的
ocs	Candidate
deliquium	失神
sectarial	=sectarian
lettered	有文化修养
manganic	自锰
allegorize	以寓言诠释
desipient	琐碎的
dreamily	梦似
throughly	彻底
flexuose	曲折的
sleuthhound	警犬
phrenitis	精神错乱
falsehearted	欺诈的
unaneled	未受临终涂油礼
belle	美妇
specific	详细而精确的
oropharynx	口咽
rocket	火箭
calling	召集
indus	印第安座
empyreuma	焦臭
fancydan	华而不实
understatement	保守的陈述
buirdly	强健
un	联合国
genevan	加尔文教徒
varietal	品种
quark	夸克
conrail	联合铁路公司
resect	割除
downrange	发射中心和沿着试验航向
wisp	把……卷成一捆
midriff	膈
curlypate	头发拳曲的人
cacholong	美蛋白石
slipcover	套子
result	起因
vagrant	游民
nonunionist	反对工会者
neurolept	=neuroleptic
periwinkle	玉黍螺
realizable	可实行
libreville	利伯维尔
riouw	Archipelago
unnational	非民族
ast	较大的电脑生产厂家
improvisatore	即兴作曲家
chesterfieldian	柴斯特菲尔德爵士所有
carom	一击连撞二球
interrogator	讯问者
distortion	变形
manuduction	指引
pestle	槌
consort	同航线的船
urdu	乌尔都语
northmost	极北的
marshy	生于沼泽
weightily	沉重
figuline	陶土
crowfoot	毛莨等的俗称
science	自然科学
ferryhouse	旅客等渡船的候船室
haleb	=Aleppo
doyenne	女性老前辈
epiblast	外胚叶
unnational	非国有
pious	虔诚
smoketight	不透烟
browsy	适宜于随便翻阅
repaint	重漆
dimidiation	切半
palish	稍微苍白的
dyspeptic	胃弱的
hydrophile	吸水
dichlamydeous	两被的
conglomeritic	=conglomerate
clear	清澈的
bleak	寒冷的
sexual	有性的
table	台子的
gummiferous	有树胶的
leukemic	白血病
bacchantic	狂饮作乐
gettable	可以获得的
havre	=Le
tussal	咳嗽
leaseback	回租
phonetic	语音学的
sortilege	巫术
parenteral	注射用药物的
cultivated	耕耘的
georama	内壁绘有世界地图的空心大圆球
seizing	捆绑
prolific	多产的
cerebrate	用脑筋
piccolo	小型
unskilful	不熟练
nitwitted	糊涂的
teatime	喝茶时间
unfinished	未琢磨
jest	开玩笑
herniation	形成疝
vasodilating	血管舒张
infantility	幼稚
uto	United
cupper	用杯吸法者
myrmidon	忠实的追随者
gavelkind	一种土地、财产继承制度或习惯
parathyroidectomize	`pArE9WaIrRIRI`dektEmaIz/
aduncate	向内弯曲的
ulterior	将来
drivel	说傻话
makuta	likuta
canonical	规范
ghostly	可怕
thiuram	秋兰姆
vespers	晚祷
fense	围住
morbidity	不健全
ductor	油墨辊
emancipator	释放者
neutral	不确定的
portraitist	人像摄影家
tlas	三个字母的缩写
jarvey	二轮马车车夫
waxy	象蜡
plainclothes	便衣
gippo	肉汁
adrenalize	使激动
ebb	潮退
pronto	很快
inseam	内接缝
clear	完全地
crudity	生
thunderous	象打雷的
fitted	合身的
motory	引起运动的
flattering	讨人欢喜的
wellhouse	井楼
inbound	内
gripesack	手提包
funniosity	可笑的事
xerophytism	喜旱性
abiochemistry	无生化学
subscriber	订户
expiable	可偿的
stridulation	鸣声
sculpture	刻蚀
elastomer	弹性体
dispassionately	冷静地
base	根据地
microseismology	微震学
divisible	可分
hippodrome	跑马场
compulsive	由强迫产生
twinborn	孪生
cordial	兴奋剂
acrimoniously	尖刻地
maternity	孕妇
slip	Interface
mna	Administration
sublime	崇高
capacious	容积大
extirpate	消灭
abidance	持续
triturable	可研磨成粉末的
dealing	行为
airborne	空降的
promotional	增进的
pillory	示众
bazooka	火箭筒
conradian	康拉德
introducing	引介
dentiform	齿状的
measle	米珠
willow	柳木制
frizzle	吱吱响声
html	Language
nickelic	含镍
perch	人所居的高位
alluring	迷人的
earliest	早的
parnassian	诗
equal	比得上
hong	行
regenesis	复活
matriculate	被录取者
brcs	Red
conjunctive	连接的
pore	熟读
prudish	过分规矩的
nasaiism	发音鼻音性
speckless	无瑕疵的
sheargrass	剪刀草
quartette	四重奏
ferruginous	铁的
ashram	聚会所
moot	无实际意义的
canalage	运河通行税
nonboarding	不搭伙
roman	罗马人的
elegant	端庄
unlanded	没有地的
frse	Society
otherguess	别种
hyphal	菌丝
stringless	无细绳的
craniology	头骨学
illogically	不合逻辑地
headstream	发源地
eventual	最后的
domain	领
complaint	抱怨
flabbily	无活力地
acrasia	自控能力缺失
turgite	水赤铁矿
echelon	梯次编队
crick	急性硬直
experimentize	进行试验
jamming	干扰台
helmet	头盔
unprinted	未经印刷
zionite	支持或拥护犹太人复国运动者
renegado	=renegade
infibulate	套住
casper	一个卡通造型
broad	主要
mathematical	精确的
unmirthful	不高兴的
broad	露骨
globoid	球状的
arsenopyrite	毒砂
crookedly	弯曲
dsrv	rescue
causalgic	灼痛的
notts	=Nottinghamshire
unstockinged	未穿长袜
perchloride	高氯化物
bowlder	玉石
entitle	给……题名
grievance	冤情
moravia	摩拉维亚
pasteurella	巴斯德菌
concept	观念
sluttish	邋遢的
pearly	用珍珠装饰的
complemental	补充的
nominee	被任命者
pretense	主张
scholasticism	墨守成规
aepyornis	隆鸟
chromocentre	染色中心
israelitish	古以色列的
argo	Jason求取金羊毛所乘之船
preignition	预燃
ploughback	利润再投资
dubious	不确定
pants	裤子
block	阻塞
dud	无用物
cockle	麦仙翁
matrilateral	母系
stainless	不锈
knap	打碎
contrastimulant	镇静剂
nasute	头部有鼻形突出的
sluttish	淫荡
hiroshima	广岛
coptic	科普特人的
cramp	难解
anticathode	阳极
misuse	误用之实例
cattiness	如猫的性格
geometrid	尺蠖娥
friary	寺院
sba	Administration
prelatical	教长政治
tithable	课十分之一税的
carpet	地毯
since	自……以来
mycophagist	食菌者
autoconverter	=autotransformer
schizomycosis	裂殖菌病
unmatched	无比的
lustrum	人口普查
revolted	起义
actinoid	放射线状的
velutinous	天鹅绒状的
masher	对女子调情者
deathly	死一般
wen	人口集中的大城市
hrip	in
driblet	微量
abranchial	无鳃类的
sufficient	充分
kedger	小锚
cogged	骗人的
satiate	满足
deuteron	氘核
sulfonium	=sulphonium
kapellmeister	合唱团或管弦乐队的指挥
columned	立有圆柱
traitorously	叛逆地
underripe	不够成熟
undemanding	容易的
undistinguished	平凡
regurgitant	回流
hieratic	僧侣
psychiatric	精神病学的
pooftah	脂粉气的男子
stead	对……有用
clamour	喧闹
astir	起床
frustrated	失败
punctum	细穿孔
bread	生计
style	类型
homophonic	齐唱
unrhythmic	无韵律的
pharyngoscope	咽镜
detrude	推倒
soilborne	土壤带有
christianly	有基督徒性质的
passus	节
msts	Sea
aesir	为首的诸主神
flexuous	曲折的
unwed	没有结婚
thrift	节俭
runway	飞机跑道
nongonococal	非淋病性
backless	无后盾的
rammish	好色的
destruction	毁灭
nasty	令人厌恶
helpless	无助的
comically	滑稽
oomiac	=umiak
sagely	贤能
pervasive	普遍深入
noncommissioned	无委任令
dorsetshire	多塞特郡
teacup	一茶杯容量
alleviant	缓和剂
imaginative	虚构
olio	杂集
deniable	可拒绝的
arrestment	逮捕
flog	驱使
mdap	共同防御援助计划
devoice	使浊音变清音
verligte	开明分子
intentness	热心
effervesce	冒泡
subdepot	分仓库
cunt	肉体
strangulation	箝制
very	真实的
discretional	自由决定的
esperance	希望
teether	出牙嚼器
cingalese	锡兰人的
novel	新颖
colter	犁头
ardent	燃烧般
randall	兰德尔
parentally	像双亲
agger	古罗马帝国的道路
yawny	令人打呵欠的
energize	活动
stratocracy	军政
cyclical	轮转的
hope	信赖
auxocardia	心扩大
buzz	作嗡嗡声
fall	失守
swanky	时髦的
plush	舒服的
pietism	虔敬
nullipennate	无飞行羽
scoot	溜走
blackmailer	敲诈者
hvar	velocity
overfleshed	过肥
pyrrhonist	绝对怀疑论者
slightly	些微地
landsturm	国家总动员
unshaded	无光度或色泽差别的
foreshow	预告
coppernob	头发呈紫铜色的人
crotchety	有怪想
genitival	属格
turgor	肿胀
outmaneuvre	以策略制胜
irascibly	脾气暴躁地
vast	辽阔的
suppletion	补充法
kite	试探性行动
choice	爱惜
evadible	=evadable
manueline	曼奴埃尔式
fertilizable	可施肥
overproud	过分自豪的
homozygote	纯和体
jurimetrics	判决法理学
conciliarism	至上主义
wale	挑选
pointer	指示器
dreamfully	梦多
soviet	苏联的
vertu	艺术品或古董
visitator	视察员
pvm	并行虚拟机
headlike	似头的
inhabitation	有人居住的状态
hydrographic	与水文地理有关的
intended	n
trivially	无能地
viniferous	产葡萄酒的
callan	青少年
draggle	拖脏
heliodor	金绿柱石
extenuative	使减轻的
crosswise	斜地
afrormosia	非洲红豆树
plosion	爆破音
brassily	低廉而华丽地
stridulate	发出尖而高的声音
unescorted	没有护卫
cranky	摇荡不稳
pontiff	大祭司
extortionate	勒索的
methodic	有条理
radiotelephony	无线电话
carry	能达到
pri	初级速率接口
dissatisfaction	不平
unesco	联合国教科文组织
grainy	木纹状
canalicular	微管的
ensorcellment	蛊惑
radius	半径
dilettantish	半瓶醋似
anonymously	化名
justiciable	可在法庭裁决
seasoned	经验丰富
revolution	旋转
decuple	十倍
fastener	纽扣
bacony	熏肉一样的
luxuriant	丰产的
slatted	用板条做
bodensee	博登湖
haram	共配一雄的一群雌性动物
lankly	细长
backless	无靠背部的
economic	经济
leader	社论
mouseproof	防鼠
frgs	of
fianna	爱尔兰勇士
southwester	西南风
emanate	散发
doughhead	傻瓜
nonrecurrent	不反复出现的
teutonism	日耳曼精神
tress	枝条
subsequent	并发的
wholesale	批发
hebei	河北
postholder	担任职务者
beautifully	漂亮地
classy	优等
north	北方的
posb	邮政储蓄所
deodorant	除臭的
aristotelian	亚里斯多德学派的人
skeptical	无神论的
loral	眼端的
wlm	movement
unremitting	不懈
serotonergic	含血清素
tael	两
tripinnate	三回羽状的
naturopath	自然疗者
costly	昂贵的
din	絮絮不休地说
comment	注释
latria	专对天主的最高敬拜
guilty	犯罪
eternal	没完没了
lubrical	=lubricous
habilitate	提供周转资金
excaudate	没有尾
nosogeographic	地域病理学的
micronucleus	微核
clarinet	单簧管
offhand	即时的
bilestone	胆石
swart	黑黝黝
dactylioglyphy	玉石雕刻术
spicily	讽刺地
atmometric	蒸发计量学
lousily	讨厌地
dextrocular	右眼优于左眼
harmlessly	无恶意
punny	一语双关
distressing	悲伤的
familiarly	精通
aphanitic	非显晶岩
placement	放置
narrowly	精细
nae	不
liber	登记册
unsegregated	打成一片
unwatered	干旱
indubitable	不容置疑的
political	政治的
navigate	操纵
stud	马群
suggestible	耳根软的
yoga	瑜珈术
roily	动荡
diadochokinesia	轮替运动
oxidise	=oxidize
reconvey	取回
unbrotherly	非兄弟般
shrewmouse	形如老鼠的动物
ringsider	坐在场缘前座的人
sab	Science
nethermost	最底下的
spectacled	有眼镜状斑纹的
crannied	有裂痕的
studding	壁骨材料
snuck	sneak的过去式和过去分词
consenting	同意的
cratered	多坑的
lad	青年男子
semifascist	半法西斯主义的
bowdlerize	删除不妥的文句
designing	有计划的
externality	讲究外表
prohibition	禁止
thenceforward	其后
nail	钉子
mouthwash	废话
triangulable	可单纯剖分的
treenail	大木钉
scrawny	骨瘦如柴的
fibrocement	石棉水泥
isomerize	异构化
mask	使模糊
friar	男修道士
arrow	箭
cnn	以提供即时电视新闻报导而闻名
lensman	摄影师
consular	领事
carnal	性欲
scrivener	公证人
tentacular	有触手的
attainments	成就
patripotestal	父权
fiefdom	采邑
disestablishmentarian	/
heterograft	异种移植物
faineancy	不管
scissile	易裂开的
aftershock	余震
alumnae	女校友
bardolater	崇拜莎士比亚的人
preprofessional	为从事职业作准备
westward	向西的
invincible	不能征服的
rubytail	青蜂
hopple	把脚拴在一起
quinquagesima	四旬斋前的星期日
supervoltage	超电压
swordplay	剑术
uc	computer
harmless	无害的
subdistrict	小区
disprovable	可证明为误
ling	鳕鱼
trouvaille	意外收获
cognizant	认知的
choreographist	编舞者
larcenous	盗窃
fruticose	灌木状
spice	趣味
arithmetic	算术
fluidity	流质
strap	皮带
legume	豆荚
unconventional	非传统的
androcentric	以男性为主
cv	vision
ladyhood	贵妇之身份或风度
banana	香蕉
purine	嘌呤
impavid	无惧
slag	矿渣
corruptibly	可被收买地
abscise	切除
araneology	蜘蛛学
exacerbate	恶化
scouting	守候活动
hcl	high
millstone	重担
tiercel	雄鹰
implausibility	不象真实的
caplin	=capelin
severity	激烈
rashly	无见识
microcopy	缩微本
transferable	可转换
refoot	换底
rosiness	淡红色
sulphonic	酸性硫酸基
zunyi	遵义
gigametre	百万公里
hoop	戒指
emblazonment	纹章装饰
glair	釉桨
swither	困惑
resuscitate	复兴
wholescale	成批
latent	潜伏
maleficence	恶行
somatic	肉体的
shiner	打伤的黑眼圈
thioarsenite	硫代亚砷酸盐
consummate	至上的
packman	小贩
aloetic	芦荟
laurence	男子名
electrolytic	由电解产生的
wolframite	铁锰重石
unprofitable	无利益的
emulsification	乳化
aero	飞行的
octahedral	八面体
targeman	持盾者
photochronograph	动态照相
chromatology	色彩学
ujjain	乌贾因
residence	住处
initialism	词首字母缩略词
monticulate	有小丘陵的
puberulent	被微柔毛
elysian	象天堂的
gesture	表示
rbs	Sculptors英国皇家雕塑家协会
bavarian	巴伐利亚方言
slighting	藐视
agminate	聚集的
riddling	解谜的
proportionately	成比例地
unheroic	不英勇的
coper	马贩子
umayyad	=Omayyad
levelling	使成水平
rallyist	参加汽车竞赛者
whole	未损伤的
froe	锛
boldfaced	粗体字的
boldfaced	冒失的
supportability	可支持
taint	污点
lollypop	棒棒糖
sigmatropic	单键转移的
bohr	波尔
phototypy	凸版照相术
tutti	合唱
hilt	刀把
intentional	有意图
phrenitis	谵妄
bestow	安放
sermonesque	讲道
ranker	出身行伍的军官
sigmatropic	单键转移
gonorrhea	淋病
utricle	小胞
ata	高级技术附件
comprehensible	易于了解的
levee	防洪堤
champion	拥护
miswrite	写错
qr	rook
peenge	抱怨
monopolistic	专利
embalmment	薰香
reentrant	再进去的
kirigami	剪纸艺术
cutis	真皮
thermidor	热月
jointly	连带地
kook	愚蠢
spadable	可铲掘的
fibrillous	纤维状
innervate	促使活动
leftism	急进主义
crepuscular	拂晓
agminate	成群
barelegged	没有穿袜子
razzle	眼花缭乱
dreamful	常易梦见的
departure	出发
lateralization	偏侧性
exorcise	除怪
unclouded	晴朗
awshucks	质朴无华的
hydrosere	水生演替系列
timecard	工作时间记录卡
rally	集会
confoundedly	恼人地
bba	business
licet	那是合法
distinction	声望
restaurateur	饭店主人
upswept	向上斜的
wellingtonian	威灵顿
adjuvant	助理员
loser	输者
cinematics	电影艺术
exfiltrate	溜出敌军阵
honied	甜如蜜的
treat	宴请
tagmemicist	序位学家
unheroic	胆怯的
justificatory	起辩护作用
stearine	硬脂
superjacent	在上的
hatless	不戴帽子的
gravelly	铺有碎石
threadworm	蛲虫
uncle	伯父
ost	of
nyt	Times
namely	也就是
tew	战术预警
liaison	联络
sbn	Number
quadrivial	四路交叉
riverside	河岸
fissure	裂沟
preignition	提前点火
fabled	寓言中
plasmoid	等离子体团
colonnaded	有列柱的
ditto	与前同
ips	second
screed	冗长的句子
repentant	有悔改表现
geriatric	老年医学的
heritor	嗣子
gray	广告商的
profligate	肆意挥霍
enculturative	使适应某种文化
unobservant	不遵守
eonian	永远的
isomerization	异构化
lolly	棒棒糖
subchairman	副主席
proof	试验
microcosmic	微观宇宙
urinose	尿
unsung	未赞颂的
doctrinal	学说的
nannoplankton	微型浮游生物
uri	Identifier
amuse	使愉快
wiredrawn	太琐碎
urgent	紧急的
calif	哈里发
titaniferous	产钛的
stage	筹备
autography	亲笔
fleece	诈取
basehearted	性情卑鄙
peenge	发牢骚
norwards	往北地
reentrant	凹角的
frowsty	闷的
msee	Science
monumental	非常
inner	内部
decongestive	可降低充血的
ephemeris	短命的东西
fastigiate	倾斜
merry	欢乐的
cdma2000	Multiple
armour	装甲部队
lienal	脾
ramona	拉蒙纳
slothfulness	懒惰
smtp	Protocol
distressing	使痛苦
cos	余弦
pseudomemory	记忆错误
formation	编队
washery	洗涤处
unescorted	无人陪同的
bountifully	慷慨
retardance	迟缓
waterbrain	=gid
reprehensible	应斥责的
monarchic	国王的
actomyosin	肌纤凝蛋白
stymie	妨碍球
twinge	如刺一样痛
anapestic	短短长格
abstractionism	抽象派艺术
egotistical	自我本位的
surfmanship	凌波舟驾驶技巧
crosscourt	斜线
fan	迷
oecd	Development
superb	堂堂
minus	负的
zwieback	烤干面包
descensive	下降的
inexpressive	缺乏表情
palaestra	角力学校
corporative	社团
fecal	糟粕的
autocratic	独裁
erasure	记号等
chartered	受特许的
irruption	侵入
tawny	茶色
kennetic	认知的
literalness	文字的
disemploy	开除
ribosomal	核醣体的
promotee	被提升者
oos	Out
zymosan	酵母聚糖
bradycardia	心搏徐缓
racemulose	串状排列的
filmgoer	常看电影的人
exterminatory	有根绝作用
cytoplasm	细胞质
separate	单独的
kaonic	含有K介子
state	情形
oscinine	鸣禽类的
ornithischian	鸟臀目恐龙
wonsan	元山
rowdedowdy	=rowdydowdy
eventual	结局的
klipdas	野兔
dastardliness	懦弱的行为
scorzonera	鸦葱
lah	6
yarak	强健
razorback	剃刀鲸
knockabout	粗造
argot	暗号
ideaed	主意多的
incorporeal	无实体
karelian	卡累利阿人
infirmity	衰弱
emancipatory	解放
discommodity	麻烦
unattended	没人照顾
yagi	引向反射天线
chafferer	恶作剧者
zn	元素锌的符号
sourcebook	原始资料
strikethrough	删除线
maternal	母性
mutafacient	诱变
banality	陈腐
colonnaded	有柱廊的
solanum	茄属植物
jouk	躲避
reflector	反射镜
languishing	渴望
awry	歪曲的
tartness	酸
noplaceville	偏僻小镇
repeated	再三的
multilateral	多国的
braincase	脑壳
mizzle	蒙蒙细雨
viny	象葡萄树
oogamous	卵配生殖
cither	齐特拉琴
tidily	整洁地
affright	惊吓
lame	僵痛的
maytime	五月时节
phytol	叶绿醇
dimply	有凹处的
explode	使爆炸
ventage	小孔
believing	有信仰
imprecise	不精确
flyaway	宽大不合身的衣服
circumscissile	周裂
guilt	内疚
rabbiteye	兔眼乌饭树
poloist	马球比赛者
contempt	不尊敬
ergodic	各态历经
filter	筛选
eurocrat	欧洲共同市场的官员或职员
stubbed	残断
guesthouse	宾馆
macroptic	患视物显大症
moorhen	雌苏格兰雷鸟
fetter	脚镣
anticatarrhal	抗卡他的
czarina	沙皇皇后
teacup	茶杯
peradventure	可能
exudation	渗出物
posterize	多色调分色印
synovial	分泌滑液的
gnn	全球网络导航器
pulverulent	满是粉
confiscable	可没收
modulo	以……为模
civil	民间
excursion	短程旅行
result	以……为结果
moll	Mary
semilustrous	略有光泽的
vaginated	有叶鞘
paper	用纸糊
asternal	不连胸骨的
lectin	植物血凝素
egg	怂恿
vaaljapie	劣质新酒
geitonogamy	同株授粉
stow	装载
monovalent	仅能抵抗某种病菌
jeeringly	嘲弄
angel	天使
northwestward	向西北
pubescent	思春期的
underhand	秘密
msha	of
slipslop	无味的
freehand	凭手画的
drawsheet	抽单
schizont	裂殖体
biter	咬人的动物
succedaneous	替代
entirety	完全
telemetric	遥感勘测的
spaewife	女术士
interchange	交换
souse	扑通地一声
brocaded	穿锦缎的
please	使喜欢
fall	瀑布
killing	使人疲乏的
more	大大高于
capsicum	辣椒
rsv	Version
impressibility	易感动
simper	假笑着说
estrepe	浪费
assumption	假装
retail	以零售方式
axunge	猪油
exhaust	用不完的
allowance	允许
centralist	中央集权主义者
pressure	强制
polysaccharid	多醣
axenic	无菌
contributing	贡献的
nonfiltered	没有过滤嘴的
mephistophelean	险恶而狡猾的
torment	痛苦
irksome	令人厌烦
baltic	波罗的海诸国
multiracial	多民族
thessaloniki	=Salonika
woman	使成女人腔
withershins	逆时针方向
premeditated	预谋
raca	一文不值
cauterant	腐蚀剂
restart	重新启动
octocentenary	800年
failingly	似将断绝地
radicant	从茎部生根
rustler	积极分子
coccid	介壳虫
invocation	祈祷
logion	名言
sitomania	贪食症
dianetic	排除有害印象精神治疗法
sublattice	子格
vine	藤
sangfroid	冷静
reconstructed	改造
poussie	小猫
sib	近亲的
auramine	金胺
appendices	appendix的复数
hitlerian	希特勒
slimmish	稍为苗条
thunderbolt	霹雳
micell	=micelle
radioactive	有辐射能的
antalkali	碱性中和剂
megadyne	兆达因
dinkum	可靠
queuetopia	到处排长队的社会
dvd	数字光盘
quadrillionth	千万亿分之一
respect	尊敬
fancydan	华而不实的
excruciation	酷刑
forethoughtful	adly//
clothe	给……穿衣
polemical	辩论法
fordless	没有浅滩
lpn	Licensed
mass	大多数
whorl	螺纹
beckoning	引诱人的
nocturnality	夜间活动的习惯
dissipator	浪子
dowel	销子
schuss	高速直线滑雪
scramble	拼凑
wordily	唠叨
rite	礼拜式
wired	以铁丝围起
psychotic	精神病的
complacence	自满
vagotonia	迷走神经紧张
eriophyllous	叶上有绒毛
apt	有……倾向
cantonment	宿营
ecstatically	入神
gleam	一丝光线
cyathiform	杯形的
catalyst	催化剂
underabundant	不够富裕的
slablike	平板状
lathy	板条似的
latu	lat的复数
nitroso	亚硝基
knob	使有球形突出物
actuation	刺激
ciliiform	a
inextirpable	无法根除的
muteness	哑
johnstown	约翰斯敦
scandinavian	斯堪的纳维亚人
dystopian	反面乌托邦
serviceability	有用性
armourial	纹章的
unshakeable	坚定不移的
voltolization	高电压处理
autotomy	自割
waver	摇曳
redbrick	新大学
biogeocoenosis	生物地理群落
agamous	无性生殖
shaker	混合器
stygian	阴暗
party	社交会
banquet	宴会
urc	Uniform
acceptant	容易接受的
dlp	Light
recital	背诵
reprovingly	责难地
decapacitation	除能
lit	light的过去式及过去分词
basilica	长方形会堂
lateritic	含有红土
blastissimo	极强
primiparous	初产的
dinner	宴会
pulverization	粉碎
aetatis	在……岁时
afterschool	课外的
roxana	罗克珊娜
windsail	风车之翼
dirtiness	污秽
gradation	分等级
flaunty	虚华
pourable	可倾倒
multichain	多链的
sneaky	鬼祟
disguise	假装
bargain	合同
gallican	教宗权制限主义派
cornily	带乡下味地
adipose	肥胖的
paunch	腹
painfully	痛苦
bored	无趣
hornpipe	角笛舞
gdmo	for
wifie	=wife
gene	吉恩
breadless	无面包
neurohypophyseal	垂体神经部
midiskirt	中长裙
bechic	镇咳
sailfish	旗鱼
changeful	不稳定
produce	招致
vacuum	利用真空的
capitoline	古罗马的七个山丘之一
heterecious	=heteroecious
correctional	修正
venezuelan	委内瑞拉人的
colourless	乏味的
navar	指挥飞行的雷达系统
intervenient	介于其间
cristated	有冠的
appoint	任命
fissureless	无裂缝
menstrual	一月一次的
besmear	涂
spillover	外流人口
hetaera	妾
hurtlingly	疾驰地
modestly	谨慎地
autoimmunization	自身免疫作用
prognose	预测
jerboa	跳鼠
quick	活泼
saintship	圣徒的地位及品格
dropping	兽粪
oaec	Asian
sweetener	甜味佐料
semiarid	半干旱
illustrational	例证的
uscgr	Guard
nantes	南特
maidy	小女孩
unfreeze	融化
spine	剌
hypnos	许普诺斯
slantingwise	=slantwise
cultivation	耕作
salicylaldehyde	邻羟基苯醛
refinery	精炼厂
yahata	=Yawata
unprevailing	不起作用
scurrilous	下流
percentage	百分比
medium	半生熟
phleboid	静脉似的
exaltedly	意忘形
erogenous	性感的
barren	荒
terminological	专门名词
lithia	氧化锂
hippodrome	竞技场
wreck	拆毁
cockerel	小公鸡
mullet	胭脂鱼
gorki	高尔基
aplasia	成形不完全
comble	高潮
snowdrop	雪花莲
bystreet	胡同
filmdom	电影业
reservation	预定
hymenopteran	膜翅目昆虫
sissified	女人腔的
dispersedly	散乱
outsang	outsing
euphuistical	词藻华丽的
something	大约
direct	径直
theoretically	理论
apothecary	药剂师
discuss	讨论
unkindly	不近人情地
ruffianize	行为残暴
vouchsafe	允许
feathery	柔软如羽毛的
controvert	议论
amaldar	经理
sheave	捆
whole	所有
grizzly	略灰色
sax	萨克斯管
wisely	精明
ficin	无花果蛋白酶
nondiscrimination	9nCndI`skrImI`neIFEn/
employless	失业的
undersanded	掺沙太少的
jawan	印度士兵
distribution	配给物
discombobulate	使泄气
perceptible	可察觉
suit	一套衣服
regurgitant	反刍
pointillist	分色主义画家
ontologize	用本体论的观点看待
moabite	摩押人
floristic	植物种类的
typhomalarial	伤寒型疟疾的
nutburger	坚果牛肉饼
contribution	投稿
trembler	震动的东西
antimonic	锑的
cashmerette	仿开士米斜纹绒
hand	协助
automan	=automaker
sacral	圣礼
relight	再点火
banger	鞭炮
anticatarrhal	消炎
honorary	名誉
pulverulent	满是粉的
attestor	证明者
usurpatory	侵占的
cocket	海关之图记
negligible	可以忽略
sanative	有益于健康的
adulterer	通奸者
hawksbill	玳瑁
vexillary	旗兵
consentient	同意的
hyaloplasm	透明质
indigested	未消化的
bromize	用溴处理
sameness	同一
halogen	卤素
guileful	狡诈的
grotesque	奇异
nitty	多虱卵
slum	贫民窟
proclinate	向前
floriferous	开花的
snot	卑鄙下贱的人
assuming	傲慢的
heroicomical	英雄喜剧
venomous	有毒腺
logorrhea	多言癖
microtechnique	显微镜使用术
codeclination	余赤纬
aiche	Engineers美国化学工程师协会
callisthenics	运动
judgement	判决
tirelessly	不知疲倦地
spadebone	肩胛骨
toltec	托尔特克人文化
nameable	可命名的
contrite	深感懊悔的
nhra	Rod
atlantean	Atlantis
balsamic	如香油
simoleon	1元
epicurean	伊壁鸠鲁的
polyploid	有多倍染色体
ostentatious	装饰表面的
resitting	再次开会
wadset	抵押
inchmeal	徐徐地
extemporaneous	无准备
nyse	New
slugger	打击力强的选手
flank	侧面与……相接
monachal	僧院的
usage	使用
marquise	侯爵夫人
nonmonetary	非金融
regenerative	再生的
ratable	按比例
tensile	拉力
chinoperl	and
italian	意大利文化的
cpaffc	with
ebony	黑檀树
resistibility	抵抗力
rotational	轮流
dominating	主要的
califate	伊斯兰教国王的地位
hqmc	海军陆战队司令部
overdare	使气馁
lapboard	放在膝上代替餐桌的小板
smothery	令人透不过气
clonally	无性系
blockhouse	木舍
flex	折曲
jag	使成缺口
organochlorine	有机氯
spirochaetosis	螺旋体病
block	印版
atypic	不合型
innervation	动感
plumbaginous	石墨
baptism	洗礼
whirlwind	旋风
unvoiced	无声的
linen	亚麻布制
cornily	粗野地
controversy	论战
fine	优良
camlet	一种轻的布料
indecomposable	不能分解的
bronc	北美西部产的野马
ophidian	蛇类的
capitalintensive	投资密集
sclc	Conference
dallis	毛花雀稗
discommendable	不赞成
overcharge	过度充电
nucleolar	核仁的
modernbuilt	现代化结构的
nummulated	钱币形
tomo	灰岩洞
introspectionism	9IntrEJ`spekFstic/`IntrEJ9speLnIzLm/
cerebrotonic	大脑紧张型的
prove	证明
matronly	尊严的
pockmark	麻子
conceptually	概念
monofilament	单丝
cashmerette	仿开士米织物
antichurch	反对教会
poort	关口
impolitely	没规矩
phototransistor	光电晶体管
glamorous	富有魅力
cystiform	胞状
drawgate	运河中之水闸门
minty	有薄荷味的
silicula	=silicle
cosher	娇养
englishism	英国精神
zs	Society动物协会
alkalify	碱化
gorge	胃
backless	无背的
soilborne	土壤传播
mammal	哺乳动物
spark	发动
planification	规划化
photoelectric	光电
ingenital	天生的
semidetached	半离
auc	of
supplely	柔软地
gainable	可得到
scalene	不等边的
ryan	赖安
animatingly	有生气地
algerian	阿尔及利亚人
encyclopedic	百科全书式
aftersales	出售以后
sociality	社交
chanceless	无接球机会的
sunniness	向阳好的
extensimeter	=extensometer
grisliness	恐怖的
inductive	感应
petiole	叶柄
ssbn	Ballistic
reface	重修表面
beastly	如野兽
upbind	束
herbaceous	似绿叶的
aptotic	无变化
nonofficial	非公式
unprizable	无多大价值
influxion	注入
rituality	仪式性
indolence	懒惰
lunatic	疯人
dispersedly	分散
lixivia	浸滤液
strabismus	斜视
smithereen	把……击碎
nisei	第二代日裔美国人
glitch	失灵
cognoscente	行家
flexometer	曲率计
ranula	舌下囊肿
stringer	长条支承木材
international	世界
eyeground	眼底
wizard	术士
helical	螺旋状
aboveground	在地上
confab	会谈
begrime	积垢
microcode	微码
endorsement	签注
calvous	光头的
interdependent	坏
existent	存在的事物
manor	庄园
ble	Brotherhood
exploiture	开发
curvy	曲线美的
minisub	袖珍潜艇
silly	失去知觉
icecap	常积不消的冰
hosepipe	橡胶软管
ironic	讽刺的
haiti	海
hydrargyric	水银
uninterpretable	无法说明
unshakable	坚定不移的
marchman	边境居民
exorbitant	过高
coalbreaker	碎煤机
periodical	定期
subscapular	肩胛下的
pectinate	栉齿状的
dumpishly	迟钝
sewage	污水
prolong	拖延
dour	严厉的
wrappage	包装材料
tass	Soviet
vandalic	破坏艺术的
malang	玛琅
townwards	=townward
furbelow	俗丽的装饰
fagot	加调味品的烤肝片
pentathlon	五项全能运动
grizzled	头发斑白
quirkish	含糊其辞的
earnest	热心的
mammoplasty	乳房成形术
dainty	秀丽
heloise	海洛薇兹
quandary	困惑
unpublicized	未公开
rearward	向后方
esthesis	知觉
influence	有影响的人感应
corollaceous	象花冠
monosemy	单义性
hereon	关于此
quaquversal	穹状的
bushelbasket	容量为一蒲式耳的圆篮子
clausal	分项
aphthoid	似小溃疡的
prospect	前途
multilist	多目表
aru	Railway
abetment	煽动
escap	Social
heady	顽固
penitent	悔过的
refer	提交
globetrotter	世界观光旅行家
ackemma	飞机修理工
monotrichate	=monotrichous
monoprix	"不二价"商店
obedience	服众
unmirthful	一本正经的
leftist	左撇子
fat	肥
mythopoeic	创作神话
disassimilation	异化
removed	离开的
station	身份
heady	猛烈的
uncorruptible	不会腐败的
taciturnly	沉默寡言地
somatological	人体学的
paramagnet	顺磁物质
sparkling	闪烁
dc	Certificate
festive	欢乐的
x	字母x
vestiary	衣服
recriminative	互相责备的
archaistic	拟古的
reproduction	繁殖
courthouse	法院
orthocephaly	正颅型
galvanism	电疗法
nationalism	国家主义
febricide	退热的
foredate	倒填日期
ethernet	以太网
sniffle	抽鼻涕
trypsinization	胰蛋白酶化
clochard	钟楼
penannular	近于环状的
pelycosaur	盘龙
electrohydraulics	液内放电法
specializing	专攻
fourthly	第四
stirabout	麦或玉米稀饭
emanatory	发出
phrenetic	精神病的
pitfall	缺陷
veiling	帐幔
detectaphone	侦探用电话机
hogwild	放纵的
seasonably	合时令
hypnotoxin	催眠激素
object	目标
bailiwick	范围
soursop	刺果番荔枝
pusillanimous	胆小的
scarce	不充足
expansible	能扩张
nationality	国籍
blackish	带黑色
consonant	协调一致的
extant	显著的
ncsa	Supercomputing
mouthpart	口器
burst	急于
micromethod	微量测定
dipsy	深海的
transitional	变迁的
teleology	目的论
multiflora	野蔷薇
longhair	演奏留长发者
vitebsk	维帖布斯克
sprawl	四肢伸开地坐
lancang	澜沧江
reflex	反射
inby	在附近的
marron	=maroon
undercharge	充电不足
intranasal	鼻内
uproar	喧嚣
brindled	有斑
jesu	耶稣
thermoset	热固的
polydemic	多地区生长的
imposition	强迫接受
angelhood	天使
unslumbering	从不睡眠
collide	碰撞
latania	拉塔尼亚芭蕉
injectable	可注射
revolvably	能旋转
overrun	超出限度
disallow	不接受
sun	恒星
volute	向上卷的
retarded	智力迟钝的
biomaterial	生物材料
penitentiary	收容所
intersatellite	卫星间
minitance	好战
anglicist	英语学者
metamorphic	变形的
doughtily	强地
intercommunity	共有
beflag	插满旗子
infix	使……钻进
summit	最高阶层
mistaken	犯错的
zoonosis	人畜共患病
mtbf	平均故障间隔时间
persist	坚持
lithic	石
hypoblast	内胚层
thin	微弱
goldie	金奖唱片
actualization	现实化
diminutive	小型
forewarning	预先警告
orthodox	东正教的
ruth	Ruth
greyly	带灰
unconformity	不服从
salut	干杯
forwhy	因为
gastrologist	胃病学家
nonrepresentational	非写实的
splenetic	脾气坏的
spongy	多孔而有弹性
metalwork	金属制造
poignant	剧烈的
flocculent	丛毛状
televisor	电视播放者
hypomagnesemia	血镁过少
gelatose	明胶膘
aubade	抒情器乐曲
unimplemented	未生效的
seviche	酸橘汁腌鱼
arresting	可观
dance	飘扬
overplaid	套格子花纹织物
gso	Staff
plasmalogen	缩醛磷脂
threeman	三人共同管理的
lockram	粗亚麻织物
dynamoelectric	发电的
indolently	怠惰
clod	土块
hydrocrack	氢化裂解
lavendery	有熏衣草香味的
haggis	肝等内脏和燕麦粉煮成的食物
noogenic	心理演化
solder	焊料
vasodilator	血管扩张神经
gutturalize	使发颚音
bolwtorch	乙炔吹嘴
volumetric	测定体积的
labialized	唇音化的
cool	无所顾虑
hebetic	青春期的
pinball	钉球戏
exhalant	呼出的
divinely	庄严地
prosperously	幸运
sunfed	Development
agelong	久远
legatine	具有使者职权的
faucial	喉头音的
clung	cling的过去式及过去分词
limpingly	勉强
greet	获悉
safety	安全
cinerous	灰烬
laminarization	分层
dangler	耳环
riskily	危险万分地
nora	Honora
derivative	系出的
bill	钞票
psychoanalyst	心理分析学者
graduand	即将毕业的学生
brimful	盈满的
hypergamous	与相同阶层的人结亲
leak	漏
frap	收紧
wy	美国怀俄明州邮递区号
avventurina	故名
threnody	哀歌
godhood	神性
supercargo	押运员
downhill	下坡
ntfs	New
reject	抵制
inescapable	不可避免
anschluss	联合
swish	带着嗖嗖声挥动
bombe	甜点心
cursive	连接
toughly	能吃苦耐劳地
widthwise	与宽同方向
profligate	享乐者
catchweight	无体重限制地
adhere	粘附
rhodesian	罗得西亚的
chequebook	支票簿
arboreal	树
homozygous	纯合子
cottage	村舍
triolet	八行两韵诗
communize	使共有化
plo	Palestine
osfcw	作战用固体燃料协调人办事处
haut	豪华
eutomous	容易解裂的
corer	挖核器
csce	in
bure	草屋
temptation	诱惑
emplastic	黏性物质
delusive	虚妄
taurine	金牛座的
quilt	制成棉被
curt	简略
inquietness	焦急
run	赛跑
capataz	工头
still	还要
blacklist	记于黑名单中
flop	拍击声
vraic	海草
ute	小卡车
fetch	绕道而行
humidity	湿气
beckon	招手
soembawa	=Sumbawa
unrelenting	冷酷
fujisan	富士山
yauld	活跃
retort	回报
gladsome	令人高兴的
reformative	改进的
voluble	爱说话
immurement	监禁
subdural	硬膜下
kinglike	君王似
scalloppine	煎小牛肉片
enchantment	迷惑
debone	将去骨
fortunate	幸福
flagellator	鞭打者
overset	排版过密
invigilate	监考
rattling	活泼的
logicize	使合乎逻辑
monstrous	畸形
riskily	冒险
oligophagous	寡食性
saccate	有囊的
hypercautious	极其小心
slavdom	斯拉夫民族
jain	耆那教徒的
sunwise	向右转地
pierce	深深感动
literature	文学
generic	类的
gadfly	讨厌的人
rhizopus	根霉
gelatiniferous	产树胶
depravation	堕落
xenophobic	恐惧外国人
verriculate	覆盖竖毛的
exclusive	排外
viscerogenic	出自脏腑
drambuie	苏格兰威士忌利口酒
uso	Organizations
covert	偷偷摸摸
phyllotactic	叶序的
noodge	=nudzh
acceptable	可接受
smacking	拍击
mallorca	马略卡岛
subtractive	减去的
jal	Japan
whip	车夫
say	想说的意见
longipennate	长羽
vigilantly	警惕地
absorptive	有吸收力
airspace	空域
awninged	挂有帆布篷
push	推行
unscripted	不用剧本
sexagesimal	六十
jib	移转
scrap	拆毁
osteoradionecrosis	放射性骨坏死
epitomize	成为……缩影
ferry	摆渡
glomerulonephritis	血管球性肾炎
seemly	适宜的
insatiable	贪求无厌
splenectomy	脾切除术
crenulate	细圆齿状的
outhaul	驶帆索
ingoing	深入
flagman	信号旗手
egoistical	利已主义
nonpolitical	非政治性的
respectant	向后看
informed	见多识广
tearjerker	使人流泪的电影、歌曲、故事
csma	Access/Collision
pester	纠缠
superable	可征服的
historicism	历史相对论
ingenuous	直率的
reposefully	平稳
conversant	有交情
readable	易读的
nascar	Association
phs	Health
flagitate	恳求
contumacious	顽固的
grandiose	堂皇
antiphlogistin	消肿膏
mistrust	不信任
marinescape	海景
illinoisan	伊利诺斯州人
floridly	浮华俗气
shippable	可装运
supernatural	超自然物
unascertainable	不能确定的
filth	污物
gauzily	纱似地
lantern	幻灯
gluon	胶子
tutor	辅导
jangle	吵嚷
unsuspected	无嫌疑的
moorings	系泊处
shiftless	偷懒的
ethnohistoric	人种史学的
shred	碎片
nosogeographic	疾病地理学的
whoop	唤起
borrow	借
outwardly	表面
almuce	皮兜帽
engorge	充血
pneumatolytic	气化
torrefaction	干燥
intercalate	设置
indiscreet	轻率
citron	香木缘
thousands	数千
omphale	翁法勒
promptive	敦促的
prelusive	序言的
literal	无夸张的
unglamorous	乏味
ominously	不吉利
hypoazoturia	尿氮过低
insurrectionary	起义者
disposure	布置
neuropathist	神经病学家
flinty	含燧石的
triassic	三叠纪岩石
dorp	小村
reminisce	回忆
epilepsy	癫痫症
kinetonucleus	=kinetoplast
undercharge	填不够量的火药
affluency	=affluence
ceorl	自由民中最下层的人
assumpsit	允诺
whipcord	鞭绳
lemnaceous	水萍科植物的
hemoglobinuric	血红素尿的
phoenician	腓尼基人的
trisubstituted	三元取代的
wheaten	小麦的
irl	中断请求线
eyestrings	眼神经
rage	情绪激动
rhomb	菱形
depeople	减少人口
autoist	使用汽车的人
strafe	惩罚
region	层
cranialgia	头痛
goad	激励
geoponic	乡间的
undress	便服
johannisberger	Johannisberg
traffic	交往
spread	蔓延
effortless	容易的
ble	of
mesogaster	=mesogastrium
rape	强奸
mandi	大市场
cockscomb	鸡冠花
twentieth	二十分之一
amphipath	两性分子
semiautobiographical	半自传性的
vouch	传出庭作证
memoirist	传记
acetate	醋酸盐
aymaran	艾马拉族
speak	说话
vulgarization	俗化
cleansing	有去污作用的
antimonide	锑化物
nonproletarian	非无产阶级的
mendable	可改进
clique	小圈子
uniflow	单流
puddling	搅炼
agateware	玛瑙花纹的搪瓷铁器
msfm	Master
aerial	空气的
frictionize	摩擦
convoy	护航
moralistic	说教的
fulbe	富尔贝人
hydroponist	水栽专家
clothing	衣服
empress	女皇帝
coleoptera	鞘翅类
pythogenic	腐生
shilingi	1坦桑尼亚先令硬币
marginal	边际的
con	反对
prompting	促进
itching	贪得的
superserviceable	急于帮忙
polynuclear	多核
yike	争吵
extort	勒索
emery	刚玉砂
appd	approved
calisthenic	柔软体操
station	……局
bicentric	双心
rowena	罗威娜
undergarment	内衣
dignity	高贵
spaetzle	鸡蛋面疙瘩
pinocytotic	胞饮
antihypertensive	抗高血压的
kilostere	千立方米
flashbulb	闪光灯泡
phoney	膺品
triform	在种不同形式合成
agog	兴奋
mythical	虚构的
hypophysectomize	切除垂体
eutopia	乌托邦
serail	=seraglio
koine	以阿提喀方言为主的希腊共通语
swart	有毒
pitiably	卑劣地
reoccupy	再占领
irreproachability	无懈可击
reputably	好评地
crablike	似蟹的
lymphokine	淋巴因子
galen	伽林
tenositis	腱炎
embroider	装饰
oblique	间接的
depositional	沉淀的
subdeacon	副补祭
conversant	熟悉
froward	不易控制的
attestant	证人
autocephalous	自治的
wsb	Board
quarrel	怨言
barbarous	沙哑的
interrogation	问号
sizzle	烧灼
orotund	夸大
limiting	限制
hierarchism	僧侣政治
aquiver	颤抖
machiavellian	权谋术的
noncarcinogenic	非致癌
iced	冰冷
reflectance	反射比
bedeck	装饰
inestimable	无价的
tussal	咳嗽的
roach	使成拱状
clairaudience	超人的听力
disharmonic	不和谐的
epicondylian	上髁
reemerge	再度出现
unambitious	无奢望
damned	被咒骂
farming	耕作
flexible	柔软
dde	动态数据交换
absonant	不协调的
smackeroo	1英镑
cornered	有角的
fasciated	用带子束住
haloperidol	氟哌啶醇
unenlivened	不快活
ineffective	工作效率低的
truest	确实
undesigned	偶然的
subtemperate	亚温带
awkwardness	笨拙
diabolical	恶魔的
fenny	长在沼泽地带的
supportability	可忍耐
denazify	消除纳粹影响
punchboard	放荡女人
scandal	耻辱
spieler	商业宣传员
pocket	小型
logomachy	对词的争议
exposure	暴光
creationism	创造宇宙说
soulful	深情的
impertinent	无关
friability	易碎性
sweltering	酷热的
israelitish	犹太人
tuppence	两便士
tremolo	颤声
indiscretion	不慎重
multiplicable	可乘的
compulsory	被强制的
liftgate	提升式门
systemless	无规则的
anthropomorphic	神、人屯壅
anabasis	远征
gothicism	哥特式
tributary	从属的
lotiform	莲花状的
cheerly	兴高采烈
argala	印度或非洲产的鹳类
reflectional	反射
ichnographically	平面图法
nausea	恶心
smart	时髦
enthrall	奴役
headquarters	司令部
aline	排成直线
radiate	辐射
skull	头脑
chop	官印
fatefully	宿命地
dialectal	方言
pear	梨子
venogram	静脉造影
dirty	变脏
sculpt	雕刻
divine	非常可爱
diorite	闪长岩
amimeche	Institution
snr	信号噪声比
moppet	小孩
scratch	擦
abridgement	删节
sincerely	真诚地
swanky	炫耀的
preconcerted	预定
phytane	植烷
gct	Civil
examinant	主考人
safekeeping	警卫
drivel	流口水
antennary	触角的
lentoid	透镜状
wivern	双足飞龙
remotely	偏僻地
subadult	接近成年
hurtlingly	飞奔
extraordinaire	异常的
done	妥当的
wpc	Woman
thujaplicin	大叶崖柏素
controllable	可控制的
shovelhead	窄头双鬓鲨
galactophorous	输乳
leone	利昂
subantarctic	亚南极
mmpi	Multiphasic
tenemental	出租的
superempirical	超经验
lax	松的
chondrosarcoma	软骨肉瘤//tous//
design	谋划
erythrosin	四碘荧光素
inquilinous	寄居
tog	打扮
preferment	优先
mercery	绸布类货物
cockcrow	黎明
repeated	重复
scenery	景色
heathy	石南似的
boneblack	骨黑
potentially	潜在
powerbook	强力笔记本电脑
feretrum	尸架
scaremonger	散布谣言的人
durst	dare的过去分词
temerity	卤莽
babbittry	市侩作风
symptomatology	症候学
scree	满布石块的山
malpighian	马尔皮基的
scutch	以打麻机打
dogskin	狗皮
slack	马虎从事
unexpanded	未展开的
hyperpyretic	体温过高
rural	乡下
rhetorical	带修辞色彩
education	训练
cicatrize	愈合
whittle	切肉用大刀
exilic	流亡
geopolitics	地缘政治学
tabaret	塔巴勒绸
fortalice	外堡
snapper	咬人的狗
overbrim	溢出
crutch	支撑
fleckless	无斑点
sir	先生
isopterous	等翅目
aerohydroplane	水上飞机
subtle	敏感
moiety	一部分
wondrous	非常
wristlet	腕套
carlish	粗鲁
mgal	milligal
minuscule	极小的
swordbearer	护剑官
upstairs	向楼上
lancinating	象枪刺般的
nonrecurrent	不再发生
bathroom	浴室
laminar	薄片状
guerdon	奖赏
contrarily	反之
presswork	印刷
annex	并吞
skew	歪斜
apodictic	绝然
transcurrent	横贯的
gland	密封管
consubstantial	三五
consistent	调和
attend	专心
loimic	疫病
beedie	线扎手卷小烟卷儿
upend	倒放
locomotory	运动的
arrack	亚力酒
yacare	宽吻鳄
covert	在丈夫保护下的
middleware	中间设备
chronic	延续很长的
endorsee	被背书人
downsman	英国南部草原居民
inchoation	肇始
precocial	早熟性
floridly	浮华俗气地
cellarer	葡萄酒库管理者
stationary	固定的
staffage	画中的陪衬物
argentine	阿根廷
voyage	飞过
denationalise	=denationalize
polemologist	战争学家
wept	weep的过去式及过去分词
candela	小雪茄烟
ding	执拗地讲
crimped	有波纹
dissection	切开
icaaaa	America美国大学业余运动员协会
hypanthium	隐头花序
annihilator	歼灭者
doxographer	古希腊哲学家论述的编集者
forgat	forget的过去式
kenogenesis	=cenogenesis
undoable	不能做不了
inflictable	可科的
unrelenting	不屈不挠的
scurry	以轻快而交替的步子走动
sextipara	六产妇
plectrum	拨子
passionful	=passionate
translation	转换平移
tumultuary	混乱的
second	第二
trephination	环钻术
clerically	如牧师般
semihexagonal	半六角形
trochilus	柳莺
talky	多对话的
fyn	菲英岛
charm	魅力
paridigitate	每只脚上趾数相等
larmor	precession
ecogeographic	生态地理
unstable	不牢固
refutatory	反驳的
periodically	定时性
subversive	危险分子
peek	偷看
imp	装翅膀
cliffside	悬崖之边或面
defiant	挑战的
embodiment	体现
arthrotropic	向关节
embryotic	未发育好的
veni	conquered
grue	一粒薄浮冰
tolerable	可容忍
laryngoscopic	喉镜
sexboat	=sexpot
comb	蜂巢
cowish	胆小
mesh	圈套
waver	颤抖
amygdala	如扁桃体
adjoin	邻接
endorsement	认可
pbb	biphenyl
cocoa	可可豆
suit	合式
incompatible	性质相反的
callous	无情的
biquadratic	四次方程式
cock	头目
dashdotted'	NULL)
seropositive	血清反应阳性的
lipoidal	类似脂肪的
counterclaim	索赔
urbane	文雅的
ameerate	穆斯林国家的身份或阶层
sharkskin	鲨皮呢
steepled	尖塔状
barbaric	野蛮的
inequilaterally	不等边
benefic	行善的
chronogram	计时器所作的记录
baseburner	自动添煤之火炉
droppable	可以滴落的
eto	of
share	均分
soap	Access
concealment	隐藏
tritiated	用氚示踪的
exoatmospheric	外大气层的
stodge	贪吃的人
specify	列入清单
britishism	英国人的独特之处
enteralgia	肠痛
kayf	=cafe
neronian	尼禄似
fabricate	构成
sprat	小人物
fibroid	纤维性的
vixen	雌狐
allopathic	对抗疗法的
interrogative	质问
trainable	可训练
pndb	perceived
isobar	同重核
hartbeest	羚羊
coastwaiter	监管沿岸货运的海关人员
vortically	旋涡似
pricer	问价而不买的客人
duckbill	鸭嘴兽
mixing	混频
square	使成方形
decarburization	脱碳
tintinnabulation	铃响声
latten	薄金属片
circadian	生理节奏
overfull	过多
mother	母亲
flowerless	隐花的
wrangel	弗兰格尔岛
shivery	颤抖
abrade	折磨
valuableness	贵重
wifeless	无妻的
electroplating	电镀
crossbusing	互用校车接送另一区的儿童
survey	纵览
honorific	敬称
animosity	憎恶
enjail	把……关进监狱
zomba	松巴
namable	可命名的
temple	太阳穴
pastorally	田舍风光地
isoagglutinogen	同族凝集原
motorcycle	摩托车
mineralocorticoid	盐皮质激素
costae	肋脉
mana	超自然力量
croneyism	=cronyism
psittaceous	鹦鹉的
function	官能
cycadeoid	植物
slot	狭槽
truculence	野蛮
decagram	十克
tet	=teth
uppermost	首先
quantifiable	可以计量的
gom	Man
barricade	路障
etymologic	语源的
beamish	春风得意的
samel	未烧透
bastinade	棒
hexadecimal	十六进制的
relaxative	缓和的
clypeus	额板
futuramic	设计新颖
bta	Tourist
hamstring	腿窝
twisty	狡猾
proud	妄自尊大的
calamite	芦木
underperform	工作不如预期
breadthwise	横向
immigrant	移居的
acquired	已获
uplifted	举起
proportionately	相称
waiver	自动放弃
recidivous	有经常犯罪倾向的
thereout	由此
listen	收听
stridulatory	尖声鸣叫的
pinetum	松树园
wide	广大地
jupe	女裙
helpless	无能的
gumptious	精明的
irremovability	无法除去
phony	假冒者
wintry	冬天的
chooser	选举人
acerb	尖锐的
scotograph	盲人写字器
survivorship	生存
spinstry	纺织工作
quartus	第四
chasmal	似裂罅
imperence	冒失
curse	使受罪
constantly	坚持不懈地
ultrabasic	超基性
unitrust	单一信托
crotchety	想入非非的
manual	手动的
featured	作为号召物
thermometric	温度计
juglandaceous	与胡桃科有关
synodal	宗教会议的
labour	苦干
polystomatous	多口孔
redbird	红雀
gantlope	=gantelope
countdown	倒数计秒
bunglesome	拙劣的
unacquaintance	无知
prefocus	预先调节……的焦距
fried	喝醉了
relation	联系
transmural	透壁的
fatefully	决定性地
albuminuria	蛋白尿
conspirator	同谋者
funny	好笑的
revenge	复仇
ghostly	可怕的
bulgaria	保加利亚
multiped	多足动物
formulable	可公式化
interesting	引起好奇的
specialist	专门医师
cull	精选
privilege	给与……特权
endocast	颅腔模型
thrombokinase	凝血酶原激酶
drawly	拉长语调的
nonallergenic	不会引起过敏
unexaggerated	未渲染
pitch	倾斜
proffer	提供
authenticator	证明者
loco	发疯的
evidentiary	根据证据的
monotropy	单变性
point	瞄准
toluyl	甲苯甲酰
druidess	女祭司
available	可用到
buddhistical	佛教的
absent	缺席
chatty	饶舌
altaic	阿尔泰山的
interested	感兴趣的
pathetically	情绪上地
patter	滴答地响
afghani	阿富汗的
plummer	block
damnation	诅咒
proliferation	增殖
thomasine	托马森
boottree	靴楦
ostende	=Ostend
paperwhite	多花水仙
fog	烟雾
intermarry	近亲结婚
decimet	十个一组核粒子
insinuative	巧妙巴结
summarily	草率地
erring	做错事
rear	暴跳
coral	珊瑚虫
konakri	=Conakry
twit	嘲笑
excogitate	计划
boring	令人厌烦
syndactyly	并指
aciniform	多小核
monogamous	一雌一雄的
jag	刺
statuesque	轮廓清晰
depth	深奥
epact	闰余
chalcedony	玉髓
harshness	严肃
intrigue	用诡计取得
drinkable	可饮用
cannonry	大炮
titular	有资格的
optima	optimum的复数
unversed	无知的
hit	打
systemless	无体系的
jowl	颌
inaptitude	不适当
aerohydroplane	水上飞艇
toothache	牙痛
deck	修饰
polyandrous	一妻多夫的
elegantly	优致
quintic	五次
judgeship	法官的地位
superterrestrial	面上
parasitize	寄生于
noninterference	不干扰
guenon	长尾猴
estrogenic	雌激素
croupy	义膜性
pku	phenylketonuria
suboxide	低值氧化物
udometric	雨量计
lyrical	热情的
nymphalid	蛱蝶科动物
precipitate	使沉淀
godward	对神的
tricrotic	三波
paid	pay的过去式和过去分词
striolate	具细条纹的
cockeye	斜视
outright	完全
rheumatoid	风湿症
like	希望
plasma	等离子体
west	西的
dioecious	雌雄异体的
sad	忧愁
souse	腌制的食品
rhyme	使押韵
gummatous	似梅毒瘤的
foreface	前颜面
giddiness	轻率
hsaa	保健科学促进奖
stereopticon	立体感幻灯机
laminar	由薄片或层状体组成的
educible	可推断的
renovascular	肾血管的
clamp	夹子
volume	音量
enrobe	使穿衣袍
asi	s
senior	资格较老的
singular	单数
chirp	吱喳而鸣
rutilant	发亮的
downhearted	无精打采
instrumentally	有益
teth	希伯来语的第九个字母
lawman	警察
sillar	未固结熔灰岩
traffic	在……通行
capitalise	=capitalize
ivory	象牙
oversee	检查
concern	关心
dissection	解剖
bedraggled	湿透的
cuboid	立方体的
electroplate	电镀物品
sherif	穆罕默德的后裔
inbred	内在的
soaraway	进展神速
cautious	谨慎
ependymary	室管膜
sound	健康的
benthos	海底生物
vestibular	门厅的
roofed	有屋顶
orbit	生活常规
curmudgeonly	小气
outtrick	以诡计取胜于
parrotfish	鹦嘴鱼
hardy	辛苦
geewhillikins	=gee
hfs	File
chalk	粉笔
lunitidal	太阴潮
saving	保留
petaled	有花瓣的
windblown	风飘型
puritanical	清教徒的
vision	先见之明
saving	挽救的
diner	用餐者
specialization	专门化
rehearse	演习
inflect	变化词尾或变形
unsaid	未用语言表达出来
antitheism	无神论
cooly	苦力
tantalising	=tantalizing
overage	过老
shark	鲨鱼
responder	应答器
incoherent	不连贯的
struma	甲状腺肿
dalmane	盐酸氟胺安定
egoistical	自私自利
motivate	激发
rooklet	小秃鼻乌鸦
submerge	潜水
deimos	火卫二
worth	价值
topically	谈论
poolside	在游泳池边的
stably	坚固地
pippy	多种子
canvass	细查
cigs	Chief
logicality	逻辑性
inworks	发生在工厂内
sequin	作衣服饰物用之小金属片
anima	灵魂
stp	Twisted
rhexis	破裂
debenture	债券
lochial	产褥排泄
moderator	缓和剂
practicing	开业的
inhaul	卷帆索
dysfunction	功能紊乱
innocuously	无害地
quackish	胡吹的
septal	隔膜
jules	朱尔斯
havana	哈瓦那雪茄烟
spry	美国Spry在线服务公司
undertaken	undertaked的过去分词
aciniform	如成串葡萄状的
larkishly	嬉戏地
soupfin	shark
proprieter	社长
sceptical	怀疑论的
barefaced	不戴面具
febricide	止热
hypersonic	极超音速的
senora	夫人
obtrusively	莽撞地
uneducated	无知的
included	内藏的
smarty	自作聪明的人
fountful	多泉水的
autocar	汽车
floridness	脸色好
acupressure	针压法
misbeliever	信仰邪教者
galvanization	电镀
fairytale	童话式的
sottish	愚蠢的
prevalent	普遍的
sloughy	泥沼的
papalism	教皇皇权至上主义
bedsonia	衣原体属微生物
grievance	委屈
anthophilous	虫媒的
haemagglutinate	使袸`neIFEn/
apogean	远地点的
innuendo	旁敲侧击地表达
pusley	=purslane
acropetal	向顶的
aforehand	事先地
piezometric	量压的
morigeration	奉承
wottest	=wost
arbitrative	有权仲裁
upstretched	向上伸出的
dicta	权威的断言
emphasis	强调
aldan	阿尔丹河
haulm	杆
vain	虚荣的
valetudinarian	衝eErIEnIzEm/
crossette	窗耳
galactophorous	输乳的
cosmic	宇宙的
impetuous	冲动的
parabolical	寓言似
dramatic	戏剧性的
dmt	离散编码
oceanization	洋化作用
maladministration	乱政
dotty	薄弱的
monotonous	单调
raf	Royal
anacidity	胃酸缺乏症
dogdom	狗世界
tagraggery	杂乱的混合
heeling	倾斜
aldebaran	毕宿五
comma	逗号
semen	精液
praxiology	人类行为学
undignified	无威严的
unwatered	不供应水
kherson	赫尔松
atomic	原子能的
hamfatter	拙劣的演员
semiconical	半圆锥形的
unaccommodating	不与人方便的
pronase	链霉蛋白酶
abnormal	反常的
overstory	上层林冠
ultramundane	超俗
defective	不完全变化动词
vcd	视频高密光盘
emotive	动感情的
turnip	芜箐甘蓝
otology	耳科学
concentrative	集中的
jingbang	一群
unvalued	不受重视的
mechanochemistry	机械化学
trailing	拖尾
epidemical	流行
canicula	天狼星
panoply	华丽服饰
scaldino	小陶火钵
russell	拉塞尔
leatherworking	皮革制作
cuttle	乌贼
uxoriousness	疼爱妻子
impractical	不切实际
oestrone	雌酮
pob	post
overflow	洋溢
skirl	风笛发出的尖锐声
transversal	横断的
snippet	不足道的人
zoochemistry	动物化学
aquatic	水上
tapestry	编织锦或织画
shh	安静一点
kingcraft	治国之术
digiboard'	NULL)
antibaryon	重子的反物质微粒
methoxychlor	甲氧氯
pob	office
tantivy	快跑!
infidel	异教徒
sociologism	唯社会学论
resend	再派遣
underlie	成为……的基础
usher	引导
berkeleyism	=Berkeleianism
calculator	计算器
necrotic	坏疽的
vestiary	服装的
limaciform	蛞蝓形的
mansion	官邸
tripura	特里普拉邦
ladified	有贵妇人风度的
provisionality	临时性
hcg	gonadotrop膜促性腺激素
powder	撒粉
unrestrained	无限制
atwirl	快速旋转
shock	使受电击
esc	计算机上的Esc按键
sungari	见
kerflop	扑通地
scintiscanning	闪烁扫描
overrule	否决
mulatto	黄褐色的
baee	初级教育学士
bowshock	弓形激波
heady	顽固的
conjoin	联合
theandric	神人
diastalsis	间波蠕动
chromatograph	套色复制
warty	有疣的
expropriation	收用
computation	计算
upstair	楼上
batfish	蝙蝠鱼科的鱼
khaf	希伯莱语第十一个字母的变体
harmonic	谐函数
kegling	滚木球戏
tail	限定继承
unwanted	多余
jot	草草地记下
wosa	Windows开放系统结构
digit	手指或足趾
scleroid	硬性
revival	复活
politeness	有礼
indefensible	不能防卫的
sylvinite	钾盐
sealift	海上补给的
bum	过游民生活
fifa	Federation
chuffy	不高兴
likewise	同样
turtledove	情人
morphologic	语形学的
trisubstituted	三代的
unmelodious	刺耳
unimproved	未加改良的
tgwu	Workers''
internationalise	IntE5nAFEnElIst/9IntE`nAFLnElzation//
miniature	缩小的
nervily	大胆
perennity	永久
cancroid	癌症状的
sinuous	动作复杂
septal	隔膜的
blin	俄式薄煎饼
zolotnik	索拉尼
anaesthetic	麻醉的
query	疑问
hymnography	赞美诗写作
bootstrap	解靴带
bathybic	深海底的
dunderhead	笨蛋
taboo	忌讳
take	获
celibate	未婚的
been	是
charter	包
heterochthonous	外来
papillate	乳头状突起的
manometry	压力测量法
garrulous	啁啾
circular	函件
hurt	危害
patroness	女赞助者
quotiety	率
goethean	歌德风格的
aggregative	集合性
ornithological	鸟类学的
transitive	及物动词
hepburnian	Hepburn式罗马字拼法
shield	盾
knowledge	知识
beanstalk	豆茎
scramble	攀缘
linen	亚麻纤维制成的优质纸
graphitoid	似石墨的
labial	嘴唇的
unequaled	无敌
forehanded	节约的
hood	用头巾包裹
blind	瞎
shunless	不可避免
supposititious	假的
angst	担心
climbout	急剧陡直的爬升
enchorial	古埃及人的通俗文字的
noddy	燕鸥类
untruth	假话
engarb	给……着衣
disregardfulness	轻视
lewdness	邪恶
gab	唠叨
salient	显著
liveborn	活胎产
mahatma	超人
potentiality	可能力
hapchance	偶然事件
scua	Association苏伊士运河使用国协会
leavings	剩余
monographic	专题论文的
feebleminded	精神薄弱
fiducial	信托
leak	撒尿
compellent	有强烈吸引力的
invulnerable	无懈可击的
blastoff	发射
humanitas	=humanity
strobic	似旋转
hygrometric	测湿的
metalclad	铁壳的
mongrel	混血儿的
grav	格拉夫
benefice	圣俸
monniker	=monicker
aglow	发红地
orangism	奥兰治党主义
thresh	脱粒
acculturationist	文化传入过程的研究者
filariid	血丝虫
supposititious	冒充的
yank	猛拉
stub	短而秃
aarp	Resolution
unsc	United
clausal	分句的
judicable	应受审判的
juratory	宣誓
unionist	工会主义者
vedanta	吠檀多
waveringly	犹豫
maculate	有斑点
ha	嘿!
underplay	表演角色不充分
survey	测量土地
tureen	有盖的汤盘
presto	极快的
accountably	可说明
weeping	哭泣的
counterespionage	策反
triangulation	分成三角形
cancerate	癌化
mixture	混合物
montgolfier	热
unsolvable	不能溶解
lampshell	腕足动物
filly	活泼
forewarning	预先警告的
topgallant	上桅帆
inquiet	不安的
intilted	向内偏斜的
habitation	居住
jestingly	闹着玩
resurvey	再勘查
annihilability	可毁坏
matey	平易近人
acopic	消除疲乏的
coypu	此动物的皮
cinchonism	金鸡纳中毒
siliceous	硅酸的
sniff	闻
astrosphere	中心球
witted	头脑……
atheoretical	非理论
aqua	浅绿色
reliant	信赖的
atingle	刺痛
ascites	腹水
presiding	指挥
fulsome	令人生厌的
phobia	恐怖病
understand	了解
vlsm	Subnet
excurved	弯曲的
illegalize	使违规
microanalyser	=microanalyzer
reunify	再统一
sedimentable	可沉积的
abattage	为防止传染而被屠杀的有病之牲畜
modernisation	=modernization
percolation	过滤
fetch	接来
northeasternmost	极东北
machinate	策划
cathode	阴极
unsaid	未用语言表达出来的
thibetan	=Tibetan
carte	菜单
janissary	爪牙
fortnightly	隔周出版物
oppugnant	敌对的
face	抹盖
latinesque	有拉丁特色的
chastening	惩戒性
exorcisement	=exorcism
homesite	住宅根据地
screwball	奇妙的
jumby	鬼
festa	祭日
halfway	半路
crackajack	能干的
exploitive	=exploitative
circumpolar	围绕天极的
liquid	易变卖的
safranine	盐基性红色染料
mortuary	埋葬死人
excitedly	兴奋
rule	规定
squetee	=squeteague
rush	用
hortative	奖励
thematic	题目的
runnerless	无长匐茎
pedunculate	有肉茎
general	大体
emissary	使者
endorser	转让人
imitating	模仿
chondrosarcoma	软骨肉瘤的
kernel	内核
centrism	中间路线
unfordable	无法通过
strut	炫耀
hosteller	旅馆主人
chatellany	城主之阶级
incivism	没公德心
summon	号召
endearing	引起爱情的
maoist	毛泽东主义者
ioof	of
monomoy	莫诺莫伊式破浪艇
run	浇铸
dendron	树枝石
rhizomatic	像根茎的
exhibition	展览品
spadicose	似肉穗花序
chassepot	后膛步枪
nullipara	未产妇
holding	把握
douglas	道格拉斯
kilt	苏格兰方格呢短裙
televise	播映
passiveness	被动
widow	寡妇
supernutrition	滋养过多
centurion	百夫长
corrective	中和物
portiere	门帘
deductive	演绎的
unlicked	幼稚
diagonal	斜纹的
gallovidian	=Galwegian
exaggerator	言过其实者
pothook	挂钩
msfm	in
latter	近来的
bahamian	巴哈马的
ceramic	陶器的
viviparous	胎生的
apprehensible	可了解的
lyrate	竖琴似的
sealless	未盖印的
bioflavonoid	维生素P
babylonish	言语不清
patras	佩特雷
language	语言
creepy	匍匐
erubescent	变红
theatre	=theater
isa	Industry
undam	使如决堤般流出
judicable	可审判的
circassian	切尔克斯语
vestibulectomy	耳前庭切除术
cudgel	用棍棒打
psat	Test
weave	摇晃
asphyxy	昏厥
mm	毫米
cpa	Pacific
putrid	腐烂的
pokey	无趣
pataphysics	荒诞玄学
pregnable	易受攻击的
unaided	独立
angiocardiogram	心血管X线照片
activism	激进主义
fleetful	船队数量多
heterocyclic	不同环式的
marriageable	适宜结婚
pelt	攻击
daredeviltry	蛮勇
riddlemeree	胡言乱语
comprizal	包括
overvalue	估计过高
muzzle	戴口络于
galop	快步舞
mortlake	牛轭湖
bookkeeping	簿记
smalt	绘画用的深蓝色粉末颜料
ballot	票数
mvd	Ministerstvo
fluently	流利地
underkill	低量毁伤
culmiferous	生成空心茎
redistillate	复蒸馏物
pledgee	接受抵押或人
borated	搀硼酸的
saddler	制造马鞍的人
odorously	芳香
randomness	无安排
maintain	继续
loiteringly	懒散
here	在这里
gratifying	悦人的
falsehearted	背信的
recess	使凹进
accordable	可一致的
archiepiscopal	大主教
uss	States
unbuttered	未涂黄油的
disannex	使脱节
palmoil	chop棕榈油烧肉
olive	橄榄枝
dower	从亡夫处得来的用以维持生活的财产
unwarrantable	无正当理由
whimling	异想天开的人
permanence	持久
labial	唇音的
cabb	使用解答书
flesh	肉
overboard	自船上落下
cullender	漏锅
choice	上等的
egomania	自大狂
habituation	适应
dispirited	沮丧的
fozy	肥胖的
swinishly	下流地
octosyllable	八音节字
map	绘制地图
dentiform	齿状
vitriolic	象硫酸的
colonic	结肠
totemistic	崇拜图腾之种族的
fimbriate	有须毛为缘的
pwd	Works
nce	Catholic
glaucomatous	绿内障
rivet	铆钉
synchronal	同时的
fowling	捕鸟
consilient	一致的
labe	为Elbe之捷克文名称
grandpa	爷爷
let	允许
service	服役
cloyless	不会倒胃口的
posse	临时组织的一群人
furthermore	而且
unalleviated	未缓和的
fanon	披肩
cognitive	有感知的
sangreal	圣杯
jeer	讥讽
sick	病态的
impoliticly	失策地
purlieu	森林边缘带
rishi	哲人
colles	科勒斯氏骨折
slopwork	成衣裁制工作
atmosphere	空气
inequable	不一样的
beltsville	White贝兹维尔小种白火鸡
colchicine	秋水仙碱
winnow	分出好坏
procercoid	原尾蚴
solenoglyph	管牙类毒蛇
diddikai	有吉普赛血统的人
spongeware	海绵釉陶
maffei	galaxy马菲星系
elk	软鞣粗皮
polt	图表
broadcloth	一种宽幅的细毛织品
restraining	控制的
stall	畜栏
vinery	葡萄园
bitch	母狐
unreachable	及不到的
unsmirched	未受玷污
monastery	修道院
trippy	由致幻药引起幻觉
gahnite	锌类晶石
cologarithm	余对数
roundly	圆圆地
vestibulospinal	前庭脊髓束
egotism	自我中心
epicotyledonary	子叶上
blob	溅污
storage	贮藏
benefit	有益于
stronghearted	勇敢
shit	拉屎
kindergarten	启蒙阶段
inchmeal	徐徐
worshipful	尊贵
feel	以为
recondense	再凝结
panjandrum	首领
cytomegalovirus	细胞巨化病毒
esurient	贪吃者
noteworthily	显著
individuate	使个体化
cap	and
embryotic	未发育好
imprecise	不严密
aortography	主动脉X光摄影术
avengement	复仇
anautogenous	需吸血后产卵
sympathetic	赞成的
slab	厚平板
interfusion	混合
dumbbell	哑铃
nephron	肾元
snoopery	窥探行为
pseudoclassic	拟古的
inactively	无用
pintano	豆娘鱼
tristigmatic	三柱头的
pterosaurian	翼指龙
elastomeric	弹性体的
noel	圣诞颂歌
reproachless	无可非难的
synectic	共同研讨的
eagre	河水上涨
suzerain	封建主的
guileless	坦率
calfhood	幼犊期
politic	策略性
var	无功伏安
downright	完全
gynaecic	女性
owing	该付的
lycia	利西亚
fantail	扇尾鸽
godet	三角形布
gonadotrope	促性腺物质
abuilding	在建造中的
skeeler	旱冰鞋
tridentate	有三尖的
petuntse	白墩子
jejunum	空肠
laevo	=laevorotatory
sympathetic	交感神经
spicily	香
npl	Physical
wader	钓鱼用的防水长靴
endoscope	内诊镜
medal	勋章
pop	突然
wake	振奋
arrive	抵达
den	洞穴
lcp	人员登陆艇
licensee	领到执照的人
panzer	装甲的
blower	送风机
peruke	男子假发
psia	square
megabit	百万位
phantast	=fantast
lepidosis	的排列和性状
elfish	好恶作剧的
neurilemma	神经膜
unimpressible	不可铭刻的不易受感动
adjudgement	宣告
discord	嘈杂声
fulgurating	钻心的
pastureland	牧草
done	合乎礼仪
bgp	Protocol
ketogenic	生成酮
slow	缓慢
pursuable	可实行
schismatic	分裂论者
outline	轮廓
mounting	装备
coenobitism	修道士生活
reproachingly	责备似地
hydrochloric	氯化氢
adminiculate	用旁证证实
fallow	使
appeasable	缓和得了的
mansion	大厦
schizophrenogenic	引起精神分裂症
bats	神经不正常的
supramundane	远离俗世
entrenous	你知我知
gastronomist	美食家
narrow	有限的
affectionate	挚爱
blazon	夸示
numismatician	钱币收藏家
coach	四轮大马车
cureless	无法医好的
pb	铅
curmudgeon	乖戾的家伙
quinella	赌前两名
owl	惯于晚上活动的人
icky	讨厌
heroon	英雄祠
leptodactyl	有细长脚趾的
wicked	缺德的
abet	煽动
ornithologist	鸟类学者
oose	尘团
dought	dow的过去式
pandean	牧羊神的
edi	无纸贸易
blanch	发白
balzacian	巴尔扎克风格
bats	怪异
epithelization	上皮形成
hypsography	标高图
orphanage	孤儿院
militiaman	国民军
earthward	向地球
unbelieving	不信宗教的
demilitarization	废除军备
cavitate	成穴
revolting	反抗
speculative	投机
scoff	愚弄
reciprocate	互换
capably	能干地
ahwaz	阿瓦士
shock	使休克
exhaust	排气装置
wakeful	不能入睡
sunstroke	中暑
paradox	似非而是的论点
zaniness	愚蠢
pennyworth	交易
roily	被激怒
mandrake	曼德拉草
verity	事实
freeheartedness	坦白
corbel	枕梁
neuristor	类神经器件
exophthalmic	眼球突出症的
earthborn	尘世的
dentolingual	齿舌音的
compaginate	使连接
chuvash	楚瓦什语
trabeate	横梁式的
outgame	在勇气方面胜过
sophistic	诡辩
california	加利福尼亚
flowing	如流的
gamin	讨人喜欢的娇小的顽皮姑娘
piloti	底层架空柱
uncatchable	抓不住
bowl	投球
inadvertence	不注意
inaudibility	听不见
neonatal	新生
lacrimal	满是泪水的
sclerosing	致硬化的
colourize	给……着色
conveyer	运送装置者
mrbm	ballistic
hindmost	最后面的
invent	创造
reclame	虚名
interdigital	交叉指型
corticated	有皮层
unsccur	United
encephalomyocarditis	脑心肌炎
pilous	多毛的
rictal	嘴裂的
thorough	十分的
chairmanship	主席的身份或资格
sebacate	癸二酸盐
insuperability	不能制胜
fold	信徒
collutorium	漱口剂
illuminating	启蒙的
persepolis	波斯波利斯
touchback	持球触地
lenitive	润泽的
lrl	lunar
crumpled	摺皱的
title	头衔
intended	有意
related	讲述的
regroup	重编
morpheus	催眠物
unmined	未开采
admitted	被承认的
conceptual	概念上
aethereally	轻飘地
peneplain	准平原
fertilizability	可施肥
triassic	三叠纪
dauntless	大胆的
militiaman	民兵组织
signalize	使显著
truckline	汽车货运线
renascent	复兴
unfed	未得到支持
scarabaeus	圣甲虫
ultramontane	教皇绝对权力主义者
shapeable	=shapable
gasogene	煤气发生装置
inexpressive	无意义
ladin	拉汀语
parasitical	食客的
trailing	曳尾的
award	授予
triad	三幅一组
cragginess	嵯峨
succursal	次要的
gerentocratic	统治者阶级
chlorid	氯化物
phlogosis	丹毒
turbofan	扇涡轮
weekend	度周末
hairstylist	发式师
optimistical	乐天
crustacean	甲壳类的
hexerei	巫术
tu	铥
mind	注意
funchal	丰沙尔
suit	适宜于
chlorosis	萎黄病
privy	个人
flourish	活跃
dithery	犹豫不决
antiphony	轮流吟唱的歌
stank	stink的过去式
lairy	艳俗的
uncontradicted	未受反驳的
bustling	忙乱
supraspinal	棘上
avicide	杀害鸟类
faker	伪造者
tertial	第三列的
variolate	给……引痘
aloof	孤零的
beery	啤酒的
tetragynous	四雄蕊的
lipotropy	抗脂
toddle	散步
semidomestic	半驯养
lemonish	有柠檬香味
yarmouth	=Great
felicitous	巧妙
replace	把……放回原处
micropolis	城市式小区
deportee	被放逐者
unsaturated	没有饱和的
super	特级
geographical	理学
diastereoisomer	非对映异构体
bored	无聊的
translatable	可转移的
freewheel	轻快地行动
farewell	再会
once	一旦
rite	仪式
gbf	Books
kilt	轻捷地移动
junky	质量低劣的
misunderstand	误解
removalist	搬运公司
englobement	包入球中
karoo	南非洲的干燥台地高原
unenvious	不羡慕
zineb	代森锌
papaya	番木瓜果
intolerability	难耐
wattlebird	食蜜雀
antivenin	抗蛇毒素
unlively	沉闷
investigate	研究
peckerwood	啄木鸟
seichometer	湖面波动测定器
ada	Byron
immobility	固定
tektite	玻陨石
isopulse	恒定脉冲
scousian	利物浦人
unseen	未见过
resonantly	共鸣地
elver	幼鳗
semisolid	半固体的
tutor	指导教师
subapical	位于顶点下的
north	北方
stickybeak	爱管闲事者
monochromator	单色器
nyc	York
fibrillate	有原纤维的
feather	羽毛
torture	拷问
manhandle	人工推动
dm	多米尼加联邦
nonparty	无党派的
sexcentenary	六百周年纪念
diammonium	phosphate磷酸氢二铵
tony	高贵
gandhiism	甘地主义
newman	纽曼
fukien	福建的旧称
evenly	均匀
sewage	下水道
chromoplast	色素母细胞
suggestible	容易受暗示影响
various	多方面的
uplooking	有抱负的
bilateral	双边的
brainstorm	集体讨论
biff	一击
quenelle	油炸鸡肉或牛肉圆子
inbred	先天
unsound	不安全的
dulotic	奴役现象
janeite	的崇拜者
filamentary	细丝的
agoing	在动着
spectacle	公开展示
ciscaucasian	北高加索
doggery	贱民
recombination	再结合
postpone	推迟
matrimonial	与婚姻有关
flotative	浮力
pharmaceutic	配药学
complexioned	脸色……
unduly	不适当
ectozoic	体表寄生虫
redeemer	买回者
fingerling	小鱼
circassia	切尔卡西亚
multivitamin	多种维生素剂
paleohabitat	史前动物栖息地
filipinize	菲律宾化
attrited	磨坏的
weirdie	怪物
crawlerway	慢速道
flouncing	荷叶边
coyly	害羞地
mound	隆起
first	最初
baneberry	此种植物的果实
provocate	刺激
commodore	船队队长
gassy	含气
chanson	n歌曲
scousian	利物浦方言
delusive	欺骗
fijian	斐济族
hematogenous	造血
analogic	类似
clockface	钟面
reencounter	重逢
burgee	三角旗
adumbrative	预示
huskily	嘎声
ormolu	铜锌锡合金
bombardier	投弹手
rattling	很
expiration	呼出
unspilt	未流出的
eversible	可外翻的
lifesaver	救生者
cordial	兴奋
embryon	胚胎的"之义
ski	滑雪
petrosal	岩石的
fathead	傻瓜
traveled	富有旅行经验
female	妇女的
macrophotography	宏观照相
cao	Officer
ski	滑雪橇
rush	冲
foliage	植物
gladiatorial	争论的
maybe	或许
fuzzy	有绒毛的
insidious	阴险
ley	牧地
organized	有组织的参加工会的
bracing	裤吊带
bushmaster	毒蛇的一种
turnsick	家畜晕倒病
zing	对……挑剔
cresyl	=tolyl
astigmatic	散光的
recognition	赏识
unworthy	不足取的
tridimensional	三度空间的L`nAlEtI/
longtime	长时间的
outside	外界的
broadcast	播撒广播
laudatory	赞赏
semireligious	半宗教性
demographic	人口统计学的
polychaetan	疣足多刚毛
rudely	无礼
polytechnic	工艺的
alimental	富有养分
spent	用尽
savvy	知道
preindicate	预先指出
footwear	鞋类
cannibalize	吃人肉
ultimate	最终的
nebuly	=nebule
cling	紧贴
manito	神灵
slam	撞击
dalmatic	法衣
huzza	赞许
pod	豆荚
intangibly	模糊
floralize	饰以花
waltz	跳华尔兹舞
esol	Other
glider	滑翔机
crackdown	压迫
ccpit	中国国际贸易促进委员会
faraday	法拉第
alg	antilymphocyte
labyrinthitis	内耳炎
knucklebone	膝节骨
destructional	破坏的
manacle	脚镣
colourbred	按特定毛色培育
sharecrop	作佃农耕种
aculeated	尖锐的
scrupulously	多顾虑
trow	以为
applicably	适当地
pectinose	阿拉伯糖
coha	Affairs
relatival	关系代名词的
productively	有结果
elastomeric	人造橡胶的
vitellogenetic	=vitellogenous
crispbread	薄脆饼干
gk97	GameKnife97
lifer	职业军人
fleshpots	暖衣饱食
reflourish	再开花
hegemony	霸权
pleat	褶状物
watcher	岗哨
noseless	无鼻子的
scarce	稀有的
rabbinism	犹太的法学博士的教导
duplicity	搞两面派
familiarly	亲密
kansan	堪萨斯州
prentice	无经验的
descriptive	叙述
sovietise	=sovietize
eightieth	第八十
subemployment	不充分就业
fatimite	法蒂玛人的
shock	蓬乱的
plummet	铅锤
creedal	信经
untoward	倔强的
another	另一个人
mix	混淆
polytheist	多神教徒
dynamic	动力学的
aswoon	晕倒地
myelosclerosis	骨髓硬化
anticlerical	反圣职者的
ersatz	代用
subjugation	平息
hakeem	医生
supraorbital	眶上
deliriant	引起精神错乱的
visceralization	内脏病原体侵入
medichair	诊察椅
overinterpretation	引申过甚的解释
roundly	全面地
rediscount	重贴现
turbinate	陀螺状
considerately	体贴地
way	道路
tendentious	有倾向的
echoism	拟声
caravaggiesque	卡拉瓦乔的
bromidic	陈腐的
naturalisation	归化
underrun	低于估计的产量
honeylipped	甜言蜜语
villein	农奴
separably	可分离
heartsease	三色堇
compulsive	强迫的
rejective	排斥的
zanyism	笑剧
overbid	过高出价
semidiurnal	一天两次
peachful	宁静的
frith	狭窄的海岔
green	绿色
theory	意见
flush	激动
pretense	要求
vtp	中继协议
ceratin	form
pour	倾泻
tabetic	脊髓痨的
chanty	船歌
tuck	使隐藏
cacophonous	发音不和谐
abreast	并排
countercheck	防止
protostar	原恒星
downside	底侧
claudian	克劳狄
unhealthiness	不干净
expertize	做专业性判断
purchaseless	无立足点
saturate	使饱和
omnivorously	随手
precinct	范围
photoemission	光电子放射
terminally	一定时期
fallen	落下来的
causalgic	灼痛
autumnal	已过中年的
lifesaver	济急的人
countermand	撤消
anaemic	患贫血症
ost	and
shelfful	可装一架之量
jsp	Server
folkmote	群众大会
explicatory	解说
apiarian	养蜂
germanic	德国
vauntful	自负
stylops	捻翅虫
immensurable	无垠
acetaldehyde	醋醛
illuminable	可启发
antimonic	含锑
inconformity	不一致
glibly	流畅地
fair	展览会
autographical	亲笔的
reflow	落潮
gossoon	少年
nitrotrichloromethane	硝基三氯甲
regretful	惋惜的
jungian	研究易雍学说的人
around	大约
cashaw	红南瓜
gridiron	格状物
bottlebrush	天花菜类
pulseless	无脉动
expeditiousness	敏捷
skiascopy	X线透视检查
particularize	详细说明
voguey	流行
ytterbia	氧化镱
reversional	倒退
coacher	家庭老师
saffron	藏红花色的
everyman	普通人
accusable	有可非难之处的
plus	加的
businesslike	有条理的
tacky	有些粘
bale	货物
unexpected	意外
continued	继续
gait	训练……的步法
tremellose	胶状的
precompose	预作
deluxe	华丽
transversion	颠换
testament	遗嘱
scca	of
debouchure	河流的出口
adipic	来自脂肪
deet	避蚊胺
clypeate	有额板的
novelty	新颖
pseudocoelomate	有假腔
paillard	一块小牛肉
immersible	可浸入
outside	外界
habitacle	壁龛
rack	烧酒
acinus	葡萄状腺
draconic	古代执政官
excise	收税
mis	管理信息系统
hemostasis	止血法
dofunny	那东西
microparasite	寄生性微生物
purification	净化
lav	洗手间
insulating	绝缘的
artisan	技工
saddlery	出售马具的店
transplantation	移民
gasless	无气体的
ophthalmic	眼药
green	绿色物品
tell	断定
applicatively	合用地
tumble	倒塌
aca	Institute
some	少许
neuroblast	成神经细胞
aliphatic	脂肪质的
verapamil	异搏定
regard	看待
departure	启程
monkey	猴子
acouophonia	听诊
monumentalize	纪念
cofeature	辅助节目
detrain	下火车
brightness	智慧
epilation	脱毛法
popover	一种淡烤的酥饼
offscourings	渣滓
bft	二进制文件传输
visit	参观
nimiety	过多
substance	物质
anesthesiologist	麻醉学者
saponite	皂石
turkmenian	土库曼的
prefectural	方官
am	Modulation
afloat	飘浮
bicolor	二色
eyelash	睫毛
boiling	沸腾的
staff	杖
duckweed	浮萍
abstinence	节欲
apochromatic	高度消色
xml	解释扩展标记语言
diabolo	空竹
retraining	再训练
mgd	gallons
billowy	巨浪似的
hideaway	隐避处
ladder	袜子抽丝
ultramundane	世界之外
crepe	绉纱
glycerin	丙三醇
hereof	关于此点
neuroregulator	神经调节质
banns	结婚预告
diazo	二氮化合物
christmastide	圣诞节节期
upscale	迎合高层次消费者
jammy	粘上果酱
bruin	熊先生
choleric	易怒
snooze	瞌睡
issuable	争论
nebulize	使成喷雾状
overset	颠覆
telecentric	焦阑的
hexamine	=hexamethylenetetramine
blueprint	计划
cod	cash
kith	邻居
sucrose	蔗糖
epizootic	体外寄生
undutiful	未尽职的
assiduous	勤勉的
waltham	Forest
labyrinthodont	迷齿亚纲动物
incisive	深刻
enwrought	=inwrought
pierian	缪斯女神的
captress	女捕快
prancy	欢跃
wisperer	造谣生事者
exocoeiom	胚外体腔
reformable	可改进
morphinize	用吗啡麻醉
aquiline	象鹰
topknot	头饰
chamaephyte	地上芽植物
finish	使完美
banksia	拔克西木属
dichroism	二色性
consubstantial	同疼
parabomb	自动开伞空投器
greenlandic	格陵兰语
medal	授予……奖章
sorbian	索布人的
tephra	火山灰
techy	易怒的
spiedino	蘸面烤肉卷
hondurean	=Honduran
freshness	气味清新
waspie	妇女紧身带
incurrent	流入的
indagate	调查
pigment	色素
overweighted	重量超过
reinless	自由的
ligamentous	韧带
dayglow	白天气辉
swinishly	贪婪
agony	苦恼
perceptual	知觉的
homebred	没有教养
countersign	副署
calix	盏
tannia	=tania
salop	英国行政区之一
misgiving	疑虑
whiting	白垩
tail	尾巴
nuclear	中心的
troublous	纷乱
schistous	片岩质的
bleep	发出哔哔声
sidearm	侧投球
analysis	分析
prelatical	高位者
embayment	港湾形成
proturan	原尾虫
brisk	凛冽的
aggressive	侵略性的
unsound	不稳固
coffee	咖啡
accounts	帐目
duteously	守本分
proteide	含蛋白质
character	写
extremely	极端
heap	堆
iconologist	肖像学
captive	被迷住的
bitsy	极小
indented	犬牙交错
accord	符合
cyc	cycle
unionides	的复数
scissor	剪
delicate	微妙
depot	库房
coonhound	猎浣熊的猎犬
ringing	响亮
emotionless	不露情感
unprohibited	未阻止的
ligeance	领
irresponsive	无答复
envy	嫉妒
emotionality	情绪性
technocracy	技术统治论
homeliness	粗野
eightpence	八便士
unoiled	未上油
devastating	破坏性的
valorously	勇敢地
draftable	可征召入伍
visitation	探望
distillate	精华
nagger	爱唠叨的人
predigest	预先消化
damoclean	危险临头
admissible	可接纳
recrudescent	复发的
hydrometeorological	水文气象学gy/`haIdrEJ9mi:
royalty	皇室
uncomely	不恰当
signee	签字者
incendivity	可燃性
decane	十炭矫质
strait	艰难的
distal	末梢的
artillery	炮的总称
exegetical	评释
turgid	浮夸
rebate	给……回扣
yird	人间
daemonic	恶魔
mudstone	泥岩
haily	冰雹状的
governessy	家庭女教师似的
crackdown	打击
circular	循环
upland	丘陵
bonnily	快活地
postvaccinal	接种后的
fruitlessly	徒劳
riba	British
snowcreep	积雪徐动
polling	联接到另一主机查看电子信件或新闻
wafflestompers	宽底旅行鞋
fibrinosis	血内纤维蛋白过多症
ophidiarium	蛇馆
whittle	切
slag	炉渣
autumnal	秋
crotch	胯部
ammocete	鳃鳗幼体
vanadous	亚钒
allelopathy	植化相克
cmos	Complementary
haily	冰雹状
friendliness	友谊
mythological	神话的
bedlamite	狂人
brachylogy	简明
loggerhead	铁球棒
impendency	危急
modulate	调整
mirk	阴郁
echo	随声附和
foetor	=fetor
recursive	递归
shebang	妓院
floral	花似
pc	Car
unresponsive	反应迟钝
cpaffc	for
bifid	两半
chlorometer	氯量计
eurasia	欧亚大陆
cowhouse	牛舍
dry	口渴
tea	喝茶
porifer	多孔动物
backwardly	往后
rude	无礼的
gyplure	树虫杀
surveillant	监督的
clean	干净
available	接受探访
demented	失去本性的
aftertime	未来
pivotman	策应队员
wadding	软填料
gruel	使精疲力尽
bond	结合
hexastich	六行诗
scotopic	暗视的
glarney	玻璃弹子
pentad	五个一组
deration	解除配给
fear	畏惧
cote	栏
mopoke	枭
sex	区别……的性别
counterdevice	对抗装置
capsulotomy	囊切开术
decolorant	漂白的
areocentric	以火星为中心的
girdle	带状物
sucrase	蔗糖酶
drumbeater	担任广告的播音员
epiandrosterone	表雄酮
antasthmatic	气喘治疗剂
unjoined	未加入的
elective	有选举权
melodramatist	通俗剧作者
puffy	膨胀
atrocious	残暴的
proponent	提出认证遗嘱者
inarm	环抱
whiter	白
rsgb	Great
midlife	中年
pure	纯的
gastrulate	形成原肠胚
rail	责骂
projectionist	幻灯放映员
latinic	主要是拉丁性质的
defensibly	可保卫
pumpable	可用泵抽吸
multifilament	复丝
pluralise	=pluralize
ultramontane	山外之人
damoclean	达摩克利斯
limp	易曲
climate	思潮
straight	率直的
reindustrialization	再工业化
demandable	可请求的
canular	套管状的
tamarack	美洲落叶松
thiofuran	=thiophene
amusia	无歌唱能力
handfast	抓牢
uplight	向上照射的灯
trimly	整洁
transfixion	凝固
appear	出现
spiritedly	有精神
tragedienne	悲剧女演员
ipts	国际实用温标
psychopathology	精神病理学
capapie	完全
caffeine	茶精
frantically	狂暴
protrusive	凸出的
embargo	禁运
strongylosis	圆线虫病
mfp	Function
federal	联合的
salvar	=shalwar
demented	失去本性
alu	算术逻辑单元
parameter	参量
sluttish	懒惰
varvel	惊异
electrify	使电气化
chantable	易唱的
dissect	把……解剖
seat	使坐下
wet	多雨
repent	忏悔
luthern	=dormer
dastardly	懦弱的
overwinter	把……保存过冬
hebrew	希伯来人
coeternal	同为永远
adultery	通奸
upwafted	被向上飘送
lymphangiitis	=lymphangitis
fluster	慌慌张张的行动
federal	联邦的
capitoline	Capitol的山丘的
monopolistic	垄断
duodecimal	十二进制的
great	主要的
fardel	束
gliding	流畅
costive	沉默寡言
waterlogging	水浸
nonenzymic	非酶
mazuma	钱
unpriestly	不适于教士
regret	遗憾
superhawk	强硬派
tachysterol	速甾醇
coulter	犁刀
infanticidal	杀婴儿的
unveil	揭开
cyclopic	巨大的
zilch	无
this	今
quadrophonic	四声道的
pejoration	恶化
irradiance	光辉
socialistically	社会主义地
overnight	前夜
flabbily	无生气地
setover	超过位置
incabloc	防震装置
kilogrammeter	公斤米
bethel	礼拜堂
beady	有泡的
bookshelf	书架
curse	祸因
aviate	飞行
devotional	专心
numbly	麻木
geo	陡壁峡口
foregone	过去的
frse	Edinburgh爱丁堡皇家学会会员
observer	观察员
internally	在内
crisply	清楚地
plenteous	丰饶
ubiquity	普遍存在
ipm	每分钟英寸数
kapo	囚犯头
hypostases	坠积
ingestible	可摄取的
wrapping	包装纸
malaceous	苹果科的
seem	象是
yielding	屈从的
eclamptic	惊厥
foveolate	有小凹的
wetfastness	耐湿性
clonus	阵挛
slimly	苗条
sql	结构化查询语言
bryozoan	苔藓虫
saceur	Supreme
planer	刨工
moneyless	一文不名的
telluric	地球的
bushwa	空话
mib	Base
imply	暗示
intersexual	两性间
vaticinal	预言
impactful	有效的
refulgent	辉煌的
satisfy	使满意
flyer	飞行物
quadrillion	千之五次方
decennary	十年间的
vintage	制造年期
hera	Assisted
fire	给加燃料
anile	衰老的
rbi	In
antoninianus	第三世纪的罗马银币
ponce	男妓
celeriac	块根芹
drearily	沉寂
surrebutter	原告的第三次辩驳
exculpatory	辩解的
adventure	冒险的经历
reducible	可约的
ned	的昵称
televisionless	无电视机的
rhapsodical	狂想
methimazole	甲巯基咪唑
scavenge	从废物中提取
minuscule	用草写小字写的
nrotc	Naval
hhfa	Housing
quadrifid	四分裂
circulator	循环器
moravian	摩拉维亚
catastrophist	灾变说者
indurative	变硬
regulable	可控制的
sidelong	打横
impenitency	不悔改
lunatic	精神错乱的
unhallow	亵渎
ablaze	闪耀的
crudification	粗制滥造
desultorily	散漫
subfossil	亚化石的
cystamine	胱胺
linkswoman	女高尔夫球员
hopeful	怀有希望
hopefully	有希望
sermonesque	说教
photoinduction	光致引发
irisated	彩虹色的
superannuated	退休的
anatolian	安那托利亚语
dissidence	政见不同
fidget	慌张
devastating	全然
scrubber	洗刷者
oniomania	购买狂
nephrotoxic	对肾脏有害处
morphosis	形态形成
bait	折磨
feel	摸索
miliaria	栗疹
turnery	车床工厂
innocent	无知的
attend	留意
flippantly	轻率地
suspicion	怀疑
unicef	International
amuck	疯狂
hadhramautian	哈达拉毛族的
spirituelle	愉快
vaginotomy	阴道切开术
doctorate	博士头衔
cosmetician	化妆师
rabbet	槽口接缝处
delftware	代夫特陶器
photoinduced	光感生
martyr	折磨
frowardly	固执
ely	伊利
brethren	同胞
ptolemaist	托勒密体系的信徒
ploughshoe	犁托
sociologese	社会学家特有的写作风格
cuvierian	居维叶的
nuffin	没有东西
woadwaxen	=dyer''s
poesy	诗歌
suine	代白脱油
rasping	锉磨声
traffic	交易
unrelenting	无情
hoop	铁环
obituary	讣告
reedy	尖声
libyan	代利比亚语
revivable	可苏醒的
thickleaf	青锁龙属植物
gobi	戈壁
mail	邮寄
idomeneus	伊多梅纽斯
nonneoplastic	非肿瘤引起的
ericaceous	杜鹃科
gumptious	精力充沛的
enolization	烯醇化
symptom	症状
whisker	使有须
vermiculite	蛭石
interspinal	棘突间的
welt	伤痕
outlast	比……活得长
assertorily	断言地
cussed	乖僻的
rental	租用的
bestrew	布满
calculated	适当
triumphant	胜利的
fire	使发光
tony	Tony
encomiast	阿谀者
cozy	舒适的
medullary	脊髓的
semiarboreal	半树栖
frcp	皇家内科医师学会会员
remorsefully	极为懊悔
meself	=myself
shipboard	舷侧
carved	有雕刻的
euphoriant	使人欣快
ark	箱子
infrequency	罕见
fian	hunters]
arcadianism	牧歌般之情调
wollastonite	硅酸钙岩矿
kite	风筝
super	充当跑龙套的角色
antinational	反国家主义的
mainsail	主桅帆
niersteiner	尼尔施泰因白葡萄酒
zeebrugge	泽布勒赫
quagmiry	多泥泞
windowsill	窗沿
prang	飞机坠毁
pelles	佩莱斯
eelspear	刺捕鳗鱼的叉子
ungraceful	无礼貌
maladaptive	不适应
unnatural	不自然的
dubitatively	半信半疑地
slender	微弱的
pinnated	羽状的
scramble	混乱
lot	签
disk	磁碟片
piscary	捕鱼场
wordy	废话连篇
uto	Towns
spinosity	尖刻的话
thuringer	图林根香肠
recede	后退
sandpiper	矶鹞
knobby	多节的
serenely	沉着
pouch	钱袋
hypophyge	=apophyge
ovicidal	杀卵
combat	抗击
mealymouthed	不敢直说
murexide	红紫酸铵
milquetoast	意志薄弱的人
unventilated	空气不流畅的
lacerant	折磨人的
northwestwardly	西北的
roadworthiness	车辆之性能
holding	财产
topographic	形学上
heterosis	杂种优势
heaviest	巨大的
personify	使人格化
lapboard	膝板
zygote	接合子
diphtheritic	白喉的
lark	玩乐
peptic	助消化的
wysbygi	在获取之前所见
glairy	蛋白质
hoopster	篮球运动员
reinforce	求援
audiovisual	视听
irvine	警官
triethanolamine	三羟乙基胺
conspire	凑合起来
homonuclear	共核
arboraceous	树木状
pocketful	满袋
argol	粗酒石
slowup	=slowdown
unimpugned	未受怀疑
orbicular	圆的
influxion	流入
normalization	正常化
suzerain	宗主国的
espial	侦探
bothnia	Gulf
inaptly	不适当
algidity	寒气
enterotoxemia	肠毒血病
underproductive	低生产
turk	土耳其人
hilac	ion
temperate	适度
quaker	贵格会会员
fluidonics	射流技术
strained	矫饰
clamour	吵闹
slavonia	斯拉沃尼亚
sloppy	潮湿的
awedness	表示敬畏
vane	叶片
crypt	地穴
nancified	搞同性恋的
brazen	厚颜无耻的
scleroprotein	硬蛋白质
sickly	有病
rematch	重赛
auburn	赤褐色
belting	带类
square	直角的
bracket	墙上凸出的托架
brisk	轻快的
intercellular	在细胞间
nematocystic	刺细胞的
pleasure	乐事
mischance	不幸
bmta	Association
airfreight	货物空运费
classically	古典主义
bravest	勇敢
reap	收割
dogged	顽强
tarry	逗留
disoriented	无判断力
affixation	附加
trinity	三人一个组
lentic	生活于静水中
overcare	杞忧
poofy	搞同性恋的
irreducible	不能削减
saccharise	使糖化
liable	有……倾向的
executive	实行的
secund	只在一边的
include	包括
shapeless	不成形
damagingly	非常
crisis	危机
rigmarolish	冗长废话的
sicko	有精神病的人
decant	轻轻倒出
gasiform	气体状的
antilithic	预防结石
preserver	保护者
vvip	important
quantitatively	数量上
tunis	突尼斯
increscent	增大的
restraining	遏制的
lilied	百合花覆盖的
synergic	协作的
outdoorsy	户外的
counterplan	反击计划
win95	美国微软公司的个人机用视窗95操作系统
caneware	蔗黄陶器
tuneable	谱好曲
aral	咸海
futurism	未来派
hajji	到麦加朝圣过的伊斯兰教徒
chrysarobin	驱虫豆素
monomial	单项
acta	Association
kiwanis	基瓦尼俱乐部
cancroid	蟹状的
troglobite	穴居动物
undulance	波状
indulgency	赦免
potbellied	大腹便便的
kittiwake	三趾鸥
vulgarity	粗俗语
sabbatize	把……作为安息日
droit	权利的对象
seedy	破旧的
cockalorum	小公鸡
countermine	将计就计
unpresentable	见不得人
bridle	缰绳
scivvy	=skivvy
rsc	Royal
palaeoanthropic	古人的
ladik	拉迪克地毯
methodology	方法论
polypus	水螅
cabobs	在串肉针上烧烤且调味甚厚的肉片
mobile	运动物体
sanctum	私室
dcmg	Dame
capacitance	电容
sublime	极端的
kokobeh	果皮粗糙的
residentiary	居住者
bundesrath	旧德意志之联邦议会
noctivagant	夜游的
adlittoral	浅水的
monohull	单体船
repoussage	凸纹饰物
intermarriage	联姻
sinuous	不老实的
section	地域
mailcatcher	邮包取送器
combine	结合
wellsite	钙交沸石
western	有西方特征的
reflex	反省
radiantly	清朗
people	使住人
unwinnable	不能取胜的
upright	竖立着
ramp	斜坡
host	主机
whistly	似口哨的
pandemonium	大混乱
sulfuretted	被硫化的
volatilise	=volatilize
gdr	原德意志民主共和国
whomp	重击
wakashan	瓦卡希语组
spinny	=spinney
photoactinic	能产生光化作用
descensive	向下
housebound	居家不外出
tempestuousness	剧烈
making	制造
scaramouch	胆小鬼
evaginable	外翻
ability	才干
fallow	休耕地
schizophrenia	精神分裂症
unfaithfully	不忠实
farmworker	农业工人
ier	乘数
suffosion	管流现象
preshrunk	加以防缩加工
shearing	剪取的羊毛
unexpected	想不到
escap	亚太经社会
hydri	Hydrus
spinosity	有刺
retook	retake的过去式
graveside	坟墓边
deportment	举止
unexpiated	未抵偿
unfathered	出处不明的
withdrawal	撤退
transplacental	经胎盘的
jwv	Jewish
coloured	有色
eupepsia	消化良好
scribble	潦草写成的东西
second	次货
tristful	阴沉
markedness	显著地位
parfocal	等焦面的
unwary	不警惕
mores	道德观念
immature	未完全发展
remains	遗体
copen	blue
jagged	参差不齐
paleogeology	古地质学
cephaloid	像头的
honoria	霍诺丽亚
injury	侮辱
madman	精神病患者
skill	熟练
feasible	可行
beetlehead	笨人
uncontrollable	无法控制
curvaceous	肉体美的
locker	上锁的人
boleyn	Anne博林
revival	再生效
abstemious	节约的
electrosol	电溶胶
stratopause	平流层顶
clipper	快速帆船修剪者
nonart	没有艺术价值
sasin	印度羚
outward	外出的
infielder	内场手
impiously	不虔诚地
infatuatedly	迷恋
peace	和睦
trotty	活泼的
chez	在
ketene	乙烯酮
consort	符合
gapemouthed	目瞪口呆
mucky	粪肥的
villainous	恶毒的
orally	口头上
lamed	希伯莱语第十二个字母
remediably	可救济地
identical	同样
endoplasm	内质
showup	排队成一队供识别的人
enspirit	=inspirit
acouphone	微音传达器
brent	黑雁
dyspeptic	患胃病
semitone	半音
midian	米甸
fireworks	激烈争论
intervertebral	椎间
voiced	浊音的
mungarian	匈牙利语
demo	民主党员
ac	Alternating
manila	马尼拉
prophylactic	预防药
snitch	偷
tonality	音调
cosmonaut	宇航员
vfr	目视飞行规则
rude	残暴
aerocade	飞机群
warring	战斗
epipetalous	花瓣上着生的
broadbrimmed	宽边的
minelayer	布雷舰
phonation	发声
whither	cin
ocherous	赭色
material	具体的
lauraldehyde	樟醛
childproof	能防止孩童瞎摸弄
ubykh	尤比克语
diageotropic	横生的
complimentary	问候
lazyboots	懒人
segregative	不喜欢交际
ddn	Data
ferredoxin	铁氧化还原蛋白
colotomy	人工肛门成形术
lorn	寂寞
polluting	玷污
uncultured	没有文化的
turd	可鄙的人
nation	国家
failure	失败者
help	补救办法
undistinguished	听不清
unlicked	不象样
arsenic	砷
still	照片
worldbeater	出人头地者
dignify	使尊荣
worldbeater	惊人之举
confect	配制
putrefactive	腐烂的
blender	搅拌机
swanky	爱出风头的
recognizably	可被认识地
formulaic	刻板
underrate	看轻
loud	喧吵的
his	他
wove	布纹
bowel	内部
ferocious	极度
signal	信号的
spermaduct	输精管
signiory	=signory
ataman	哥萨克
serve	侍候
fwpca	Pollution
complain	抱怨
swiple	打禾棍
deipnosophist	餐桌上的健谈者
chanson	小调
syncopate	词中省略
quarreler	争吵的人
crib	抄袭
saleratus	重碳酸钠
hektostere	=hectostere
expense	费钱之物
corrupt	混浊的
nowaday	现在
unenvious	不妒忌
leaping	跳跃
scruple	微量
merry	愉快的
mansard	双重斜坡的屋顶
recompose	重写
herniary	疝
wattlebird	垂耳鸦
lha	High
kickshaw	华而不实的小玩意
dejecta	粪便
roentgenoparent	用X光可以看见的
pygmyisn	像矮人
cultigen	分类学来源不详之生物或植物
spiracle	气门
discommendable	反对的
stridence	刺耳
moonstruck	多愁善感的
urologist	泌尿科医师
collegiate	学院
dropt	掉下
crib	婴儿床
legislation	立法
uncondemned	未受谴责的
epipastic	撒布用
declarative	宣言的
discernable	可认识
administrant	管理人
precipitantly	倒栽
ferry	来往行驶
unready	没有准备
scribe	犹太法学家
imbolden	鼓励
acetylide	乙炔化物
unorderly	杂乱的
revolted	起来反抗的
ding	钟声
deficient	不完善的
parallactic	视差
beneficent	仁慈的
patternmaking	制模
flopper	为图领取保证金而捏造事故的人
subluxation	不全脱位
arborescence	树木状
chlorinous	氯的
plant	安置
cold	冷淡的
nablus	纳布卢斯
nondollar	非美元地区的
scholarly	学者气质的
leave	动身
visitandine	圣母往见会修女
eiderdown	鸭的绒毛
still	还
cpi	Consumer
unforeseen	无法预料
substantia	nigra黑质
conveyer	让与人
tritish	有点陈腐
unsicker	不可信赖的
midmorning	早晨
fabulosity	非现实性
flocculous	丛毛状
renown	名声
nickelous	亚镍
atingle	刺痛的
capitoline	Jupiter神殿
timesaving	节省时间的
liven	具有活力
coprophilous	生长在粪便上
drowsily	睡
undro	Organization
hematogen	血色蛋白元
concretive	凝结性
granulation	使成粒状
compelling	引人注目
fervently	热诚地
potassic	含钾
toastmaster	主持人
hallmark	特点
scopula	=scopa
kiel	基尔
chromiderosis	色汗症
ashiver	发抖的
baneful	有害的
disciform	盘状
merienda	傍晚小吃
lordliness	权势
interfoliaceous	叶间
merciless	无慈悲心
capable	能干的
humanitarian	人道主义者
most	大多数
dobeying	洗衣服
twine	麻线
parsee	帕西人
asocial	自私的
millenarian	一千年
italiote'	NULL)
fitted	合身
intraoperative	外科手术进行时发生
show	展出
bleep	哔哔声
marplot	捣乱者
put	出发
stepbrother	同父异母
bungaloid	平房式
bushwhacking	砍伐丛林而前进
tabourine	=taborine
dentilabial	唇齿音的
bejewlled	以珠宝装饰的
lieabed	常睡懒觉的人
stop	击落
collywobbles	肚子疼
nasty	下流
directorate	理事之职
subtetanic	轻度抽搐的
bifolium	对折的书页
stolidly	迟钝地
oogenesis	成卵法
foreplay	前戏
mitered	戴礼冠的
tergant	显示出背部的
putzfrau	女清洁工
nonuple	九重
topless	无顶的
overreach	延伸过远
weird	神秘
monk	修道士
eacm	African
gasman	煤气表抄表员
unresponsive	无同情心
unenvious	不吝惜的
nomad	游牧的
cinefluoroscopy	荧光屏电影摄影检查术
foolish	傻
lovable	惹人爱的
bardling	末流诗人
ratel	猫的一种
wanderer	流浪者
bac	酒桶
churchwarden	教会委员
ductile	易教导的
temporary	临时的
anathematize	开除教籍
idol	幻象
mirk	黝暗
tent	帐篷
interstitial	裂缝的
haemodialysis	血液渗析
napless	磨破了
mucopurulent	黏脓性的
indaba	南非土人间的会议
dali	达利
amenities	令人愉快之事物
swept	扫频
approximative	接近
cartoon	动画片
various	多方面
upturned	翻过来
infrequency	很少发生
pupillary	学生的
edifying	教训性
phonic	声学的
sextillion	百万的六乘方
carzey	厕所
underdog	失败者
cochleate	螺旋形
spent	失去效能的
outsparkle	比……闪耀得更亮
spinous	难弄的
fictitious	假想的
flaring	俗丽的
immunodeficiency	免疫缺陷
virus	毒害
juris	法学博士
disulfoton	乙拌磷
outpouring	倾泄
lithotritize	用碎石器为……压碎膀胱结石
misspoken	念错
feverous	热病的
coenosarc	共肉
limp	柔软
countercheck	对抗方法
shyly	胆怯
clouted	凝固的
prefer	更喜欢
fractionary	分数的
chloracne	氯痤疮
shaky	摇晃
agog	热切地
unyieldingly	坚硬
lifeless	无生气
chokedamp	窒息瓦斯
silicious	=siliceous
birdman	鸟类学家
larcenist	盗贼
defog	从……除雾
pronounce	发音
scotch	苏格兰人
shift	移动
poppyseed	罂粟的种子
podocarpus	罗汉松
ultramicrotome	超微切片机
isocephalic	人像头部等高
produce	制造
yielding	出产的
piracy	非法翻印
wreckage	遭难
cordillera	山系
ghibelline	皇帝党员
atomism	原子论
coterminal	共终端
hegemonism	霸权主义
ectomorphic	外胚层体型的
promulgate	传播
artificial	假
lopsided	倾向一方的
eurhythmic	音乐舞蹈体操
glucoreceptor	葡
worried	闷闷不乐的
basidium	孢子台
isacoustic	与等声强有关
unsleeping	警觉的
smart	大大的
jowled	双下巴的
scallawag	饭桶
uncontroverted	无可置疑的
outgeneral	以指导凌驾
vane	风环
ballproof	防弹的
prophase	初期早期
anelasticity	滞弹性
importability	可输入
ferric	含铁
spyhole	窥视孔
chekhovian	契可夫式
maceration	泡软
braky	多刺丛的
argot	隐语
weatherly	能驶向上风
tong	用钳子钳起
inviolate	未受侵犯的
brow	表情
sandwort	鹅不食
embalm	使不朽
orchidectomy	=orchiectomy
edgily	刀口锐利
ideaed	主意多
unkindly	不近人情
interocular	两眼间的
billy	棍棒
reconcilably	可调停
hydropsychotherapy	水浴心理疗法
copier	抄写员
rheoscope	检电器
cestus	古罗马拳击者的手套
mythus	神话
vegetative	有关植物生长的
veil	帐
sexual	性别
excruciate	施酷刑
converge	聚合
autosuggest	通过自我暗示产生
palatalize	使腭音化
electrograph	电雕刻器
gamelin	=gamelan
responsum	释疑解答
druidess	女督伊德
polimetrician	计量政治学者
legs	木头支架
staves	棍
m	发票后一月
fiercely	猛烈地
sychnocarpous	结多次果的
recognition	赞誉
cochlear	耳蜗的
larcenous	盗窃的
hookshop	妓院
eunuchoid	惧内的
fluctuant	变动
isoelastic	等弹性
intercut	使镜头交切
musing	冥想
semibasement	半地下室
uneducational	无深造作用
ocap	开放式线缆应用平台
valediction	告别词
superannuated	过时的
overstrain	使过度紧张
interlingua	拉丁国际语
laticifer	乳汁器
kiribati	基里巴斯
sapphirine	蓝宝石
perfectible	可使完美的
fratch	争论
buy	购买
hoarsely	嘶哑地
viseite	磷方沸石
jollify	快乐
sodalist	慈善团体成员
cartilaginous	软骨的
centroid	质心
woodbind	忍冬属植物
antithyroid	抗甲腺
hurtling	飞奔的
whys	目
stellate	似星
prescientific	科学以前
troopship	运兵舰
otherworldliness	来世
operationalize	实施
excuse	理由
craniopagus	头颅连胎
struma	腺病
enroll	招收
endogenic	内营力的
shopworn	陈旧的
crockford	英国圣公会圣职者名册
soliloquize	独白
once	一次
epicotyledonary	上胚轴的
actinometry	辐射测量学
concessional	让步的
jitterbug	爵士乐迷
weekend	周末的
canalicular	似小管的
unthoughtful	轻率的
unenvious	不吝惜
whirlabout	团团转
microprocessor	微处理器
corporate	社团的
billfold	皮夹
methaemoglobin	正铁血红蛋白
nookery	舒适安稳的地方
lapidarian	碑文的
trouvere	叙事诗人
fun	嬉笑
un	pro
schizophrenogenic	引起精神分裂症的
balzacian	巴尔扎克小说
watchword	口令
demented	发狂的
hotter	热的
sophistic	诡辩的
xanthochroic	金发白种人
wiseacre	自以为万事通的人
idiosyncratic	异质
fornicate	弓形的
exonerative	免罪
improvisatori	即兴
sexipolar	六极
foozle	笨拙的一击
upsala	=Uppsala
disannex	使分开
southerner	居住在南方的人
epochmaking	划时代的
worrying	烦恼的
strut	肿胀
unmirthful	不高兴
bft	Binary
recuperative	有恢复力
vhf	Very
fructicative	能结果实
lampholder	灯架插头
callant	青年
predatorial	=predatory
somatotopical	躯体特定区
handcar	手摇车
leave	委托
waveshape	=waveform
compunication	计算机通信
archaeometry	考古定年学
innerve	刺激神经
cissy	脂粉气质的男人
highland	高
barge	用船运输
mambo	曼博
true	真正的
quicksandy	多流沙
vespertilian	蝙蝠的
whiter	苍白
polak	波兰人
metabiosis	半共生
donee	受赠者
refashion	重制
austere	简朴
adiaphorism	广教主义
tabid	衰弱
aldermanship	高级市政官的职位
wack	怪人
paraprotein	副蛋白
justicial	公平的
daughterhood	女儿时期
damnable	该死
dexter	幸运
fast	禁食
exchangeable	可替交的
cocarcinogen	助致癌原
pulverise	=pulverize
womankind	女性
fatigue	疲乏
face	面临
diabetic	糖尿病
expiree	服满刑期者
serena	塞丽娜
opporunity	机会
glumpy	忧郁的
quadrivial	之一
dcvo	Dame
sylvatic	栖息于森林的
deneb	天津四
rankle	溃烂
formulize	把……作成公式
decorously	高雅地
sameness	一致性
debate	争论
lionlike	狮子般的
wickiup	一种小屋
dullhead	傻瓜
testify	作证
diminutive	小的人
sewage	用污水灌溉
macronutrient	常量营养元素
falsification	弄虚作假
sheltery	遮蔽
forecastleman	在前甲板值勤的水手
silkscreen	丝网印刷品
slickness	光滑的
recognized	公认的
accurately	正确地
elemi	榄香脂
semina	胚种
premium	额外费用
wistfully	希望地
undistorted	未失真的
chufa	荸荠
copiously	充裕
chary	仔细的
mononucleated	单核的
orcinol	苔黑酚
oligocarpous	几乎没有果实的
scout	搜索
koa	其木材
vein	叶脉
airy	空中
delivery	财产等的正式移交
remonstrative	忠告
gemara	中的注释篇
doddery	蹒跚的
dragway	减重短程高速汽车赛车道
nothingness	空白
baldicoot	和尚
depot	航空站
surveillant	监视
hearted	呈……心情
mistrust	猜疑
kerosene	火油
roc	Required
grisliness	严重的
sweptback	向后倾斜
ariot	骚乱地
secretaryship	秘书等之地位
malic	苹果的
rabbitwood	兔子木
niggard	小气的
slot	开槽于
philogynous	爱慕女子
novato	诺瓦托
unstable	不稳定的
dilatory	不慌不忙的
denatant	顺流洄游的
lacertine	有蜥蜴状花饰
thixotropic	摇溶的
resectoscope	前列腺切除器
rebill	再付费给
considerately	体谅
absorbance	吸光率
plumbing	铅工业
session	会议
releasor	放弃权利者
unpleasant	使人不愉快
coition	交媾
rafferty	混乱
signed	有正负之分的
sycophantic	说奉承话
unaptly	不适合
thecodont	槽齿类
gasping	喘气的
synonymic	=synonymous
brachiate	十字对生
butyl	丁基合成橡胶
duplicated	复写书
eaprom	电可改写可编程只读存储器
attractant	引诱剂
counselee	接受劝告者
epithetical	浑名
directorial	指挥者的
flavorous	美味的
hideously	可怕
canaller	运河货船
