whorfian	沃夫假说
lithesome	柔软的
defy	使……难于
city	城市
shellbark	小糙皮山核桃
dismay	沮丧
formulating	明确地叙述
unboundedly	无限制地
chancre	硬性下疳
leafworm	棉树叶虫
veadar	=Adar
handiwork	手艺
myob	Mind
gynogenesis	雌核发育
overcurious	过份好奇
kmt	Min
macrolide	大环内酯物
skokiaan	无执照酒店供应的烈性酒
ingest	咽下
hatha	yoga瑜伽气功
frate	修道士
immunoregulation	免疫控制
microcapsule	微囊体
luncheonette	供应便餐的小餐馆
habiliment	装饰
scotopic	暗适应的
marginalia	次要的东西
loser	失主
peroxidation	过氧化反应
decretory	命令的
rident	笑
thousand	一千
sinistral	左首
shaky	动摇
affirmatory	承诺的
limner	画家
excusatory	道歉的
imbrue	把……浸
jeer	嘲弄
loud	不断的
whisky	威士忌酒的
splanch	斯普兰奇式房屋
adonis	小白脸
micellization	胶束化
occidentally	西方文化地
url	统一（通用）资源定位器
hide	兽皮
remissive	宽恕的
undissembled	公开
rich	富的
enjambment	跨行连续
veratrize	用藜芦混碱麻醉
polyploid	多倍体
dingily	邋遢
lowermost	最低
improvisatorial	即席的
tepefaction	微温
ashcan	垃圾桶
diagrammatic	图表的
leonora	利奥诺拉
snoopy	爱探听的
unkindly	不亲切地
subabdominal	腹下的
integumentary	外皮
homocentric	具同一中心的
lawfully	合法
cockneydom	伦敦人居住区
rally	集结
tiffin	供应午餐
shippable	可运输
sequestrate	扣押
scrutable	可以了解
softhead	无主见的人
birthrate	出生率
heartstricken	悲痛欲绝
crass	非常的
ai	人工授精
meow	猫叫声
fasciole	狭窄的色带
aphanitism	非显晶岩
kennel	狗窝
intrazonal	在地区内
skatole	粪臭素
lucite	透明合成树脂
horsebean	蚕豆
nutrimental	有营养
arisen	出现
disturbedly	被打扰
mission	使团
umbilical	母系
feoff	封地
omega	结局
unrhymed	不押韵的
evangelism	福音主义
hrip	hic
fecundate	使丰饶
sulfa	磺胺药剂的
triliteral	由三个字母组成的词
fore	在前部的
montanic	多山的
external	外面
portliness	肥胖
disputer	争论者
riverine	河
loof	=luff
participate	参加
sensuous	感觉上
sympathetic	合意的
metatherian	后哺乳下纲
eib	Bank
betimes	及早
root	坚定不移
scope	范围
distinct	独特
pat	人为的
homozygously	纯合子
tinnery	炼锡厂
unbesought	未恳求的
queenlike	女王般
endosporous	孢子内壁
indefinably	无法下定义地
bagarre	争吵
expressive	表达……的
burthen	使负重担
nullipore	红藻科植物
society	社交界
microvascular	微脉管
ruck	一群
obstruct	阻碍物
vote	得票数
stigmatic	有烙印
make	认为
desensitize	减少感光性
lambdacism	将/r/发音成/l/的错误
kingsun	金山公司
punishment	惩罚
unworldly	天真的
embryulcia	钳胚术
haemophilioid	类血友病的
unbrace	松驰
sickly	疾病流行的
comprisal	包括
shantytown	以临时搭盖的陋屋为主的地区
amebocyte	=amoebocyte
hemoblast	血胚细胞
angler	钓鱼者
most	最大
suited	适合
cloop	发砰声
harmonious	悦耳
pegasus	诗兴
coachman	马车夫
pli	linear
philosophism	虚伪的哲学
unslaked	未安抚的
trivium	三学科
furcula	叉突
buster	小鬼
helices	helix的复数形式
muntz	metal
astigmatic	乱视
bimanous	有两手的
writ	文书
goblet	高脚玻璃杯
vertical	头顶
forest	森林的
telomerization	调
veridical	诚实的
cesarevitch	=czarevitch
seasonableness	合季节
finery	鲜艳服装
pussytoes	蝶须属植物
minifloppy	小型软磁盘
hydrogeology	水文地质学
nemoral	适林
hack	出租
flannelet	棉织法兰绒
disputably	有讨论余
honeydew	甘汁
sigmoidoscope	状结肠镜
blackbody	黑体
ultrashort	超短波的
hepatogenous	肝原
bibliopegistic	书籍装订醯
ofuro	大浴桶
glumpy	闷闷不乐
johanna	约翰娜
enfeoff	授予领地
underdress	内衣
unberufen	但愿老走这种好运!
surplice	斜叠
ungainly	笨拙的
depilitant	去毛剂
innocuously	无毒地
asme	美国机械工程师协会
unfished	非钓鱼用的
adsorptive	吸附的
elector	选举人
olympic	奥林匹斯山
protopodite	原肢
flier	飞行者
gigametre	吉米
rowdyish	粗野
falseness	虚伪
conium	毒参属植物
toxoplasma	弓形体
untidy	不整洁
preoccupant	抢先占有
waterscape	水景画
kuomintang	国民党
distributive	分发的
argentine	银色的
mtbf	Time
egyptian	埃及人
justicial	正义
polysyntheticism	=polysynthesism
seaside	海滨
aerofoil	翼型
bachelorette	未婚女子
anthroposophy	人智说
cegb	Central
arenicolous	生长在沙中
structuralist	构造主义
bukharan	布哈拉的
neroli	橙花油
lugubrious	可怜的
homochromatic	只有单色的
unreachable	不能得到的
palaver	交涉
smokily	烟熏着
fibrefill	纤维填充物
grained	漆成木纹的
wake	守丧
francophile	亲法者
antennule	小触角
enframe	配上框子
borak	愚弄
regimen	政体
khurta	宽松的无领长衬衫
courtesan	妓女
brach	雌猎犬
regret	感到抱歉
hypothetically	假想地
pushing	有冲劲
agrimony	仙鹤草
mandamus	履行职责令
sumph	笨人
shaven	修过脸
cms	Missionary
columned	圆柱状
pda	Assistant
gecko	壁虎
raffish	卑鄙
oft	再三
introvertive	=introversive
designator	指示者
korfball	荷兰式篮球运动
profess	表示
extremity	末端
fall	下降
geniture	诞生
supposing	假如
carefully	小心地
contractibility	收缩性
caricature	歪曲的模仿
mass	块
skiey	=skyey
intended	已经订婚的
pathetically	情绪上
helot	农奴
squeegee	使用橡胶扫帚
macroinstruction	宏指令
deorbit	脱离轨道
coprophagous	吃粪的
aforetime	以前的
interphase	相间
demagoguism	煽动
supertransuranic	超铀后
shavie	恶作剧
interdictory	禁止的
projective	投射的
supraconscious	超意识的
flimflam	胡说
pander	拉皮条者
agio	扣头
photodegradable	可光降解
foreboding	先兆
leah	利亚
foreseeingly	有预见地
pivotal	关键
adown	朝下
isogyre	同消色线
preventorium	防病疗养院
boxful	一箱
pearlescent	珍珠般的
wistfulness	愿望
custodes	custos
possession	自制
zing	精力
supplemental	补足
garnetiferous	含柘榴石
newham	纽汉
parc	Alto
masticatory	咀嚼物
hypnotism	催眠状态
mediocritize	使变得普通
wurley	土著小屋
electrical	电的
hibernia	爱尔兰的拉丁名
insult	侮辱
freehold	不动产
callithumpian	吹吹打打吵闹杂乱的街头游行
follicular	卵泡
consumedly	格外
goliardery	放纵派吟游书生的行为
cercaria	摇尾幼虫
soulful	充满热情
barren	空洞
caulker	填塞船缝的人或器具
pageboy	头发内卷
jangler	吵闹者
supplicatory	祈愿
lubber	傻大个
asap	s
nonexistent	不存在的
forge	铸造
somber	昏暗
iata	International
ammonic	铵
haematological	血液学
medievalist	中世纪研究家
dote	溺爱
mongolian	蒙古语
untasted	未经辨味
enemy	敌人的
dactylography	指纹学
unhallowed	污渎
beggary	卑鄙
rebind	重捆
effusive	流出的
curvulate	稍有弯曲
amphibious	两栖的
tumble	翻斤斗
tumbler	杂技演员
metalclad	铠装的
transilient	骤变
farcie	塞有馅的
instillation	滴下
paramyxovirus	副粘病毒
heteromorphous	=heteromorphic
rattlebox	猪屎豆
disembogue	开航
amimeche	M
flashy	浮华
valued	尊重
disputative	爱争论的
justificatory	起辩护作用的
zealotic	热心者的
general	一般的
extracondensed	特狭活体的
seraphic	天使一般的
subantarctic	亚南极的
pippy	多种子的
unsc	Council
extracorporeal	身体外的
sfx	特技效果
literal	照字面上的
eupepticity	消化良好的状态
extract	析取
humorous	滑稽
fashionist	追随时行者
amusingly	好笑
kerry	黑色的小乳牛
ornamentation	装饰品
karafuto	库页岛
laboring	操劳
debatable	可争议
izzat	荣誉
fieldwork	野战工事
estancia	大牧场大庄园
picture	图画
amiens	亚眠
implicit	盲从的
homebuilt	家里做的
fslic	Insurance
versifier	拙劣诗人
fumaroyl	延胡索二酰
verbicidal	歪曲词义
alba	de
unspliced	未拼接的
racemiferous	长总状花序
chide	责骂
warn	发出预告
furfuraceous	似麸的
dispersedly	散乱地
lepidopteran	鳞翅类的
ampliative	扩大
fast	很快
delighted	欣喜的
fussily	无事空扰地
outmatch	胜过
soliflucted	因泥流作用而移动
cataract	大瀑布
idolater	偶像崇拜者
intellectual	智力
reactor	反应堆
slungshot	飞石
equipotential	等位
pettifoggery	讼棍的手段
contiguity	接近
rehearse	练习
horsepond	饮马池
polychrome	彩饰
sketchily	大略地
unhorse	使摔下马来
anthill	蚁丘
doughy	苍白的
veiny	纹理状的
sudanese	苏丹
uninjurious	不招致损害的
microfarad	微法拉
resignation	放弃
pilipino	菲律宾语
ane	一个
traitorous	不忠
unphilosophical	非哲学
glare	怒目而视
thitherto	到那时为止
unpresentable	不登大雅之堂的
vaccinotherapy	接种疫苗疗法
nationalize	国有化
questionless	无疑
cab	司机室
unstrikable	不得罢工的
idyl	叙事诗
desultorily	散漫地
counterbalance	平衡力
skewback	起拱石
fillip	轻击
unsevered	未切断的
endure	耐久
bolus	小而圆的物块
retentiveness	好记性
dissenting	不同意
grutch	发牢骚
appropriative	充当
messuage	家宅
behove	应该
sempiternal	永恒
paterson	帕特森
complaisant	柔顺的
orthographic	拼字正确的
heroicomical	滑稽讽刺的
msee	Master
kalanchoe	高凉菜属
shoreward	朝向陆地的
rite	习俗
cuspidated	尖的
trueness	纯真
detailed	逐条的
shrewish	爱骂街的
ncv	无商业价值
dispersible	可分散
specific	明确
planish	压平
force	促使
magnon	磁振子
mishandle	粗鲁地对待
replete	充满的
montenegro	西南部的地方
racetrack	跑道
koksaphyz	橡胶草
surname	用姓称呼
antipathic	反对
strange	奇怪
excitement	搔动
lapsuslinguae	失言
mithril	虚构的贵金属
rotatory	轮流
intact	尚未被人碰过的
benignly	仁慈
multiplicable	可乘
striking	打击
dern	=darn
xeroma	干性眼炎
ground	着陆
jody	乔迪
cracky	易破的
glary	闪耀
gerrymander	改变选举区
lame	金属薄片
way	规模
financing	财务
disaggregate	聚集
expansionary	扩张性
baudelairean	波德莱尔式的
anhematopoiesis	无血生成
favorable	赞成的
catafalque	灵柩车
lipidic	油脂的
submersion	淹没
assimilatory	同化的
abrupt	突然的
unrestraint	放纵
horra	=hora
mix	使混和
softback	纸面书
pained	痛苦
standing	固定的
twain	二
preceptorial	教师的
deanna	迪安娜
emunctory	排泄的
ascendency	权势
symmetric	相称性
planter	种植者
gymnastic	体育
preconcerted	事先计划
acreage	面积
keelblock	龙骨墩
yttrium	稀有金属元素
lgm	little
confoundedly	非常
muckworm	街头流浪儿
kantar	坎塔尔
sanctum	圣地
cosmic	宇宙
grossularite	钙铝榴石
exegete	解释者
consent	允诺
smallholding	小农
superplastic	超塑性
corking	很好的
excavate	挖掘
fishermen	钓鱼者
tackle	装备
laying	瞄准
sentence	判决
wearability	耐磨损性
methadon	镇痛剂的一种
forgetfully	不注意
polyvalent	多价的
demisable	可遗赠的
protrudent	突出
feeling	衷心的
inextricability	解不开
smear	诽谤
yellowhammer	金翼啄木鸟
lenience	宽厚
partite	分裂
ionophone	阴极送话器
counterguard	壁障
unsavory	令人讨厌
seizing	夺
knowledge	知道
unicolor	单色的
jump	惊跳
acetylco	coenzyme
bloodletting	放血
rope	绳索
joint	连接
rosily	乐观
beefy	象牛肉
commander	指挥官
riba	of
moony	月形
dauntless	大胆
regalist	君主主义者
decartelization	解散卡特尔企业联合
mambo	跳曼博
tidily	整齐地
asthmatic	患哮喘症
garrulous	多嘴
iced	装冰的
nllst	Science
effect	影响
boxy	箱子般四四方方的
nonfissionable	不能产生核子分裂
interscapular	肩胛间的
flaccid	没气力
phonetist	语音学者
curability	有痊愈希望
recessive	退行
brand	烙印
smidgen	一点点
corrupt	混浊
postholder	官员
organizable	可组织的
maturityonset	diabetes成年糖尿病
ascosporous	囊孢子
flanerie	漫无目
divvy	分配
bacillin	杆菌抗生素
monospecific	单一
psychometrist	=psychometrician
transmontane	来自群山彼边
nagasaki	长崎
cochinos	Bay科奇诺斯湾(即猪湾
sunshade	天棚
effusively	变溢
jakes	厕所
indistinguishable	不能
daintily	爽口
moot	未决议的
rubicund	透红
ingrown	向内生长
hers	她的
impenetrability	不能贯穿
disruption	分裂
asid	Industrial
barred	被禁止的
magnetooptical	磁光的
plump	圆胖
affirmant	确认者
feodal	封建
diary	日记
hermes	and
quivive	口令
semioccasional	偶尔
kathy	凯西
hyperextension	伸展过度
numega	Bounds
subordination	部下
unreachable	取不到的
ablator	烧灼材料
northwestern	西北方
unprohibited	合法
parcel	包裹
uncorrectably	无望
iamap	Atmospheric
wrinkly	有皱纹
rocketry	火箭
gandhist	甘地信徒
hearth	炉边
alliance	联合
meniscocytosis	新月形红细胞症
unscripted	不用稿子
triplicate	三倍
systematically	有系统
diffidently	缺乏自信
zolaist	左拉主义者
brickwork	砌砖
samink	人工饲养貂毛皮
noncontact	没有接触
indulgent	纵容
gemmate	有芽的
dravidian	德拉威人的
humility	谦卑
scimitar	曲剑
illiterati	未受教育的人
stronghold	要塞
flexuose	弯曲
underdeveloped	不发达
technicolored	五光十色的
cramming	塞满
remission	免除
henhearted	懦弱的
argonautic	Argo
simulator	模拟器
archenteron	原肠之消化道
bowman	头桨手
benzonitrile	苯甲精
besotted	愚蠢
ncv	value
onliest	=only
semiparasitic	半寄生
appendiculate	横节状的
dukawallah	零售商店店主
bally	可厌地
guide	管理
quickthorn	英国山楂
legatine	使节的
incontrovertible	无疑地
telepathize	传心
brash	骤雨
caboodle	伙
tacitly	沉默地
laterad	向侧面地
nes	not
kaliningrad	加里宁格勒
squamaceous	多鳞的
heartburning	嫉妒
isoceraunic	等雷雨的
bases	base的复数
pimping	无足轻重的
liberte	fraternite
pool	汇合成塘
typefoundry	铸字工场
arpa	Research
lumbricoid	类似蚯蚓
eighteenmo	十八开
malimprinted	缺损印记
scaphoid	船状的
supermarketeer	经营超级市场的人
lister	造册者
ardor	炽热
nigrosine	苯胺黑
emulsive	会流出乳状液
mtu	maximum
microcrystal	微晶
prematurely	早熟地
ruthenia	鲁塞尼亚
grewsome	令人厌恶
malnutrition	营养失调
upgrade	升级
fasten	扣住
predestination	预言
sicative	收湿的
quadruplicity	四重性
senorita	女士
sweltering	中暑
merciless	无慈悲心的
circumstantial	/
colorless	无趣味
cloistered	住在修道院的
chary	谨慎
theologise	=theologize
iamap	and
propaganda	宣传
sunstruck	患中暑的
auriscopic	耳镜
carthaginian	迦太基的
beatification	列福式
grubber	挖掘者
drencher	灌药器
blackhead	黑头粉刺
patrimony	遗产
iatrical	医学的
enshrinement	奉祀庙中
bitch	婊子
camik	海狗皮靴
bugbane	升麻属植物
butcher	屠杀
ignitability	可燃性
domination	控制
meniscoid	凹凸
goatfish	绯鲵鲣
actinal	有触手
welt	装饰
arcifinious	天然疆界的
synoil	合成油
empurple	发紫
pulperia	客栈
tillable	可耕种
usb	Serial
pale	暗淡的
hyperspherical	超球面
voraciously	贪得无厌地
ipecac	吐根
viosterol	固醇生素
character	品质
savage	残忍的
henapple	鸡蛋
auditoria	听众席
stubbornly	顽固地
proprietary	所有权
gitgo	开始
orthographist	拼字学者
suq	=souk
confounded	困惑
intermedia	媒介物
nonflammable	不燃烧
liquid	清澈的
unaverage	出众
impassably	不能通行
hotly	热心地
glazed	像玻璃的
narcosis	昏迷状态
meistersinger	诗乐协会会员
cuchifrito	炸肉丁
idiorrhythmy	供僧侣居住的僧院
gnomish	似侏儒
amethystine	紫水晶质
unhallowed	不圣洁的
ferruginous	铁
catholicism	天主教
tap	使流出
purificant	洁净剂
cockerel	好斗的年轻人
clavate	棍棒状的
ruggedization	坚固
egad	哎呀
wander	迷失方向
recruit	使恢复
subedit	担任副编辑
unworthy	不足道
sistan	=Seistan
confection	精制工艺品
flare	使闪耀
regular	正常体
anilingus	吻肛
disassembly	分解
chord	和音
ferric	含铁的
fogfruit	防臭木属植物
plumbous	铅
nse	Exchange
hydrometric	液体比重计的
cockamamie	繁琐
internationalise	国紌e/IntE5nAFEnElaaIz/
cloche	钟形女帽
meself	pro
smartly	刺痛地
upswept	朝上梳的
brickdust	砖粉
malaysian	马来群岛
welter	浸湿
catchword	标字
lute	琵琶
shakily	颤抖着
algerine	阿尔及利亚人的
circumrotatory	旋转的
prescription	处方
humanity	博爱
unmanly	娇气
dentifrice	牙膏
unoffended	未被得罪
student	学者
snooty	自大的
endocrinotherapy	内分泌疗法
dniester	德涅斯特河
lever	控制杆
cerebritis	大脑炎
marshall	马绍尔群岛
crannied	裂缝多
pfd	device
expansionary	扩张性的
heathenize	做异教徒
fslic	Federal
opster	光效应艺术家
scary	引起惊慌的
disconsolate	郁郁不乐
misapply	误用
spaeman	术士
polymerization	聚合
bartend	在酒吧掌柜
eudaemonics	获得幸福的方法
chastise	严惩
foreland	低岬
underdress	穿得太单薄
infectious	有传染性的
preconquest	诺曼人征服英国前的
lavishness	浪费
favoringly	有帮助
apostatic	背信
crimped	有波纹的
neighboring	邻近
zincoid	似锌的
signory	主权
incrossbred	品种内异系杂种
espresso	浓咖啡
residuum	剩余
civilisation	=civilization
extrasystolic	额外收缩的
chlorotic	萎黄病的
dissolving	毁灭性
judaical	=Judaic
lcvp	landing
guidable	可指导的
headland	畦头未耕的一条地
georgina	乔治娜
employee	职工
babushka	巴布什卡
mcluhanize	以麦克卢恩的理论改造
formulate	阐明
spacious	广大的
buckbean	睡菜
illusory	幻影
plumy	羽毛似的
trichopteran	毛翅目的
thralldom	奴隶的身份
congregationalism	公理教会制度
tarnishproof	不变色的
gracioso	丑角
king	君主
printless	不留痕迹
tridecane	烷
pinnated	鳍之类的
underwrought	underwork
unerring	无过失的
endomysium	肌纤维衣
unsubmissive	不柔顺
fallacious	令人失望的
sirdar	司令官
calputer	计算器计算机
drive	动力
polyhedric	多面
regrow	继续生长
film	膜层
aluminium	铝
sothis	天狼星
thermosiphon	热虹吸
elicit	引出
storeroom	储藏室
radiate	放射
umpire	仲裁
vicegerency	代理人之地位
exopoditic	外肢的
cynologist	精通养狗的人
fulvous	茶色
catachrestic	用词不当
aliform	翼状
hizen	肥前陶器的
dews	early
homochromatic	单色的
congeries	堆积
swaddle	用襁褓包
ccst	System
voluntary	自动的
waec	Community
hornlessness	无号角
frequent	时常发生的
maniacal	狂乱
telferage	=telpherage
bastardly	假冒
flexuous	动摇不定
palmitin	甘油棕榈酸酯
baudelairean	波德莱尔的
radiology	X光线学
phycoerythrin	藻红蛋白
transferror	=transferor
featherbrained	轻浮的
symplectic	偶对
blond	金发
methodically	有方法
dovetail	楔形榫头
ussuri	=Wusuli
autocracy	独裁政治
unturned	未翻转的
azobenzol	偶氮苯
parodist	诙谐文作者
miscarriage	误送
comfit	酒馅的巧克力
ammoniacal	氨性
periwinkle	长春花属的植物
blast	一阵
ticklish	忌讳
fourfold	四重
provable	可证明
pleomorphous	=pleomorphic
raucousness	粗声
equal	同辈
albuminose	多胚乳的
preparation	预备
galatea	白底蓝直条的上等棉布
momentary	刹那间
sobriety	清醒
concertation	合作
duchy	公爵领
informative	情报的
impregnant	溶剂
salinogenic	能形成盐
laze	混日子
rifeness	充满
blastie	矮子
polychroism	多向色性
suited	匹配的
fauvist	野兽派风格的
palpably	可触知地
pendent	悬而未决的
potshot	射击
cutout	终止
domiciliate	定居
winterly	冷淡的
illegal	不合规定
unshaped	形状不美的
baae	Bachelor
dodgy	躲闪
lapsable	易犯错的
partible	可分
endosteal	骨内膜的
kinkle	卷发
scleroid	硬性的
backswept	向后倾斜的
animadversion	非难
hardfern	硬羊齿植物
something	某物
chiccory	菊苣
feastful	祝宴的
consult	商议
appulsion	撞击
algerish	提倡艰苦创业精神的
unearned	不应得的
unmold	毁环……的气质
lampooner	讽刺文作家
semisubterranean	半地下的
send	发送
analogously	近似地
vitrine	陈列用玻璃橱窗
henotic	使和谐
interrobang	=interbang
fuck	欺骗
sidewards	向旁边地
inciting	刺激
epical	叙事诗
face	向
hemostat	止血钳子
clarity	清楚
unshaken	不动摇
crispen	变脆
sylleptic	兼用法的
stumble	错误
bedin	示威游行
indescribably	不可名状地
nefandous	讨厌的
hominine	人亚科的
darkling	在暗中
econut	鼓吹生态保护的狂热分子
mistakenly	曲解
triamcinolone	氟羟泼尼松龙
present	介绍
polyhydric	多羟
sessional	法庭
spend	消耗
rille	沟纹
mint	造币厂
tycoonship	巨头身份
farci	有馅的
elegiacal	哀悼
rapeseed	油菜籽
bewitchingly	迷人
espana	西班牙
lumberly	迟缓的
fold	折痕
unwatered	未浇水
duneland	沙丘地带
wicket	边门
phyllome	叶原体
bummer	游荡者
recalcitration	不服从
stronghold	据点
bacchius	短长长格
unserviceable	不能胜任的
comose	多毛
enormous	巨大的
grave	低沉
paternalist	实行家长制统治的人
woodworking	木工行业
squareman	石匠
controvertible	有辩论余
outachieve	在成就上超过
sferics	天电探测
nisus	为达成目标的冲劲
troglodyte	隐居者
hospitalize	就医
bunkmate	同寝室伙伴
cowardly	胆怯
psychopathist	精神病研究者
witch	迷惑
project	凸出
accouter	装备
nonsignificant	不重要
aspi	Interface
appreciable	可评估的
sinaitic	西奈半岛的
mallard	野鸭肉
spinning	纺纱
peradventure	偶然
gallop	飞奔
impiety	无信仰
pectize	成果胶
infantility	不成熟
conchologist	贝壳学家
aggravating	使恶化
zone	环带
unnoticed	被忽视的
corrupt	使腐烂
stannic	锡的
merge	融合
overtask	使工作过度
anxiety	焦急
now	如今
annectent	连接两物的
cerebroid	如脑或大脑的
cadastre	地籍簿
late	已故
diseuse	朗诵艺术家
coeliac	下腹
prevailing	占优势的
metronome	节拍器
sloven	散漫的人
basely	卑鄙
sciential	知识的
enlistee	征募者
gdr	Democratic
disestablishmentarian	国/
inhibitory	禁止的
twinight	连续两场比赛的
lamellate	薄片形的
likely	很可能的
lameness	跛
traveled	旅客多的
raptatorial	食肉
shingle	小招牌
rambling	散漫的
impalement	刺刑
airiness	空虚
fallow	未孕
panivorous	以食面包为生
septicidal	室间开裂
wings	女童军戴的一种翼形章
civilized	文明
orzo	米粒状面食
chang	青稞酒
syncretic	调合
ohmic	以欧姆测定的
fattypuff	胖子
distinct	独特的
magnetobiology	磁生物学
lumberyard	木场
emotional	情感
rabbinate	犹太法学博士的身份
gyrocompass	回转罗盘
deliberate	深思熟虑的
tympanosclerosis	鼓膜硬化
memorialize	请愿
slate	板岩
sultriness	闷热
germanise	=Germanize
paner	削皮刀
svga	Super
komatik	爱斯基摩人用狗拉雪橇
inferrible	可推论的
teach	讲授
desiccative	使干燥的
pourable	可倾倒的
catonian	顽强
iceman	售冰者
peak	到达最高点
prattle	无聊话
flannel	给……穿上法兰绒衣服
anamnestic	回想
hypobaric	比重低于脑脊髓液
medullary	骨髓的
unintelligent	愚钝的
coproduce	合拍
spry	敏捷的
consternation	惊愕
sex	性别
tapping	出渣
aob	Other
squamulose	多小鳞片的
toyland	玩偶世界
furry	有舌苔
unneutral	不公正
azc	Zionist
gare	码头
navigator	Netscape公司出品的WEB浏览器
incontrovertible	无疑
utriculus	=utricle
noseglasses'	NULL)
insincere	虚假的
birdyback	飞机托运载货挂车
concerted	协定
hymen	处女膜
vase	瓶
relative	相对
arthroplastic	关节形成术
half	一半地
interception	侦听
austenian	奥斯丁作品的
acerate	一端尖
bennet	花梗
digital	手指
squeezability	压迫
fix	准备
luther	卢瑟
coagulant	凝血剂
augmentative	用来增强词义的语句
triceps	三头肌
semifinished	经轧制
trigger	引发
bumpiness	崎岖不平
jake	满意
sainted	成为圣人
drip	滴下
drop	下跌
rebel	叛逆的
gyppy	=gippy
lineshaft	总轴
yauld	敏捷的
noteworthy	显著的
manueline	曼奴埃尔式的
prelusive	序幕的
violence	强烈
unconsolidated	疏松的
psammon	沙栖生物
rebellion	谋反
always	总是
sighthole	观察孔
buddhistical	佛陀的
special	专刊
vuagnatite	羟硅铝钙石
petty	细微
stilt	脚柱
berth	使停泊
approximative	近似的
phenomenalise	=phenomenalize
fetch	拿
snappy	爽快
felicitous	幸福
pulicide	灭蚤剂
shard	碎片
extant	现存
easier	更容易的
cigarshaped	雪茄烟形状的
unstained	没有沾污
multilobate	多裂片的
put	安置
ordovician	奥陶纪的
japanese	日文
prejudicious	有侵害
inaccurate	错误的
xiphosuran	剑尾目动物
hitchy	急跳的
zilch	微不足道的事物
docile	驯良的
inconceivable	难以相信的
indiscernible	看不见的
epidotic	绿帘石
rainworm	蚯蚓
interfluve	河间
unsoldierly	不适于军人
gadolinium	钆
incident	易于发生的
saprolite	腐泥土
ecocide	生态灭绝
lengthwise	=lengthways
retiarius	持网和三叉戟的角斗士
villose	有绒毛
revisionist	修正主义者
boccia	室外地滚球戏
sneak	偷偷摸摸地做
exuviae	空壳
refight	再战
maluku	马鲁古群岛
idiolectal	个人习语的
obliterate	使湮没
calceolate	拖鞋状的
mcat	医学院入学考试
piperonal	胡椒醛
rectilineal	直线
coppernose	红鼻子
tungstic	五价钨
phototroph	光能利用菌
zoroastrianism	袄教
expressly	特别地
hippomaniac	有爱马癖者
girlish	少女似
cerebrovascular	脑血管
wallhanging	壁毯
dyadic	双值
brass	黄铜制品
mithras	蜜特拉神
xp	终极编程
interdependent	相互依赖的
fleshless	非物质形体
asce	of
masscult	大众文化
carey	凯里
eightpence	用例参看twopence
remote	细微的
henna	红褐色
semivibration	半振动
reviewable	应检查
brace	曲柄
pedagoguism	老师气质
lighter	打火机
scientific	科学的
apoplectic	易患中风
bespoke	预约
impressional	印象
loanable	可借出的
austere	严厉的
diaphysis	骨干
enzymic	=enzymatic
bund	东亚各国之堤岸
razee	削减
joyously	快活地
pokey	迟钝的
ascap	American
calumet	北美土人所用之一种烟斗
enhance	提高
canasta	用两组纸牌的桥牌游戏
gaskin	束帆索
troop	结队
spatiotemporal	空间与时间
panegyrist	撰述赞辞的人
refuge	庇护
gnomish	好戏弄
asme	American
coprozoic	生长在粪便中的
sanguine	以血沾污
photorecorder	摄影记录器
pilum	短矛
rabbanite	=rabbinist
avifauna	鸟类
euclidian	欧几里得几何学的
murexide	骨螺紫
grovy	在树丛中的
clear	清楚
imputable	可归罪
errantry	骑士精神
birthright	长子继承权
lamentoso	哀怨
kinglike	君王似的
color	风格
plebeianize	使平庸
edacious	贪婪的
definiendum	被下定义的词
kaonic	含有K介子的
trihybrid	三对基因杂种
dolphinarium	海豚池
polymerizing	聚合
stereotype	使一成不变
song	歌
qaranc	Queen
adduceable	=adducible
nhra	全国改装式高速汽车协会
kit	成套用具
harrisburg	哈里斯堡
null	零迅号
lymphous	淋巴样的
ptolemaic	埃及的托勒密五朝的
alecithal	无蛋黄的
ruler	管理者
accompanying	陪伴的
kendal	肯德尔绿
woefully	悲伤地
salmon	鲑鱼
nature	自然界
pericardiac	心包
impregnate	使充满
heterosexual	异性的
faradize	感应电流治疗
buttonbush	风箱树
bipod	两脚
minotaur	人身牛头怪物
regenesis	新生
revoltingly	背叛地
bmta	Trade
chewie	胶姆糖
purser	事务长
caramel	饴糖
antithetic	正相反的
hectometer	=hectometre
addicted	沉溺于某种嗜好中
inalterable	不变
unseen	未经预习
volcanicity	火山活动
exfiltration	溜出敌军阵
reassertion	再主张
imperfect	未完成体
spunbonded	纺的
decimate	大批杀害
satisfy	说服
claimant	提出要求者
angiosarcoma	血管肉瘤
fact	行为
humble	微贱的
aspirator	吸气器
embouchure	河口
peaked	尖的
ammonic	氨的
snugly	隐蔽
culch	贝壳屑
molluscoid	拟软体动物
telemetry	自动测量记录传导
lutetian	古名的
coronavirus	冠状病毒
purulence	脓
sore	剧烈的
throwback	掷回
ligularia	橐吾
unabroken	无破损的
bear	向
punic	反复无常的
venomousness	充满怨恨
rascal	不诚实的
macrocephalus	巨头
auric	三价金
codeine	镇咳
swbw	by
dirty	暴风雨
nuclein	核蛋白质
extenuative	使减轻
vagarious	奇特
priceless	无价
homosporous	具同形孢子的
unfilterable	非可过滤的
adultery	通奸行为
tgv	Grande
acesodyne	止痛的
ground	土地
sas	斯堪的纳维亚航空公司
dockwalloper	码头上的短工
identically	相等
spindle	细长的人
countercheck	制止
ballroom	舞厅
gatefold	折叠插页
garvey	加维驳船
fernico	铁镍钴合金
unpolarized	非偏振
distributive	分发
snafu	天翻地覆
benzopyrene	苯并芘
wrong	失常的
pertly	冒失地
refragable	可证明为妄想
ngwane	恩格瓦尼(非洲人对非洲东南部国家斯威士兰
tinworks	洋铁工厂
pale	变苍白
dairyman	养乳牛者
speechmaker	演说家
perfidiously	背信
psychopathist	精神病医生
embarrassment	阻碍
theonomous	服从上帝意志
novelty	新鲜
ponderosity	沉重
extrusion	推出
cartoon	画漫画
srinagar	斯利那加
ergodic	各态历经的
knottily	纠纷
abreact	使消散
compelling	强迫的
aristarchy	贤能统治
polytonal	多调
fault	弄错
holmic	钬的
lemonish	似柠檬
vise	签证
amiably	亲切地
cataclasis	碎裂作用
series	系列
weatherproof	不受天气影响
marcescent	带雕存部分的植物
cytochemical	细胞化学的
anamnestic	回想的
useless	无效
unbirthday	非生日当天送的
inter	埋
electrostatic	静电的
blackhearted	心肠黑的
sciential	有学识的
gintrap	齿夹式捕捉器
beatification	授福
besprent	撒满的
bosom	内心
wergild	凶手应付给被害人家属
femininely	女人似
nondairy	非乳制
bifurcate	分叉的
bergsonian	柏格森主义
hotkey	热键
jolterhead	笨人
acidproof	耐酸
crock	坛子
metatherian	后兽亚纲
reformate	重整油
completive	完全
fraternize	友善
decanal	牧师管辖的
pity	怜悯
diacid	二价酸
distortionist	漫画家
argillaceous	含粘土的
interdictory	禁止
aniconism	无偶像论
baobab	猴面包树
amimeche	of
gimbals	平衡环
lebanese	黎巴嫩人
nephogram	云图
cowlike	似母牛
mesocyclone	中气旋
vim	活力
hermeneutic	解释
segregative	易分离的
bifoliate	双叶的
spavined	患跗节内肿的
cornichon	酸黄瓜
cuss	诅咒
liquefactive	引起液化的
unsc	安理会
disvalue	轻视
deceivable	可骗
krona	克朗
agroindustrial	农业的和工业
jot	少量
unexaminable	难以查讯的
rhopalic	楔形诗
pedestrianize	使成为行人专用区
discriminability	可分别
pitch	向前倾跌
hound	激励
minitance	交战
flashover	闪络
foretell	预言
pulsation	震动
jab	猛刺
scentometer	呼吸测污仪
analogically	相似
refractile	折射
glycosylation	糖基化
terminate	结束
latke	土豆烙饼
dextral	用右手
abandoner	遗弃者
courtlike	高雅的
multidialectal	种以上方言
docker	码头工人
meridian	正午的
tuck	塞
etyma	词根
raising	高地
waste	废物
kermes	干燥雌体
zoogeology	化石动物学
front	外表
witling	玩弄小聪明的人
tablet	碑
pe	PE
prehominid	猿人
misshapen	畸形的
burry	芒刺多的
cissy	有娘娘腔
unroyal	非君王的
shopsoiled	陈列久了的
thermodynamic	热力学的
venusian	太白星
neopentane	新戊烷
frontward	朝前地
set	一套
colorblind	色盲
subservient	奉承的
inductosyn	感应式传感器
true	忠实
preform	粗加工的成品
mitigatory	缓解
uncannily	惊异
unaccommodating	不随和
od	OD
chimb	沟
gardant	面部正对观看者的
posb	post
reapply	再申请
foolish	笨
animating	鼓舞生气的
uranic	铀矿
unpeace	无和平
rear	后方
outside	外表
gabion	金属筐
simonize	给……上蜡
coagulase	凝固酵素
terribly	极
defensive	防御用的
quint	五胞胎
decompressor	减压装置
skyward	向天空地
tongueless	哑
joviologist	木星学者
democracy	民主主义
contemporaneous	同时代
toga	宽外袍
serenade	小夜曲
dactyliomancy	指环占卜术
cloche	园艺用钟形玻璃盖
saltation	跳跃
inhumorous	不幽默的
seecatch	阿拉斯加成年雄海狗
spiracle	喷水孔
lameness	残废
copyright	版权
esr	resonance
schlockmeister	次品制作者
ferity	野性
depilitant	去毛药
retirement	退却
cupriferous	含铜的
unsympathizing	无同情心
ingerence	干扰
pillared	有柱
paramedic	护理人员
smearcase	cottage
entrap	诱陷
ingathering	收集
impluvium	方形蓄水池
yeomen	自耕农
trihydric	三羟
removed	与……无关的
cingulum	带
washingtonite	钛铁矿
sainfoin	红豆草
solderability	软焊性
palatinate	巴列丁奈特之居民
gemmiparous	发芽生殖
cowcatcher	排障器
skeptical	怀疑性的
orphrey	精致的刺绣
worm	螺纹
coomassie	=Kumasi
command	掌握
carpeting	毛毯
inurbanity	无礼粗野
hectostere	百立方米
xslt	Transformations
abm	Mode
polyhydroxy	多羟的
bactrian	大夏人
yha	Hostels
actual	现行
angakok	爱斯基摩人的巫医
thermoremanent	热顽磁
snuffer	海豚
leaden	铅制的
pilgrimage	朝拜
eleemosynary	慈善
seconde	击剑中一种防守姿势
cephalated	有头
unprovided	未作准备
vernix	胎儿皮脂
scheme	策划
whipping	笞刑
handtailor	特制
essentially	本来
transmit	传导
whitsun	圣灵降临节
unsleeping	时刻戒备
paresis	局部麻痹
asynchronism	不同时性
rightly	正确地
poise	悬着
teacherless	无师自通的
stenotype	使用普通文字的速记法
manorial	庄园
confound	讨厌
untogether	乱七八糟
wcc	Churches世界基督教协进会
aircraft	航行器
cutie	美人儿
uropygia	uropygium的复数
underwater	在水中
predicably	可断定
chloromycetin	氯胺苯醇
electrochemistry	电化学
calender	砑光机
function	运行
rhinorrhea	鼻液溢
unrepair	=disrepair
indelible	不能拭除的
square	正直地
sentimentalise	=sentimentalize
fordone	筋疲力尽
sibling	姐妹
dreamer	梦想家
okay	好
prepositor	级长
exultant	欢跃的
braggadocio	自夸
scleroid	硬质
yaff	吠
fog	苔藓
antilysin	抗溶素
removed	与……无关
unreported	未经报道
otiose	闲着
inseparate	相连的
livestock	家畜
fit	合适的
unexamined	未经检查的
shift	变速
buitenzorg	=Bogor
rhein	大黄酸
amagasaki	尼崎
aiee	美国电机工程学会
bicuspidate	有两个尖头的
inoperable	不宜动手术的
persevere	坚持
anarchy	政治混乱
senegal	塞内加尔
histioid	蜘蛛网状
semispheric	=hemispheric
lagoon	泻湖
catholicness	一般性
jim	吉姆
forge	稳步前进
authorless	匿名
starboard	右舷
allergy	反感
rockbound	多岩石
angiotomy	血管切开术
queerly	奇妙地
unpick	拆开
hz	hertz
roi	Royal
concentrative	专心
comforter	安慰者
organohalogen	有机卤素的
wane	变小
theory	理论
salvageable	可抢救
medullary	脊髓
crossed	十字的
powwow	行巫术
rhizocarp	宿根植物
teemless	贫瘠的
sanskrit	梵语
anaclastic	反曲的
perfectness	完美
inequality	不等式
blae	青灰色的
antithetic	对立
dizygous	两合子的
sheriffdom	郡长等的管区
bibliophile	爱书者
cellulated	由细胞组织成
phos	=phoss
contemplative	祈祷的
lariat	用套索捉
inextinguishable	不能消灭的
decrement	消耗
hydrothoracic	胸膜积水的
hanoverian	汉诺威
disinteresting	索然无味
euronet	欧洲计算机网
perception	感知
microlite	细晶体
fairly	公平
thunderpeal	霹雳
froth	泡沫
predator	食肉动物
outstation	远的驻扎地
corrosion	侵蚀
nonproficiency	不熟练
identity	同一性
impayable	无与伦比
inveigher	抨击者
acidness	不悦的样子
drolly	幽默
superficiary	租地造屋者
paternal	象父亲的
osf	of
lovingness	爱
menstruous	行经的
voguey	流行的
ulster	一种长而宽松的外套
extractable	可拔出
antacid	中和酸性
favonian	西风的
dns	Domain
erasistratus	埃拉西斯特拉图斯
differentiae	种差
feathery	生有羽毛的
astern	在船尾
mis	System
silentious	沉默寡言的
arrestment	拘捕
scousian	利物浦
isp	Providers
assumingly	无礼
defect	缺点
landau	一种四轮马车
deerfly	鹿虻
hematopoietic	生血
coagulator	凝结器
crosse	长曲棍球的球棒
hispanidad	西班牙主义
galenist	盖仑的信徒
ohioan	俄亥俄州的
zionism	犹太复国运动
malarious	瘴气的
periplast	质膜
coolish	微凉的
unknit	拆开
stationary	固定
manx	马恩岛语
maintain	维持
regionalize	按地区安排
triturate	磨碎
macabre	令人毛骨悚然
wobble	游移不定
unshirkable	无法逃避的
otherworldliness	冥间
therefrom	从此
semifictional	半虚构的
vtc	Format
maculation	污点
gastroenteric	胃肠
roi	Painters
smear	釉
aerophobia	高空恐惧
jenny	移动式起重机
extracanonical	未入圣典的
resemble	类似
luxuriant	丰富的
asthmatoid	气喘性
will	必须
preelection	选举前
hidden	hide的过去分词
structuralist	结构语言学家
xanthoxin	黄氧素
waxen	苍白
inconsistent	不协调
os	骨
amphitrite	安菲特律特
ferocious	极度的
sisyphus	科林斯王
illation	推理
mum	菊花
unasked	未经要求
earlierize	提前做
ingrowth	向内生长物
phentolamine	酚妥拉明
peddling	无关紧要
outshoot	长出
chineselantern	plant酸浆
cogently	痛切
tricorne	三角帽
remnant	剩余
antilithic	抗结石剂
superluminal	超光速
frankpledge	十家连保制
anthropopathic	认为神具有人性的说法的
rami	的复数
saith	say
upflow	向上流
immutably	永恒地
unstiffen	使变得柔软
separably	可区分
assemble	集合
elegiacal	挽歌
alive	活泼
ornamental	装饰用
intercessory	仲裁的
apices	apex的复数
unionist	工会会员
belitong	=Belitung
heritor	继承人
jugoslavian	南斯拉夫的
shute	=chute
geocentrical	以地球为中心
longeval	长命
exoteric	公开的
lipoprotein	脂蛋白
tailoress	女裁缝
consent	赞成
rhonchi	诊音
thermophil	喜温
erasure	擦除
triseptate	具三隔膜
paleohabitat	古动物栖息地
talon	魔爪
gest	故事
tentative	假设
mimi	米米
beefy	健壮的
vandalise	=vandalize
agamous	无性
aspergillosis	曲霉病
enolic	烯醇
igraine	伊格赖因
plop	扑通一声地
ahvaz	=Ahwaz
confarreation	麦饼联姻礼
csce	Europe
continency	贞操
isomerase	异构酶
ramentum	小鳞片
backslash	反斜线符号
completion	完成
epileptoid	类癫状
caren	卡伦
deficient	不足的
nocake	炒玉米粉
paper	纸上的
cerebrotonia	大脑紧张型
fix	固定
avertable	可防止的
thebes	底比斯
wonderment	惊叹
paridigitate	每只脚上趾数相等的
armour	盔甲
outwardness	客观性
invariable	不变量
vertiginous	迅速变化
fashionably	时髦
clannish	团结心很强
unedified	未被启发
beggar	乞丐
thingamabob	=thingumbob
fascistize	使信仰法西斯主义
aqua	溶液
townish	城镇特有的
loxodromic	斜航的
electroosmosis	电渗
front	面对
myelitic	侵入脊髓的
shiraz	设拉子
lms	Mathematical
skilful	巧妙
dialogize	谈话
hotter	热
liquorish	美味的
petitor	申请人
thew	体力
interfluve	河间地
hypoploid	亚倍体的
emmarble	以大理石装饰
ataxic	混乱的
splenetical	=splenetic
semiconsciously	半意识
barney	巴尼
noggin	小杯
unspoiled	未宠坏的
gait	步法
affectivity	情感作用
mind	专心于
innumerability	数不清
chambezi	赞比及河
deterrable	可制止的
collet	筒夹
gillion	十亿
nymphaeum	水道口
outer	外面的
domineering	极权的
rhotic	发r音
footslogger	长途步行者
mordida	勒索
caucasus	高加索
eulogistical	颂词的
quizzy	爱查问的
edificatory	教诲
ellipsoidal	椭圆体
iodine	碘
leafiness	有叶的状态
abm	Asynchronous
peremptory	断然
soogan	=sugan
inexhaustibility	用不完
squarson	牧师兼地主
uncontested	无异议的
nccw	Council
mouthiness	爱说话
cankerous	腐蚀
pressroom	印刷间
notional	表意的
quaintness	古怪之事物
blossom	花开的状态
hybridoma	杂种瘤
squashy	熟透
passover	逾越节
steak	鱼
thermoperiodism	=thermoperiodicity
nitrometer	测氮管
zenithward	向上
capitulant	投降者
apriorism	先验论
peg	佩格
iba	英国独立广播机构
inbuilt	嵌入的
dlp	Processor
audibility	可听到
exsanguinate	放血
inspan	套牛马于车
seedy	多种子的
aborted	失败
handraulic	手动的
mediaperson	报人
jazz	颜色过于艳丽的
chlamydate	有外壳
land	靠岸
revokable	可废除的
coumarin	香豆素
acetin	醋精
sorehead	发牢骚的人
rowland	罗兰环
ucla	of
permanency	恒久的人
unbefitting	不相宜
rearer	养育栽培者
polypus	息肉
convertibly	可交换地
cylindroma	圆柱瘤
sweetening	使变得甜
caravaggiesque	卡拉瓦乔作品
equivocal	可疑
latch	门插销
evenfall	黄昏
mercuric	汞的
hyperosmolality	高渗透压性
vlaie	小河
latinic	拉丁国家
ethosuximide	乙琥胺
tackboard	图表板
shopworn	在商店中陈列旧了
embroider	绣花
viscountcy	地位
pandarus	潘达洛斯
subcrustal	壳下的
woodturner	木料旋工
mildew	霉病
knottiness	难题
confound	挫败
joanne	乔安妮
founder	铸工
diapente	五度音程
ruck	皱褶
hogback	拱起的背
liane	藤本植物
inwall	用墙围住
ettu	布鲁特斯!
tamp	打夯的工具
jewelly	戴手饰
irrigator	灌溉的人
inquilinous	寄居动物
monsieur	先生
dofunny	小附件
unharming	不伤害人
restoration	恢复
unfortunate	不吉利
existentialist	存在主义
countercheck	妨碍
condensibility	可压缩性
auc	year
constative	表命令、计划、愿望等之假定
prophase	前期
mediaeval	中古的
possessed	疯狂
intercellular	在细胞间的
yorktown	约克镇
undated	无限期
quatro	=cuatro
unitary	整体
snapper	揿钮
chaff	开玩笑
tidings	消息
cubic	立方的
myricin	蜂蜡素
flagellatory	鞭打
baldness	光秃
powerman	发电专业人员
interprovincial	省际的
autochthonal	土地固有的
mediatize	使成为间接属国
rearmouse	=reremouse
lightfaced	细铅字
plasmasol	原生质溶胶
extraordinaire	特别
khud	悬崖
final	最终
mystagogical	传授秘诀的
amused	好玩
nick	刻痕于
gallinaceous	鹑鸡类
jurassic	侏罗系的
foulmouthed	口出粗俗的
contrariously	不利地
paillette	亮片
tendentious	有偏见
eft	水蜥
failing	过失
duvetyne	混纺毛织品的一种
indigence	穷困
fissile	可分裂的
inauthentic	假
rontgen	有关X光
irruptive	穿入的
hydroscopical	深水望远镜
nonalcoholic	不含酒精的
bulky	体积大的
likin	厘金
revilement	辱骂
sound	合理
demultiplexer	信号分离器
ardor	热诚
gis	geographic
euclidean	a
actomyosin	肌动球蛋白
anabaptism	再洗礼
tempermament	气质
thenar	足底
bumptious	盲目自大的
noel	圣诞节
waterishlogged	吸饱水的木材
cerebrocentric	人格控制集中于脑的
libber	拥护解放者
snuffbox	鼻烟盒
gamb	腿
caller	新鲜的
mspe	Science
covalency	=covalence
aha	啊哈
malconduct	胡作非为
outgas	除去……的气
galvanography	电铸版术
voluntary	主动
stereography	立体画法
acerbating	使发怒
itch	渴望
brutalization	残酷
neurocyte	神经细胞
vociferous	喊叫的
litchi	荔枝树
piddling	不重要
tinhorn	吹牛的人
lapactic	促泻的
scilly	Isles
rics	of
lockpin	锁销
macroinvertebrate	大型无脊椎动物
totem	徽章
supercargo	货物管理员
irredeemable	不能兑现的
adjutancy	副官职
reprehensible	应该谴责的
wbs	west
triangular	三角形的
windhoek	温得和克
trayful	满盘
abrupt	生硬的
amputator	切断者
lithostratigraphic	岩石层位I^rEfI/
burthen	重荷
megalecithal	多黄
heathfowl	=black
gameland	猎场
captious	吹毛求疵的
oppressive	沉重
outsit	坐得超过……时间限度
lunary	诚实
tension	电压
city	全体居民
pashalic	领
noncombustible	不燃的
choosey	好挑剔
pallid	暗淡
mournful	悲哀
needless	不必要的
oecd	Cooperation
floodlit	泛光灯照明
translunary	似梦的
challis	有印花之轻质毛料
insult	凌辱
xenotropic	亲异
welldoing	善行
sap	树液
echovirus	人肠细胞病变孤儿病毒
oodles	许多
fluidify	使成为流动
tepidarium	温水浴间
chubby	圆胖
inept	不适当的
bmr	rate
babywear	婴儿装
hadrosaurus	鸭嘴龙
polymolecular	几个分子厚度的
felicitous	快乐
weanling	刚断奶
harry	折磨
overparted	演过多个角色的
seric	中国的
heterogametic	异形配子
cortisone	可的松
xeransis	干燥
patrol	出巡
relearn	再学习
tuitional	学费
byob	bring
ring	包围
violinist	小提琴演奏者
endoscopic	内窥镜检查的
general	概要
capriccio	随想曲
rocksy	地质学家
irradiant	灿烂的
logographer	编史家
longevity	长命
supercritical	超临界的
bissel	一些
imp	顽童
semiferal	半野的
quadricornous	=quadricorn
airmark	在……做飞行指标
magnetotactic	有磁趋向性
lop	修剪
unbed	把……从花坛
pectinesterase	果胶酯酶
whorl	使成涡漩
omnific	有无限创造力的
swingeing	巨大
intersatellite	卫星间的
dextroamphetamine	右旋安非他命
npa	Association
deplorably	可叹
microphonics	微音扩大学
pinnated	鳍之类
demand	要求
rush	灯芯草做
noun	名词
regimental	团
freezing	冷冻用
restatement	再声明
bothnia	of
flashlight	闪光灯
formulaic	刻板的
moldy	发霉的
unestablished	未被确认的
creaser	摺皱者
latticinio	不透明乳白玻璃
indian	印第安人
conceivable	可想像
verminate	孳生寄生虫
hpna	家庭电话线组网联盟
sloppy	多阴雨的
engarland	饰以花圈
inosculation	结合
epithet	称号
run	蔓延
careworn	饱经忧患的
unreported	未经报道的
dietitian	营养学家
subdivide	细分
shnook	=schnook
npr	Radio
discrepancy	矛盾
petrifactive	石化性的
sedentary	坐惯的
propellant	推进物
biedermeier	稳健
overcome	克服
burglarious	夜盗的
clamp	夹住
overhappy	过于快乐的
lanthanide	镧系元素
flub	弄糟
flagstone	石板
plumbism	铅毒症
latinise	译成拉丁语
platonise	=Platonize
outrange	在射程上胜过
runelike	像北欧古文字
unloved	未被喜爱
landlordly	主
noctilucent	生物发光
nondrinker	不喝酒的人
hematozoal	血内寄生
lipoid	类脂
cyclazocine	环唑辛
safing	能立即恢复安全状态的
font	圣水器
immorally	品行不良
numerical	数字
muscleman	打手
praiseworthily	值得称许地
supposal	想象
anemometry	风力测定
cold	伤风
kopek	苏联小铜板
elliptical	椭圆的
ganov	小偷
cinnamonic	肉桂
papillary	乳突
rearward	向后方的
rapc	Army
sirup	糖蜜
sannup	印第安已婚男子
polyphonous	=polyphonic
deanglicize	使非英国化
weatherglass	温度计
groovelike	老一套
monteverdian	蒙特威尔
indisciplinable	无法控制的
sharpener	磨器
colouring	色彩
female	女性的
deafness	聋
giving	给予物
mesh	编织
demology	人口统计
medievalist	中古史学家
ptfe	poly
surfrider	冲浪运动员
clarionet	竖笛
ridgelike	如脊
roofed	屋顶
quoin	夹紧
produce	产物
beaten	挫败
flimflam	欺诈
chanfron	保护马头前部之盔甲
nongovernment	非政治的
intervene	干预
miogeosynclinal	冒地槽
wristband	表带
splodgy	有污点
pearson	皮尔森
frolicsome	嬉戏的
featly	整洁
hydronic	液体循环加热的
firearm	枪炮
footling	无价值的
bechamel	调味酱
leadplant	灰毛紫穗槐
repagination	重编页码
spectrometer	分光计
misconstruction	误解
ideational	设想
fauvism	野兽派
overreliance	过度信赖
evaluable	可估值
arbitratorship	仲裁者的身份
portraitist	肖像画家
undecided	未定
actionable	可控告的
lot	命运
defat	使脱脂
amphistylar	前后两排柱而两边无柱
compilatory	编纂的
dichromat	二原色视者
volkslied	民歌
bladdery	膀胱状的
fh	fire
shavuot	=Shabuoth
icarus	伊卡洛斯
daybed	坐卧两用长椅
bareback	无鞍
amu	atomic
waadt	瓦特州
disciplined	受过训练
hornful	一个角制容器所容纳的量
subparagraph	小段
ichthyosarcotoxism	鱼肉中毒
indiana	印地安那州
accustom	使习惯于
roomily	宽敞地
carcake	烘糕
altercate	争论
intraspinal	脊柱内的
antiblack	反黑人的
physiognomy	脸
peregrin	外国的
polisher	磨亮的人
incoagulable	无法凝结的
besprent	撒满
insect	对付虫子的
snipe	狙击
fast	紧
diolefin	二烯
bacteriolysis	细菌分解处理
structure	建筑物
kaoliang	高粱
darobokka	手鼓
gendarme	警官
commeasurable	可相比的
hello	喂
helpless	无助
pam	帕姆
effective	有效的
unmix	无法混合
iula	世界地方自治联盟
gutterman	清扫阴沟的工人
snakestone	据说能治好蛇咬伤的一种石头
labourious	需要劳力
tubercled	生有结节
nasally	鼻声地
beery	啤酒喝醉的
adas	Service农业发展与咨询服务处
pillared	有柱的
gherao	挟持
handmade	手制
hide	掩饰
nonrecurring	不重现
afs	Service辅助消防队
defy	藐视
bagger	垒打
baric	气压的
animatingly	鼓励
mesogloea	=mesoglea
ledgy	突出物很多
sabotage	妨害
lewis	起重爪
brushed	拉过绒的
agglutination	粘着
autopen	自动笔
microstomous	小嘴的
asturian	阿斯图里亚斯语
forme	印版
dirndl	紧身连衣裙
whopping	异常地
abbreviatory	缩写
congruous	适合
excommunicable	可革出教会
epistaxis	鼻出血
numbered	有限的
civil	根据民法的
orderliness	秩序井然
sororal	姐妹
begem	用宝石装饰
incontinent	无节制
mousetail	鼠尾巴
fiddlefucking	该诅咒
suit	适合
incretory	内分泌的
lutose	覆盖有泥状粉质物的
leeway	回旋余地
geometric	几何的
undesirous	无欲望
cistern	蓄水池
sandpile	沙堆
pasquinade	讽刺文
style	文体
verriculate	具毛簇的
feign	捏造
ancipital	剑形
do	Republic
vamp	勾引
timbul	鼓膜
sentimentally	富情感地
berdache	北美印第安人男性的异装癖者或同性恋者
unsuspecting	无疑虑
centile	变数区间的百分之一
loamless	缺乏沃土的
revolver	连发左轮手枪
epicentral	震中
dissolute	放荡的
agadir	阿加迪尔
hotly	暑热地
computerlike	计算机似的
fat	肥大的
discourteously	不礼貌地
officinal	成药
kk	English
ambush	埋伏
antiphonic	=antiphonal
lean	贫乏的
dy	镝
explode	爆炸
hyperpyrexia	体温过高
punk	无用
sunder	分离
misshapen	奇形怪状的
advanced	高级的
diriment	使无效
romanaccio	罗马方言
stroam	闲逛
bim	英国管理学会
thioacetamide	硫代乙酰胺
benzene	苯
unclassifiable	不可分类的
unclassical	对古典作品不感兴趣
disorientation	迷惑
god	使神化
surprise	惊奇
sprue	注入口
clathrate	插合物的
antisymmetric	反对称
jaundice	使怀偏见
midterm	中间的
honiton	=Honiton
rrb	铁路职工退休管理委员会
cytogenetics	细胞遗传学
processional	游行
corruptly	腐败
gassy	空话连篇
traductor	邮包吊放装置
suggestive	暗示的
inverse	反转
shoemaker	鞋店
undevout	不真诚
allopatrically	单独地发生
microstrip	微波传输带
inconsiderable	琐屑
papua	巴布亚岛
ditto	同上
green	无经验的
ocd	Defense
chamber	膛
anguiped	有蛇状足
counterpane	床单
peremptorily	紧急地
mean	卑鄙
cockleboat	轻舟
parasympathetic	自主tIk/
magnetogasdynamic	^AsdaI`nAmIks/磁气体动力
rhizopodan	根足虫纲动物
dictation	听写
thrifty	节约的
flo	弗洛
pollenosis	花粉热
ochlocratic	暴民政治的
indecisive	非决定性
spain	西班牙
epigeal	浅水生长
keet	珍珠鸡
dye	染色
entomology	昆虫学
nom	Nominative主格的
miogeoclinal	=miogeosynclinal
sharpener	削刀
propitiate	劝解
oversexed	性欲过剩
hadith	穆罕默德言行录
hydraemic	稀血症
been	来过又走了
owly	像猫头鹰
hystricomorphic	豪猪型亚目
delation	控告
hag	女巫
dundrearies	颊旁长髯
crashproof	耐撞
unadvantageous	无助
eclectically	折衷
pus	脓
contrariness	反对
joint	共同
volute	向上卷
underprop	支撑
dinkey	小型火车机车
lunar	月的
pedestrian	通俗
photomontage	集锦照相
absurdness	愚蠢
attractive	吸引人的
gravific	产生重量
dell	小溪谷
crappy	讨厌
hardcore	没有限制的
boudin	香肠状碎肉
glyconeogenesis	糖合成
recertification	换发新证
gummous	由树胶构成
catchpenny	薄利多销
bedstand	床头柜
lactary	奶似的
backstay	后部支索撑物
bechic	镇咳的
stem	词干
triliteral	有三个字母的
requin	shark
disharmonious	不调和
lactometer	检乳器
terroristic	恐怖主义
sacramentalist	圣事主义者
circumoral	在嘴边
riser	起床者
rgs	Society
laic	外行人
quotidian	日常的
tungstous	低价钨
unassailed	未受袭击的
homopterous	同翅类的
suppurative	化脓性的
nii	Infrastructure
oceanic	海洋
cognitive	认知的
sidle	侧走
twistification	的事物
membranate	似膜的
synchronous	同步的
difunctional	双官能
concomitance	伴随
stealing	有偷窃行为的
delir	发狂
acotyledonous	无子叶
woodworking	木工艺
preadult	成年前的
lithographic	平版
fool	游荡
pratique	入港许可
unentangled	未缠住
diametral	直径的
skullcap	无边便帽
highstick	举杆过肩阻截对方
value	估价
mimeograph	油印
surplice	斜叠的
abluent	洗净
outfit	用具
dobber	浮标
athermancy	不透热性
statistical	统计
showplace	剧院
stop	障碍
whoredom	偶像崇拜
lilacky	丁香紫
huzza	表示大喜
flexura	曲折
hectometre	百米
accumulate	积聚
square	平方的
sensitize	敏化
sugi	cedar
ambisinister	两手均不灵活
nubia	努比亚
cpc	Party
zwickau	茨维考
ethanolamine	乙醇胺
raaf	Royal
ywis	=iwis
recumbency	休息
used	习惯
maneuver	机动
multitude	群众
cease	终了
tropism	向性运动
smokable	可以点燃抽吸的
mitospore	有丝分裂孢子
ptfe	tetra
unenlivened	无生气的
chile	智利
triable	可以试验
subtilize	过分精细
jetty	码头
pentastich	五行诗
mouthy	爱说话的
metatherian	后兽亚纲的
springhare	=springhaas
millet	稷
soggy	沉闷
hypertensive	高血压患者
circumscribe	限制
camp	露营地
dysfunction	官能障碍
tribeswoman	部落的女人
edge	挤进
radioheating	射频加热
convocation	教士会议
potatory	饮酒
count	计算在内
halomethane	卤代甲烷
wirk	=work
zoogloea	菌胶团
intention	意图
gruntling	小猪
invisibility	难看见
uat	Transport
incurrent	向内流
intrigue	激起……的兴趣
cloud	玷污
demos	民众
flimsy	脆弱的
precipitate	陡然下降的
absorbency	吸收能力
disputability	有讨论余地
water	水
gks	System
zuni	祖尼语
unaccountable	无责任
ephemeralization	陈旧加速化
hemimetabolous	不完全变态中的
algicide	=algaecide
squally	可怕的
indigently	贫乏地
slogger	猛击者
prevenient	以前
homoeothermic	温血
disyllable	双音节词
kindling	激发
angara	安加拉河
petrification	化石
improver	改进者
latifundium	大农场主
jimmy	铁撬
backcloth	背景幕
atherogenic	导致动脉粥样化
pipelike	管子似
smart	剧烈的
sentiment	感情
unsphere	使离开所在位置
penumbra	半影
fillis	粗麻绳
yestermorn	昨天早晨
monopolistic	专利的
thunder	雷
interstage	级间的
alarmedly	惊恐地
riblike	像肋骨
haylage	窖藏半干草饲料
upclimb	往上爬
votive	奉献
cytochemical	细胞化学
phi	个字母
neuropteran	脉翅目昆虫
bronchobuster	牛仔
pitiful	令人同情
filmable	可拍成电影的
flatcar	无盖货车
hyperboloidal	双曲面
ours	pro
wherefrom	出于那个
anchorage	停泊地点
uninformative	不增进知识的
unanswerable	无法回答
larch	其木材
vanitory	组合式梳妆台
menstrual	每月的
superstitionist	醉心于迷信的人
dexiotropous	向右的
morphology	词法、词态学
afghani	阿富汗
kooky	乖僻
granddam	老太婆
melanie	梅勒妮
francicize	使采用法语
uric	尿
tail	跟踪
grandiloquent	夸大
rotatory	使回转
organum	推理法
anenst	关于
bms	of
rake	斜度
cystic	胞囊
sha	angle恒星时角
arthrodial	滑动关节
chauffer	小炉的一种
vlb	由VESA开发的一种局部总线
overrun	超过
attractor	引起注意的人
nephrostome	肾孔
snaillike	蜗牛状的
megarian	麦加拉学派
founder	方正集团
rewin	再赢
sensibilia	可被感知的事物
foxiness	狡猾
parapeted	有栏杆
vertices	至高点
subside	下沉
galvanic	以流电所产
legitimatize	立为嫡嗣
psi	希腊文字母的第23
peppergrass	胡椒草
silkworm	家蚕
wit	智慧
weathermost	最迎风的
telegoniometer	无线电测向仪
shrubby	灌木的
attendance	出席的人数
vocally	用声音
swale	洼地
amortisation	分期偿还
unmeasured	不可测量
prophylactic	避孕药
beheld	behold的过去式和过去分词
darrell	达雷尔
veiled	隐藏的
journalistic	新闻工作者
heptaglot	用七种语言写成
izzat	个人尊严
chemoreception	化学感应
commove	使兴奋
inurbanity	粗鄙
azure	苍天
dissolubility	可溶性
quattuordecillion	一后有八十四个零之数
mature	使成熟
grillroom	烤肉馆
vouch	担保
contain	容忍
unsegregated	打成一片的
foraminiferal	有孔虫目
constrained	不舒服的
knightly	勇武
foreplane	粗刨
braless	不戴胸罩的
kerb	街头的边石
sponge	海绵体
eclectic	折衷主义者
msha	Administration
semilanceolate	半矛尖状的
araeosystyle	对柱式建筑
soubise	苏比斯调味汁
creamcolored	乳酪色
millionfold	百万倍
pig	贪婪的人
typology	象征学
approver	承认者
azury	浅蓝色的
karaya	gum刺梧桐树胶
tribulate	使经受苦难
bouffe	滑稽
redball	货运快车
ragamuffinly	衣衫褴褛的
waltham	沃尔瑟姆福雷斯特
pulsant	脉动的
and	/
blatant	喧嚣
synergic	协作
farthing	一点儿
implausible	不象真实的
sivaite	湿婆教派信徒
castrate	去掉最重要的部分
overpaid	overpay
cooptative	由原任委员投票
callow	未生羽毛
discoid	铁饼状
culpa	罪
prosperously	繁荣
temperate	温和的
dissect	切开仔细研究
redolent	芬芳的
milliroentgen	毫伦琴
distressing	使痛苦的
flaring	引人注目的
nectar	甘露
urbanity	文雅
queasily	令人恶心
ferric	三价铁
flinty	燧石似的
necroscopy	=necropsy
pillowy	枕头般
dusky	朦胧的
winch	绞盘
rsvp	if
diastasis	心休息期
reactively	反动地
philadelphia	费城
bidarkee	皮筏子
craniofacial	颅面
assembled	装配
unenclosed	不在修道院受管束
softgoods	匹头
stalactiform	钟乳石状的
reid	里德
untwist	解开
tunicate	有被囊
antileukemie	抗白血病
coagulin	凝固素
ost	Technology
antarctic	南极的
phantasmagoria	=phantas
text	正文
broadax	钺
integer	整数
unexaminable	无法测知的
tantivy	疾驱
lawd	上帝
luggie	带耳状拎环的木桶
demodulate	使解调
diproton	双质子
armband	臂章
betta	搏鱼属的鱼
fernbrake	羊齿植物丛
multidialectal	能讲2种以上方言
refractable	可折射的
vinaceous	像葡萄的
avertable	可防止
effuse	泻出
cpaffc	ForeignCountries
idyllize	使田园化
gametophyte	配偶体
anklebone	踝关节
conceivably	令人信服地
hortative	鼓励的
willow	柳木制品
algesimeter	痛觉计
triangulate	a由三角形而成的
popularity	流行
localizer	定位器
accusal	谴责
volute	涡形的
bobbysoxer	十三岁至十九岁的少女
pyrotechnic	烟火
autogenesis	自然发生说
herd	兽群
streptococcic	链球菌
tuneable	能调出和声的
unrope	解开绳索
xeromorphous	旱生型的
fl	氟
samp	玉米粥
ophthalmological	眼科的
promethean	独创性的
wayfaring	旅行的
younker	青年
defaecate	通便
exchangite	全国交易俱乐部会员
burro	驴子
hazardous	碰运气的
chelation	螯合作用
bootmaker	制靴者
dehort	劝阻
pliocene	上新世的
saving	搭救的
internee	被拘留者
amain	全速
beef	牛肉
amniography	羊水照相术
leaf	叶
spiflicate	痛打
unrevealed	未揭露
doughtily	勇敢
inspirator	吸入器
auntie	舅妈
lists	竞技场
fratcher	吵架
vagabondage	流浪生活
acclimate	使适应新环境
polyhedric	多面的
wad	块状软物
disaggregate	分解
scrumptious	极好的
mall	购物商场
heavenly	天上的
ethnogenesis	种族进化
domnus	达姆纳斯
ndola	恩多拉
walkway	走道
sneaky	鬼祟的
decanal	院长的
pectinaceous	果胶的
rightward	向右的
antemortem	临死前的
gemmiparous	发芽
retractable	可收回的
moistureless	无湿气
dde	Exchange
impedient	障碍的
driveability	操纵灵活性
fordo	使疲倦
gynandromorph	雌雄嵌体
flashily	瞬间地
sunken	凹陷的
triplicity	三个一组
furfuraceous	糠
sublimize	使高尚
uniform	相同
revenge	替……报仇
carry	运送
spunk	精神
irenic	和平主义
emblazonry	纹饰
integrated	综合的
unhallowed	污渎的
ber	Rules
marzacotto	透明釉料
remediably	可治疗地
youthfulness	少壮
steering	操纵
shovelfish	=shovelhead
diagonal	对角线的
moonlight	月光
tornado	龙卷风
molluscoidal	似拟软体动物的
pleasurable	快乐
flagging	委顿的
carry	意味
mussily	乱七八糟地
syrupy	像糖浆的
contrastively	对比地
tricolor	三色旗
marmorean	大理石
comb	鸡冠
sepalous	有萼片的
compressional	有压缩性
henchman	跟随者
academicism	艺术院的作风
excusatory	道歉
grown	长大
unprincipled	不道德的
verify	校验
sibling	兄弟
expander	使身体健壮的强身器具
uniparental	单亲的
chastiser	儆戒者
dropping	滴下
triose	丙糖
wherefore	原因
infector	传播者
philological	语言学的
contraceptive	避孕用具
siren	警报器
saxonism	撒克逊气质
cephalometry	头部测量法
tradeoff	权衡
hypochondrium	忧郁症
tradeoff	折衷
vitriform	玻璃状的
yieldly	支付
foresight	远见
levin	闪电
subjacent	在下级的
butcherly	无人性的
lactonize	内酯化
otherwise	另外的
expressly	特别
compliment	道贺
underfund	对……提供资金不足
hydromagnetics	磁流体动力学
culverin	一种枪
cryoplankton	冰雪浮游植物
templelike	似庙宇的
radiatory	=radiative
ephah	伊法
calvous	光头
ferromagnetic	铁磁
trivalve	三瓣
sinanthropus	中国猿人
scapula	肩胛骨
trichologist	毛发学者
xanthochroous	呈淡黄色的
sceptre	授与王权
grainy	多粒
impish	顽皮
sia	Singapore
combing	梳毛
portability	可携带
fireweed	在火烧过的土地上长得极快的杂草
unsigned	无符号
undistinguishable	难辨别地/IFEbl/
future	将来
emr	可教育的智力迟钝儿童
undersecretary	副部长
garishly	华丽
farce	为加穿插
enamelware	搪瓷器
savable	可救
weatherglass	晴雨表
vengefully	复仇心切地
vespertine	薄暮的
imperishable	不朽
finisher	润饰者
iise	伊尔瑟
sakeen	西藏羱羊
likuta	里库塔
ethnogeny	民族起源学
epithetical	形容语句
laurel	授予荣誉
straw	稻草
hallstatt	初期铁器时代的
trammel	拘束
pursuable	可实行的
carotin	胡罗卜素
smeary	弄脏的
agrestal	野生
pliability	柔韧性
counterchange	使交错
cline	渐变群
aldis	奥尔迪斯手提信号灯
ferrule	金属环
impractical	不切实际的
extrachromosomal	染色体外的
performance	演奏
healthful	有益健康的
turnip	芜箐
underseas	海面下地
jansenist	詹森教派信徒
pyrrhonist	怀疑论信徒
uintaite	硬沥青
auberge	小客栈
duplicate	完全相同
lab	研究室
topically	时事问题地
avirulent	无毒性的
reimprisonment	再囚禁
mythological	神话学
sprocket	链轮齿
absorbable	容易被吸收
dies	死
countian	居民
pentastyle	五柱式
twopence	两便士银币
deride	嘲弄
hortative	忠告的
micromere	小裂球
calcaneal	脚后跟
systemic	全身
inleakage	透入
equal	均等的
praxis	例题
parricide	杀近亲
fencelessness	没有围墙
arachis	落花生
reelect	重选
saccharogenesis	成糖
sororize	结为姐妹
flaunt	飘扬
incept	起始
beastly	令人不快的
ejectamenta	喷出物
peradventure	或者
sainted	德高的
steady	稳定
sullage	淤泥
redescribe	完全重新描述
bluntly	率直
shirtband	衬衫的襟子
vasculitic	患血管炎的
cooner	猎浣熊之猎犬
scoop	挖
halogenation	卤化
atonalistic	不成调的
oversupply	过度供给
daftly	愚蠢地
frap	缚紧
catheter	导管
acd	Automatic
uncomforting	不舒适的
woodcarving	木雕品
lacteous	乳状的
prothesis	词首增添字母或音节
desmoenzyme	结合酶
lifetime	终生
backcourtman	后卫
czar	独裁者
balsamroot	香根
duplicated	复制出的
regolith	土被
cpi	Price
faecal	渣滓
derogation	堕落
andromonoecious	雄花两性花同株的
teleology	目的论者
glosseme	语符
longtime	长久
eminent	显赫
yea	肯定
noncommunist	非共产主义者
vasodilating	血管舒张的
mesaxon	轴系膜
magnesian	氧化镁的
stud	用饰纽装饰
bodkin	锥子
ens	实体
trivalency	三价
screen	拍摄
anymore	再也不
anourous	无尾
tarpeian	塔尔皮亚岩石的
rim	边
eject	推断的事物
interjectional	叫声
beatific	快乐
fjp	Jewish
alarming	令人担忧的
outlandish	古怪
vile	不足道
zaragoza	=Saragossa
avail	有用
semirural	半农业的
vigorous	有力的
spooney	=spoony
ministrant	服侍者
picnicky	郊游的
boxy	箱子般四四方方
vasospasm	血管痉挛
polymorphous	多形态
epileptogenic	引起癫痫
mure	禁闭
blowfly	大苍蝇
semitropical	亚热带
token	象征的
ethereality	灵妙
philhellenic	亲希腊
backcloth	背景
bourne	目的
unfair	不公平
vernally	春天地
circumscribe	在……周围画线
shooter	射手
slinky	体态富于曲线的
incontinent	仓促地
scolding	责骂
likely	合适的
littlish	相当小
bonus	奖金
diastem	沉积暂停期
recursive	回归
imperturbed	镇静的
outspent	outspend
incomplete	不完全的
awing	飞翔的
fictitious	习惯上假定
hilar	门
usefully	有效
acarpous	不结果的
exanimation	昏迷
blastoid	海蕾
schmuck	笨人
entreprenant	大胆
bulkily	巨大
maninke	=Malinke
gdmo	Objects
riposte	机敏回答
pygmyisn	侏儒似的
structure	组织
pulchritudinous	美貌
broadway	百老汇
motorbicycle	两用车
interfacial	面间的
ratbag	乖僻之人
expensively	昂贵
microimage	缩微图象
nonlicet	不准许的
taurus	金牛宫
vlbi	interferometry
notionist	宗教观点偏激的人
tophamper	桅上的帆桁等物
enshrinement	秘藏
ribbed	有棱纹
visualizer	视觉型的人
sandhi	连接音变的
manageability	易管理
csce	on
courteously	有礼貌地
dipsomaniacal	=dipsomaniac
disharmonious	不调和的
inartificial	非人工
lomentum	=loment
polymorphic	多形态的
meaning	意味深长的
insinuate	含沙射影地说
intermezzi	幕间剧
function	活动
impracticably	无法可想地
ennead	九个一组
stably	有恒心
poultry	家禽
regular	定期的
methacrylic	甲基丙酸烯
soar	滑翔
inexpedient	不适宜的
osteal	骨性的
fairly	正当的
brahmanist	婆罗门教徒
carcinogenic	致癌物的
toluca	托卢卡
symphony	交响乐
villein	佃农
subsynchronous	次同步的
sweaty	吃力
petrous	岩石般
passee	凋谢
perceivably	可知觉
unfatherly	有失父亲身份
innerve	使活跃
svga	Graphic
creephole	借口
ibew	国际电气工人兄弟会
dolldom	娃娃国
unfaithful	不准确的
petty	小规模的
mismanage	办错
nutburger	碎果仁馅饼
mutually	互助
eastwards	向东方地
endopodite	内肢
often	常常
crawler	爬行动物
skiwear	滑雪服装
contumely	侮辱
luxuriant	肥沃
paper	用纸包装
unmurmuring	不咕咕哝哝的
cloop	砰声
rivalry	敌对
allusion	提及
wild	疯狂
inappreciable	微不足道的
loose	不牢固的
hydro	水疗院
albomycin	白霉素
underpaid	所得报酬过低
emporium	商场
exacting	严格的
avisandum	=avizandum
undissolute	不放荡的
impalpably	不能感知地
glm	length
slan	anno
slav	斯拉夫人
vitrifiable	可玻璃化
uplooking	有抱负
seaway	船只在海上航行
dextrogyrate	右旋
used	旧
fedora	一种浅顶软呢帽
dysthymic	心情恶劣
handjob	手淫
autoregulative	自动调整的
glare	光滑的表面
alphonse	阿方斯
stress	重压
gerontic	年迈
unambivalent	肯定
screwy	扭曲
jaunty	洋洋得意的
matted	有席子
antivivisection	`AntI9vIvI`FEn/
uranous	含铀的
hystricomorphic	豪猪型亚目的
hopeless	不可救药
jingoism	主战论
rapturousness	狂喜
proso	稷
witticism	俏皮话
hardie	=hardy
tuneable	能调出和声
associate	副的
fulgurating	突然剧烈发作的
rot	腐烂
headlong	轻率地
mid	中央的
lengthily	冗长地
ovulatory	产卵
adas	and
twelfth	第十二
solemnify	使庄严
andromonoecious	雄全同株
overdry	使过干
forgive	饶恕
npv	p
sugariness	象砂糖
definitive	最后的
indian	印第安语
semicircle	半圆形
sweepstake	赌金的独得
exoelectron	外激电子
screenwriter	编剧家
gunyah	土人的小屋
foresighted	有先见之明的
cristated	有冠
put	击
dioptric	折射光学的
chainomatic	链码天平
corydalis	紫堇属之植物
canuck	法裔的加拿大人
setter	塞特种猎狗
diseur	独白艺人
unintelligible	难解
dantesque	庄重
tarlatan	塔勒坦布
vodkatini	martini
charlottetown	夏洛特敦
imagery	雕刻
bowyer	射手
thisbe	提斯柏
orthicon	象管
superbomber	超重型轰炸机
macrolepidopteron	大型鳞翅昆虫
seedtime	播种时期
wide	宽的
industrialist	产业工人
uproar	骚动
gayal	大额牛
setup	调整
rebellious	反叛
journal	定期刊物
toast	使暖和
triquetral	三棱
umbellule	次生伞形花序
convulsion	震撼
spr	Psychical
nonetheless	虽然如此
gastralgia	胃痛
funny	滑稽人物
mudfat	肥壮
anteriorly	居先地
scotophase	人工黑暗期
apocatastasis	复原
arthrodia	滑动关节
stale	陈腐
purvey	供给
liquidly	流畅
supremacy	霸权
sordid	肮脏
rainwater	雨水
automatic	机械的
tweeter	高音用扩音器
msls	Science
degeneracy	堕落
resistable	=resistible
gauss	高斯
bitch	母狼
insectivorous	食虫动植物
secondary	二级的
channels	通道
rattlebox	格格响的玩具盒
flaxseed	亚麻仁
kinless	无亲戚
calipash	龟的背肉
syntactically	在语句构成上
endure	忍耐
parament	祭台布
techy	易怒
either	也
cogency	肯切
haunch	腰
mepacrine	麦帕克林
sap	体液
urban	市内
corpus	尸体
ducking	急速的低头
peppercorn	胡椒子
peplus	=peplos
mammiferous	哺乳动物
jut	伸出部分
neotype	新模式标本
hell	阴间
quezon	奎松城
unmitigated	未缓和
material	材料
goggle	瞪眼看
interchange	相互交换
concoctive	调合
dutifully	忠实地
inanimation	不活泼
weak	无力
grubstake	资金
clone	无性系
zone	地域
similitude	相似
formalin	福尔马林
pentad	五年间
tsunyi	见Zunyi
coulomb	库仑
sadism	病态的残忍
summary	概要
hsaa	Health
spiritualistic	降神术
megatanker	巨油轮
hickey	唇印
tornado	英国、德国、意大利三国合作研制的双座双发超音速变后掠翼战斗机
cut	切口
uncorrectable	无法改正的
watchfully	警惕地
gradualness	渐次
referenced	引用
leucocyte	白细胞
shelly	壳一般
interstrain	不同品系间
transignification	质变
stakhanovism	斯达汉诺夫运动
option	选项
semimilitary	半军事的
unorganized	未加入工会的
mdap	Assistance
stingray	黄貂鱼
hate	不喜欢
retrieval	拯救
rundown	纲要
untold	未说过的
caernarvon	卡那封郡
undistinguishable	难辨别的
imap	Protocol
curricular	课程的
cythera	塞西拉
spuddy	矮胖
str	submarine
nattiness	帅
yoghourt	酸奶
pancuronium	溴化双哌雄双酯
azygous	非对偶的
vb	Visual
naily	钉有很多钉子的
helve	装柄于
ectogenous	外生的
traitorously	不忠地
veronica	耶稣面像
responsible	有责任
gutty	有勇气
abbevillian	阿布维利文化
exhaustive	无遗漏的
francophone	人
unstrikable	禁止罢工
reflectingly	反映地
fiddlefucking	操他妈的
gore	淤血
druze	=Druse
despise	轻视
capitalintensive	资本支出庞大
carping	吹毛求疵
osb	本笃会
inched	英寸
disanimation	灰心
confederacy	同谋
belated	误期的
metaboly	物质交替
crura	腿
spodosol	灰土
excision	切除
aliunde	来自其他方面
reticent	沉默寡言
recriminative	互相责备
riflery	射击技术
dexiotropous	向右
nitrifier	硝化细菌
traceableness	可描绘
salination	盐化
sneery	嗤笑
ocs	Officer
printery	印刷所
hoodwink	欺骗
tirade	长篇激烈的演说
xanthochroous	带黄色
demonstrability	论证可能性
juvenescent	到达青年期的
amethyst	紫水晶
indistributable	不可散布
taxloss	赋税亏损
barkeeper	酒吧老板或酒吧招待员
quadricorn	有四个角
corf	养鱼槽
reval	=Tallinn
psilophytic	裸蕨植物的
puerpera	产妇
unembroidered	朴素的
tell	知道
driftage	漂流
souse	被浸透
etruscan	伊特鲁里亚人
aeroacoustics	空气声学
garrett	加勒特
antihelium	反氦
mini	袖珍型
anomalous	反常的
dopaminergic	多巴胺能的
crossbar	闩
chromous	含二价铬的
drainage	排水
necrotic	骨疽的
exaggerative	夸大
trusteeship	托管统治
mend	改进
monolog	独脚戏
chinkapin	栗树的一种或其果实
morphographemic	语素字素
sabretache	军刀挂套
transmit	发射信号
gradual	逐步
yankeeland	新英格兰
piquant	辛辣
flex	伸缩
holding	持有
niedersachsen	Saxony
petaliferous	长有花瓣
checkout	检验
disseminule	传播体
judaize	使犹太化
slimmer	减轻体重者
emptysis	吐血
unneutral	非中立
rhq	Regimental
replacing	更换
suppurative	化脓性
jadish	精疲力竭
oceanicity	海洋度
demisemi	四分之一
whence	从何处
istria	伊斯的利亚
landsting	两院制议会
underage	未到法定年龄
slump	消沉
lampooner	冷嘲热讽者
overland	经过陆
amort	无生气的
radiograph	拍……的射线照片
chromophile	染性
department	处
tonsorial	理发师
lsat	School
meddler	爱管闲事的人
floppy	松软
tallboy	双层衣橱
syndicalism	工会组织主义
bubblehead	笨蛋
debilitate	使虚弱
threnode	葬歌
heterocrine	多种分泌的
overshoot	飞过目标
simple	简朴
mickle	多
lark	百灵鸟
twinkling	荧荧
pleonastic	冗言的
extracanonical	经典以外的
voluminous	大部分的
seismonastic	感震的
inaptly	不合宜地
undermost	最下地
indemnify	赔偿
outstretch	伸出
fricative	摩擦音的
breasthook	尖蹼板
crosspiece	横档
nondirective	不直接提问
reinvest	再授给
upbraiding	谴责
crankish	暴躁
kweilin	见Guilin
liminary	开头
elated	兴高采烈
arctic	北极的
slate	石板
skyward	向上的
hayrack	装有草架之货车
melancholiac	患忧郁症
pustular	脓疱的
fordless	不能徒涉的
unfeigned	真实的
fluoroscope	荧光检查器
nullification	使无价值
riverfront	河边陆
nigrostriatal	黑质纹状体
dalmatic	加冕服
frustrated	落空的
topgallant	最佳
biochemist	生物化学家
uninsured	未保险
belief	信任
propyl	丙烷基
unvexed	安详的
sublimate	升华
prepositional	当前置词的
benignly	亲切地
airily	轻盈
featly	优美的
hairdressing	美发
unsaleable	无销路的
plumbism	铅中毒
explicatory	说明的
swim	使浮起
dragonesque	似龙
diagnose	诊断
supersedure	取代
abbreviatory	缩略的
est	东部时区
unregretted	无人对之表示悔恨
willed	有某种意志
tapette	搞同性性关系的男子
hottish	尚热
vain	徒然的
bmx	bicycle
certain	确定
cagayan	卡格扬河
unaspiring	无上进心
penannular	形不成闭环
antalgic	止痛
trisubstituted	三元取代
equivalve	两壳形式和大小相同
andantino	微急地
slimsy	脆弱的
traditional	惯例
disunite	使分离
spark	火花
pat	正好
woodland	林
resourceless	无方略的
cataleptic	全身僵硬症病人
clipped	省略一部分的
loudly	响亮
unexacting	不严厉的
crosspiece	闩
shrub	灌木
archimandrite	修道院长
logroll	互相捧场
eglantine	野蔷薇的一种
fleshless	瘦
reverential	可敬
pinstripe	细条纹的布料
causeless	无显著原因的
absent	缺席的
testamentary	遗嘱中有
esthesiometer	触觉测量器
mastership	熟练
simulate	冒充
dithyramb	酒神的赞美歌
diphosgene	双光气
jewbaiter	迫害犹太人者
rewinder	倒带装置
opal	乳色玻璃
creepy	爬行
brevet	名誉晋升
aapss	Academy
flittermouse	蝙蝠
rugged	崎岖的
delphic	神谕的
stragglingly	落后
girder	梁
armistice	停战
keeler	用来测量液体的容器
dat	Tape
furnishings	家具
fnma	Mortgage
tangency	接触
swiz	诈取
connexion	联系
housebroken	管教好
forward	早
overaggressive	过于放肆的
impressive	感人的
banka	=Bangka
lifetime	寿命
naturalization	移植
jimberjawed	有突出下颌
dovecote	鸽房
unsheltered	无居所
humourously	幽默
pompano	鲳参鱼
trieste	的里雅斯特湾
repose	长眠
plf	per
pasteurise	=pasteurize
undereducated	受教育不足的
tymbal	鼓室
fetiparous	胎儿未发育完就生产的
mailable	可邮寄的
nc	网络计算机
cotemporaneous	同时代的
clothespress	衣橱
demisable	可让渡
sarcoplasm	肌质
ubiquitarian	基督圣体遍在论者
sabinian	萨比尼安
blame	责备
introduce	引进
trichroic	三色现象的
opuscule	小作品
robe	礼服
stably	稳定地
moulage	印模
probationary	缓刑的
calorigenic	产生热量
tainture	污点
ternate	三出
polarimetric	偏振测定
vendable	=vendible
cartelize	组成卡特尔
bicornuate	新月状
hesperornis	黄昏鸟
magistral	威严傲慢
unload	卸货
detail	详情
zigzag	Z字形的
egodefense	自我防御
approvable	可核准
declivity	倾斜
trigonal	三角形
perennity	持久
austerity	节俭
rappen	分
saving	救助
stuffless	不充实
handshaking	握手
terraneous	陆生
depressor	抑压者
eastward	向东的
theologically	神学
raintight	不漏雨的
experimentation	试验
uncorrected	未订正的
pneumatic	灵魂
semiprofessional	半职业性选手或运动员
topiary	修剪灌木的
portamento	滑音
maritime	海运
teletype	用电传打字机拍发
bracing	支柱
squirely	适合乡绅身份的
triplicity	三倍
eely	滑头滑脑
fold	折叠起来
firth	河口湾
eventless	平凡的
noisome	有毒
thallus	叶状体
methaqualone	安眠酮
pyramidion	方尖塔的顶角锥
undersign	在……的下面签名
redintegration	复原
relocatee	迁至新址者
leprous	患麻疯病
acinar	腺泡
velarize	使软腭化
irreproducible	不能再现的
appoint	指定
luxuriant	奢华的
tail	后部
cebu	宿雾市
cracking	裂化
gestate	创案
howl	嚎啕大哭
orins	of
flickeringly	闪烁
immetrical	无韵律
left	leave的过去式和过去分词
cochleate	螺旋形的
shuddering	震动的
dauntless	不屈不挠
regenerate	起革新作用
rich	丰富
farrier	蹄铁匠
white	白
typology	类型学
mangonel	投石机
yanqui	美国人
credibly	由可靠方面
nasa	Space
wisperer	低语者
thunder	雷声
biogeocoenosis	生态系
quadrivial	四高级学科的
undulatory	波动的
socialise	=socialize
siderolite	铁陨石
unga	General
absently	茫然地
repute	称为
corruptly	可被收买的
url	Resource
chemoprophylactic	化学预防的
impercipient	认识不足的
gemmer	勘探宝石者
boatrace	竞渡
extradite	引渡
esterase	酯酶
loss	损失
unfluctuating	稳定的
sentimentally	富情感
frigga	弗丽嘉
latvian	拉脱维亚
kimberlite	角砾云橄岩
luck	幸运
hyperosteogeny	骨质增生
alcides	阿尔喀德斯
hexapartite	分六部分
eldo	European
whipsaw	用粗木锯锯
supereminent	极为出色
antiallergenic	抗变应性
oddish	有点怪的
several	单独
humidistat	湿度调节器
rusty	迟钝的
ephedrine	麻黄硷
simplicity	简单
quintillion	百万的五次方
unrwa	联合国难民救济及工程局
metagalactic	总星系
book	名册
sagger	制烧箱的耐火黏土
red	赤字
intermarriage	异族结婚
symmetrophobia	不对称
midwinter	仲冬
funny	好笑
stingy	缺乏的
beastly	残忍
deceive	行骗
hoveler	无执照难船救助员
lampless	不点灯的
chiliast	信徒
html	Hypertext
flavopurpurin	媒染3号茜素红
mondain	凡夫俗子
tanning	皮肤晒成褐色
tdma	Division
periodic	定期的
marsh	沼泽地
fusional	熔解的
pigeonite	易变辉石
tache	纽带
innervation	心]运动感觉
adina	艾迪娜
trilobate	具三裂片
vfd	fire
bronchotomy	气管切开术
metol	甲氨基粉
regret	哀悼
footie	=footy
uranalysis	=urinalysis
workpeople	工人们
ipsu	IP
tuft	用丛毛修饰
jagged	锯齿状的
insouciant	漫不经心
stimulus	刺激
freshwater	内河
overstrength	人员超编的
mis	Management
choosing	决定
reliant	依靠
ulnar	尺骨
bivouac	露营
wilmer	威尔默
swat	长打
kolo	科洛舞
unhinge	使失常
pinocytic	=pinocytotic
intercrop	间作
piggish	贪心的
gneissose	片麻岩
flap	拉下的边
iii	罗马数字
adrenotropic	促肾上腺的
niff	臭气
nongovernmental	非政府
nyse	Stock
triphosphate	三磷酸盐
map	图
ito	International
perfect	正确
variceal	静脉曲张的
entomologic	昆虫学的
upswing	提高
wordpad	记事本
insider	权威人士
cytotechnologist	细胞学技士
biting	刺痛
squash	压扁
coiner	伪造货币者
hypocrinism	内分泌不足病
homolog	相同器官
lenitive	轻泻
nasty	污秽
teletypist	电传打字电报员
fluidise	=fluidize
offenceful	有罪的
square	成直角地
paretic	局部麻痹的
pentomic	五群制原子师的
homespun	朴素
fifa	Football
nonviable	无法生活
socius	伙伴
bridewell	感化院
coffee	咖啡豆
tepefy	变微热
somatogamy	拟无配子生殖
unicuspid	单尖
achromatic	非彩色的
hardly	严厉
comprehensivize	使
handle	搬运
artiodactylous	偶蹄动物的
butterbur	菊科蜂斗菜属
reverently	虔诚地
sutra	经典
keckling	包缆绳
thanatopsis	死亡观
moabite	摩押人的
hateless	无憎恨之感的
unattainable	难到达
xenial	异花受粉
clan	氏族
denunciatory	非难的
fretsaw	线锯
veil	掩饰物
color	色彩
parochialism	教区制度
cladogram	进化树
everyday	日常的
piercing	刺穿的
phyllotactical	叶序的
pettitoes	脚趾
phelps	费尔普斯
denotation	指示
preceptive	教训性的
hemodynamic	血液动力学的
asepsis	灭菌法
dasher	猛冲者
carnallite	光卤石
shifting	狡猾
oligochrome	只用少数颜色
highstick	举杆过肩
parthenogenone	单性生殖生物
attorney	律师
forbidding	令人难亲近
ruggedness	粗野
cinzano	沁扎诺牌苦艾酒
undivided	专心
capriform	如山羊
verbal	口头的
elkhound	猎鹿犬
gynogenesis	雌核生殖
proruption	膨胀
burying	埋葬
ordinant	命令
reflex	反映
vain	愚蠢
ruthenic	四价钌
stoutly	刚强
schizocarp	分裂果
mimeograph	油印机
whiney	=whiny
shoeshop	鞋店
bushy	浓密
wearisome	乏味的
entrammel	妨碍
register	挂号
intercommunion	交流
charge	充电
garnishry	装饰品
brs	Road
terotechnology	维修工艺学
laura	劳拉
spck	for
lipotropism	亲脂
leadswinging	装病
psilanthropy	=psilanthropism
protectionism	保护主义
rheometer	血流速度计
charily	节俭地
routeway	通路
unspilt	未流出
cogent	使人信服
cut	删节
exterminatory	根绝
phycomycetous	藻菌
anxiety	忧虑
twirl	旋转的东西
rattail	没毛的马尾巴
froth	泡
phellogen	软木形成层
unrenewable	不可更新的
utter	流通
impermissibility	不允许
ginnel	小巷
programer	节目制作者
scatty	疯狂
vesuvian	火山
proud	自豪的
vadm	Admiral
begrime	弄脏
arytenoidal	杓状的
volumeless	不占容积
client	委托人
lancinating	刺痛的
ostracize	放逐
ikan	鱼
adventure	冒险
philhellenic	爱好希腊
pipelaying	铺设水管之工程
delicatessen	熟食店
fsf	Free
nccj	Conference
zedzap	一种文件传输协议
manhattanite	曼哈顿区人
driegh	=dree
bluff	诈骗
impresario	乐队指挥
rooster	公鸡
wsb	Stabilization
halt	立定
landwards	向陆
matchwood	碎片
jundy	推
potlatch	冬节
unrhythmic	无韵律
calling	职业
unmerciful	无情的
singularity	单一
alimental	食物的
garrote	西班牙的绞刑具
ripsnort	喧闹地行进
pedes	的复数
oscular	嘴的
unjoint	解开结子
unequalable	超不过的
unaspiring	无抱负
deceit	谎言
procuratorship	procurator
lickspittle	献媚者
colorific	给予颜色
dustpan	粪斗
halfway	半路地
punic	古迦太基人的
achaean	希腊的
bmw	Works
religion	宗教
grundy	过分重规矩的人
comate	多毛
reduplication	加倍
uracil	尿嘧啶
unseeing	没有看到
kainite	钾盐镁矾
prostration	俯卧
premise	房屋连地基
toastmaster	致敬酒辞者
fatbrained	脑筋迟钝
ditchdigger	开沟机
windowy	洞多
bhil	比尔人
expiree	前科犯
causal	原因的
sinfully	罪孽深重地
distractible	易于分心
tastefully	风流地
pet	宠物
hide	皮革
scale	数值范围
knight	骑士
extortionist	勒索者
incondite	生硬
undeniable	不可否认
serve	招待
inscriptionless	无碑铭的
dnb	National
saltish	微咸
maldivian	马尔代夫人的
shyly	胆怯地
residue	残余
september	九月
monophobia	孤独恐惧症
dustpan	畚箕
zymogram	酶谱
sterling	纯正
customary	习惯的
semidomesticated	半驯tI`keIFEn/
haply	偶然地
flyaway	不合身
moline	风车式的
glomerulate	聚成密集小群的
granger	农夫
seignory	领
electrothermal	电热
fecundity	多产
brute	畜生
pharmacological	药理学的
russ	俄国人的
colossians	歌罗西书
holometabolous	完全变态的
dynamograph	握力计
maiden	纯洁
drive	干劲
clique	结党
neapolitan	那不勒斯人
crenelation	开垛口
necessitarian	必然论者
monotonous	单调的
lippy	爱顶嘴的
wardian	沃德箱
lutetian	Lutetia
do	给予
electropolar	电极性
rigid	刚硬的
ref	裁判员
flightily	浮躁
rancher	牛仔
chloritic	亚氯酸盐
push	努力争取
splintage	使用夹板
rurally	农村风味
sideward	旁边
dop	合成树脂可塑剂
unconcerned	不关心的
shadberry	唐棣
referrence	谘询
anticyclonic	反气旋的
days	每天
deprave	堕落
bucharest	布加勒斯特
pessimal	最坏
bbb	breakfast
acidize	用酸处理
amniotin	一种春药
atrabilious	沉闷的
grill	烤肉
pock	使有麻点
domesticity	专心于家务
fertilize	使多产
waterproof	不透水的
spumescent	泡沫状的
tony	时髦
misfire	不发火
marsupialization	造袋术
dyschronous	不合时
bevatron	质子加速器
atomix	yeah
flush	泛滥
inebrious	喝醉
out	外出
dignify	故做显贵
marianist	巴黎圣母会成员
tantalization	逗弄
parament	礼罩
tandjungpriok	丹戎不碌
corporation	企业
zigzag	作Z字形
liquid	流动的
vasculitic	患血管炎
geraniaceous	牻牛儿苗科
onlooking	旁观
hemocyte	血球
lacerable	撕得碎的
tinamou	鸟类之一种
justificative	起辩护作用
nikethamide	尼可刹米
confection	糖膏
juvenal	羽毛未丰的
inarguable	没有疑问的
garter	吊袜带吊住
vulture	贪婪的人
extracanonical	未入圣典
repressive	压抑的
python	巨蟒
mhr	of
panelling	镶板
subjectless	无主题的
idle	闲散
rigmarolish	胡言乱语
beravement	丧失
accredited	可信任
minicell	小细胞
simple	无经验
tatty	不值钱的
suspender	袜吊
scutate	圆盾形的
sapphirine	假蓝宝石
vestige	退化的器官
disappointed	失望的
insinuative	暗示的
flounder	辗转
ringwise	呈环形
dislimn	使的轮廓模糊
tradable	可买卖的
singularity	异常
pouch	把……装入袋中
clime	地方
monogamian	=monogamous
reinforce	增援
alveolate	多小孔的
whop	打败
penoche	=penuche
various	多样的
tricolette	针织网眼丝织物
sequestrum	腐骨片
geezer	古怪老头
arms	武器
tontru	南京市政府重点支持的信息产业龙头企业
amylose	多糖
cirrous	有触毛
hii	健康保险学会
stravage	徘徊
kanu	Kenya
unapprehended	未被理解
bird	鸟
promises	承诺
natively	生来
skupshtina	国民议会
credence	信任
converse	倒
rituality	墨守仪式
fruit	成果
fortress	要塞
traditionary	惯例
dews	system远程预警系统
suborning	行贿
boatyard	船坞
iconomatic	名称
punisher	惩罚者
ps	IBM
delate	告发
vein	使成脉络
worrier	担心的人
radialization	辐射
blotchy	到处有污点的
red	红的
underbush	=underbrush
monosymptomatic	单症状
dessiatine	俄国的地积单位
furrier	毛皮衣制作工
alleviate	使易于忍受
haemolytic	血球溶解的
excursion	远足队
synchronization	同一时刻
regrant	重新批准
anglomaniac	崇拜英国的人
rancher	农场工人
ciliated	有纤毛
camp	扎营
woodcraft	木工术
trame	=tram
reproduction	复制品
rupestrian	在岩石上发现的
sequestrectomy	死骨切除
emblaze	点燃
madcap	狂妄
tx	德克萨斯州
pothanger	吊杆
rabbanist	rabbinite
sahuaro	=saguaro
schlemiel	倒楣的人
joint	合办
podsolisation	=podzolisation
plumb	铅锤
moorish	摩尔人的
outskirt	郊区
arbitrative	有权公断的
academicism	形成主义
unmoral	无辨别是非能力的
floatable	可浮起
bakkie	小型厢式轻便货车
androgenous	雄性单性生殖的
decahedral	十面体
warn	警告
dysteleological	无目的论的
curtle	ax=cutlass
mustardy	芥子粉的
protrudent	伸出
philomel	夜莺
angry	狂暴
savage	野蛮
pesky	麻烦的
procoagulant	促凝血的
extract	开方
hdcd	高解析度光盘
caravaggesque	卡拉瓦乔的
drawbench	拔管机
coalhole	煤库
eonism	异性装粉癖
hobbyhorse	摇动木马
sabbathbreaker	不守安息日的人
chronograph	记时计
mirador	塔楼
squamaceous	鳞状
remoteness	远离
equivocator	说话支吾的人
antitone	反序
becripple	使成残废
amniotic	有羊膜的
reins	激情
examinator	审查人
reconcilably	不矛盾地
flexibility	弹性
disclaimer	放弃
primary	根源
woman	女仆
lumbermill	锯木厂
brash	仓促
famulus	助手
theirself	pro
sthenic	精力旺盛的
shareable	可分享的
leviable	应纳税
numbhead	=numskull
nymphet	放荡的少妇
acyclic	脂肪族
unaccountable	无责任的
easygoing	懒散
seize	逮住
invertebrate	无骨气的
extortive	强求
informative	见闻广博
intelligibility	可理解性
chromophil	亲色性
nce	新天主教版本
fructiferous	结果实
hogg	尚未剪过毛的小羊
smooth	圆滑
psephology	选举学
bergamot	香柠檬
valet	衣物架
eeoc	Egnal
brushwork	画法
excusatory	辩解的
brimless	无边的
apolitically	不关心政治
oxenstjerna	Axel即Oxenstierna
discoloration	污点
brunhild	布伦希尔特(德国史诗
anaesthesia	感觉缺乏
enlighten	教导
elisor	司法
underemphasis	重视不够
backlining	背衬料
eyepatch	眼罩
laten	变迟
entoplastron	内腹甲
distance	遥远
devotement	奉献
intensify	强化
prothesis	圣餐的准备
muscle	臂力
hyperdactylia	多指
boustrophedon	右行左行交互书写的书法
dissectional	剖析
teleostome	硬骨鱼
bioautography	生物自检法
mephitic	有毒
villiform	绒毛状
deceitfully	骗人
spicily	痛快
rics	皇家特许测量员协会
supersensitive	过敏的
presence	存在
cerdar	雪松类植物
larrikin	喧闹
comstockery	对有伤风化的文艺作品的强烈反对
bailiff	镇长
irinite	铈钍钠钛矿
jokari	乔凯利球戏
flanerie	漫无目的
unbranded	无物主的
friend	朋友
omnidirectional	全方向
debark	使下船
nicotian	烟草
indented	锯齿状的
levyist	主张没收资本者
reposal	信赖
illatively	根据推论
anigh	靠近
batman	传令兵
arithmetical	算术的
mowing	割草
pocket	小型的
catenary	悬链线的
compunctious	惭愧的
recitative	吟诵的
gnarl	生节
phosphokinase	磷酸激酶
speak	操
walnut	胡桃木
untillable	不能耕种的
dead	无感觉的
pitch	斜度
eventless	平静
drolly	诙谐地
explore	探究
wrapper	包装材料
doited	老糊涂
clear	完全
greta	格里塔
fairyhood	小神仙
bhoodan	(20世纪50
carucate	卡勒凯特
looped	酩酊大醉的
hcg	human
opaque	迟钝
millionfold	百万倍地
winder	螺旋形阶梯
terrifically	可怕
stimy	阻挠
grandee	大公
kinkled	卷曲的
aerophagia	吞气症
dead	呆板
righthearted	正直
sesquioxide	倍半氧化物
taxis	整复法
discombobulate	使混乱
tickler	记事本
caliban	凯列班
commissariat	粮食
ambulation	步行
forebrain	前脑
poud	=pood
mixotrophic	混合营养的
mukhtar	乡长
statuette	小雕像
papaveraceous	罂粟科
belfried	有钟楼
hemocytoblast	血胚细胞
convent	女修道院
buccaneering	海盗的
katalase	=catalase
whichever	pro
spiritedly	活泼地
xms	extended
padova	=Padua
hardcore	绝对的
aleak	湿气的
amplitude	振幅
reinstate	恢复
anechoic	无反响的
calix	杯
redoubted	可惧的
monomaniacal	对一事狂热
tiliaceous	椴科植物
electoral	选举的
glycerate	甘油酸盐
super	过分
akvavit	=aquavit
slavery	奴隶制度
arillode	假性假种皮
sympetalous	合瓣
disproof	反驳
raising	提高
inadvertency	怠慢
narrows	纽约湾海峡
buirdly	粗壮的
empoison	使蒙受毒害
alienism	外侨身份
crista	羽冠
encarpus	花果形装饰
usphs	States
dieresis	分音符号
cankered	不怀好意
fantod	烦燥
phil	菲尔
apparente	明显
distance	一长段时间
great	大写
monosexual	单性别
mode	模式
thiophosphate	硫代磷酸盐
send	送
while	时间
fissile	易裂
isoplastic	等基因移植物
accumulative	积聚
fast	彻底地
capsulary	蒴
falculate	镰刀状的
saltireways	成X形
alight	落下
discriminatorily	歧视地
heteronymous	同形异音异议词
sensoria	感觉系统
altorilievo	圆雕
comparable	可比较
dreamfully	梦多地
abolitionist	废奴主义者
uncensored	未经审查
device	发明物
amused	开心的
computernik	电脑人员
aquifer	蓄水层
fragile	脆
pledge	典当
helplessly	无能为力
crossette	门耳
naeb	of
phe	Engineer
comtian	实证主义
boycott	联合排斥某国货物或与某国绝交
jo	Jordan
unsoldierly	不英勇
whisht	默然的
aerophobe	飞行恐怖症患者
lymphosarcoma	淋巴肉瘤
diplophase	双倍期
numerously	多数地
gharry	车
sindon	优质布料
conversance	熟悉
remunerative	有利
weathermost	最上风的
auxiliary	补助的
haemophilic	血友病
cynegetic	打猎的
drive	驱使
mesothelial	间皮
despiteously	可恨地
deposition	免职
nonfluency	不流畅的言辞
dance	舞会
fire	烧制
vestibulospinal	前庭脊髓束的
anarchic	无法无天
curacoa	柑桂酒
corposant	放电光球
unreasoningly	无理智地
outboard	外侧的
dragonesque	龙状
macerate	浸软
mire	泥潭
costful	昂贵
forswore	为forswear的过去式
onwards	在先地
slicken	光滑
blacking	黑色鞋油
dressing	敷裹
pennant	短绳
gulf	深渊
born	天生就……的
fatted	肥胖的
logogram	速记用略字
niggerize	使黑人化
afforce	加强阵容
flowerless	隐花
limy	涂有鸟胶的
corsican	科西嘉
poltfoot	=poltfooted
antirust	防锈
noiseless	寂静的
tame	使变得平淡
heterocaryotic	=heterokaryotic
salbutamol	柳丁氨醇
unequalable	超不过
protension	伸展
rushlike	像灯心草
arterial	动脉
numerate	读
trichomonad	毛滴虫
swathe	包围
evolving	展开的
fringlish	法式英语的
gibbose	拱起
clop	马蹄声
hateful	可恶
mean	不舒服
cacography	书法不佳
micromanipulation	9maIkrEJmE`nIIpjJ`leIFLn/
mesmerize	施催眠术
fine	美好的
guidwillie	热诚的
blusterous	虚张声势的
utter	发出
psychotogen	致精神病药物
acd	自动呼叫转发器
nerd	讨厌的人
acetic	乙酸
thanatopsis	对死亡的见解等
gangman	劳动班组成员
nagmaal	举行圣餐仪式的时刻
lysimeter	溶度计
whither	目的地
whorl	涡
antique	古董
washy	稀薄的
atomy	侏儒
peacock	炫耀
hateful	可恶的
exhausted	疲惫
sulfonal	索佛拿
revolvably	能旋转地
sound	健全
razorback	狭尖的背脊
whatnot	不可名状的东西
deposition	沉积物
autocephalous	自治
perception	DPS公司出的数字影像压缩卡
respirometry	呼吸运动计量法
tease	梳理
droning	发嗡嗡声的
buildup	组合
shebang	事情
davey	戴维
matrix	矩阵
dionysian	酒神节的
mealymouthed	转弯抹角说
spatula	压舌板
sportswoman	女运动家
arthroplastic	关节造形术的
illusionist	魔术师
uselessly	无用
incendiary	纵火犯
trueness	真
dissimilation	异化
level	瞄准
wise	明智
khoums	库姆斯
paroemiographer	谚语汇编者
pileup	连环相撞
feverfew	菊科植物
interlineate	=interline
short	简略
summerhouse	凉亭
terrorist	恐怖分子
tardigrade	节肢动物
medially	平均地
smooth	流畅
pungent	严厉
twu	Union
typhomalarial	伤寒型疟疾
traditional	传说
thermophil	喜温的
bulbous	球根长成
mothery	含醋母
comfortlessly	不舒服
triphibian	善于陆海空战的
macumba	马库姆巴
tale	叙述
evenminded	沉着
floricultural	养花的
dingo	澳洲野狗
exterritorial	治外法权的
cornily	产谷地
bust	胸部
flea	跳蚤
kickdown	换低挡
suboceanic	洋底
oceanaut	海中作业员
jcr	Junior
cotyledonous	有子叶的
laver	水盆
inexplorable	无法研究
victrola	维克多牌唱机
unwilling	不愿意
evolvement	演化
dog	犬
coralliferous	含珊瑚的
jussive	命令的
durable	持久
mitreboard	斜锯架
condottiere	雇佣兵
plena	的复数
wuchang	武昌
niftic	漂亮的
intimidatory	恐吓的
chlorophenol	氯酚
quadrantal	象限的
latent	潜伏的
jaculatory	投掷
indwelling	留置的
eugenic	优生学
coastward	向海岸地
homostasis	同态
tother	别的
ackey	西非黄金海岸用银元
bluecoat	穿蓝色衣服或制服的人、警察、士兵
disbandment	解散
polyamine	聚胺
zootechny	畜牧学
volkslied	民谣
placidly	平静
venous	静脉
angelic	天使的
kokobeh	果皮粗糙
festoon	花彩
ashkhabad	阿什哈巴德
illimitable	无边际的
smokeless	无烟
misdirection	写错
yh	hostel
usurpatory	篡夺的
giselle	吉塞尔
fiery	炯炯有神
exploratory	探险的
punner	夯具
besiege	围困
jerk	急拉
himyaritic	希米亚里特语
belock	锁闭
egoistical	自我中心的
dendrochronology	树木年代学
epigeal	生长在地上
upset	使心烦
occlusive	闭塞的
poignant	尖锐的
oilily	油似地
publishable	可出版
harlotry	卖淫行为
pussley	=purslane
zoologize	研究动物
dolerite	辉绿岩
ostentation	夸耀
dissected	多裂
prolixity	罗嗦
invite	邀请
frostbiter	冬季帆船运动员
backstop	捕手
fuel	燃料
barytic	重土
through	通过
hitlerism	希特勒主义
scatter	驱散
punitive	刑罚
sustainable	养得起
animal	动物
practicism	务实主义
serriform	锯齿形
restrain	制止
circumambient	周围的
styliform	刺针状
chaliced	杯中的
windshield	挡风玻璃
submaxilary	下颚
nitroaniline	硝基苯胺
insubordinately	犯上
zygomorphic	两侧对称
froggish	蛙状
byr	十亿年
acarpous	不结果
icu	intensive
formalism	虚礼
trevira	聚对苯二甲酸乙二酯纤维
cytotropic	细胞互向性的
belecture	谆谆教诲
linux	一种可免费使用的类UNIX操作系统
hiking	徒步旅行
polak	波兰人的
neonatal	初生
rabelaisian	法国讽刺作家拉伯雷
oceanaut	潜航员
stillborn	生下来已死的
sbn	Standard
palytoxin	水螅毒素
unexcited	镇定
diminutively	仅仅地
vealy	初生牛犊般
bold	粗体
spongiose	多孔
walk	走
unworthily	不相称地
start	惊跳
diplacusis	复听
kidnapper	绑匪
ludwig	路德维格
bowerbird	澳洲产的一种鸟
baneful	有害
sink	水槽
audiphone	助听器
jewry	犹太人
hunt	搜索
pretty	机灵的
nonfluency	不流利
softbound	=softcover
haemoid	像血
sportfishing	从事垂钓
unturned	未颠倒
pancarditis	心包内膜炎
breezee	微风
unsearched	未搜寻过的
hybridise	=hybridize
rpc	Corps
bittersweet	又苦又甜
ordonnance	安排
attenuation	变细
blond	白肤碧眼金发的人
typhogenic	引起伤寒的
pollinize	=pollenize
terrify	恐吓
hydroboration	硼氢化反应
caribbean	加勒比海
vigneron	葡萄栽培学家
lacerable	撕得碎
capsulotomy	晶状体切开术
bike	自行车
unstudied	未学过的
stilt	支柱
amorously	好色
lenitive	减轻痛苦的
homy	自在
gimcracky	华而不实的
cetacean	鲸类动物
postpartum	产后的
epistle	书信体诗文
unrazored	未修剪过
interrupt	打断中断信号
neighboring	接壤的
besieger	围攻者
stinking	臭的
coordinate	并列的
sextus	第六个
temporal	现世
nonfinite	非限定的
coverlet	床单
lias	早侏罗世
studious	热心的
vdc	Volunteer
satiation	厌腻的
worthy	应……
woodworking	干木工活的
criminologist	犯罪学者
genearch	族长
tiffin	吃午饭
scraggly	起伏的
dichloride	二氯化合物
gratefully	感激
stockpot	什锦锅
bisulfide	二硫化物
criminal	罪恶
fledgy	盖以羽毛的
unquestioning	不加疑问
roily	焦急的
scrappy	杂凑的
delightedly	欣喜地
gni	gross
picaresque	以歹徒为题材的
scca	Club
bum	游民
untrodden	杳无人迹的
impeccance	无误
vortices	旋涡
recreancy	胆小
inerrability	确实
napoleonist	拿破仑式统治方法鼓吹者
ungainly	笨拙
insulation	绝缘
transformation	改EnEl/
neuroactive	刺激神经组织
confusedly	受困惑
amentia	智力缺陷
dapperling	短小精悍的人
waterloo	沃特卢
supervisory	监督的
contrastimulant	有镇静作用
disturbingly	令人不安
ccitt	Committee
glimpse	一看
benty	多硬草的
slicker	刮子
apeak	立锚
tsoris	麻烦事
maelstrom	大漩涡
railing	扶手
available	可用到的
inerrably	无误地
adder	小毒蛇
during	在……的时候
educible	可引出的
arrestment	阻止
interzonal	区间
diadochic	同晶性型的
ramekin	小干酪蛋糕
variety	种类
underemphasize	对……重视不够
monotrichic	单鞭毛
defiant	目中无人的
hant	常到之处
cisalpine	阿尔卑斯山这一边的
dialogize	对话
lithocyst	石囊
parpen	系石
matchmaking	火柴制造
service	服务性
najd	=Nejd
effeminacy	女人气
undiluted	未冲淡
discrete	离散的
nonenforceable	不可强制执行
snifty	傲慢
radiotoxicology	辐射毒害学
unqualified	无资格
dizygous	两受精卵的
buzkashi	马背叼羊
fist	拳打
invalid	有病
riot	暴动
clicket	弹簧锁钥匙
sleet	雨夹雪
aerially	空想地
wail	哀号
bms	Science
visitatorial	巡察的
depopulation	灭绝
parkland	公用场
consternation	恐怖
veranda	走廊
haily	冰雹
plaint	悲叹
phineas	菲尼亚斯
drum	击鼓
hemimetabolic	具有半变态特性的
recalcitrant	顽抗的
curdle	凝固
neurocirculatory	神经循环系统
athwarthawse	横在
tufa	泉华
podgy	矮胖
myob	不关你的事
universally	全体地
supposed	假像
pack	捆扎
condensative	易凝缩的
temperate	戒酒的
totemistic	图腾
neologist	新教义信奉者
trash	垃圾
lavendery	芳香
eld	古人
dm	Music
jackhammer	手提钻
cloxacillin	邻氯青霉素
unpatriotic	无爱国心
willing	自愿的
supervisal	管理
volleyball	排球
bourne	小溪
rainbelt	多雨地带
naris	鼻孔
limy	涂有鸟胶
keratose	角质物质
gentilesse	礼貌
allelomorph	对偶值
rearmament	重整军备
topically	总论地
crochet	用钩针编织
composmentis	精神健全
graven	雕刻的
scurrilous	下流的
crustless	没有外壳
scots	苏格兰人的
encapsulate	压缩
oni	Naval
galvanocautery	电烙器
cryptic	含义模糊
deadhouse	停尸所
bonhomie	敦厚
porky	肥胖的
theocrat	神权政治家
riancy	兴高采烈
pentachord	五音音阶
bec	economics
angor	绞痛
dais	讲台
antihelix	对耳轮
bulgy	膨胀的
tlo	total
charily	节俭
seedy	不适
inconceivable	不能想像
nemoricoline	生长在树丛中
octangular	八角形
ethos	民族精神
retentivity	记忆力
demonize	使成为魔鬼
aesthetics	审美学
monostrophic	单韵律
rap	Projectile
gamesmanship	竞赛时使用的虽不光明但不犯规的方法
nauseate	使恶心
adunc	向内弯曲
corporation	法人
protectress	女性保护人
consequential	结果的
algonkin	=Algonquin
comfortlessness	不舒服
adiathermancy	绝热性
argillaceous	粘土
murphy	马铃薯
agravic	失重
veil	口实
dank	透水的
ruddily	呈现赤红色地
natural	自然界的
nonabsorbable	不能吸收
discoverist	发现教学法
exorable	可用恳求打动的
weird	超自然的
homophonic	同音
sculpture	雕刻品
downrange	发射中心和沿着试验航向的
highjacker	强盗
corporative	法人
wire	电信
dislike	讨厌
wftu	of
antipruritic	防痒的
intelsat	International
neuter	无性
transferability	可转让性
paotou	包头
slapman	便衣警官
semplice	单纯的
hectograph	胶版
message	消息
liechtenstein	列支敦士登
susceptibility	易感性
darkling	黑暗的
heliotype	胶版
embellishment	修饰
volume	册
axisymmetrical	轴对称
veteran	老兵
fenestra	小孔
benedick	新婚者
haemoptysis	咳血
call	呼叫
pentalogy	互相关联五部分的组合体
unneutral	不公正的
fungitoxicity	杀真菌毒性
brittle	脆弱的
rhapsodic	狂想的
epididymis	附睾
satisfaction	令人满意的事物
ambivalent	好恶相克的
crownling	幼主
injective	单射
deconvolve	展开……卷积
debeak	去喙
incitement	激励物
ketch	一种双桅船
naughty	淘气
convivial	欢乐
thesaurosis	贮积病
tenner	十磅纸币
haplology	重复音略读
fiver	五镑钞票
sternforemost	倒退
periventricular	室周的
snafu	天翻地覆的
bagarre	骚动
streaky	容易变的
chasmic	如深壑般破裂
enclosure	围住
herbalism	草药医术学
foil	阻止
kayo	击倒
secretary	秘书
guanine	鸟嘌呤
lane	巷
bacchic	喧闹
crownwork	齿冠成形术
salvageable	可挽回的
kanarese	卡纳拉人
dormie	=dormy
astern	向船尾
crescive	成长
mineral	矿石
physostigmine	毒扁豆碱
closely	接近地
equivalent	同意义
cfs	second
isapi	Internet
opprobrium	责骂
additional	额外的
inchoate	未形成
isdn	Digital
orb	围着
tyrannical	残暴
mouthy	爱说话
corporate	共同
aborative	精心的
suberect	几乎直立
death	致死的原因
shortgrass	短禾草
avariciously	贪财
decumbent	横卧
shroff	鉴定
sternutative	喷嚏的
inverse	反面
sexual	有性
spitsticker	船首形木刻刀
waxweed	叶柄萼距花
stinkweed	发出臭味的植物
greensand	绿砂
phototypesetter	照相排版机
serotonergic	血清素激活
beloid	前窄后宽的
tinned	镀锡的
banditi	土匪
lifeful	充满活力的
regal	适于帝王
troubleproof	无故障的
gleam	瞬息的一现
slivovitz	梅子白兰
masticatory	咀嚼剂
apiarian	养蜂的
hindward	往后的
bevy	一群
unhasty	慢吞吞
suffrutescent	半灌木状
astroid	星状
instantial	实例的
ostrejculture	牡蛎养殖
enzootic	地方性动物病
rhymeless	无韵
monadism	单元论
donnish	象大学宿舍的学监一样的
nervily	大胆地
cheek	颊
throughput	生产量
promptive	激励
jointing	焊接
crankery	脾气古怪者的行为和想法
salability	出售
gothicism	野蛮
marathon	马拉松赛跑
reformatory	改革
moonish	反复无常
cuddle	拥抱
ethnologist	人种学者
flintshire	弗林特郡
polyzonal	多圈的
muddle	混浊状态
byzantine	拜占庭派的建筑师
deerstalking	猎鹿
logograph	语标
boa	围巾
adaptability	适应性
retract	所卷
semiorbicular	半球形的
computernik	电脑迷
virtue	德行
happify	使高兴
maharaja	王公
saccharomycete	酵母菌
urticaceous	荨麻科植物
tankfuls	一槽的量
troop	群集
methadon	美沙酮
shoo	嘘
deathlike	象死人
collision	冲突
castellan	寨主
kerman	科曼地毯
geniality	亲切
innovatory	革新
humpery	交媾
imputation	归罪
caisson	弹药箱
odour	香味
fairly	公平对待某人
recast	重做
wheatland	适宜种小麦的地
halfway	部分
chevy	追逐
forrader	更向前
phenix	不死鸟
ambisonics	高保真度立体声响复制
fine	杰出的
desiccant	干燥剂
citral	柠檬醛
cancroid	癌症状
overplus	过剩
decidophobia	决策恐惧
disloyalty	不忠实
otp	开放商务协议
atwitter	兴奋
unwholesome	不健康的
upward	以上
photovoltaic	光电的
emblazonry	炫耀的展示
soliloquist	独语者
oppugnant	敌对
pyroborate	=borax
acceptable	合意的
leer	斜视
colligation	捆绑
unfenced	没有防备
quoter	引用者
thermostatic	温度调节装置的
ferric	铁的
seminatural	半自然的
warily	留心地
befriend	待人如友
agamic	无性生殖
teutonization	条顿化
gaullist	反纳粹德国占领运动的支持者
thuriferous	产乳香
heptaglot	用七种语言写成的
irksome	讨厌的
fallacious	令人失望
syncretic	类并的
amiantus	石棉的一种
astringer	驯鹰师
foursquare	坚定的
acclimate	服水土
veneration	尊敬
erratic	无确定路线
gangplank	跳板
cymar	女衬袍
insoluble	不能溶解
simplehearted	心地纯洁
declarable	应申报的
meanwhile	其时
vilely	讨厌地
marrate	说明
neogene	晚第三纪
sweetheart	情人
mechanics	结构
creepy	皮肤上有足爬似的
hematozoon	血寄生虫
honeymoon	蜜月
rifle	用步枪射击
undp	Development
affinitive	关系紧密的
gay	尤指男性同性者
hexabiose	己二糖
stymie	完全妨碍
expo	展览会
cutaneous	影响皮肤的
finlet	小鳍
underlaid	underlay过去式及过去分词
unture	不正确
elliptically	省略地
rigorism	死脂
vervain	马鞭草
mint	薄荷糖
eskar	蛇丘
farmy	有田地的
sphygmomanometer	血压计
foldout	插页
judo	柔道
capapie	完全地
germanophobia	恐德症
cockeye	喝醉的
lymphopoiesis	淋巴细胞增殖
starry	布满星星的
white	蛋白
topocentric	以地面上的某点为中心的
lickerish	好色
entirely	完全
opaquely	不透明
anilingus	舐肛
brimfull	盈满
straightforward	正直
fanatic	盲信者
ligurian	意大利土语
cameralist	经济学者或官员
rampant	猖獗
belecture	时加叱责
stunt	矮小的人
potass	钾
climograph	气象图
dagoba	佛骨堂
stirring	忙碌
rabboni	先生
absorbable	可吸收
coxcombical	浮夸
neuridine	纽利定
acidimeter	酸比重计
subjunctive	虚拟
mhr	Representatives众议院议员
record	履历
rubberize	涂橡胶
undone	未完成的
choler	大怒
destrier	军马
wire	打电报
workmanlike	精巧的
craniotomy	颅骨切开术
nlp	loan
tripey	无价值的
refluent	倒流
memory	内存
frizzle	使卷曲
personal	容貌的
lacustrian	湖上住屋的
unimer	单聚体
uncoil	解
bidialectalism	两种方言通
temperable	可回火的
railwayed	有铁路
quiesce	沉寂
fashionably	按照流行
thorium	钍
claque	一群捧场者
leaflike	像叶子的
houseperson	料理家务的人
chanceless	无可能性的
generosity	宽大
fixure	固定位置
loam	用肥土填
bms	Marine
fragmental	断片的
gnaw	啃
early	及早的
pubic	耻骨
microalgae	微藻类
tress	发辫
enigmatical	谜一般的
uneven	不平均的
unsuspectingly	信任地
csma	Mutiple
unpoetic	无诗意
noblest	华丽
bald	枯燥的
concertation	协调
mudslide	泥流
carnassial	食肉的
autotruck	运货卡车
inflator	充气者
algidity	发冷
villose	长绒毛的
seventeenth	第十七
treason	通敌
doglike	忠实
clift	断崖
cryptographer	译解密码者
consanguineous	密切
rason	黑色宽袖长袍
cycle	一段时间
contempt	耻辱
tepid	不热情
holozoic	以摄取有机物为食
here	此时
dolerite	粗粒玄武岩
methodologist	方法论学者
coi	中央新闻署
pravda	俄
ethical	民族特有
careful	仔细的
insatiable	不知足
flighty	轻狂的
upholster	装饰
preteen	青春期前的
imaginabale	可想象
swore	swear的过去式
jaboticaba	拟爱神木
peritrack	=taxiway
chinois	漏勺
maleficence	坏事
inconsonant	不协调的
scutter	疾走
diastereomer	非对映异构体
anvil	砧骨
mechanistic	机械论学说
underpass	高架桥下通道
yb	镱
itching	渴望
anchylose	变僵硬
dogwatch	暮更
iba	Independent
marengo	马伦戈式的
omnific	有无限创造力
hutchie	临时帐篷
exostosis	外生骨疣
rouse	奋起
hols	假期
enigmatical	不可思议
cerite	铈硅石
sixfold	六重
unserviceable	无用的
aeciospore	锈孢子
arrant	彻头彻尾的
maisie	梅齐
platiniferous	产铂
jillet	轻浮的女子
daphnis	达佛涅斯
fenderless	无挡板的
visitorial	访问的
hydroxyketone	醇酚
tripper	旅行者
immunosorbent	免疫吸收剂
typhogenic	引起斑疹伤寒
ecosystem	生态系统
concertize	演出
dermatozoon	皮肤寄生虫
levelheaded	清醒的
gunite	压力喷浆
unaccountably	不能说明地
proselyte	改信仰者
kook	怪癖的
mothy	多蛾
closet	储藏室
vetanda	禁忌
compathy	共有的情感
lenity	慈悲
rhodomontade	=rodomontade
ligature	绷带
kama	爱神
several	单独的
tetrarch	小王
lubberland	极舒适的地方乐土
unseparated	分不开的
overmountain	住在山上的
viewpoint	观点
hood	引擎罩
vasculature	脉管系统
solion	电化增益器
privateer	武装民船
undutiful	不顺从的
relation	亲戚
manna	吗哪
unchain	解除
landaulet	landau
servant	仆人
compromise	妥协
bibulosity	酗酒
unexcelled	极好
atrocity	凶恶
mediocritize	使变得平庸
convalesce	渐愈
opisometer	曲线计
rive	撕开
slentando	渐慢
animalization	兽性化
steeper	浸润器
ungainly	难看地
refulgent	灿烂
mustache	胡子
infinite	极大的
verminate	孳生害虫
mazu	马祖
charlatan	吹牛者
aew	airborne
azygos	无对偶的部分
ingenuously	率直
pantheon	伟人祠
apivorous	食蜂
hardball	硬式棒球
lightfastness	耐光
blet	疲倦
niggle	小气地给……
conmanship	骗术
kingstown	金斯敦
guttiferous	产藤黄的
unblest	不幸的
euphemistic	委婉
allantoic	尿囊内的
uddi	Discovery
fagot	柴把
awry	错误
civil	文职
apoplectic	患中风者
mesothoracic	中胸的
tuffaceous	凝灰岩的
airman	飞行员
flowery	绚丽
crank	易怒
encephalic	脑的
revulsant	引起诱导的
vinous	葡萄酒的
diphenylaminechlorarsine	二苯胺氯胂
lapsed	堕落
vacuum	产生真空
posseman	民兵
faint	无力
antienergistic	逆能
interdependent	相互依存地
crassitude	粗糙
leftish	左派
tuneful	和谐
armourial	纹章书
startler	令人惊骇的人或事件
cask	桶
derangement	发狂
corneous	角状的
okazaki	冈崎
councilor	评议员
agenesis	发育不全
rataplan	敲鼓声
esthetical	美术的
hegumen	修道院长
flow	泛滥
truckage	搬运费
discordancy	不一致
unwakened	未觉醒的
milton	米尔顿
apocynaceous	夹竹桃科
brakesman	轫手
polemarch	官员
jacobian	函数行列式
neutrality	中性
samel	半烧
ryukyu	琉球群岛
unanimously	无异议地
transmigrator	移民
onager	中亚野驴
polycrystal	多晶体
linolenate	亚麻酸盐
freeform	形式自由的
gamebook	猎获物记录簿
totality	全食
plo	Liberation
skinpopping	皮下注射麻醉品
plateresque	带复杂花叶形装饰的
reclame	臭名
nibble	轻咬
urolith	=urinary
monomial	单项式
susceptibility	磁化系数
innervation	神经支配
isthmectomy	峡部切除术
fretful	焦躁
airer	晒衣架
guilty	有罪的
ah	希吉拉纪元
metallise	=metallize
antagonistic	反对的
preharvest	收获期前
blowlamp	汽油吹焰管
foozle	笨拙的行为
unsicker	不确实的
preinvasion	入侵之前
trivially	很一般的
audiogenic	声音所引起
love	爱慕
regress	回归
proportionment	比例
separator	脱脂器
parameterize	=parametrize
undeify	使非神化
merciful	慈悲的
inferiority	自卑
seiko	日本精工株式会社
devastatingly	讥讽
oligotrophic	贫营养
almsdeed	善举
bofors	博福斯式高射炮
hammada	石质沙漠
mu	字
bourne	目的地
coq	羽毛
hibernation	避寒
validate	使生效
pharyngal	咽的
unfading	不凋萎的
predator	掠夺者
nerc	National
vitellogenin	卵黄蛋白原
guiltless	无辜
semon	义符
liabilities	债务
merchantable	有销路的
enol	烯醇
undertrick	宕墩
pugilistic	拳击家的
outcast	流氓
start	出发
unsuitability	不相称
sickening	令人作呕
extraparliamentary	非国会所能控制的
erect	笔直
boltrope	帆边绳
prejudicious	有损害的
indigoid	靛蓝类染料
omnific	创造一切的
jacobian	的理论的
petroleuse	用火油纵火的女子
compliably	依从
temporal	世俗
rehabilitation	复原
tumultuate	使骚动
shipment	装船
geopolitician	地缘政治学者
partner	股东
synchronicity	同步性
blaze	火焰
cougar	美洲狮
hackle	针排
luteotropin	=luteotrophin
gynaecoid	似女性
most	多数
foist	硬卖给
assumed	假定
southward	向南的
hyperbole	夸张法
electrostriction	电致伸缩
coagulatory	凝结的
emanant	发射
edo	Data
jd	Jurum
utp	Twisted
plebiscite	公民投票
dullish	昏暗
completely	完全
avian	鸟类的
rumply	弄绉
eradicator	根除的人
fuddle	使迷糊
potatory	饮酒的
face	地形
pulse	脉冲
eec	Emission
contrariously	相反地
polysulphide	多硫化物
satay	=satai
diestock	螺丝攻
unadaptable	不能改编的
chirograph	任何正式签字的文件
correlative	关联
disinvestment	收回投资
acclamation	赞成
unexcited	不兴奋的
larcener	盗窃犯
biased	结果偏倚
warden	区长
sutural	缝口的
vvip	very
cool	淡漠的
overcome	战胜
sleepful	睡得很安宁的
ridgel	=ridgeling
pinocytotic	胞饮作用形成
semidiurnal	12小时的
dipteral	四周双列柱廊式
dorset	of多西特
astronomy	天文学
maneating	食人
level	平坦
martemper	使分级淬火
typhous	斑疹伤寒症
aeolotropy	各向异性
castrate	删除
whim	反复无常
candida	坎迪德
frequently	频繁地
contradance	对面舞曲
chromatolysis	染色质色原溶解
unseen	未见过的
metatarsus	跖骨
bolt	上门闩
lincolnite	林肯拥护者
nllst	Lending
strangulation	压缩
inexpectant	未预期的
witchetty	grub
reenlistment	延长服役期限
coruscation	闪光
manifer	护手铠甲
enumerably	可列举地
unimaginative	缺乏想象力
ectosarc	原虫外膜
forget	忘记
policlinic	门诊部
erotological	色情文学的
decline	下降
land	国家、国土
igmp	Internet
euphroe	绳索收紧器
unpresumptuous	谦逊的
perambulatory	巡行
cud	反刍的食物
convolvulus	旋花植物
inextinguishable	压不住的
caudal	尾部的
ammonium	铵
duplicate	副
valuables	贵重物品
anik	"兄弟"号卫星
autogyro	旋翼飞机
intervene	干涉
geanticlinal	地背斜的
purpoint	point
incompetent	不合格的
smart	巧妙
hormuz	霍尔木兹海峡
ahg	globulin抗血友病球蛋白
pigout	一顿大吃
crosswind	横风
northernmost	最北
wittily	机敏地
piedmontese	皮埃蒙特
froward	刚愎的
snappish	急躁的
catalog	目录
abbreviatory	缩写的
tel	电话
unobstructed	不被阻塞的
waterproof	防水的
owlish	象猫头鹰的
strikingly	引人侧目地
outdoorsy	户外
poe	载货港
soak	浸
whither	去处
chionodoxa	四萼齿草
gold	金制
molasses	糖蜜
armamentarium	物质
abrupt	陡峭
piezometric	压力计的
adamite	裸体主义者
meccano	装配玩具
deadeye	三孔滑轮
pantagruelist	庞大固埃式人物
hyperoxemia	血酸性过强
infrasonic	次声所产生
rename	再命名
gibbose	凸状
aldo	奥尔多
analogic	类推的
mankind	男子
highland	丘陵地带
seem	似乎
calumniator	诽谤者
pipsqueak	矮小的人
garment	外衣
conquerable	可战胜
inquirer	调查者
anticodon	反密码子
brinded	有斑纹
cippus	古罗马
null	零
melodic	调子美妙
insufferably	不能忍受
sportsdom	体育圈
tumescent	肿起的
aquatone	用有感光胶的金属板做套色印刷的方法
pantie	s:
score	刻划
fuel	加燃料
fashionable	流行
seric	中国人
stupe	热湿布
asc	consciousness
silly	无助的
antiviral	抗滤过性病原体
toparch	小国统治者
ratiocination	推论
remarriage	再婚
nynorsk	尼诺斯克语
resident	居住的
co	Colombia
astuteness	精明
wetland	潮湿的土壤
ascomycetous	子囊菌类
sfx	special
obscene	猥亵的
breadthways	横地
waterworks	喷水装置
accused	被告
prehormone	前激素
sundial	日晷
didactical	教训的
tanniferous	生丹宁酸的
closet	厕所
fake	伪造
lithophile	亲岩性的
detrude	扔掉
limpet	帽贝
vallum	垒墙
winking	目语
groundage	进港税
ovoid	卵形体
fully	充分
rift	裂缝
hurriedly	仓促
tumescent	肿起
mpm	metres
sided	有边
