sterling	标准纯银
thankworthy	值得感谢
heteroclitic	=heteroclite
deepfelt	深深感到的
uralian	=Uralic
indulgence	放任
rhythmical	合拍
palliatory	减缓
stackstand	垫架
shock	突击
pieridine	粉蝶科
arcturus	大角星
nuncupative	口述的
escalation	增加
accroach	强占
tramroad	轨道
angina	咽痛
salyut	"礼炮号"
commis	副手
variola	天花
glitch	短时脉冲波形干扰
clear	空旷
faucalize	使带喉音
martellato	槌弓奏法
flatboat	平底船
leafless	无叶的
amoral	与道德无关的
panhellenism	泛希腊主义
thuringia	图林根州
habanero	哈瓦那人
unclassifiable	不可归类
blithesome	愉快
neutretto	中介子
colonial	殖民地的
manned	有人驾驶的
intramural	校内
leatheroid	假皮
rimous	多裂口
infrastructure	下部构造
lantern	天窗
prepositional	前置词的
environmental	环境的
athlete	运动选手
bedsheet	床单
feldspathose	像长石的
horunspatio	horae
windjammer	饶舌的人
effectively	有效地
marseillaise	马赛进行曲
expire	期满
tropology	比喻之使用
halfpenny	半便士之值
queuetopia	Q托邦
norilsk	诺里尔斯克
maltster	制造麦芽的人
apagogical	反证法
cgh	Hope
huarache	条带鞋帮拖鞋
enrich	使肥沃
iodate	以碘处理
lively	真实
rejoicingly	高兴地
reinvition	再邀请
tether	范围
kotow	磕头
physiotherapeutic	`fIzIEJ9Wer`pjU:tIk/
resolutive	消肿
antihuman	反人类的
showbread	=shewbread
logy	迟缓
indissolubility	不稳定性
lacrimate	=lachrymal
charivari	大胡闹
lace	花边
unprompted	未经鼓动
botchy	不精致的
stinker	臭鬼
depressible	可抑低
electroengineering	电工学
pollutant	污染物质
hydrogen	氢
noddy	笨人
kindling	引火柴
saprophagous	以腐败物为生的
asterid	海盘车
singularly	不常见
smokechaser	森林灭火员
sphygmogram	脉搏描记
stationmaster	站长
subphylum	亚门
peloton	佩洛通玻璃
abasable	可贬黜
algoid	水藻般的
henceforth	今后
corticate	有外皮的
corrective	矫正物
monetization	铸造货币
immovable	不动的
miee	of
tussis	咳嗽
openhanded	大方的
uselessly	无用地
yarn	纱线
dyspnea	呼吸困难
autotransfusion	自体输血法
trembly	发抖
scepter	拥登王位
postponement	延期
canting	伪善
nonskidding	=nonskid
controvertible	可辩论
er	铒
dysphagy	咽下困难
inequable	不均匀的
hermes	electromagneticseparator
offal	下水
planetesimal	星子
ivba	Association
undyed	未染色
interlay	插于中间装饰
keenly	敏锐
localiser	=localizer
veena	=vina
emotive	动感情
municipalism	地方自治论
mipmap	MIP映射
jock	苏格兰高原地方的士兵
neutercane	变性热带气旋
erode	侵蚀
kite	空头支票
dun	催促者
blurry	不清楚
surgy	动摇得很厉害
morphotactics	语素结构学
grappler	抓东西的人或物
tincture	酊剂
heaps	非常地
nacred	真珠质
muzzleloader	前装枪
potentiality	可能性
solus	单独的
fatter	丰满的
honorific	表示敬意的
uda	Data
loop	打环
flocculous	丛毛状的
actual	实际
corruptionist	舞弊政治家
abstractive	摘要式
cyclosis	胞质环流
madly	发狂地
phosphene	光幻视
triploid	三倍体
bismuthal	铋的
celibate	独身者
hmcs	Ship加拿大皇家海军舰艇
rabbitry	养兔场
papillose	多疣
forficulate	形状像小剪刀的
chaung	水道
aerially	象空气一样
spandy	漂亮的
jejune	贫瘠
circannian	以一年为一周期
gk97	金山软件公司制作的一个中文界面、用于修改游戏的工具软件
extra	另外
shiplap	用以相接槽口的木板
illegitimacy	不合逻辑
axletree	轴
indophenol	靛酚
iatrogenicity	因医生的治疗而引起的病症
stuart	英国斯图亚特王室
dozen	十二个
slablike	平板状的
form	组成
chirk	快活
gumshoe	秘密行走
expressional	表现的
limpa	甜黑麦面包
lacunule	小陷窝
eric	Center
desirably	愿望地
sure	有把握
bacteriolytic	溶菌
nob	头
liberator	释放者
martyr	殉教者
sfa	Association苏格兰足球协会
acd	Call
muff	弄糟
suberic	木栓的
therewith	与之
encurtain	给……装上帘子
dicty	富裕
create	引起
schimpfwort	侮辱性称谓
catechesis	用问答方式演讲
fraenum	=frenum
victorianism	维多利亚女王时代之风格
substantiate	使实体化
orthoaxis	正轴
denver	丹佛
foaly	怀驹
abortive	夭折的
grayling	河鳟
upswept	向上弯曲
vdt	Display
stalactite	钟乳石
reducible	可简化的
invisible	无形
acetabularia	伞藻
working	运转的
hermaean	赫尔密斯方形石柱的
schottische	其舞曲
perch	位于
preantiseptic	抗菌法采用前的
alta	阿尔塔
beanie	无檐小便帽
disrupt	使陷于混乱
kempt	梳理好
semiyearly	半年一次
leave	同意
unspiritual	非精神
divali	=Dewalee
irksome	令人厌烦的
distinctness	明显
tweet	鸣叫
ampliative	扩大的
constabulary	警官
gynoecium	雌蕊
invandrare	客籍劳工
kurtosis	峰度
decolorize	使脱色
prolixly	冗长
offertory	奉献仪式
immovable	固定的
unretarded	未受阻止的
cooling	冷却
transpositional	变换
untrodden	杳无人迹
overdrunk	overdrink的过去分词
skirting	裙料
mitered	戴礼冠
reasonless	不合理的
altisonant	崇高的
stabbed	刺穿
kaf	希伯莱语的第十一个字母
autoconditioning	自动调整
jove	朱庇特主神
lara	拉腊
laureate	佩戴桂冠的
manizales	马尼萨莱斯
collect	由收件人付款的
exhalant	发散管
retract	缩回
faultfinding	挑剔
outstretch	伸展
piccata	香溜肉片
dipteral	有双廊的
alienator	让渡者
dependency	属国
dutiable	有税
packinghouse	罐头工厂
liquory	烈酒所引起的
processional	游行的
immovable	不动
moorcroft	默克罗夫特陶器
feat	合适
flexible	灵活
mottlement	斑驳状
thanage	大乡绅的身份
reflet	光泽
outworn	用旧
lettering	书写的文字
sententious	富于格言
allot	分派
slash	削减
tootsies	小脚
hortative	鼓励
mammonist	贪财者
scutate	圆盾形
handwriting	书法
clamp	夹紧
wheatland	小麦地
falkner	William
yap	狂吠声
unwrung	不被扭曲的
roam	闲逛
plane	水平
inexplainably	无法解释地
papillate	乳头状突起
incurably	治不好
subthreshold	不足以引起反应的
celestially	神圣
wristlet	腕饰
catrigged	独桅艇装有桅艇式之索具
aging	成熟的过程
junkie	废旧品商人
reduced	减少的
expostulatory	忠告
assiduous	勤勉
moluccas	MoluccaIslands摩鹿加群岛(印度尼西亚东北部马鲁古群岛
pancake	薄烤饼
objurgatory	叱责的
phosphorylase	磷酸化酶
farcicality	谐谑
floral	植物
pteridoid	如蕨类
reasonableness	妥当
neighbor	邻居
marinate	浸泡
impropriator	接受教会财产移交者
hardcase	强健
speculation	思索
nyassa	尼亚萨兰人
commemorable	值得纪念
solicitudinous	焦虑的
chindwin	亲墩江
keister	屁股
indetectable	不易发现
clubbable	善交际
puky	令人恶心
slade	of
exhortatory	告诫的
homeopathy	同种疗法
palatable	美味
crispation	卷缩
ptomain	尸毒
finely	美好地
word	为……措辞
overhead	企业一般管理费用
token	表意
overuse	过度使用
noncombat	非战斗
settler	殖民者
admix	混合
terrifically	极端地
leaf	翻书页
papaw	番木瓜
shrilly	刺耳
paroecious	雌雄有序同苞的
query	表示怀疑
aeolian	伊奥利亚人的
communalize	镇等所有
wolfy	似狼
agreeable	惬意
vasculitic	患脉管炎
prank	恶作剧
brugge	=Bruges
univocal	意义明确的
rale	肺的诊音
fascinator	头巾的一种
pollination	授粉
bibliographic	书籍解题
holophytic	自养
frothily	起泡地
whisper	私语
defiance	挑衅
hypothetically	假想
pycnidium	分争孢子器
woald	=weld
barred	有木栅的
thermogenesis	生热作用
formulate	作简洁陈述
congius	康吉斯
wicked	邪恶的
unpunctuated	缺标点
canid	犬科动物
perturbation	混乱
compress	压缩
astoundment	惊讶
roundly	圆圆
hhfa	Finance
rascally	无赖的
homoeothermic	恒温
myrmecophile	蚁冢昆虫
nonfluency	不流畅
dowager	贵妇
hest	训谕
outright	彻底
token	记号
haematozoon	血寄生虫
purpresture	侵占公产
powan	白鲑
kikongo	刚果人
mind	智力
unspeakable	可怕
cinematographer	电影摄影技师
insectivorous	食虫
techy	暴躁的
liwa	大行政区
protechny	烟火的施放
nullifier	使无效者
decelerate	减速
henotic	有相同倾向的
cornuted	妻子与人通奸的
humble	卑下的
torte	果子奶油蛋糕
water	水面
effectually	全然
sean	Sean
magistrate	文职官员
garp	Atmospheric
cryometer	低温计
book	控告
cogent	强有力的
exuviate	蜕皮
phytopaleontology	古植物学
corresponsively	反应
inadvisability	不能变更
osier	柳树
cannular	管状的
emptier	抽空机
hulking	粗陋的
foxpro	运行在Windows操作系统下的、功能更为强大的数据库语言系统
remediless	不可救药
overmeasure	强行剩余
make	构成
barelegged	露腿的
brio	元气充沛
lacteous	乳
fellow	同事的
hike	飞起
attractive	有魅力的
toggery	衣服
grok	体验
girsh	=qursh
apomixis	孤雌生殖
fourfold	四重的
telekinesis	心灵促动
jubal	犹八
esophageal	食道
nymphomaniacal	患慕男狂
ballot	选举票
scurf	头屑
ulsterite	乌尔斯特人
obsessive	强迫性
manilla	吕宋纸
positive	实际的
emmenology	月经学
freezes	冻结
highway	大路
oni	海军情报局
unclos	联合国海洋法会议
would	愿意
slinkingly	偷偷摸摸地
polyisocyanate	=polyurethane
nuncupative	口述
cornered	被逼至绝路的
fishybacking	卡车渡运
gdss	群体计策支持系统
separator	离析器
feebleminded	无决断的
glandered	患鼻疽病的
stubbed	粗短
benevolently	仁慈地
courses	路线
immigrate	使移居入境
genicular	生在关节上
amitrol	杀草强
overspray	不粘附喷涂物
vincible	易于克服
comfort	安慰
pyrotechnic	令人眼光的
augustly	庄严地
surfboat	凌波舟
vigesimal	第二十
late	已故的
cirl	bunting黄道眉鵐
inexpediency	失策
chorda	腱
dissatisfied	不满意
dene	沙
seismography	地震定测法
couldst	can的过去式
agrotechnical	农业技术
annoyingly	恼人地
reelingly	旋转
ochreous	赭色
subinfeudation	分封地
nce	Edition
adularia	冰长石
unsheathe	拔出
virulent	致命的
disguise	伪装
hauteur	傲慢
tawie	易对付的
batata	甘薯
ignobly	下流
sexual	性别的
seismograph	测震仪
secularism	世俗主义
automatic	自动机械
arthrectomy	关节切除术
communistic	共产主义的
farmhouse	农场里的住房
pleiocene	上新世的
evagination	外翻
tubifex	颤蚓
transgress	违反
psychologic	心理学
moisten	弄湿
debrief	听取报告
mean	不舒服的
posh	豪华的
accouter	供以服装
exciting	使人激动的
remolade	=remoulade
closefisted	小气的
chesapeake	切萨皮克
olive	Olive
meditate	冥想
salvolatile	挥发盐
cellulated	细胞状的
apt	易于……
instantial	提供实例的
gallopade	其舞曲
eruditely	饱学
enormously	巨大
gyral	回旋的
coprophagous	吃粪
calk	尖铁
scalding	滚烫
invariable	不变的
labour	劳工
choke	窒息
sporadic	零星的
onlooking	旁观的
raf	Force
gramineous	草
datura	曼陀罗属的植物
cyclostomous	圆口动物
samyama	三夜摩
chd	coronary
diffusible	可散播的
lampholder	灯座
laminated	薄板状的
exponentiation	求幂
vpd	Printer
interlacustrine	湖间的
pvt	压力、体积、温度
fallen	堕落的
aauw	University
syncopal	晕厥的
winglike	翅状的
sitar	锡塔尔琴
slump	衰退
conch	海螺壳
inearth	埋葬
url	Uniform
unfurl	显露
guardsman	卫兵
coniform	圆锥形
mac	军事空运司令部
defensibility	可防卫性
antiphonary	轮流吟唱
piscine	鱼的
pantomimist	哑剧演员
expander	使增大者
undeveloped	未开发
stubbornly	倔强
oceanic	海洋产出
rune	诗歌
plasmolyze	质壁分离
unexacting	不需付出很大努力
palewise	垂直
distinguishable	可辨识的
oogamous	卵配生殖的
feme	妻
fany	Aid
banderol	小旗
tainture	瑕疵
snubber	拒绝者
ectotropic	外生的
way	行业
bearable	可忍受的
iconically	形象
moabite	摩押语的
twice	两次
marl	撒泥灰土
vacationland	度假胜
unequable	不温和的
antirust	防锈剂
embezzlement	挪用
antisudorific	止汗的
cosmotron	质子同步加速器
troposcatter	scatter
intuitivism	直观论
banality	平凡
corded	用索子捆扎
accidentally	意外地
colorful	色彩
overripe	衰败的
arm	武器
uddered	有……之乳房
hump	小园丘
twelvemonth	十二个月
aristotelian	亚里斯多德学派的
venom	使恶毒
lighting	照明
unswore	unswear的过去式
naillike	像指甲的
sibilation	齿擦音发音
shrewish	脾气暴躁
tinny	锡
runround	浅甲沟炎
infaust	不吉的
resemblant	相似
coquet	娇艳的
aeroamphibious	海陆空
jnd	Just
cask	装入桶中
revelation	启示
yeasty	动荡
morbid	由病引起
vote	投票选举
ultracritical	吹毛求疵
spheriform	球体的
barbarization	野蛮化
galactopoiesis	乳汁的分泌
atlantean	如
accelerator	加速者
cunt	阴道
cinder	灰烬
gambrel	马脚状的铁钩
vdi	Device
macassar	望加锡头油
deadening	隔音材料
computational	计算
mohammedanism	伊斯兰教
retroflexed	翻转的
transvaluation	重新评估
firefight	炮战
merchantable	有销路
vespertine	薄暮
tole	金属薄片
univalvular	=univalve
dissenting	不同意的
weak	疲软的
existentialist	存在主义的
connectivity	连通性
serosity	浆液一般的性质
alternation	轮流
glasshouse	暖房
resinosis	流脂
ultrarapid	超速的
vakky	=vacky
castellar	城堡
fustanella	白短裙
pubsy	使人联想到酒馆
bimanous	有两手
retroverted	后倾
asce	Engineers
subsonic	次音速
singaporean	新加坡人
maternity	产科
affirmant	断言者
inaccessibly	进不去
presumably	推测起来
starve	饿得要死
cussword	咒骂的话
impeachment	指摘
cestoid	象绦虫的
fractionlet	小片
haunted	闹鬼的
emigre	移居者
bilharziasis	血吸虫病
justiciary	司法上
guttate	有斑点
hoarstone	界石
bec	of
ferrimagnet	铁氧磁材料
typeholder	字母托架
downtrodden	被践踏的
feel	觉
upland	山地的
humaneness	深情
unregretted	无人惋惜
exemplariness	可资鉴戒
womanity	女子特性
out	外观
honorable	光荣
ingestible	可摄取
whisk	拂
auxotroph	营养缺陷型
sinner	罪人
unnumbered	没有数
positivist	实证哲学家
come	来
unexaminable	难以查讯
seti	intelligence
andvari	矮神安德瓦里
autunite	钙
hyposensitization	消除过敏
epizoon	皮表寄生虫
structureless	无定形的
eyestrings	眼肌
intolerable	无法忍受的
drag	拖曳
impassable	不能通行的
dependence	依靠
pity	憾事
unpleasant	讨厌
philippeville	菲利普维尔
inherently	天性地
home	产
unroyal	非国王的
yuletide	圣诞季节
labber	浑身泥泞的人
speaker	演说者
unconvince	使不确信
nuffin	没有什么
creamcolored	淡黄色的
glamourous	=glamorous
rhymeless	无韵的
doohickey	窍门
dicom	and
knop	球形手把
duplicate	复制的
desmid	带藻
days	天
conjugated	共轭
hfs	分层文件系统
benedictory	感谢
busing	以公共汽车运人
juggle	玩戏法
hypersuspicious	极其多疑的
forewoman	女领班
variational	变化的
economy	节约
bioclimatic	有关生物与气候
pyroclastic	火成碎屑的
rfz	rinforzando
pulchritudinous	美貌的
undenominational	不属于特定宗教派别
volplane	滑翔
exorbitant	过高的
outburst	破裂
numerous	许多的
mythologic	=mythological
flowage	泛滥的河水
retrad	向后
rattle	喋喋不休的人
maldivian	马尔代夫的
chirimoya	=cherimoya
exceptionable	可抗议
braceleted	戴手镯
entertaining	款待
illative	推理
chemotropically	向药性
algerian	阿尔及利亚的
herpetology	爬虫学
leftward	在左方
slopehead	越南人
maven	内行
ungrounded	无根据
pussyfooter	禁酒主义者
edwardian	爱德华七世时代的
fasciola	小束
hydrolytic	水解的
redactor	修订者
polymery	多出式
dolt	傻瓜
transplant	移植
unaccepted	不承担
monumentalize	为……立碑
kvetch	催逼的人
serra	锯齿状器官
jealous	警惕的
bilabiate	两唇
entrammel	束缚
savable	可节省
ito	Trade
pyorrhoea	脓溢
maladroit	不灵巧
triennium	三年时间
outrecuidance	极端自大
vast	大量
principled	原则性强
miotic	瞳孔缩小的
threnode	挽歌
cultrate	锋利且尖锐
clearly	明朗
lithosphere	岩石圈
henceforward	自此以后
mooneyed	患夜盲症
dangly	悬摆的
out	出局
shamefacedly	羞愧地
pug	捣
wimble	钻孔器
unbrace	放松
onsweep	朝前疾驰
snakelike	蛇一般
cease	停止
monetary	货币的
paramedian	靠近中央的
placement	定位球
holohedry	全面体
colourfast	不退色的
retrieval	挽救
anisole	苯甲醚
loamless	缺乏沃土
auctorial	作者的
immoralism	非道德论
drum	鼓形圆桶
clearheaded	头脑清楚的
when	pro
mediaeval	中世纪的
claimant	原告
arctoid	熊状的
broadcast	播音
kiushu	=Kyushu
arbitrariness	恣意
smokily	冒着烟
syndactyl	并指的
standing	站
aniseed	大茴香
sexploit	对……进行性利用
radioprotective	避免受辐射影响
dominant	支配
noncommunist	非共产主义者的
trigamous	雌
unnerve	使身心交疲
cheekiness	厚脸皮
maiden	无经验的
overdub	把配到原带上
arietis	Aries的所有格
adeptness	熟练
stopper	塞住
unstressed	无重音
triacetate	三醋酸基
pontifical	主教
mnas	Member
canaliculus	小沟
misfortune	不幸
safelight	安全灯
commend	委托
parturifacient	催生
exotic	异国情调
questionable	可疑的
anglican	英国国教
informidable	不可怕的
autoregulative	自动调整
spaewife	算命女人
countersign	口令
preceding	前述的
aspca	Society
fattener	养肥后供宰杀的禽畜
trichroic	三色现象
fisticuff	一击
antagonize	对抗
dm	Mathematics
termwise	逐项
irrepressibility	镇压不住
encephaloid	脑样的
catchy	诡诈的
quadrinomial	四项式
automatous	自动
supracrustal	覆盖基底岩石
fantasist	幻想曲作曲家
raptor	猛禽
suction	吸引
edging	边缘
repentance	后悔
drift	观望
knut	纨裤子弟
improper	不正确
defame	诽谤
agog	渴望
structure	构造
immobilism	保守主义
sweatband	防汗带
nutsy	痴狂
agrotechnical	农业技术的
glaciation	冻结成冰
dexiotropous	右旋的
omnisex	全性的
stridulation	尖锐的声音
desoxyribose	脱羟核糖
unsoldierly	不像军人
veterinary	医牲畜
molilalia	=mogilalia
eldorado	富庶之乡
corrective	纠正
carcinoid	良性肿瘤
privity	默契
silvern	银的
flocculate	絮凝
unlinguistic	与语言学无关
hemoptysis	咳血
pulmonic	有肺的
peel	剥落
slatted	装有板条
rarefy	稀薄
pinitol	右旋机醇甲醚
mitrebox	铺锯箱
sean	矿脉
abroad	海外
balletic	象芭蕾舞的
stole	女用披肩
axillae	叶腋
sierra	马鲛
dune	沙丘
cigs	Staff帝国总参谋长
granulometric	颗粒测定的
superrational	超理智的
scree	卵石
resourceless	无资力
rapturous	兴高采烈的
galactophorous	产乳
award	奖品
spurwort	田野方茎茜
orthoepic	正音法
hailstorm	下得很大的冰雹
unef	Force
arrhythmically	节律不整地
pardi	肯定
hyperaphic	触觉过敏
shirty	心情坏的
embroidery	刺绣
scoliosis	脊柱侧凸
ingerence	干涉
sural	腓肠的
disuse	停止使用
divest	剥夺
abuzz	活泼
college	学院
functionary	负责人员
ballistics	弹道学
flush	挥霍
praecipe	原令状
rsv	修订标准版
putrescible	易腐烂
effervescency	沸腾
hereunto	到此为止
study	求学
monkeyshine	胡闹
inscient	不知道的
strongpoint	优点
oaec	Economic
abatage	为防止传染而屠杀有病的牲畜
hemochromatosis	血色沉着病
ethylate	使引入乙基类
contention	论点
arouse	唤醒
magnetic	有吸引力
synaeresis	缩约
autochthonal	土生的
dapple	花马
mores	风俗
itt	美国国际电话电信公司
bulk	散装
evolution	进化
blitz	闪电战
deplorable	可叹的
wright	制造者
magnisonant	夸大的
ncsa	Center
fictitious	假想
bachelorship	学士资格
gandhian	甘地主义的
swabber	拖把
unreversed	非倒转
baseborn	出身微贱的
dragrope	拖绳
accusable	有可非难之处
gluteus	臀肌
cyanocobalamin	氰钴维生素
zone	地带
levorotatory	左旋的
restful	宁静的
susceptive	有接受力
jealous	警惕
taphole	出铁口
aspca	of
unisonal	=unisonous
tarred	涂了焦油
bia	互联网络业务分析
impartiality	公正
misdiagnosis	误诊
looped	酩酊大醉
leptoprosopic	面孔狭窄
penstemon	=pentstemon
debark	使登陆
scrubland	灌木丛林地
vote	使投票
bellow	咆哮
bergamasca	柏加马斯卡舞曲
rodent	啮齿动物
dracontologist	研究湖中巨型生物是否存在的人
fixation	固定
feod	封地
confluent	汇合
causable	可致使发生的
undefiled	无污的
haemodialysis	血液透析
supracrustal	覆盖基底岩石的
semireligious	半宗教性的
showfolk	艺人
rear	饲养
spile	插管
nodulous	有小结节的
arrogantly	自大
xql	XML
howe	孔
neuropathy	神经病
bulletproof	防弹的
hypercythemia	红细胞过多症
urceolate	缸状的
solemnly	庄严
amphitryon	主人
imagery	肖像
economical	节约的
acinaceous	多子
playwear	轻便服
untaught	没有受教育的
feldspathose	像长石
vinculum	联结
fable	煞有其事地讲述
gutturalize	颚音
kindlessly	冷酷
hip	熟悉内情
illiquid	无流动资金
flavescent	稍带黄色
baalize	改崇拜偶像
gildsman	=guildsman
telecentric	远心的
belgravia	伦敦的上流住宅区
sclerodermous	=sclerodermatous
curricular	课程
dicrotisc	二波的
undershot	下颚突出
undenominational	不属于特定宗教派别的
permissible	可容许程度的
doyen	老资格
supposititious	想象
trembly	战栗的
saltworks	盐厂
cutcha	贫弱的
biquinary	二五混合进制
postwoman	女邮递员
starveling	贫穷
manual	手
moonish	如月
ambulatory	非固定
firestone	耐火石
ashler	琢石
hep	High
synoptist	以相同观点叙述福音书的作者
rich	充足的
crabbed	难懂的
stanch	止血
bgp	Border
succumb	屈服
slack	松驰
smudgy	满是污垢的
dysthymia	心境恶劣
polyclonal	多克隆的
reexplore	再探索
capriccio	把戏
kusch	库施
proneness	俯伏
wftu	World
whereto	为什么
pegbox	栓斗
lacker	瓷漆
mengovirus	门戈病毒
quarter	一刻钟
gulf	隔阂
piped	滚边的
recremental	渣滓
foregoing	前述
xining	西宁
barricado	=barricade
modernminded	有新思想的
querimony	怨言
clement	仁慈的
foothill	山麓小丘
tuberculin	结核菌素
eds	English
frondescence	发叶状态
gloriously	光荣
vtc	Texture
soweto	索韦托
liturgical	礼拜式的
kiva	大地穴
endemic	地方病
reverberate	反响
gratuity	赏钱
venturesomely	冒险
hemicrania	偏头痛
appendicectomy	阑尾切除
carbecue	熔车装置
nattierblue	淡青色
unclassical	非古典的
monodomous	同巢的
bott	马胃蝇蛆
deorbit	l
slumberous	昏昏欲睡
whydah	维达鸟
perfective	完成式
culpability	可责
ergatoid	拟工蚁
humiliate	耻辱
qbp	后翼象前兵
maximal	最高的
uruguayan	乌拉圭的
knob	小块
angaraland	安加拉古陆
coasting	沿岸航行
gravelly	多碎石的
sao	区段刻录
prussianise	=Prussianize
scythe	镰
monostomous	具单口的
oba	奥巴
pschent	双重王冠
unevoked	非强制执行的
columbian	美洲的
eupneic	呼吸正常
rope	索
gesture	作手势
infallibility	绝无错误
dictature	独裁
serendipper	有意外发现珍宝的人
simile	明喻的说法
akademi	学会
microporous	多微孔的
airwoman	女飞行家
innards	内脏
tychism	偶成论
dedicated	专注
downfold	低洼地
ebn	by
offal	残渣
nutty	坚果般
zaptiah	土耳其警察
tankbuster	反坦克炮
penal	刑事
champertor	助讼者
sinless	无罪的
hesiodic	赫西奥德风格的
shiplap	木板槽口的接合处
unweakened	未削弱
ruthlessly	残忍地
linendraper	亚麻布商
carrion	腐肉的
metalwork	金属制品
pdsa	People''s
futuristic	未来派
mulch	覆盖物
unstatutable	与法令相反的
lowish	有点儿低的
assumption	承当
inexcusably	无法原谅
sustentacular	支持
flush	直接地
hyperplastic	数量性肥大的
wrecky	衰弱的
locoweed	疯草
millet	黍的子实
contumacious	顽固
vitaphone	维他风
lacunal	空隙的
testamentary	据遗嘱
apophatic	用否定方法所
callable	可随时支取的
horst	地垒
domesticable	可移植的
cyclopic	独眼巨人般
galactosidase	牛乳糖
japanophobia	恐日症
solarization	日晒
holometabolous	完全变态
dominion	统治权
orgy	放荡
hrvatska	赫尔瓦次卡
rishi	圣人
anile	衰老
perchloric	高氯的
houselessness	无房屋
twentieth	第二十
concernful	重要的
rake	向船尾的倾斜
euphemize	用婉转的话说
ductless	无管的
bohemianism	玩世不恭之作风或思想
westphalia	威斯特伐利亚
dusky	微暗的
licensure	发给许可证
afoot	准备中
cinephile	影迷
world	世界的
hyperbatic	倒装法
calabash	炮弹果
wealthy	充分
resemblant	相似的
subapical	接近顶点
hazel	黑兹尔
thionine	硫堇
zigzag	作Z字形行进
nozzle	管口
garrote	上述绞刑
glossary	术语表
rainproof	防水
antigravity	无重量
unequal	不平等的
knurly	多节
smaze	烟霾
domelike	穹顶状
motivator	激发因素
gestosis	妊娠中毒
fastigiate	平安的
appurtenance	附件
sickish	多病的
autolyze	自溶
functionalize	使职能化
trick	诡计
prodrome	前驱症状
restraining	抑制的
typeofounding	铸字业
spry	充满生气
kynewulf	即Cynewulf
fortune	好运
mangily	污秽地
harmotome	重十字石
indological	印度学
pent	被关闭的
martian	火星的
broad	主要的
polymastigote	多鞭毛
russian	俄语的
perch	栖息
restyle	改变……的式样
ballpoint	圆珠笔
brainless	愚笨
educable	可教育
dendron	树模石
reproachingly	责备似
measled	患麻疹的
hyperlipidemia	血脂过多
pediococcus	小球菌
prohibition	禁酒令
leisured	有闲
atomy	矮人
petaliferous	长有花瓣的
ocdm	Office
pelicanry	鹈鹕饲养场
buckjumper	跃腾使骑者跌落的马匹
carrier	运送者
clypeate	圆盾形的
cytopharynx	细胞咽
cozen	欺骗
methodically	有方法地
psycology	心理学
place	处境
dermatography	皮肤解剖纪录
indiscriminating	不区别地
curr	发咕咕声
flack	广告
fordo	毁灭
crinoid	百合样的
arteriolar	小动脉的
changeably	易变
damar	硬树胶
fuscescent	略带暗褐色的
green	精力旺盛的
countermove	反向运动
chamomile	甘菊
ea	Arts
moralistic	教训的
prosthodontia	镶牙学
prelatic	高级教士职位的
foreboding	不祥之兆
carbolated	浸以石碳酸的
dac	道格拉斯飞机公司
insinuating	曲意巴结
vizirate	=vizierate
staple	钉
unworking	闲着
pseudonym	笔名
slummer	住在贫民区的人
tubate	形成管的
uncord	解开
galoot	呆子
stoat	白鼬
basecoat	最下面的一层
underdress	裙子
faltering	蹒跚的
claver	闲话
sigmate	在字尾加上S字形
callable	请求即付
hairnet	发网
surnominal	别名的
instantaneous	瞬间
dexterous	惯用右手的
leukemic	白血病的
winter	衰退期
swingeing	极大
littermate	同窝出生仔畜
flashily	灿烂地
fainty	无力
steamy	蒸汽的
quadripartite	由四部组成的
season	季
inswept	前端狭窄
vehemently	暴烈
cyclonic	飓风的
succursal	附属
doxastic	信念的
chronosphere	空间转移发生器
incisive	尖锐
enumerably	可点数
skepticize	=scepticize
qea	Qantas
uncatchable	不可捕获
pyroxene	辉石
subdivisible	可以再分
druggist	药商
ashine	发亮的
upcoming	即将来临的
ganefo	New
retroflex	向后弯曲的
kilometer	公里
pulque	龙舌兰酒
squally	天气愈变愈坏
incumbent	职责所在
gweduc	=geoduck
attainment	达到
nethermost	最下面的
thumbnail	极小
pertinent	相干
margaric	珍珠般的
rotator	旋转者
domestically	家庭式地
ratepayer	地方税纳税人
bastardry	暴行
knavishly	恶棍
homicidal	行凶的
saditty	摆出优越神气的
detergence	去垢力
photoscanner	光扫描器
host	当主人招待
fete	招待
units	单位/图片
aciniform	多小核的
serenity	平静
antiallergenic	抗变应性的
receptor	受体
reader	读卡机
balikpapan	巴厘巴板
confoundedly	十分地
warp	变歪
itineration	巡回
pettifogging	诡辩的
paleobotany	古植物学
species	种类
ocso	西多会
sluttery	懒惰
invariablenes	不变
sacrifice	牺牲
monozygotic	单卵的
sweepforward	前掠角
expense	损失
dashy	时髦的
fruticose	灌木状的
pix	检查重量和纯度
staple	原材料
methodologist	教学法学者
lobscouser	水兵
voteable	=votable
reverent	虔诚
tough	凶恶
alembic	蒸馏器
blazon	纹章
theravada	=Hinayana
ketolytic	解酮作用
hagiography	圣徒言行录
triangulate	有三角花样
hyperlipidemia	高脂血
cpff	fee
genome	染色体组
logion	箴言
usher	招待员
columbine	耧斗菜
snipping	碎片
satyrid	眼蝶
lustful	贪欲的
mortal	凡人
bargirl	常到酒吧间的妓女
philologize	研究语言学
recopy	再复制
precatory	恳求
malvoisie	=malmsey
avirulent	无毒性
spuddy	矮胖的
delusive	虚妄的
iaaf	International
unequal	不同
behring	白令
intrigant	私通者
psia	pounds
sarape	一种华丽的毛织布
toxemia	血毒症
parochialism	乡土观念
jaculatory	投掷的
preman	猿人
cornuted	角状
objettrouve	自然发生的艺术品
antarctic	南极
course	追猎
cqd	请速来救
everett	埃弗雷特
scoreless	没得分的
biscay	of
dogfight	在空中缠斗
tantalizing	非常着急
shashlik	=kabob
colligation	缚束
villeinage	隶农制
quadrivial	四高级学科
muster	清单
halfhourly	三十分钟地
weak	疲软
maurist	莫尔会修士
maiden	未婚的
projectile	发射的
schnozzle	鼻子
aftercare	安置
foamy	起泡沫的
pub	客栈
ferned	长满羊齿植物的
traffic	买卖
wrangle	放牧
agedly	老年人似
isometric	等大的
manipulable	可以操作
remedy	矫正
roumanian	罗马尼亚人
flourish	挥动
evasion	借口
unploughed	未犁过的
cno	Operations海军作战部长
reembark	重新搭载
malpractice	玩忽职守
depletory	使空虚的
inbreathe	吸入
ferricyanide	铁氰化物
regretful	惋惜
unaccountably	不能说明
appetent	意欲的
beloved	爱人
great	意
tepid	温热的
bituminous	含沥青的
mammiform	乳头状
inference	推论
chirkle	喧闹地干活
denaturalization	剥夺国籍
chauvinistic	沙文主义的
phenolize	用石炭酸处理
cmh	国会荣誉勋章
corneal	角膜的
overweening	夸大了的
hematopoiesis	生血作用
humpy	多隆肉的一般的
cap	军帽
deplorable	可叹
doited	老朽
site	站点
literalness	表面意义上的
sagaciousness	聪敏
paroecious	雌雄有序同苞
fecund	多产
suberin	软木脂
adsorbent	吸附的
northmost	最北部的
gothicism	哥特式情趣
tridigitate	有三指
lotic	激流的
lactam	内酰胺
muscleless	无力
lentiform	透镜的
narcomania	麻醉剂狂
prospekt	大道
inched	有英寸刻度
warmer	温热装置
receptivity	感受性
seafaring	航海事业的
decauville	窄轨轻便铁路
incogitable	无法猜测
gelignite	一种含硝化甘油的炸药
pronounce	宣告
affluently	流畅
unwanted	多余的
dioxide	二氧化物
gawky	笨拙的
melting	溶解的
gliding	流畅的
restoration	修补
prelim	预备考试
carburet	增碳
exstrophy	外翻
chirpy	快活的
rampant	猛烈的
renunciate	放弃
tuberculosis	肺结核
oven	烤箱
atheromatous	动脉粥样化的
unblest	受诅咒
rack	榨取
baboonery	粗鲁的行为或态度
caodaist	高台教教徒
shanachy	吟游歌手
placet	赞成票
pecksniff	式的
apostatize	变节
apport	物体显形
tangent	离题
sheepman	养羊人
czechish	捷克人
reast	=reest
polling	投票选举
second	片刻
dextrad	向右侧
piccanin	黑人小孩
backslid	backslide的过去式
leak	漏出
esophagoscope	食管镜
communistic	共产主义
advance	前面的
doily	小型装饰桌巾
piccalilli	辣泡菜
umbra	暗影
wye	Y字
nightlong	通宵
scale	测量
hardhearted	心肠硬的
heteronomy	非自治
caterwauling	叫春似的
abstractively	抽象性
tgv	a
connivent	逐渐集中
napoleonist	坚持拿破仑式行为的人
genova	=Genoa
protoxide	低氧化物
spirometer	肺活量计
grammaticalize	使符合语法
hydropac	太平洋航行危险警报
tackify	使更黏
rheumy	稀粘液的
nam	nim的过去式
daysman	仲裁人
rhapsodic	狂想
transmutative	变形的
augusta	奥古斯塔
waste	荒芜的
favorite	喜爱
asturias	阿斯图里亚斯(曾是一王国
dowthcory'	NULL)
this	这个
current	通用
omnifaceted	各方面
feverish	兴奋的
cembra	瑞士五针松
egghead	受过高等教育的人
factually	确实地
process	处理
uncloak	揭露
hyracoid	蹄兔的
spermatic	精液的
monofunctional	单官能
extradite	受……引渡
daze	迷惑
knocking	爆震音
unimplemented	未实施
possess	占有
pasteboard	不坚实的
distribution	销售
deliberately	故意地
perfusion	灌注
criminatory	使负罪的
unconformity	不顺从
distress	使穷困
dendrophilous	爱树
virtuoso	艺术品鉴赏家
sportswear	休闲活动穿着的衣服
multocular	复眼的
gobbledygook	官样文章
celoscope	n
nasty	肮脏
ohmage	欧姆电阻
robbery	抢掠
elude	躲避
exhaust	使精疲力尽
gager	计量者
menstrua	的复数
egged	煽动的
prattle	孩子话
ahead	在前
wire	电线
fetial	处理国际问题
reiterative	反复语
considerately	体谅地
sylvicultural	造林学
entitle	给……称号
photodramatist	戏剧片编剧
rigmarolish	胡言乱语的
okay	好的
raffinose	棉子糖
beetling	突出的
inexpressive	无意义的
thousand	无数
issueless	无子女
pluralistic	兼职
aeonian	永久的
lichenaceous	青苔属
forehanded	对将来有预备
appetite	爱好
zone	环绕
pretty	可爱的
lipopectic	脂肪固定
viatica	的复数
webernish	有点像韦伯恩音乐
francophonic	讲法语
domesticate	使安于土地
ethnoarchaeology	文化群落考古学
matara	棕色海豹皮
stalino	斯大林诺
dnestr	=Dniester
scumble	渐淡
jejune	缺乏营养
firewater	烈酒
banalize	使陈腐
martial	威武
infradian	超昼夜的
railroad	由铁道运输
dixit	武断的话
butterball	小鸭的一种
increasing	越来越多的
mustard	芥末色
escharotic	腐蚀剂
biovular	二卵生的
proprietary	所有
childie	小孩儿
kudos	荣誉
premise	提论
paternal	父亲
diminishable	可降低
acardia	无心畸形
transformation	转化
elegant	上品的
uprising	升起
exertive	使努力的
expectably	如所意料或预期地
outspread	展开
yva	Athority
subequal	几乎相等的
amenable	应服从
gramarye	魔术
allopelagic	生于不同深度
candlewood	蜡烛木
enfeoff	授予领
stabilizer	稳定器
rapture	全神贯注
lytta	纵行蠕虫状纽带
wale	使有鞭条痕
favorer	保护者
obtainable	能得到的
late	在晚期
binoculars	双眼望远镜
gilding	贴金箔
dae	of
eclat	荣誉
diggable	可挖掘的
suit	合适
nocturne	夜景
spongiopilin	海绵毯
imparipinnate	奇数羽状
fair	公平
goon	呆子
inferior	下等的
gilbertian	吉柏特派的
gilly	男仆
fibrous	含纤维的
jagged	有凹口
human	人类的
civvies	便服
scolops	感橛
chirpy	嚓嚓叫
strisciando	滑唱
widthwise	横向
monogamic	=monogamous
godwinian	持戈德温见解者
blowzy	蓬乱的
desiccated	干的
wanda	旺达
doubloon	从前西班牙金币的名称
cole	油菜
skimming	所撇取的浮沫
ferruginous	含铁的
scoria	矿渣
supranational	超国家的
cpi	Index
eschatological	来世论的
purport	声称
dateable	可确定时代的
girlo	女孩子
incipient	初始
countershaft	间轴
amphitropous	植物横生的
sanguicolous	血寄生的
cancerophobia	恐癌症
underscrub	林下灌丛
queasy	不稳定的
claustrophobic	幽闭恐怖症的
hereat	是故
broad	阔的
file	锉刀
chloroethene	氯乙
retriever	取回的人
therein	在那里
antivenin	抗蛇毒血清
unbefitting	不合适的
aphetic	非重读字首之消失的
imperfect	有缺点的
numismatics	奖章类的研究
kwando	宽渡河
zither	筝
amphibiotic	幼时生长于水中
erumpent	突然现出
hemerocallis	lily
letterer	文字书写员
amoeboid	似变形虫的
wipo	世界知识产权组织
nutty	坚果般的
connivent	靠合
increasable	可增加
fighter	好战者
adytum	内殿
inobservancy	=inobservance
omniscience	全知者
germanious	含二价锗的
knitwear	毛织类
jobbernowl	笨蛋
fidley	锅炉舱顶棚
lambeth	伦敦朗伯斯区
phonographic	留声机
hydrometer	液体比重计
biovular	二卵生
goumier	参加北非士兵小分队的北非人
zoopaleontology	古代动物学
thir	pro
delinquent	失职
psychotomimetic	重现精神病
zither	齐特琴
gular	在咽的
covered	掩藏着的
lumbaginous	腰肌痛
unhip	不谙时髦
vesica	膀胱
prediabetes	前驱糖尿病
unforced	不费力
great	大写的
boiler	汽锅
antagonize	敌对
freehold	自由保有
proestrus	=prooestrus
hemistich	诗的半句
thornlike	象刺一样
shapelessly	不成形地
unbusinesslike	不认真的
benefic	有益
destructively	狼狈地
lamenting	悲哀的
starched	拘泥刻板的
locomote	移动
bibliomania	藏书狂
aeromechanic	航空力学
radiophysics	无线电物理学
nondrinking	不喝酒的
daytale	按日计酬
finny	鳍状的
aeriality	类似空气的性质
aphrodisiac	春药
reinless	无缰绳的
wirepuller	背后牵线者
venomous	狠毒
nondescript	无以名状
heaps	非常
insuperable	不能制胜
equilibrate	相称
inducement	诱因
skunk	欺骗
radiolarian	放射目
touch	联系
squalidity	污秽
intact	尚未被人碰过
thunderstroke	雷击
thule	极北之地
crumple	压皱
rotary	旋转的
putty	灰泥
fanged	有牙根的
eluate	洗出液
corkily	喜不自禁地
accusatival	宾语
oceanological	海洋学
gloomy	阴沉的
quatre	四点
improbity	邪恶
equitable	公平的
laager	临时防御营
bolt	螺钉
cineaste	热爱电影者
undaunted	勇敢的
mna	Master
pathognomonic	能确定诊断的
reliant	依靠的
livelihood	谋生
underlife	私生活
hairtrigger	一触即发的
domesticable	习于家居
stannic	四价锡的
neighborless	无邻居
enhancive	增加的
bolter	退出党派者
spat	掌击
pasture	牧场
dyspepsia	胃弱
scoria	烧过的石头
spill	溢出
depot	火车站
demagnetise	=demagnetize
resolved	断然
corruption	堕落
cratered	有坑洞的
fuliginous	煤烟色
luncheteria	自助小吃馆
amy	艾米
circumgalactic	环星系旋转的
predominate	统治
radiometry	辐射线测定
extractor	退弹簧
reject	否决
trifle	玩弄
decimalise	=decimalize
cosmetologist	美容师
unbandage	从……上解去绷带
moonset	月落
lrv	lunar
soed	Shorter
watteau	华托式的
samlo	三轮出租汽车
implied	含蓄
hymenotomy	膜切开术
dvi	Visual
certain	无疑的
farcically	闹剧一般
sissified	女人腔
suborning	受贿
incalescent	温度渐增的
huffish	傲慢
squelcher	使对手哑口无言的辩论
flock	群
austenian	=Austenite
dummkopf	傻瓜
phlogistic	炎症性的
commination	诅咒
impar	奇数
ligeance	领地
shutter	关上
imperfect	未完成的
volatilizable	可挥发的
pitch	前后颠簸
restorable	可恢复的
thar	Desert塔尔沙漠
disturbingly	动摇
reflectometry	反射计
unicostate	中脉显明的
orcish	兽人
splash	泼
impercipient	无知觉
perforative	能穿孔的
ungimmicky	不骗人的
ragtop	敞篷汽车
weedy	杂草多
faery	幻想的
duet	二重奏
pardi	确实
literaryism	过于推敲
sclerosant	致组织硬化物质
sprig	年青人
dovetail	用鸠尾榫接合
monophyllous	具一叶
emergent	紧急的
prattle	说半截话
actionist	行动主义者
nostril	鼻孔
elysian	幸福的
delicate	棘手
boggy	沼泽多
steamship	轮船
dyeable	可染色的
orbicular	球形
lagthing	挪威议会的上院
abominator	嫌恶者
rakish	俏皮的
adviser	指导老师
heeler	手下
bumbailiff	执行官
mural	壁饰
diathesis	因素
rabbinism	犹太的法学博士的语风
dank	阴湿寒冷
nullify	无效
enlistee	士兵
un	家伙
okie	俄克拉荷马州民
egodystonic	与自我不相容的
argumental	辩论
facilitation	助长
resonatory	引起共鸣
aperitive	有轻泻效应
amido	氨基
misevolution	异常进化
salutatory	祝词
squash	拥挤的人群
actiniform	放射形的
binal	孪生
circumplanetary	环行星旋转
toadfish	蟾鱼
vestibular	门口走廊
cutoff	关车
involute	渐开线
indebtedness	受恩惠
stratocruiser	其商标名
abiogenetic	自然发生的
lochial	恶露
unconfessed	未认罪忏悔
hurl	猛投
lanceolated	枪尖形的
deepwater	靠近海洋
infatuated	昏头昏脑
confine	禁闭
webbed	有蹼
tweedle	鸟鸣声
gemman	=gentleman
siphonet	蜜管
buic	Interceptor
question	问题
ammonia	氨水
gaby	傻瓜
adullamite	持不同政见派别中的一员
unfluctuating	不变
assiduously	勤勉
dilettantish	半瓶醋似的
logistics	后勤
laudable	值得称赞
impureness	污染
moneygrubber	财迷
holpen	help的过去分词
media	媒体
uncomfortable	不安
messenger	报信者
adjectivally	形容词般地
graymail	扬言要公开政府机密的讹诈
kuwaiti	科威特人的
lairy	华丽而俗气的
coprolagnia	粪性淫乱
pepsin	胃蛋白酶
cretaceous	白垩纪的
paper	文件
still	静止画面
peshito	伯西托本
tetrachotomous	四叉的
knitwork	编织品
unfaltering	坚决
universality	广泛性
microporosity	微孔性
gironny	=gyronny
overdestroy	超量击毁
goggle	风镜
rally	重整旗鼓
scombriform	=scombroid
tagraggery	乌合之众
take	捕获量
pigeonhearted	害羞的
winceyette	棉绒
extinguishable	可熄灭的
equanimousness	镇定
baronetage	从男爵的名册
olympian	奥林山神
hydrargyric	汞的
gun	炮
amboyna	黄柏木
allotee	接受分配物的人
beerburst	bust
actual	现行的
cyclothymia	循环性情感气质
habenula	系带
septenary	七个一组
scaled	有鳞状斑点
appropriable	可供专用
polymnia	=Polyhymnia
appreciable	可感知的
latter	后者的
gleam	隐约地闪现
frisbee	飞盘
athlete	运动员
lifeline	生命线
trotty	活泼
decretal	教令
priority	优先
tapa	树皮布
dissolute	肆意挥霍的
lionize	游览……名胜
ventil	活栓
sniperscope	夜袭镜
ourology	=urology
amok	杀气腾腾
filaceous	丝质
sexagesima	四旬斋前的第二个星期日
excuse	口实
loaves	大块烤过的食物
throne	王座
twitch	颤动
untimeous	=untimely
generous	有雅量的
sericate	丝的
slowness	迟钝
muzz	使迟钝
unifoliate	有单叶的
icrp	Radiological
pertinacious	固执的
autotomize	自割
larghetto	稍缓慢地
lactary	奶的
fluke	锚爪
kirghizian	吉尔吉斯的
collect	搜集
ethnarch	殖民地等的统治者
frau	已婚的女性
compnserve'	NULL)
thereagainst	与之相反
peregrin	隼
umpire	任裁判
fib	打
savoury	可口
presidial	主持
uncloak	脱去外套
superactinide	series
worry	使苦恼
maryknoller	马利诺外方传教会的神父
mystical	奥秘的
interpolate	插入新语句
liquescent	易液化
fumigate	使发香
countertype	相等物
matey	友好
incurment	招致
squashy	易压碎的
sabang	沙璜
portly	肥胖的
warty	有疣
vindication	拥护
answer	抗辩
peg	坚持不懈地工作
welsher	欺诈者
hermeneutics	诠释学
underfur	下层绒毛
laystall	垃圾堆
compound	混合物
capable	有可能
vendition	贩卖
polyploid	多倍体的
loyalism	忠义
scaled	有鳞的
zoon	发育完全的个体
voila	那就是
unfadingly	不褪色地
blackhearted	邪恶的
ithun	=Idun
choice	精选品
archaism	古体
square	正直
scenography	透视法
suppressible	可以禁止
untilled	未开垦
sierran	锯齿山脊区居民
crosier	权杖
mooneyed	患夜盲症的
brainteaser	谜
murmur	怨言
poikilothermic	变温的
uproot	根除
palpal	须的
umt	普遍军训
infatuatedly	迷恋地
walloping	极好的
multiform	多种形式
analysissitus	拓朴学
equivocally	含糊
tortoiseshell	龟甲状的
excisable	可抽税的
dithering	抖动
indifference	不关心
magniloquent	使用夸张语言
cid	首领
thaumaturgy	魔术
trichomonal	毛滴虫
unconfirmed	未经证实的
crackable	会粉碎的
morpheme	词素
acidimetric	酸量滴定的
eschatological	末世学
transudation	渗出物
helianthine	甲基橙B
electroacoustic	/
slow	减速
lop	垂下
weasel	告密者
jarp	敲
dividend	奖金
begird	缚
fatten	使肥胖
fijian	斐济人的
administerial	管理上的
vertical	垂直的
noblest	华丽的
undercooked	煮得欠熟
withdrawal	取消
microslide	显微镜载片
exhibition	表现
kero	=kerosene
driveller	说傻话的人
love	爱情
thermotropic	向热的
chott	北非小盐湖盆地
chresard	可用水量
pooftah	搞同性恋的男子
merry	愉快
bowlder	圆石头
rasc	Service
prodrome	序论
responsible	可靠的
craftsman	手艺精巧的人
workroom	工场间
nastily	污秽
feculent	不洁的
turkophil	亲土耳其者
kept	keep的过去式和过去分词
doura	=durra
pious	虔诚的
baric	含钡的
antidromic	逆行的
gbf	Great
electroacoustic	电声学礳ally//
jiangsu	江苏
guianese	圭亚那语言
strait	窘迫
hootananny	=hootenanny
continual	连续的
dismemberment	支解
ampliation	扩大
monovalent	仅能抵抗某种病菌的
propellent	推进者
awkwardness	不雅观
exhausted	耗尽的
suppletive	异干互补的
muscleless	无肌肉的
rehandle	重新处理
judaeophil	善待犹太人的
lunate	新月状的
manyatta	村塞
sakellarides	萨克拉里德斯棉
greeneian	格林风格的
hip	使忧郁
wondrous	非常的
pursual	追逐
leister	鱼叉
descriptor	描述符
uselessly	无益
caoutchouc	天然橡胶
sprite	调皮鬼
retranslate	译回原文
balame	平衡
unyoke	解开
jiggered	等的委婉代用语
gynecic	=gynaecic
transcurrent	横亘的
inventer	发明者
notion	意见
trial	试验
sciurine	松鼠科动物
gigantism	巨人症
trimetallic	三金属
sphygmometer	血压计
whole	完全之体系
exabyte	美国Exabyte公司是全球著名的磁带机及磁带库专业化制造商
nighttide	夜潮
unevenness	不平坦
impayable	无与伦比的
resorbent	再吸收
canard	谣言
subhead	小标题
fils	儿子
mtbf	Mean
spendable	可使用
unwarrantable	不正当的
quillback	背鳍前部象翎管而突出的北美产淡水鱼
tara	再会!
dumb	无说话能力的
ambsace	最无价值的东西
gramma	grass
blowhard	吹牛大家
effable	能被说出
honeyed	多蜜的
corollary	必然的结果
hanuka	献殿节
magnetron	磁电管
bale	悲哀
redeemable	可弥补
fun	供娱乐用的
limnological	湖沼学的
fiend	能手
felicitous	极为适当
fancy	想象力
franciscan	圣芳济会的修道士
lush	青葱
biyearly	二年一次
saint	道德崇高的人
anorexia	厌食
enteritis	肠炎
outperform	胜过
assertative	=assertive
stupefacient	麻醉药品
slowish	速度稍慢
nagged	被压制
abstruse	奥妙的
sheep	胆小鬼
worsted	精纺毛料服装
deter	阻止
very	十足
antique	古时
regal	帝王的
ontic	实体
caginess	狡诈
consolidation	巩固
subnuclear	亚核
mistaken	错误
intacta	未经触动
qumran	库姆兰会社
shipbuilding	造船
epidermoid	表皮状
panini	帕尼尼
inviable	不可能生存的
os	style
callous	硬结
audiovisual	视听教材
jackeroo	当新手
unequal	不平等
manifestant	示威运动的参加者
byroad	间道
halation	照相底片上显现的光轮状晕
monseigneur	阁下
supersubstantial	超物质
sailer	船
hexamethylene	环己
parlor	客厅的
unmeant	无意的
untasted	未体验过的
exaggerated	言过其实的
underplay	表演有克制
damned	被咒骂的
pubescence	软毛
unscrupulous	不谨慎的
miesian	密斯的
celadon	灰绿色
temperate	温和
species	核素
mussily	吵闹地
perthshire	佩思郡
homy	自在的
ideographic	表意
halothane	三氟溴氯乙烷
soilborne	土壤传播的
popular	流行
rightable	可纠正的
inebrious	喝醉的
ardor	热情
superciliary	眼睑上的
pigeon	鸽子
deprecatingly	恳求地
saddler	乘坐用的马
smogbound	烟雾弥漫
finely	细微
bimetal	双金属材料
zontian	诚信社社员
inconsolable	极为伤心
clarissa	克拉丽莎
cestoid	绦虫
tot	加起来
brachydactyl	短指
empower	使能够
arseniureted	砷化
easiness	舒适
knurly	多瘤的
concutient	受到震荡
highchair	小孩吃饭时所用之高脚椅子
telly	电视
hexahedral	具有六面
thistledown	非常轻
undistinguishable	/
jutty	码头
holocaine	芬那卡因
ecotage	生态破坏演示
pocket	口袋
absorber	吸收体
wabbly	不稳定的
lemma	词条
cephalometry	头部测量学
watermelon	西瓜
jove	木星
former	以前
remittal	豁免
datacenter	资料处理中心
expire	呼气
termini	界标
mature	成熟
notarial	公证的
firemaster	消防队长
keester	手提皮箱
ascending	向上
tokonoma	床之间
vector	矢量
ridge	翻土作垄
floodwall	防洪石堤
facp	College
corporality	肉体的存在
mortar	迫击炮
depositional	沉淀
isostatic	均衡说的
shag	使杂乱
quotidian	平凡
intake	引入的量
tatty	褴褛的
hmnzs	Ship新西兰皇家海军舰艇
uncharming	缺少魅力的
subaltern	副官
miscounsel	误劝
continency	节制
surfacely	肤浅
hamburger	碎牛肉
helicline	螺旋状坡路
nonallergenic	不会引起过敏的
sacher	萨克大蛋糕
suzerain	庄主
capitulaitonist	投降主义
arty	装艺术
perversive	颠倒
fixing	稳固
atomic	原子的
transmembrane	横跨膜
crmp	皇家宪兵队
hexahydric	六元
admission	供认
peregrination	旅行
heliotypography	珂罗版印刷
phs	Public
slenderize	使细长
ensanguined	血染的
muffle	蒙住
snide	卑鄙勾当
rhodic	四价铑的
outrun	超过
sharif	沙里夫
taking	会传染
wellhead	水源
home	住宅
aquanautics	水下勘探与研究
cockshot	掷棒打靶
waterway	水路
contravention	矛盾
judiciable	可被审判
scurviness	粗俗
unspeakable	无法形容的
demonic	恶魔的
uneventful	平静无事的
snowslip	雪崩
show	说明
pyroelectric	焦热电
sericterium	泌丝器
insalubrious	有害的
restrainedly	有限制
cog	上齿轮
festive	庆祝的
octaploid	=octoploid
lean	贫乏
thiomersal	邻乙汞硫基苯酸钠
welsh	威尔士人
unbalanced	不稳定
cuttable	可缩减的
searchless	不可测知的
imperfect	未完成过去时
bedbound	卧床不起的
invariably	总是
sprawl	蔓生
solion	电化传感与控制装置
resorption	再吸收
unfoiled	未被征服
carpool	合伙使用汽车
reuter	路透社
sunlit	阳光照射
confutation	驳倒
yachtie	快艇主人
karstology	喀斯特学
rampageous	暴跳的
pucker	皱纹
shivery	寒冷
unsheathe	抽出鞘
elective	随意选择
reserved	包租的
unwholesome	不健康
rollick	欢闹
needful	必要的
resign	辞职
pluvian	多雨
maligner	中伤者
perplexed	不知所措的
backflash	逆流而着火
mim	假装羞怯的
appallingly	令人毛骨悚然地
immunohistology	免疫组织学
segmentalize	使分成部分
eagle	鹰状标饰
ruritanian	对王室持浪漫主义观念的
mexicali	墨西卡利
racemiform	形似串状花
panicum	黍
wondrous	令人惊奇
can	罐头
adsuki	=adzuki
mundane	世界的
innative	以生具来
clodhopper	乡巴佬
oswald	奥斯瓦德
unwashed	没有洗的
looped	成圈
ledger	横木
kiln	在干燥炉干燥
misquote	错误地引用
maladaptive	不适应的
missish	矜持
bustling	熙熙攘攘
flexible	柔软的
inegalitarian	不均等
plush	舒服
sitting	入席
typecasting	铸字
slaky	多烂泥
rippling	潺潺流水般声音
austere	操行上一丝不苟的
basilar	头盖骨底部的
overleaf	在背面
landlordly	地主的
sarsa	撒尔沙
companionably	友善
imam	阿訇
equivalent	相当的
enterogastrone	肠抑胃素
untwine	解开
righto	好
javascript	Java描述语言
philologic	语言学的
facinorous	罪孽深重的
sustain	持续
mitigative	缓和
ludicrous	愚蠢的
razor	剃
toolmaking	工具修理
voluminous	卷数多的
inconstantly	不稳定地
anatomical	解剖的
bequeath	遗留
uropod	腹足
helen	海伦
carefulness	慎重
infundibulate	漏斗管的
boarfish	帆鳍鱼
amenable	有服从义务的
debited	记入借方
hypophysis	脑下垂体
postbox	邮箱
transducer	变换器
ragi	鸭脚稗
vasostimulant	刺激血管的
cavalier	对女人献殷勤
removed	离开
townie	城市生活的
sned	砍掉
necrophobia	死亡恐怖
gaga	狂热的
cyclopaedic	渊博的
ambuscade	伏击
heterosexual	异性
hustings	议员竞选演说坛
dismally	沉闷地
cyclo	三轮车
filarial	丝虫的
valiantly	勇猛
bovril	Bovril保卫尔牛肉汁
polycystic	多囊的
livable	可住
acidosis	酸液过多症
sightworthy	值得一看的
upstretched	向上伸出
discutient	消散药
contrasuggestible	抗暗示
elevenfold	十一倍的
impeccant	无缺点
knurr	节疤
octal	八进制的
confront	对抗
taligrade	行走时重量落在足外侧
steep	沉浸
postiche	硬加
dogged	顽强的
edgily	轮廓过分鲜明
unslumbering	从不睡眠的
retrocede	归还
transtainer	移动式集装箱吊运车
twinned	成双成对
dtv	desktop
cardiogram	心电图
spur	刺激
scheduling	行程安排
butcherly	残忍地
devour	毁灭
bpd	day
merchant	商业的
morbid	病
cmtc	Citizens''Military
clonus	抽筋
paramedian	靠近中央
hypergolic	自燃燃料的
consubstantiate	kRnsEb5stAnFeIt/
bathos	陈腐
nonexportation	禁止出口
trioxide	三氧化物
wolfish	贪婪的
proleg	前脚
ozonize	变成臭氧
nymphomaniac	女色情狂
leaper	跳跃者
denaturalization	非自然化
adsorption	吸附
neuropharmacology	神经药理学
distobuccal	远中颊
squamaceous	有鳞的
tabetic	脊髓痨病患者
turfite	热衷于赛马的人
elfish	小妖精
unpledged	未经保证的
vomitive	呕吐的
flourish	兴旺
ilka	每一个
put	笨蛋
mechlorethamine	二氯甲基二乙胺
trawl	用拖网捕鱼
twinned	成双成对的
cloudworld	云景
divergency	分歧
garibaldian	拥护加里波第的
febrifuge	解热药
discouragement	挫折
confinement	禁闭
faery	仙女
enterpriser	企业家
execute	执行
tangent	切线的
bidon	盛液体的有盖容器
casually	随便地
corollar	花冠
pneumatic	汽力
whitefly	粉虱
subliminal	潜在意识的
rhinogenic	鼻性
cathepsin	组织蛋白酶
voxel	三维空间中定义一个点的图象信息的单位
pastureland	牧场
losing	输的
locality	位置
crust	结硬皮
derivable	可诱导的
exegesis	注释
excess	额外的
tot	小孩
haunting	不易忘怀
sun	是JAVA语言的创始者
brevirostrate	短喙的
humanoid	有人的特点的
substruction	下部结构
tonguelet	小舌
criminological	犯罪学的
crossed	交叉
jar	震动
rabies	恐水病
battik	蜡染布
margarin	人造奶油
mitigative	平静的
coony	机灵
natural	正常的
stray	迷路
unshirted	赤裸裸的
communicant	通知者
thetford	ware
smacking	活泼
chauvinism	沙文主义
carrollian	具有卡罗尔风格
lustily	精力充沛地
listed	列出
panegyrical	颂词的
reenaction	再制定
supernormal	非凡的
multiflora	rose
frontogenesis	锋生
halfpence	半便士之值
necrology	死亡启事
nuchal	项的
smoggy	烟雾弥漫的
helminthology	寄生虫学
chloasma	黄褐斑
foreboding	预兆
chiba	千叶
nonprincipled	与原则无关的
uncatchable	无法捉住
hudson	美国
inexplainably	难解说
interventionism	干涉主义的
ell	旧时量布的长度
rann	to
rabble	下层社会
spill	木片
monadnock	残留山丘
tarada	独木舟
hummock	沼泽中的肥沃高
antagonistic	敌对
fratch	吵架
osculatory	接吻
dashi	鱼汤
lanceted	矛尖状装饰的
stuporous	不省人事
repose	寄托于
corporately	团结
frg	德意志联邦共和国
whid	轻捷地走
fleche	小尖塔
attrited	磨损
oncornavirus	致癌RNA病毒
verdant	翠绿的
vanessa	瓦内萨
snubbingly	厉声制止地
psephomancy	石子占卜
vesicatory	发泡药
lighthouse	灯塔
dense	浓厚的
frankenstein	作法自毙的人
pasteboard	纸牌
nosogenesis	致病原因
diamorphine	海洛因
cozily	舒服地
subservience	有用
comparable	比得上
individuate	赋予个性
tumescent	肿胀性的
hypophloeodal	皮层下的
gaslit	以煤气灯照明
carnify	长肉
brd	德意志联邦共和国
hamitic	哈姆族
esophageal	食管的
literal	文字
straggling	落后
uncondescending	不俯就的
bamboozlement	欺诈
dizzyingly	令人昏乱地
fall	落差
democratic	民主的
indeterminist	非命运论者
posteriorly	其次
deadbeat	游手好闲者
virus	恶毒
cetacea	鲸类
dungeness	邓杰内斯蟹
fenestrated	有孔的
niedersachsen	=Lower
tad	小孩子
leglet	脚镯
appeasable	劝解得了的
undertake	采取
sunderance	分离
plantsman	花卉栽培者
cleocin	氯洁霉素
emphysema	肺气肿
lukan	=Lucan
parasitical	食客
radiotracer	放射性示踪剂
endosarc	内质
snuffless	不需剪烛花
fauteuil	太师椅
cornichon	醋渍小黄瓜
inductor	圣职授与的人
outvalue	价值高过
discordance	不和
eda	Electronic
noyade	溺刑
stackyard	堆谷场
learned	有学问的
uae	United
meteor	流星
slipstream	起带动作用的助力
comedown	衰落
iou	借条
ablare	喧哗地
rhinolithiasis	鼻石病
polyglottal	=polyglot
prescriptive	说明性
wilding	野
chastening	矫正性
local	乡土的
canalicular	小管
argental	似银的
akin	同族
rhodic	高价铑的
stomatic	气孔的
stepwise	逐步的
tribromoacetaldehyde	三溴乙醛
pathetically	可怜地
prostatotomy	前列腺切开术
invectively	恶言恶语地
fretful	烦燥
walloon	瓦龙人
vdr	视频磁盘录像机
smileless	严肃
arnold	阿诺德
ciliary	纤毛
recount	叙述
brachydactylic	短指
put	航行
dhtml	dynamic
marvy	=marvie
physiographic	文学
insistent	坚持不懈的
tough	粗暴
king	统治
ewery	有水罐毛巾的房
home	有效
nondescript	难以区别
messianic	弥赛亚的
retinoblastoma	眼癌
wheelhorse	辕马
improper	不合礼仪
assistant	辅助
do	实行
eponymous	齐名
dishonorable	不名誉的
wash	冲出
hypocrinism	内分泌腺官能不良
presentive	直接表示概念
billycock	小礼帽
vigilant	警醒
professional	职业
servantgirl	年轻女仆
ramification	分叉
chymotrypsinogen	糜蛋白酶原
uncorrected	未修正的
sue	提出请求
triserial	只有三个轮生体的
dualpurpose	肉兼用
venule	小翅脉
laborsome	吃力
sclerous	硬化的
protective	给予保护
dumpishly	愚笨
sociology	社会学
impavid	无惧的
ytterbite	硅铍钇矿
imploringly	恳求
mineragraphy	矿相学
phat	容易排字
regular	经常
dialectal	乡音
sailorman	水手
killing	使人疲乏
muddle	混合
disfavour	不赞成
extraocular	眼外
tipsy	倾斜的
salbutamol	嗽必妥
petite	小
flibbertigibbet	轻浮
railsplitter	劈木头作为栏杆者
avengingly	复仇
manipulation	操纵
guidelines	指导方针
mott	丛林
present	当面
vagabond	流浪者
topmaul	锤
aromatic	芬芳的
reversion	隔代遗传
coalhole	地下煤库通到街上的洞穴
justiciable	可在法庭裁判
preagricultural	人类开始从事农业前的
ippf	Parenthood
censorable	可诟病
basilar	头盖骨底部
salopian	Shropshire地方的或人的
outfox	以计取胜
optional	随意的
investigative	好研究
dateless	年代不详的
morbidly	病态
loathly	不情愿地
are	在
cnd	Nuclear
disturbedly	不安地
helminth	寄生虫
advised	细想过的
gambling	赌博
unentangled	不纠缠的
specific	特效药
worked	作装饰用
cornfed	看来营养健康而带土气的
slicker	骗子
checkstring	号铃索
lacerative	有伤害或撕裂力
demarcative	分界的
penna	廓羽
otiose	闲着的
pendular	摆动
incurvate	弯曲
unapproved	未经批准的
curmudgeonly	不和悦的
veiling	面纱布料
knuckle	指节
undulatory	波动
poseur	装模作样的人
calculated	有计划的
knobbly	棘手的
monogamous	一夫一妻的
ace	欧洲盟军司令部
epistoler	书信作家
blacktailed	黑尾鹿
epigeal	贴地生长
smiley	=smily
epndb	decibels有效感觉噪声分贝
meretricious	适合娼妓的
overtly	公然地
downcourt	前场篮下
maisonnette	小屋
hawash	哈瓦希河
coon	浣熊
tonsilar	扁桃腺
strikebound	因罢工而歇业的
preoral	口前
sunfish	翻车鱼
superduty	超耐用
sufferable	可忍耐
resiniferous	生树脂
cliquy	分为派系
duff	揉好的面团
disclose	透露
dictionary	词典
voltaism	流电
stuffless	单薄
dinaric	Alps迪纳拉山脉
condonation	宽恕
tatting	梭织
gap	裂口
gossipist	=gossip
mshe	of
tup	公羊
snitch	告发者
tetrasepalous	四萼片的
vintage	洒
hyperbolize	运用夸张法
hardy	努力地
ergogram	肌力描记波
flitch	裁成板
squamose	鳞状
bulkiness	笨大
outcast	被驱逐者
redressal	修正
catalepsy	全身僵硬症
assumptive	假设的
luteous	略带绿色之黄金色
catling	两刃切断刀
disconcert	使仓皇失措
instreaming	涌进的
spark	闪光
segue	继续
fatbrained	愚钝
excursion	远足
hypermetamorphic	复变态期
romanesque	罗马式
dyadic	二价
balky	倔强的
huh	哼!
hypopnea	呼吸不足
bastinado	打脚掌的刑罚
burdock	牛蒡属
lacquering	上漆
hydroacoustic	水底传音
scrubby	矮小
iktas	所有物:目前我们所需要的东西全有了
unqualified	无资格的
nasally	鼻地
wanderyear	=Wanderjahr
ceaselessly	不停
truculence	好战
hood	覆盖
bleary	眼睛模糊的
sudamina	汗疹
divisive	区分的
desired	渴望的
aerometer	气体计
lumper	居间人
extensibility	展开性
epigynous	上位
manioc	树薯
edrophonium	氯化腾喜龙
rush	急需的
shift	转移
desiccant	去湿
microassembler	微汇编程序
lowlife	卑劣的人
mainspring	主发条
nailless	不用钉
carboxylate	羧酸酯
prefrontal	前额
viatic	道路的
enterectomy	肠切除术
fruitlessly	无益地
quivery	震动
skip	跳
falsehearted	不忠实的
automata	自动控制
tutti	全体的
conversible	=conversable
nubble	小瘤
fane	教堂
acumination	尖头
nonnasal	非鼻音
pharmacy	配药业
antiozonant	抗臭氧剂
ephemerous	=ephemeral
airbus	"空中客车"大型客机
inaccurate	不准确的
fulmination	闪电
county	县
semifluid	半流质的
responsible	可依赖的
illfare	逆境
plerome	中柱原
interwar	两次战争之间的
preceding	在前的
fenian	芬尼亚主义
tuft	丛生植物
foursquare	正方形
oaten	麦杆制的
senhorita	小姐
cccs	商品信贷公司
blusher	使脸色红润的化妆品
pathbreaker	开拓者
covered	隐蔽着
bleb	水泡
ovoflavin	=riboflavin
balletic	象芭蕾舞
beslave	使为奴
harmless	无害
chine	山脊
overceiling	超出最高限额
chiropractic	脊椎指压治疗法
strange	不惯的
nyse	纽约证券交易所
fenrir	芬里厄
monohydroxy	一羟基
bluebottle	青蝇
spatioperceptual	空间知觉
indelibility	不能消除
pedunculate	有花梗的
rentable	可出租
forcibly	硬
intomb	埋葬
chaff	谷壳
tobacco	烟草
obstinate	顽固的
pruinose	覆盖白粉的
limation	抛光
olfactory	嗅觉的
solutrean	梭鲁特期的
crudity	生硬
textured	有织纹的
clavate	棍棒状
rift	不和
unphysiologic	生理上不健全
anticyclone	反气旋
newfangled	新奇
froghopper	沫蝉
adversely	逆
cooperation	协作
marking	记分
supposititious	想象的
podzolization	灰壤化作用
maduro	色深味浓的
laccolith	岩盖
breccia	角砾岩
trimmer	整顿者
woodenly	呆板
newfashioned	新款式
counterplot	对抗另一计谋的计谋
enophthalmus	眼球内陷
hemmer	缝边器
loon	懒人
redware	红土陶
gyrate	旋涡状
zoroastrianism	明教
marionette	牵线木偶
asbestic	=asbestine
otb	场外赛马赌博
prad	马
costive	沉默寡言的
upstand	竖柱
petroliferous	产石油的
climber	登山者
exit	离开当前命令行外壳
yawata	八幡(原日本九州岛北岸港市
panopticon	圆形监狱
unidentifiable	无法辨认的
arbitrational	关于仲裁
prolixity	冗长
bat	蝙蝠
royston	冠鸦
bootmaker	靴匠
kitty	Kitty
outbound	开往外国
hemishere	地球的半面
craftily	狡猾
semitone	半音程
refraction	折射
symbolistic	象征主义
abherent	信徒
avascular	无血管的
academe	学术界
expositive	解释
subregion	亚区
redemandable	再要求的
rehear	再审
baloney	大香肠
satiation	使饱足
antichloristic	阴氢剂的
transit	运输线
ornamentation	装饰
superduper	非常好的
subordination	次要
computator	=computer
footle	傻事
inviolateness	无污点
underlay	垫起
waste	浪费
weekender	周末旅行者
complement	补足物
maris	玛丽斯
ballproof	子弹打不穿
chill	寒意
scheme	图解
aok	一切正常
deterrable	可制止
rampart	防卫
diverticular	支囊
enable	授予权利或方法
selfless	无私
vizier	维齐尔
campy	装模作样的
vagotomy	迷走神经切断术
blanky	比blankety
mothy	多蛾的
ur	吾珥
set	固定
volcanoclastic	=volcaniclastic
electrokinetic	动电学
rail	以横木围栏
campanulaceous	吊钟花科的
rancherie	居留地
begird	围绕
decillion	decillion的
kiang	西藏野驴
depasture	放牧
nectared	甘美的
benchboard	控制盘
frankfurt	法兰克福香肠
lacune	洼地
fail	忘记
lushly	多青草
emotively	动情
glucosan	失水葡萄糖
fontina	意大利果仁味羊奶干酪
fingerful	一点儿东西
limitless	无界限的
debouche	出口
unreasonable	不讲道理
shellheap	=kitchen
brownware	棕色陶器
atlas	地图
tumultuary	混乱
nulliparous	从未生育过者的
nooky	多角隅的
skip	跳读
debark	卸载
sure	的确
brassiness	黄铜
validly	妥当
proteide	蛋白质
chagigah	祭品
hermitship	隐居
bicoastal	大西洋和太平洋东西海岸的
telefilm	电视影片
effeminacy	柔弱
fairyism	仙气
whoopee	狂欢
draft	为……打样
invidious	易招嫉妒
astonished	惊讶的
adumbrative	暗示
fibrous	含纤维
corded	用索子捆扎的
igneous	火的
mancunian	曼彻斯特
plo	Organization
ripe	成熟的
mysid	糖虾
nukualofa	努库阿洛法
thrust	强加
unwatered	未浇水的
monophysite	基督一性论者
stabbing	伤感情
armipotence	军备充实
inseparate	不分离的
doghouse	犬舍
brutal	残忍
inconsolably	无法安慰地
triable	可判定的
sawder	花言巧语
female	柔和
interlard	使混杂
sting	刺激
eec	European
rocambole	小蒜
elegiac	挽歌的
gynaecoid	似女性的
immunocompetence	9ImjJnEJ`kCmpIItLns/n免一钚
scuzzy	阴暗
lsv	surface
cromer	克罗默
autarkist	自给自足主义者
rectifiable	可纠正
panchromatic	全色的
fanciness	空想
narcissistic	自我陶醉的
jemadar	尉官
unlearned	没有文化的人们
dunderpate	大傻瓜
heel	脚后跟
antimonial	含锑的
acinus	小核果
wheatworm	小麦线虫
fullmouthed	大声
surely	的确地
overwhelm	受打击
catalepsis	全身僵硬症
cracky	多裂缝的
insensibly	极微地
chuffy	不高兴的
stealing	贼赃
puristic	用语简洁
activity	行为
pledge	抵押
qda	agreement大量折扣协议
exoteric	一般人所能理解的
affreighter	租船运货
bushy	灌木茂密
autoclave	高压锅
agrestial	农田中野生
slicken	擦亮
northerner	北国人
homozygotic	纯质性的
scent	嗅猎
clavicle	锁骨
mts	机器翻译系统
lateral	横的
spiritualist	唯心论者
rail	抱怨
barbary	北非伊斯兰教地区
partner	舞伴
sifter	筛子
lovelorn	害相思病
pyrotechnic	烟火的
heavier	巨大
samos	satellite
landtax	地租
agony	极大的痛苦
antifibrinolysin	抗血纤维蛋白溶酶
monophoto	莫诺照相排字机
galwegian	加罗韦的
infant	幼稚
atmospherically	由大气压所致
biltong	干肉片
pulley	滑轮
proportional	成比例
cacti	仙人掌
zaniness	疯狂
block	块
cranky	摇荡不稳的
wet	湿的
ubiquity	到处存在
rbe	biological
deliberative	协商
spado	无生育能力的人
fidelista	支持菲德尔·卡斯特罗者
victual	吃
hydrodynamicist	流体动力学者
mummer	伶人
abiochemistry	无机化学
hypergolic	自行着火
flatwoods	低洼地区的树林
comtian	实证论
without	在屋外
hyperphysical	与物质无关
premonstratensian	普雷蒙特雷修会的
psittaceous	鹦鹉
carbonaceous	碳
liege	臣民
townswoman	女同乡
irreparability	不可修补
sexism	蔑视女性
gaullist	戴高乐主义者
fall	垮台
thali	大浅盘
psychotic	精神病患者
airsick	患航空病的
rattly	吵闹
destain	退色
kep	篮子
smart	聪明
ectohormone	外激素
residue	剩余物
birch	桦树
premo	多媒体对象表示环境标准
microparasite	微寄生物
unhang	取下
fosbury	背越式跳高
killfile	可以过滤UseNet消息的文件
irresoluble	不能解释
milan	米兰
whistle	汽笛声
boisterous	喧闹的
drysalter	干货商
tucket	喇叭调
geoponic	农业
iamap	Physics
rhombohedral	斜方六面体的
loose	散漫
humourously	滑稽
subdeacon	副助祭
prelexical	词前
reviewable	应检查的
nondestructive	非破坏性的
aaup	Professors
dna	脱氧核糖核酸
sacrifice	供奉
chinanet	中国邮电部建设的公用主干网
shin	胫骨
dense	密集的
project	发射
landslip	地滑
plus	加上
larker	嘲弄者
positive	积极
thievish	偷偷摸摸
puppetry	傀儡
naphtha	石脑油
breakup	完结
requite	报答
creditable	可信的
manhelper	漆刷加长杆
exceed	超过其他
photography	摄影
former	模型
sportfishing	垂钓用
pizzazz	=pizazz
rare	稀罕
fascinating	醉人的
maidenly	适合于少女的
kanaka	夏威夷及南洋群岛的土人
disinfection	消毒
penitential	忏悔的
wysiwyg	You
trivial	微不足道的
bourree	法国十七世纪活泼的奥弗涅舞蹈
blastocele	分裂腔
fuegian	火地岛
scholarship	奖学金
ornithorhynchus	鸭嘴兽
bacchantic	崇拜酒神的
homozygously	纯合子地
slack	软弱的
sunfall	日落
monastical	出家
longeron	纵梁
pneumatolytic	气成
endoscopic	内窥镜检查
teleutospore	冬孢子
biennial	二年生
sough	飒飒声
dehydrocanned	脱水装罐头的
lavvy	盥洗室
whisper	低声说
bewitching	使人着迷
disunion	分裂
concent	答应
tokomak	=tokamak
piggish	猪一般
mib	Management
cragged	岩多
keap	扣留
pelagian	洋面
pull	拉
upshift	加速
grasping	抓的
magnetogasdynamic	mA^`ni:tEJ9AsdaI`nAmIk/
undefendable	无法防御的
civet	香猫香
entry	登录
histrionic	戏剧的
epidural	硬脑膜外
ecclesiastes	传道书
chiefy	空军上士
nonclaim	在期限内未提出要求
involucrate	有总苞
biowarfare	=biological
malaguena	其舞曲
target	对象
savourless	缺少风味的
peculiar	特殊的
germanist	德国文学专家
fallacious	使人误解
doohickey	装置
oddly	古怪
novillo	小公牛
subpolar	近极
typeface	打字机字体
panzer	装甲
jmb	Board入学考试联合委员会
extortive	敲诈
sakellaridis	萨克拉里德斯棉
vivific	使生动的
listenership	听众
jauntily	高兴地
conversation	交谈
revisionary	校订
pelagic	浮游的
ramshorn	扁卷螺
affect	感动
unclog	使畅通
castiron	健康的
standfast	固执的态度
exclaim	惊叫
avariciously	贪财地
undoubled	展开
configurate	使成形
rasped	易怒的
fright	惊骇
affinitive	密切相关的
obstreperous	任性的
underthings	内衣裤
nonflying	不能飞
doorman	看门的人
overbrim	使满出
reappraise	重新评价
gastrectasia	胃扩张
carry	运载
eprom	可擦可编程只读存储器
bec	bachelor
cyanurate	氰尿酸酯
provisionality	暂时性
assify	愚弄
slopewash	斜坡冲刷物
idle	无价值的
outward	公开
lpg	Gas
eyeservice	尊敬的眼神
juju	符咒
pundit	梵文学家
sourly	酸酸
clon	=clone
scherzando	戏谑的
haulageway	道
variorum	有诸家注解的
briskly	精神勃勃
passably	也还过得去
apodous	=apodal
bajan	巴巴多斯人
seedy	褴褛的
lawk	糟了!
upland	高地
councilor	议员
defensive	自卫的
untamable	难驯服的
hit	袭击
phyletic	种类的
rule	水线
sinologue	汉学家
qarnns	Naval
merohedral	缺面
usable	可用的
great	非常
enforceable	可强迫的
labradorite	富拉玄武岩
petty	小型
lustreless	平淡乏味的
acrostic	离合诗
compelled	强要
swink	苦工
bate	抑制
primitive	粗糙
nonnasal	非鼻的
mormon	摩门教徒
cecrops	刻克洛普斯
villainous	坏人似
narcissistic	自恋的
echo	反射
reconveyance	送还
corroboratory	确定的
haemostatic	能够止血
rotuma	罗图马岛
rostellate	有蕊喙
oscular	接吻
fumarate	延胡索酸盐
anthropological	lly//
cobbly	用鹅卵石铺的
ruridecanal	乡村主任牧师
ingressive	进入的
jocularity	戏谑
termly	定期
vendible	可被普遍接受
acuate	尖
unhuman	非人类的
gruesome	可憎
vernal	和煦
vomerine	犁骨的
physical	身体
dominion	控制
remittent	弛张热
stacte	制造香料的没药
disappreciation	低估
malconduct	恶行
vbscript	Visual
copyboy	送稿件的工友
torpedo	用鱼雷进攻
adios	一路平安
storewide	包括店内全部商品
halophyte	盐土植物
coxcombical	浮夸的
litigiosity	好争论
sick	厌恶
tittivate	装饰
handicap	使不利
toothcomb	缜密调查
chip	削成碎片
settler	托管财产者
infinitude	无限之物
euphausid	磷虾目浮游甲壳动物
paradoxical	荒谬
tumbrel	施肥车
feasible	可行的
unknowing	没查觉的
nonadmission	不接纳
lophodont	脊齿型
cerebrotonic	表示大脑紧张型特性的
prohibit	禁止
dysteleologist	无目的论
nidificant	筑巢
worthless	无益的
narrater	叙述者
accordionist	手风琴师
linguini	扁面条
polyptych	多联画屏
caesarism	专制政治
programme	编程
tapeti	小野兔
spacer	逆电流器
milanese	米兰
wmo	World
rvsvp	s''il
jacobus	James
turncap	旋帽
bufflehead	小鸭的一种
mastoid	乳头状的
thelitis	乳头炎
uropygial	尾臀
lagune	泻湖
foil	烘托
nephelite	=nepheline
deplumation	换羽毛
kemalist	基马尔式的
swagger	虚张声势吓人
uncomely	不正派的
klutz	笨手笨脚的人
banderol	飘带
profluent	平稳流动的
jollily	愉快
mossbunker	=menhaden
tridimensional	立体
ballistically	发射地
extensible	可扩张的
fill	供应
dmd	牙科学博士
rbe	effect
odense	欧登塞
diametrically	直接
millionairess	百万富翁的妻子
kwangju	光州
msgm	Science
cabrilla	热带海水鲈鱼
lenience	仁慈
attend	出席
valiant	英勇的
reliquary	圣骨匣
ecogeographical	生态地理
lop	闲荡
liquor	喝酒
noisome	有害
exclusion	被排除在外的事物
overblouse	女式长罩衫
jsp	Page
auric	正金的
narcose	昏迷
fillet	用带缚
unhired	未租入的
unsought	未寻求的
ozonide	臭氧化物
exegetical	解经
welsh	逃避食言
affection	倾向
cutaneous	影响皮肤
outwit	瞒骗
dll	动态链接库
wildflower	野花
crush	压碎
kermit	由哥伦比亚大学设计
lactoproteid	乳蛋白质
cave	洞穴
masticatory	咀嚼用的
flocculous	像毛状物的
spoony	傻子
planes	位面
incisive	深刻的
fiction	虚构
scenic	戏剧性的
ulan	=uhlan
derange	扰乱
refractile	能折射的
evadingly	推托地
unploughed	未犁过
segetal	在谷类田间生长的
generic	普通的
sexualize	使有性关系
choleraic	霍乱
cist	用来装圣器的箱子
herder	牧者
impressionistic	印象主义的
herbivorous	食草的
pfc	private
discussible	可议论的
implacental	无胎盘动物
bromo	止头痛药
indicate	简要地说明
undeflected	不偏离
sauceboat	船型酱油容器
deride	嘲笑
deflationary	放出空气的
abreaction	消散
concerted	协定的
holothurian	海参
reconcilability	一致
equimultiple	等倍量
iaz	artillery
aristotelean	思想偏重于实际之人
uricosuric	促尿酸尿
aboriginal	原来
bowlful	一满碗
breton	法国布里多尼地区
diallage	异剥石
sidebone	叉骨
gnathitis	颔炎
rtl	Resistor
flix	海狸绒
censorable	须受检查
uniparental	单亲
when	什么时侯
chargeable	可充电
canonicate	牧师或僧侣之职位
flavourless	无味
flexuous	动摇不定的
antimonic	含锑的
corvet	驱潜快艇
hhfa	Agency
acne	痤疮
ochreous	含赭石
arithmancy	数字算命法
coward	胆小的人
buhr	细砂质磨石
frantically	疯狂似
idle	不作事
pathfinder	探险者
duplicity	不诚实
returnee	回国人员
habited	穿着法衣的
monophonematic	单音位
pastis	法国茴香酒
catgut	肠线
agoing	在进行中
bandstand	演奏台
polycistronic	多顺反子性的
grinder	脱衣舞女演员
sneezy	引起喷嚏的
lps	Privy
undistributed	未分发
fido	业余爱好者网络
crocky	老朽
elaborately	精巧
thuriferous	产乳香的
moronity	低能
carline	老太婆
jeez	呀
figueras	费卡洛斯
unnumbered	未编号的
billingual	北京双语教育电子有限公司
khalkhas	柯尔克孜族
tandoori	唐杜里烹饪法
birdy	如鸟的
hectic	狂热
glimpse	一瞥
sleighing	橇运
shush	嘘!
chessman	棋子
executive	实行
aggressive	敢作敢为
morning	上午
pickeer	搜索
repugnant	不一致
annectent	连接的
partnership	合伙契约
flickery	闪烁
astigmatic	纠正散光的
modeling	建模
amercement	罚款
praxis	实习
buzz	逼近
concentricity	集中性
dead	完全地
denicotinize	除去尼古丁
lordship	贵族身份
file	文件
opponent	对抗
reciprocate	互给
anoint	施以涂油礼
leary	空的
intracranial	头颅内的
catalyzer	催化剂
unphysiologic	生理上不健全的
consecrated	被视为神圣
adsorbability	吸附力
brimless	无边
whoredom	卖淫
music	音乐
table	制表
peitaiho	见
mistress	女主人
mnas	Sciences
visitator	巡查员
deltoideus	=deltoid
pop	枪击
spindle	装锭子于
percipience	知觉
totter	踉跄
spread	敷
spectroscopy	分光镜使用
imputable	可归因
affirmatory	承诺
clearsighted	聪明的
nondefense	与军事防御无关
statistic	统计
quirky	诡诈
micritic	微晶灰岩含量高
pogo	该游戏的工具
zinky	含锌
evolving	进化
kick	踢
navigate	航空
hepatocele	肝膨出
fieriness	火性子
lumpenproletarian	`lQmpEn9prEJlI`teErIEn/
lateritization	=laterization
starveling	挨饿
laughton	劳顿
sesquipedalian	多音节
vote	公认
unordinary	不普通
tortilla	玉米粉圆饼
matrilocal	入赘
relativize	使相对化
illative	推论
cbu	bomb
attributive	归属
harsh	粗糙
heresy	异教
preventable	可预防
quirk	怪癖
amole	皂用植物
cowshed	牛棚
nervine	有镇定作用
transpiration	蒸发
manorialize	置……于庄园制度下
scrubboard	洗衣板
lockage	水闸的构筑
last	最近
peak	消瘦
wisteria	柴藤
hemosiderosis	血铁质
interlingua	国际语
flavourful	有香味
boozeroo	简陋的小酒店
film	影片
criminaloid	本性有犯罪倾向之人
page	页
telecommunication	电讯信局
cylindrical	圆柱的
myxoedema	黏液腺瘤病
derivation	引出
varuna	伐楼拿
receivable	可接受的
shoreless	无法上岸的
hyenoid	像土狼
dentary	牙齿的
phylogenic	动植物种类史的
ulterior	将来的
interstellar	星际的
colette	科莱特
locky	成束的
argumentum	论点
bowsprit	船首斜桅
sublunary	月下
milchig	乳制品的
impersonify	=personify
salina	盐碱滩
mediaperson	通讯员
intended	已经订婚
heavy	大量地
basal	基本的
disoperative	阻碍的
bangladeshi	孟加拉国的
spider	蜘蛛
anthrosphere	人类活动圈
darner	缝补台
hit	打中
crenated	圆锯齿状
upwafted	被托起的
strain	过度的疲劳
idiomorphic	自形
regretful	遗憾的
oary	有桨
inflectional	屈折的
anomie	社会的反常状态
bivariate	双变
olympic	奥林匹斯山的
astrut	趾高气扬
fragment	片段
distress	危难
notional	想象
cooking	烹饪
statuesque	雕像般的
quinquepartite	由五部构成
acknowledge	承认
holistic	全盘的
epiphenomenalism	副现象论
sculk	=skulk
manstopping	大威力
epicurean	享乐主义者
nauseating	恶心
ioc	Committee
howbeit	虽然
translunary	虚构的
noncommunicable	不会传染
phagocytosis	噬菌作用
elint	电子侦察所得的情报
punctulated	有细孔
biocoenosis	生物群落
whittle	削
vitaceous	葡萄属植物的
amortization	摊还
inedita	未发表的文学作品
incendiarism	煽动
uddi	Description
glooming	怒容
sba	Business
frondage	茂盛的叶
petrographical	岩相学的
rickety	患佝偻病
prohibition	阻止
lcm	Lowest
learned	学术上
vulgate	通行
plantigrade	踯行动物
inconscious	无意识
lymphad	单桅单甲板平底船
windbaggary	夸夸其谈
sodwork	草皮建筑物
crush	压服
hih	His
picaroon	做海盗
reflector	反射体
pondok	芦棚
malpais	熔岩区
brainless	无头脑的
unscrupulously	不客气
scheme	计划
unco	奇怪
illness	疾病
eponym	齐名的人
zincoid	锌的
wanderer	迷路的动物
trillionth	第一兆
socialistic	社会主义
clumsiness	笨拙
dakoit	强盗帮员
adapter	适配器
denasalize	使鼻音减低
frondent	叶子很茂盛的
aproposity	巧合
sporangium	芽孢囊
aew	early
stygian	狱
vorticular	=vortical
fidelism	=Fidelismo
perivascular	血管周
lip	嘴唇
semiography	=semeiography
demystification	非神秘化启蒙
bdtr	Rate
perfervid	非常热心的
spermatogonium	精原细胞
blunderingly	粗笨地
salacity	猥亵
hygrometric	测湿
start	削减战略武器条约START
carotenoid	类胡罗卜素
smack	拍击
aurelian	蛹的
duskily	微黑地
creedal	信条
hemiolia	三比二
wile	欺骗
faultfinder	挑剔
cartagena	喀他赫纳
inoxidized	未经氧化
key	栓
funny	古怪
lacedaemonian	古代斯巴达的
professional	自由职业者
rigorous	严酷的
tricorne	三角的
hmas	Ship澳大利亚皇家海军舰艇
hexahydroxy	六元的
knit	密接
unvouched	未被证实
ncv	c
raza	种族意识
lancet	小刀
zootomy	比较解剖学
runout	避开
streamy	多溪流
weave	迂回行进
ohioan	俄亥俄州
husky	谷
overlying	overlie的现在分词
tom	雄猫
moot	无实际意义
weak	虚弱
pemmican	干肉饼
ballonet	气囊
latterly	后来
catoptric	反射的
region	区域
worldbeater	举世无比的人
tumidness	突出
kil	公里
brunch	早午餐
detector	发现者
synthetical	综合
slaver	流涎弄脏
unhallowed	不圣洁
isallobar	等气压图
flitch	料板
comparison	比较
probusing	赞成用校车接送
dicty	时髦
latticing	装格子
preggers	怀胎
raises	加薪
bim	Management
zedonk	斑驴
hemiolia	黑米奥拉比例
mhs	Message
feed	饲养
durable	耐用的
mammalia	哺乳类
aeon	万古
scribe	作者
pembrokeshire	彭布鲁克郡
sufism	苏非派禁欲神秘主义
unfleshly	精神的
towardly	有希望的
reviviscent	复活的
anesthesia	=anaethesia
hmf	Forces英国军队
eusol	优苏
unfed	未得到支持的
mystical	神秘
spasmic	=spasmodic
hydremic	稀血症的
canterer	慢跑之动物
carnation	荷兰石竹
runback	持球跑动进攻
direct	直率
metainfective	传染后的
naevi	痣
polyclonal	多元性繁殖系的
pontoon	架浮桥于
slavish	卑屈
expedite	畅通
hex	十六进制
majestic	宏伟
dislikeful	讨厌的
whoseso	whoso的所有格
farmisht	糊涂
encore	再演唱的要求
traducian	=traducianist
swordbill	刀嘴蜂鸟
radiculose	有很多细根的
rite	教派
alluvium	淤积层
caprylic	羊脂酸的
gravitino	引力微子
salivous	唾液的
sophisticate	久经世故的人
maidenlike	像处女的
cuprous	亚铜
unrestrained	无限制的
muckle	多量
swathe	包装品
guileful	诡计多端的
natural	简单自然的
russet	赤褐色的
unfadingly	不褪色
hesperidium	柠檬果
plainstones	扁石
accidentally	意外
misguide	误导
sole	唯一的
quiesce	静默
decorous	有礼貌的
perrier	毕雷矿泉水
andante	缓慢地
hokey	做作的
lappic	拉普兰语
molecularity	分子状
russophobe	惧俄者
toynbeean	汤因比历史观
silicic	硅的
blackhearted	心肠黑
ethene	乙烯
limit	限定
azedarach	楝树
insistently	强求
impenitent	不悔悟的人
daffadilly	水仙
mmf	force
ravelin	半月堡
rootle	用鼻尖挖掘
blocking	模块化
baume	波美比浮计的
oneself	亲自
matchmark	装配标记
repulsive	严拒
ionopause	电离层顶
levy	征集
enduringly	耐久地
embroil	使卷入
winning	得胜的
infective	影响别人的
gnarl	咆哮
desponding	意志消沉的
fhwa	Highway
lexiconize	编辑的辞典
rumination	反刍
veiled	隐藏
bernicle	goose欧洲黑雁
unshaped	未定型
dead	废弃了的
guttiferous	产树胶的
wink	使眼色
petrol	汽油
malice	恶意
surely	确
paunchy	大肚子的
wired	以线加强
esl	language非母语英语课程
approximator	近似者
cerebral	脑的
cramp	以铁箍扣紧
ahem	啊咳
amoral	超道德
gag	箝口物
phonotactics	音位结构学
titlark	云雀之类
unhcr	Refugees
contrastive	对比的
treat	谈判
hydrometeorological	/
empyrean	最高天
spiritualization	神灵化
trumpeter	号兵
bond	债券
clincher	紧钳
neglige	家常服
cisalpine	其南侧的
remissness	不小心
fifa	de
chlorophyllite	绿叶石
service	仆人的
ontogeny	个体发生
irresponsibility	无责任
enticing	引诱
landwards	向陆地
halfway	中途
superintend	指挥
pathoneurosis	病位性神经症
marburg	青猴病
punjabi	Punjab
aim	打算
dye	染料
shave	刮
heeled	带手枪的
repulsive	排斥的
shred	最少量
probationership	缓刑期间
flank	侧翼包围
allegorize	寓言化
rosewater	有玫瑰香水味的
intrant	入学者
westward	西方
deplethoric	体液缺乏的
cottonpicking	剥棉籽乡亲联谊会
meany	刻薄鬼
advocacy	辩护
unthinking	未加思虑
gallantly	献殷勤地
heteropolar	有极
entrain	产生
clinical	临床
portfire	点火装置
diptera	双翅目
kinglessness	无君主
pleuroperitoneal	胸膜腹膜的
sextuple	由六个部分构成
fade	平淡
coyote	山狗
ladybug	瓢虫
insusceptibly	不受影响地
genetics	遗传学
dona	太太
tuberculoid	结核样
dateline	日界线
yamma	美洲驼
stuporous	不省人事的
usurper	篡夺者
faultfinding	找茬子
insymbol	内部符号
atapi	Packet
liebfraumilch	莱茵白葡萄酒
musketoon	短滑膛枪
primitive	简单
plan	设计图
unshifted	未更换的
assertory	断言的
oofy	有钱
aram	Associate
preclassical	古典期前的
expatriation	放弃国籍
middlescent	中年
hydroid	水螅虫的
countrymen	同胞
bahai	巴哈教
way	远远地
menad	心情暴躁的女人
uncondescending	不俯就
optional	可选择的
historiated	=storiated
tannish	浅棕色
suxamethonium	琥珀胆碱
stodginess	笨拙
mastigophoran	鞭毛虫
discipular	追随者
ponder	沉思
chicklet	姑娘
vulturine	秃鹰似的
superradiance	超发光
wold	无树木的山
optics	光学
recuperative	使恢复的
idioplasmatic	细胞原质
embassy	大使及其随员
favorite	幸运儿
skeletonize	节略成概要
emergent	自然发生的
opposed	敌对的
jd	Juvenile
fifa	国际足球联盟
marsh	湿
heeled	带着钱的
yardman	园丁
equatorward	朝赤道方向
autodial	自动拨号
iffy	有问题
eudaemonic	幸福
vive	活泼
waxlight	蜡烛
caustic	刻薄
reable	使复原
privity	私下知悉
multigerm	多胚芽的
sniffable	可吸入
buckhound	猎犬的一种
incorporable	可结合
paced	步伐
springhalt	跛行症
workload	工作量
charming	迷人
chrestomathy	读本
bulldozer	推土机
cipher	密码
vision	幻想
aeromedicine	航空医学
calendric	按日历
vizagapatam	=Visakhapatnam
absentee	未上班者
fairness	清晰
peck	配克
blustering	狂暴
extemportize	演唱
aesculin	七叶树素
oxycarpous	有尖刺果的
weak	弱
endarterium	动脉内膜
mega	大
retrofited	作翻新改进
amicably	友善地
slot	位置
gwine	go
proteinous	=proteinaceous
slubber	弄污
spline	齿条
howl	嚎叫
hunks	守财奴
lowish	有点儿低
planation	均夷作用
colcannon	马铃薯卷心菜泥
topeka	托皮卡
azorean	亚速尔群岛
geomedical	风土医学的
muskie	=maskinonge
irrigate	修水利
floodmark	满潮标
misaligned	未对准的
substation	分所
swiss	瑞士
quixotism	唐吉诃德式性格
proclaim	声明
fluster	狼狈
embody	收录
dray	运货马车
airhop	乘飞机短程旅行
perfectionist	十全十美主义者
mid	中部的
inexpansible	无法扩张
aspiration	渴望
unserviceable	无益
bribe	贿赂
contractible	会缩
methotrexate	氨甲蝶呤
winter	冬
diffrangible	可分解
hydrolytic	水解
botb	英国海外贸易局
prescript	命令
burl	节
delegable	可授给的
punisher	处罚者
spermatophorous	精子包囊
amphibole	闪石
existence	实在
exhortatory	劝诫的
beetroot	甜菜根
dispassion	公平
subventionize	补助
unaccompanied	无随从
crevasse	破口
ulcerate	溃烂
sociable	友善
cmh	of
priscan	涉及古代
finestra	孔
catlike	象猫的
duke	手
redwood	红杉
homicidal	有杀人嗜好的
suffering	苦楚
secondary	中级的
encephalization	脑形成
versicolor	色彩变换
surprise	令人惊讶的
suctorial	吸吮的
canned	录音的
euhemerize	以神话即历史的观点解释
momental	力矩
concerto	协奏曲
key	调节……的音调
roneo	誊写版
text	课本
multicoloured	五彩缤纷
unionize	成立工会
naysaid	反对
butterbox	巨头鹊鸭
bespectacled	带眼镜的
unifier	统一者
isolating	孤立的
inwrap	围绕……
volley	齐发
straightness	率直
anabranch	支流
privy	个人的
preaxial	中轴前的
liver	肝脏
ratable	应课税的
lay	外行的
crinite	有发状尾
repentant	后悔的
rabia	=Rabi
hrip	requiescit
geosynclinal	槽
degenerative	退化的
treason	叛国罪
misuse	虐待
unbonnet	脱帽
send	寄
quaveringly	颤音地
undirected	未受指导
mfn	Most
summerset	=somersault
metamorphose	变形
gastronomical	美食法
inquirer	探究的人
rhotic	辅音前的r全部读出
heartrending	令人心碎的
peck	吃一点点
jawboning	施工呼吁
englishism	英国风格
scrap	废弃的
laddish	稚气的
rechauffe	再煮热的剩菜
solvent	有偿付能力的
slash	猛砍
belock	锁住
postembryonal	胚后期的
superexcellent	极好的
sincipital	前顶的
rabbinate	犹太法学博士们
openmouthed	张嘴
decapitation	斩首
looby	笨蛋
backboned	有脊椎的
burnout	烧光
acceleration	加速度
positivism	确定
rhinoscopy	检鼻法
cartography	绘图法
biosafety	生物研究安全性
leukemoid	似白血病的
thiochrome	硫色素
subornative	教唆伪证罪
lacw	Aircraftwoman
brasswind	铜管乐器的
enabled	激活
hollywood	美国电影业
foresaw	foresee的过去式
blah	无聊
peccancy	犯罪
parsimony	吝啬
unimodular	幺模的
inswing	内弧线球的运动
unineme	单线的
multimegaton	有数百万吨级爆炸力的
poop	船尾
dominical	基督
divinity	神学
chiasmatypy	染色体交叉
cryptical	隐藏
serious	认真
iranian	伊朗人
barfly	常赴酒吧的人
amused	愉快
hela	海拉细胞
softly	温柔
clasp	搂抱
refer	涉及
rusty	腐蚀了的
ajutage	喷射管
motorcade	汽车行列
iscariot	叛徒
monogenist	人类同源论者
swirl	盘绕
bookrest	阅书架
shoreless	无限的
irenic	和平
lacy	花边的
spiriferous	有螺壳的
acoustic	音响学的
aeromarine	海上飞行的
stroud	粗呢衣服
overbid	过高的叫牌
underlaid	置于下面
stenotypist	速记打字员
jokul	雪山
diacritical	可区别的
pruriently	好色地
persistence	持续
inapplication	懒惰
chickabiddy	乖宝宝
shortcoming	缺点
unintelligible	无法了解的
fear	害怕
ravage	创伤
unrenewable	无法再用
hisself	=himself
tinnily	含锡地
hcl	cost
reconstituted	再造的
uncalculated	一时冲动而造成的
gmbh	mit
pee	小便
cany	藤
dr	博士
kibbutznik	集居区居民
microspore	花粉粒
unalleviated	未缓和
centrifugalize	使受离心作用
cinematic	电影
irides	彩虹
piped	拷边
excitatory	兴奋
trinitarianism	三位一体论
burdensome	繁重的
gladly	乐意地
fecaloid	粪便状的
headlike	头状的
endoergic	吸热
precambrian	前寒武纪
earthen	土制的
repulse	击退
plotz	大怒
nationalism	民族主义
fox	使变酸
levantine	早朝
woodhouse	木柴间
resedaceous	木犀草属
ratoon	截根苗
interpretive	解释的
molding	成型
theatricalism	演出法
interpolator	校对机
equalise	=equalize
aca	Accountants
silversides	银河鱼
appropriator	擅用者
splat	椅背中间纵立的长条木板
unbeliever	异教徒
adolescent	青春期
vitellogenesis	卵黄生成作用
bacteriolysis	溶菌作用
cupper	用吸器放血者
purl	漩涡
cist	古希腊时
lay	布置
maritime	海上的
angry	生气的
hindward	往后地
freeheartedness	慷慨
unknown	不知名
thecae	膜
retract	撤消
orator	原告
otp	Protocol
quercine	栎木制
remigial	飞羽的
featherlike	轻如羽毛
lycopod	石松属的植物
uninjurious	无害的
rascally	流氓
arrant	声名狼藉
quorum	法定人数
readjust	重新调整
fillip	用指弹
impugnation	指摘
nonofficeholding	下台的
hierarchy	层次
cv	computer
threaten	可能来临
sedentary	土生
reserved	保留的
actinomyces	放线菌
apospory	无孢子生殖
henwife	养鸡妇
homochromatic	单色
tetralogy	四联剧
sst	supersonic
odic	颂歌的
symmetrize	使相称
nutty	多坚果
tendencious	宣传性
unwatered	不供应水的
meaning	含意
ominously	恶兆地
acidly	心地不良地
classification	分类
digitalose	洋地黄糖
incommensurable	不能比较
unido	Nations
tosh	胡说
flinty	含燧石
unaccustomed	不平常
extradural	硬膜外的
bisection	对分
obcompressed	倒扁形的
asexually	无性生殖地
fount	墨水缸
manoeuvre	演习
monogenean	单殖吸虫
ashen	灰色
dwarf	矮子
afrikanerdom	南非白人界
denticulate	有小齿状突的
distressful	苦难重重
engraphia	印迹形成
inadvertence	漫不经心
flowerage	开花
raspy	易怒
conamore	热心
rosanna	罗赞娜
promissory	约定的
waywardly	难以捉摸
energize	给与……电压
destitute	困穷
zibet	大灵猫
rumbustiously	喧嚣地
vacuumize	抽成真空
feebleminded	精神薄弱的
paddlewheeler	明轮船
bioorganic	生物有机的
florid	华丽的
download	下载
shading	描影法
creel	捕虾篮
rhyparographic	对卑贱事物之描写的
setiform	似刺毛的
acrophony	截头表音法
unshakable	不可动摇的
technologic	工艺
benevolently	慷慨
crystallise	=crystallize
profundity	深度
potentiality	潜力
fleshless	消瘦的
gee	向右转
fastness	巩固
lagend	=lagan
pylorus	幽门部
homeward	在归途上
slovakian	斯洛伐克人
desorb	使……释放出吸收之物
spirit	热情
gatemouth	"关不住的话匣子
moratorium	延期偿付期间
uptown	在城镇非商业区
polarimetric	偏振测定的
nagged	经常遭责怪的
companionate	伙伴
gobang	五子棋
thuck	嚓声
heptachlor	n
instant	刻不容缓
canulate	中空的
nonflammable	不燃烧的
cycling	骑脚踏车兜风
diamagnetism	逆磁性
polyversity	=multiversity
oppidan	城里
nutant	下垂的
maxim	格言
dirty	下流
aurantiaceous	橙黄色
axostyle	轴杆
maximum	最高
supinely	掌心向上地
down	开阔的高地
astatki	重油燃料
gasifiable	可气化的
agrestic	乡土的
accessory	副的
subhumid	有足够雨量供草木生长的
hurt	受伤
spirit	精神
archenteric	原肠之消化道
pack	挑选
tripping	绊跌
productively	有成果
trigon	三角形
candlenut	桐实
agriology	原始人类学
overhappy	过于幸福
angry	狂暴的
cephalic	头的
alligatorfish	大西洋产的一种细长型的鱼
corticole	生于树皮上的
escarp	内壕
truer	确实
kechumaran	奇楚亚马兰语系
agrimony	龙牙草
wickiup	窝棚
hairdo	发型
heddle	综丝
usable	合用
matelot	海员
scarlet	鲜红的
imperturbed	镇静
munchausen	夸大得难以置信的冒险故事传说中的作者
disclaimatory	表示否认的
subvert	暗中破坏
spiritually	在精神上
chain	镣铐
overexertion	用力过分
preservatory	=preservative
retaliation	报复
jacobinize	改信雅各宾党人的革命思想
viale	大街
prospect	前景
convulsively	痉挛性
cacophonous	粗腔横调
attainability	所及
dragonish	凶暴的
comprehensively	包括
system	方法
hairy	多毛的
questionless	无疑的
standard	第一流
coterie	伙伴
evince	表示
definitive	最后
ichthyol	鱼油精
unromantic	平庸的
dispatch	派遣
sorefalcon	1岁的游隼
spck	Society
pinto	杂色马
ebullition	沸腾
regain	收回
puberty	青春期
submicron	亚微细粒
concourse	中央广场
persuadable	容易说服
disillusionize	使幻灭
mosul	摩苏尔
pyrostat	高温传感器
raucously	沙哑
impedimentary	阻碍
circumvolute	曲折
choirboy	少年歌者
dogleg	弯曲如狗后腿的
narcose	昏迷的
ingroup	小集团
hammam	浴室
icefall	冰崩
otorrhea	耳液溢
undependable	靠不住
connecter	连结者
orienteering	徒步横渡旷野的竞赛
militarise	军事化
islandless	无岛屿
back	背部
conspue	唾弃
goniometrical	测角
ratine	珠皮大衣呢
exclaim	大声叫
suppletory	=supplementary
monochromatic	单频
adulation	奉承
zoosperm	游动精子
underlying	优先
hatty	的昵称
fan	吹拂
muchly	长久地
unawakened	潜伏
muleteer	赶骡人
bop	殴打
hopeless	绝望
pigmentation	染色
promine	促生长素
luxurious	豪华的
dimply	有凹处
fathom	彻底了解
revaccination	再接种疫苗
xeromorphous	旱性结构的
distribution	发送
monosexual	单性别的
eyetie	=Italian
deplumate	除去羽毛
hohum	厌烦的
caster	投手
desex	使失去性能力
pitiable	可怜
frilling	皱边
rappahannock	拉帕汉诺克河
painless	无痛的
incursionary	侵略的
everyday	日常
bmta	British
lithemia	结石性血
stanislaus	斯坦尼斯洛斯
portwide	港口范围的
tumultuate	引起骚乱
sainthood	圣徒的地位
australopithecine	更新纪灵长动物
gmat	t
lawny	细麻布
austria	奥地利
contracted	契约的
compere	指挥者
sparkling	发泡
graupel	霰
stellenbosch	调离要职
will	遗嘱
dionysian	狂饮的
agrobiologist	农业生物学家
rochdale	principles罗奇代尔合作社原则
ukaea	联合王国原子能管理局
listenable	值得一听
whorfian	hypothesis
munificent	宽宏
unattainable	难到达的
newsmonger	饶舌者
hyetology	降水学
keckling	防磨卷
plutarch	希腊的历史家
podalgia	足痛
defector	背叛者
apb	向各方发出的通告
chorale	赞美诗
staminode	退化雄蕊
trump	胜过
assyrian	亚述人的
reserve	保留
nonfigurative	非形象的
ignescent	敲击而冒火的
harpsichork	大键架
snr	Noise
tallyho	呔嗬!
article	物品
maulvi	s)
discovery	发现
eusocial	完全社会性
flashiness	瞬间
flab	松弛
feign	作假
incertitude	不确定
disgustedly	厌烦
eastwardly	从东方
shock	震惊得
commandery	骑士团管理
consanguinity	亲密关系
jawlike	像下巴
desuperheat	减温
regenerative	更生
disastrously	悲惨
microform	缩微过程
seat	场所
honorable	光荣的
ahd	disease
kumbaloi	=worry
retia	网
flaked	失去知觉的
equalization	平等化
coagulant	凝结剂
humouresque	诙谐曲
cadelle	大谷盗幼虫
restitute	复原
varnish	光泽面
gnathonic	阿谀
execrative	诅咒
uricosuric	促尿酸尿的
affective	表达感情
infuscated	略带褐色的
ratbaggery	流氓派头
antipodal	正相反
huffish	不高兴
reflex	优角
jesuitical	狡猾的
gliadin	醇溶朊
sombrous	昏暗的
daiker	犹豫
anatomical	解剖
wgmc	W
ordinal	序数
sundry	各式各样
fy	year
lutrine	象水獭的
plethoric	多血症的
unplagued	未得灾祸的
twigged	有细枝的
tolerate	容忍
timbered	木造
honcho	上司
frothily	如泡
pennywort	石莲花的一种
lisping	咬舌的
testily	暴躁地
girlygirly	过于忸怩作态
accumulative	累积
psychotoxic	能引起精神病
gnomish	似侏儒的
metachrome	异染粒
prenatal	出生以前的
pantomime	演哑剧
hinder	打扰
impenitence	不知悔改
ndis	Driver
reshuffle	改组
inferable	能推论
jetboat	喷射艇
inaugurate	举行就职典礼
extraterritorial	治外法权ality/`ekstrE9teally//
glyph	字形
enchorial	古埃及人的通俗文字
immigrant	移居
classical	古典的
palm	棕榈叶
refuse	谢绝
breaker	断路器
forepale	打桩以防泥土崩落
mummery	可笑的仪式
woefully	使人痛苦的
assiduously	勤勉地
unholy	不神圣的
unaccompanied	无伴奏的
harvardian	哈佛大学的
pivot	装枢轴于
everyone	每个人
newel	楼梯上下端的栏杆支柱
cinnamonic	取自肉桂的
meclozine	美其敏
zymotechnics	发酵法
pieria	皮埃里亚
airborne	空运
deuteranomalous	绿色弱的
bowery	象亭子的
neatness	整洁
pinto	杂色
filipin	菲律宾菌素
stringless	无细绳
synergic	合作的
midpoint	中点
reproachingly	非难似
forest	御猎场
aridity	乏味
daftness	癫狂
flashlight	手电筒
disrelation	不相干
considering	考虑
gaselier	煤气吊灯
chromotype	彩色照片
baboosh	拖鞋
sectarianism	宗派主义
usurper	篡位者
frigging	受诅咒
capitalizable	资本化的
swapo	Southwest
sib	亲属的
livery	侍从
bacteric	细菌的
daemonic	似魔鬼的
worthily	可敬
eighthly	第八地
thatchy	像茅草的
pedicab	三轮车
muzz	使发呆
depletive	减少血液
obstetrical	助产的
meshy	网状的
desire	愿望
clinging	执着
verjuiced	酸的
invidiously	不公平
ransom	勒索
circumspective	细心的
uptrend	向上的
godlike	似神
cheekpiece	马勒带
pustulous	有小疙疸的
trayful	一盘
alchemistically	炼金术
zirconic	含锆的
bowery	树荫的
unmutilated	非残缺不全
goatmoth	木蠹蛾
cosmopolitan	世界主义者
crib	栅栏
wae	Enviroment
ale	淡色啤酒
fubsy	肥胖的
anabantid	热带淡水鱼的一种
aphemic	失语症
signed	有符号
chromophil	易染
fifie	旧式捕鲱小渔船
wristlock	扭曲对方手腕的一招
genuflector	曲膝者
phlebothrombosis	静脉血栓
mufti	便衣
pentameter	有五音步的
fixative	定色料
eacm	East
recruit	征募新兵
anteflexion	前屈
professional	专业人员
unpitiful	不仁慈
photoautotroph	tEf/
renature	使恢复原来属性
telegonus	忒勒戈诺斯
genially	快活地
superb	堂堂的
eia	Electronic
diamagnetic	反磁性体
unwed	没有结婚的
run	使跑
dic	Integrity
amylase	淀粉酶
silundum	硅碳刚石
spartacist	Spartacus党员
pisiform	豌豆状
cpa	Airlines
ring	回响
hydrometeor	水汽现象
acta	美国载波通信联盟
royal	高贵
flouncing	薄纱绉褶边
blunderbuss	老式的大口径短枪
noncaloric	热量极低的
vat	在大桶里处理
dairy	鸡蛋等的商店
pc	Computer
synchronological	展示同时发生
chauvinistic	盲目的爱国心的
buqsha	布格席
impervious	不受影响
fuck	他妈
excisable	应交纳货物税的
mia	action
acclimatization	环境适应性
diaphoneme	分音位
cormorant	贪婪
sib	亲属
standby	使船待命的信息
leal	诚实
flounderingly	挣扎
noninstallment	非分期付款
extremely	极端地
sexisyllabic	六个音节
watercart	洒水车
amylobarbitone	戊巴比妥
hyalographer	玻璃雕刻术
archly	主要
pentagynous	五雌蕊的
desuperheater	减温器
ferbam	福美铁
overroof	给……盖上屋顶
anking	安庆
diastolic	心脏舒张的
adlerian	阿德勒
fibroelastic	纤维弹性组织的
festive	欢乐
bathrobe	浴衣
isapi	Server
epicontinental	陆缘
rack	加以拷问
hieroglyphic	象形文字写成的文章
thickset	繁茂
introduction	入门
patter	念顺口溜
chymistry	化学
amusedly	开心
unfenced	没有篱笆
ironmould	墨水迹
ideologize	作思想分析
length	长
discursively	东拉西扯
kingship	王位
gambly	碰运气的
equicontinuous	同等连续
offset	偏移
discord	不一致
adieux	辞别
quakerish	谨严的
allness	全部
leptospira	细螺旋体
consubstantial	圣体合质耰ty//
procellous	多风暴的
elf	矮人
porterage	搬运业
autocrat	独裁者
heathery	石南丛生
suspensive	暧昧的
halfway	在中途
assumptive	假设
disastrously	悲惨地
endogenetic	内生的
hysterically	歇斯底里地
riot	骚动
antrim	安特里姆郡
striolate	具细线条的
assaultable	可攻击
forbidden	禁止的
subrent	分租租金
loutish	无礼的
homologous	相应
incoming	引入的
tsouris	麻烦事
registered	已登记
foeticide	堕胎
faience	彩釉陶器
heliograph	用日光仪传递
lack	短缺的东西
plainclothes	便衣的
ovicidal	杀卵的
finis	死
scholastic	学生
handle	触摸
downfall	衰败
omber	三人玩的奥伯尔牌戏
nidamental	生卵膜的
capitular	牧师会
canned	罐装的
spectrobolometer	分光测热计
elusory	难以捉摸
excursion	离题
wandering	徘徊
principial	最初
microsporogenesis	小孢子发生
term	术语
streamy	多河流
denitrify	除氮化物
hundredthly	第一百个
fat	油腻的
holohedral	全对称晶形
aestivate	过夏季
cusp	尖头
imperfectible	不可能完美
balefire	野火
artificer	技术兵
hydrodesulphurization	加氢脱硫
concernful	重要
pride	傲慢
atingle	兴奋的
garibaldian	加里波第的
achromatic	消色差的
corrupt	误用的
lymphatolysis	淋巴组织破坏
accustomed	习惯
pigeonhole	归档
ethyl	乙烷基
irresolution	优柔寡断
consummately	完成
contiguous	毗边
instigation	教唆
course	过程
exhibit	展品
curbing	边石的材料
labroid	咽颌类的鱼
sclerotic	硬化
completeness	完全
frowsty	肮脏的
diazine	磺安剂
muzzy	头脑发昏的
prey	折磨
slack	软弱
thickset	粗短
incontinent	荒淫的
rummage	搜出
christendom	基督教徒基督教界
reconcilable	可和解
mortify	使苦恼
inshore	沿海岸的
eblan	=Eblaite
phytolaccaceous	商陆科
juggins	蠢货
unfluctuating	稳定
kabyle	卡拜尔人
composedly	从容
unconfirmed	未经证实
subdrainage	地下排水系统
trappean	玄武岩质
aubade	晨歌
synthetist	合成者
integumentary	包皮
harmonistic	调和
consort	陪伴
ameliorate	改进
protracted	拖延的
invincible	无敌的
unleavened	未经发酵
pessimistically	悲观
antientertainment	反传统的娱乐
aerobiology	空气生物学
secretary	大臣
vitriolic	刻薄的
nauch	=nautch
millcake	亚麻籽饼
quizzery	试题集
porism	系论
trophy	战利品
political	行政上
charismatic	神赐能力的
wud	疯狂
chill	变冷
monoglot	使用单一语言
slalom	障碍滑雪
jolthead	笨人
motorable	可行驶汽车的
degenerative	退步的
holder	占有者
galvanoplasty	电版术
gentle	温和
cop	巡警
dislikable	使人厌恶
optimal	最佳的
canonize	封……死者为圣徒
unwary	易受骗的
footrace	步行竞赛
nonenzyme	非酶
fuzznuts	讨厌鬼
photoscanner	摄影扫描器
vitally	生死攸关
dilettantish	浅薄的
setting	安置
command	博得
hexaemeric	创世之六日
sycophancy	拍马屁
radicalness	激进
keystroke	键击
facilely	轻易地
echinodermatous	棘皮类的
gynaecoid	女性
acgb	of
sick	厌恶的
haematin	氧化苏木景
aerogramme	无线电报
zowie	呦
ruthenious	亚钌的
send	打发
eric	Resources
philtre	春药
mcluhanesque	麦克卢恩
coachwhip	马鞭
pronominal	代名词的
recalcitrant	反抗
coulee	熔岩流
brenner	Pass勃伦纳山口
kieserite	硫酸镁石
easement	舒适
malta	马耳他
marshall	=marshal
fiat	命令
cheery	愉快
macrophotography	宏观摄影
saucisson	粗红肠
trichomata	倒睫
iaa	indoleacetic
holotypic	正模标本
nineteenth	十九分之一
residua	残留物
westralian	西澳大利亚人
oas	办公自动化系统
jodie	平民男子
boondocks	森林地带
vole	全胜
sacramentalism	圣礼主义
clearer	更清楚
privately	私下
tercom	contour
show	出示
droppable	适于投下
thingification	=reification
cigarette	香烟
neighborless	无邻居的
lymphoblastic	淋巴母细菌的
phrenologic	骨相学的
lugsail	后缘长的四角纵帆
gripe	使肠痛
oleic	自由采取的
friended	有朋友陪伴的
revaccination	再种痘
phalanx	趾骨
senor	先生
oily	油腔滑调的
tcheka	=Cheka
undertake	承担
nickpoint	=knickpoint
handcraft	手艺
fidelity	忠实
quad	在……填补空铅
coastward	向海岸
goutweed	羊角芹
puristic	用语简洁的
cultivated	栽植
benthonic	湖底
unkink	除去……的纠结
protect	保护
strychninize	对……施用士的宁
eta	希腊语字母的第七字
habilimented	衣着整齐的
forest	林木
favorably	好意地
mongoloid	象蒙古人的
hypobenthos	深海生物
alcoholize	浸入酒精
spoony	轻佻的情人
succose	多汁的
waltz	华尔兹舞曲的
attempt	努力
loud	不断
matchboard	企口板
recessional	议会休会
supposed	假定的
desacralize	使世俗化
pollen	传授花粉给
homochromatism	单色
ablare	喧闹的
extendible	可伸长的
inadequately	不适当地
timid	胆小的
frieda	弗里达
pronate	伏身
tritiated	用氚示踪
danaus	丹尼亚斯
whitewash	白粉胶泥水
allotee	受分配的人
pedigree	血统
cmd	Charge
xanthippe	悍妇
cessionary	受让人
test	试验
guinzo	=ginzo
planetesimal	星子组成的
escalation	扩大
rising	上升
jotunnheimr	巨人之家
doghole	龌龊的房间
lustily	强壮
competently	适合
philotechnical	爱好工艺
circumambience	环绕
enuresis	遗尿
gynecomastia	=gynaecomastia
adiaphorism	不置可否论
democratic	平民
disturbingly	令人不安地
tonality	色调
genuine	真实的
prague	布拉格
temper	回火、锻炼
subfossil	亚化石
heldentenor	英雄男高音
dangerous	危险的
demarch	市长
smooth	烫平
coot	黑鸭
prevoyance	预见
apt	灵巧
zoolatrous	动物崇拜
undemonstrable	无法证明的
machining	加工
malpighia	金虎尾科的
pester	使烦恼
nawab	印度行政长官
unqualified	不合格
brandy	白兰地酒
outhouse	外屋
demisable	可遗赠
identically	同一
vrouw	妻子
pushmobile	手推玩具汽车
autobiographic	自传
echinated	有刺毛的
ropiness	成粘性的丝
smooth	平滑部分
unreflecting	不反省
checkup	审查
sarracenia	瓶子草
hingeless	无铰链的
tobacco	烟草制品
brutalist	野兽派
potable	适于饮用
comparative	比较
coliform	大肠菌
blindfold	盲目的
prawn	明虾
histophysiological	lEdVI/
msdn	Network
rabat	黑色胸带
palazzos	pants
endemic	风土的
cant	黑话
smithwork	锻工活
acmeist	阿克梅派诗人
gers	热尔省
unwittingly	不知情
latvian	拉脱维亚人的
medic	=medick苜蓿属植物
penitentiary	忏悔
ultimacy	终极性
chemigraphic	化学镌版术
yamato	日本人的祖先
appositeness	适切
petitory	提出所有权要求的
barefaced	不戴面具的
spectrally	可怕地
landwehr	后备军人
festucine	浅黄色的
gular	咽喉的
merlin	灰背隼
memberless	无会员
born	天生就……
baccate	浆果状的
curassow	大鸟
shinleaf	鹿蹄草
terebic	芸香酸的
laryngitic	喉炎的
pentaerythritol	季戊四醇
superstrength	极大的力量
psychotic	精神病
quinine	奎宁
croquis	略图
isotropism	=isotropy
bloodworm	红蚯蚓
tempt	引诱
tackling	抱住
phatic	交流感情的
matriculate	被录取入学
combo	结合物
knavishly	不正
shh	shew
convincing	令人信服
sepaline	=sepaloid
scout	侦察员
cheering	令人高兴
extension	延长
clairaudient	听力特别敏感者
overfull	太满
grey	灰色
tailing	嵌入墙中砖石突出部
unhasty	不急躁的
transoceanic	横越海洋的
economizer	节约者
outmaneuvre	以机动性胜过
thresher	长尾鲨
trilocular	三室
plimsolls	橡胶底帆布鞋
accostable	易接近
scurvy	无礼的
purchaseless	无紧缠力
mabe	of
constrictor	括约肌
vigorously	精神旺盛
postbase	派生后缀
billiardist	打弹子者
corriedale	考力代羊
situate	使位于
gristmill	磨坊
zealotry	狂热行为
skirt	裙子
foully	卑鄙地
labour	与工党有关的
sap	使排出体液
tombstone	墓石
available	接受探访的
roadworthy	适合道路上使用的
crackbrained	颠狂的
wrb	战时难民事务委员会
cramp	抽筋
swbw	southwest
glucinium	铍
remanent	残余
rarity	稀有
unsharp	钝
roadlessness	无路
positive	绝对的
spoondrift	浪涛飞沫
excerpt	引用
event	事件
prosodical	作诗法
aclu	Civil
trifolium	三叶草
unassuaged	未得满足的
pumiceous	轻石的
divine	非凡的
hinoki	cypress
traditionary	世袭
circuit	电路
exsiccate	使干燥
vivific	使生动
autotelic	自己本身具有目的的
hexylic	己基
transpositive	移调的
battlewise	身经百战
snick	刻痕
suspension	延迟
godlike	与神相称的
chromatid	染色单体
housebreaking	侵入家宅
recrementitious	垃圾造成
behave	运转
riotous	狂欢的
recover	使改过
homonymy	同名
obstructive	阻碍
sustain	维持
cilia	纤毛
mattins	晨祷
spheroidic	类似球体的
deliberate	预有准备
stuporous	昏迷的
vibration	摇动
sabbatize	守安息
unexpired	未终止的
notably	显著地
desultory	不连贯的
resting	休眠的
outlain	outlie的过去分词
print	印刷
urea	尿素
checkweighman	代表矿工确认矿方所秤矿重的人
revelation	揭示
bastile	城堡
faint	软弱的
anuric	无尿
chancre	下疳
mcmlxxxiv	罗马数字
bia	Internet
suffering	患病
swarthy	浅黑的
overentreat	以恳求把……争取到自己一边
climactic	顶点
mairie	镇公所
bovine	牛
tempi	发展速度
gracious	亲切的
recordist	录音员
arsenical	含砒素的
alkalimetry	碱测定法
stale	陈旧
binuclear	=binucleate
beefcakery	展示男性健美的摄影
jovial	愉快的
overflow	充满
nematocidal	杀线虫
incoagulable	无法凝固的
bureau	办公署
unco	陌生
rostrum	讲坛
navigation	航空
diphonemic	双音素
iata	Air
wysbygi	Get
manifestation	表现
odalisque	婢妾
expect	指望
bagworm	结草虫
toxicologically	毒物学地
scatter	散开
blackguardly	粗鄙的
bureau	办公桌
bitartrate	酒石酸氢盐
eastwards	东方
flyover	n飞机编队低空飞行
locrian	洛克里斯人
corona	冠壮物
fee	费
achaean	希腊人
stilly	寂静
irretraceable	不能回头的
kist	史前之石柜
vouvray	沃莱白葡萄酒
par	票面
amebic	变形虫的
medusa	水母体
phonometer	测音器
courage	精神
transfixion	刺穿
switch	转变
harmonic	融洽
antisabbatarian	反对守安息日
telephonic	用电话传送
homoeothermic	温血的
barbacan	碉堡或其他类似的防御工事
solvent	有溶解力
wash	弄湿
brucella	布鲁氏菌
onychomycosis	甲真菌病
crackbrained	精神错乱的
tannic	自鞣革
sadie	赛迪
prompting	提示
trimness	整顿
climatically	风土上
cement	用水泥涂
nurture	教育
pessimism	悲观主义
unweave	拆
resume	重新占用
logos	与神同一的道
blocky	斑驳的
grappa	格拉巴酒
postliterate	文字后
revictualment	再补给
sclerosing	硬化型
steak	肉
taal	塔尔语
pintoresque	似画
blusterous	咆哮的
seafarer	航海家
ada	ADA编程语言
candidly	率直
noncommunicant	不做礼拜的人
edict	布告
heartsick	悲痛
malaguena	地方的舞蹈
quadrilled	形成许多大小相同的方格的
yeomanry	自由民
blueing	带青色的
cottonpicking	收棉花
tonsillitis	扁桃腺炎
unnoted	不引人注意的
acclivity	向上的斜坡
feature	特色
embranchment	支流
osteal	侵袭骨的
exposure	位向
springboard	跳板
photoshp'	NULL)
repose	休息
piratical	剽窃的
astrosphere	地核
abscondence	逃亡
unrepulsive	不可憎
shunless	避不开
relation	叙述
elementary	元素的
subjoin	增补
blastomere	分裂球
ventricle	心室
fatherland	祖国
sebacic	由癸二酸衍生的
rics	Surveyors
unmethodical	无顺序
sacral	祭典
hucksteress	女叫卖贩子
beltane	古凯尔特族的五朔节
mycophilic	喜欢蘑菇
acinaciform	弯刀状的
eolian	风的
lounder	狠狠地打
sagacity	睿智
deranged	疯狂
snickersnee	短刀
soldierlike	雄纠纠的
cornish	康沃尔人
rave	咆哮
doomful	充满厄运的
trivially	很一般
abbeystead	修道院所在
windhover	茶隼
misascription	归因不当
dawk	驿站马车
slumbercoach	经济卧铺车厢
captainship	首领或队长之职
slim	细长
handwrite	用手写
sericite	绢云母
disoperative	侵害的
theftuous	=thievish
camelback	骑在骆驼背上的
tickicide	杀蜱药
atavistic	隔代遗传的
banaban	巴纳巴岛人
decimally	用十进制
indicative	指示
retirement	撤退
disturbedly	被打扰地
stockbroker	股票经纪人
copremia	毒毒血症
unshrinking	坚定
conciliate	安慰
aficionado	迷
grisliness	严重
uncannily	惊异地
mart	商业中心
pupillary	瞳孔
snafu	一时的混乱
porphyrise	=porphyrize
vestige	残余
adulate	奉承
touchstone	标准
anharmonic	不调和的
liquescent	易液化的
philological	语言学
start	着手
aproposity	适当
flow	流程
savourily	有滋味
orator	演讲者
illusory	不牢靠
kettle	壶
antewar	战争前的
underabundant	不够丰富的
bottine	半长靴
indirect	间接的
rebellion	不服从
while	当……的时候
thriller	使人毛骨悚然的小说
poohed	疲倦的
hammer	锤打
crinite	有长软毛
photoflash	照相闪光灯的
neorealist	新实在论
errantry	游侠行为
titanic	四价钛的
organosilicon	有机硅的
push	推
feme	妇女
hyperphysically	超肉体
vomiturition	干呕
tot	总计
metrics	作诗法
pietism	假装虔诚
zurich	苏黎世
fantabulous	极出色的
chert	燧石
mildew	霉
redear	红耳鳞鳃太阳鱼
unqualified	不合格的
ctol	常规起落
unbarbered	未修面的
saucerize	对施碟形手术
impenetrability	深奥
incendive	引火的
telecommunication	电ion
posteriorly	其次地
shoresman	陆上业务人员
stylebook	样本
breaking	破坏
plumy	用羽毛装饰
matin	晨歌
fray	磨损处
gloat	心满意足
endothelioid	内皮状
unrwa	United
booking	预约
allocable	可拨出的
encapsule	做成囊状
ccpit	of
vizir	高官
myth	神话式的人物
vdc	Defence
alvan	阿尔万
funipendulous	悬在绳上
unrhymed	无韵
sepal	萼片
rageful	狂怒的
hepatogenous	由肝产生的
pharmacy	一批备用药品
apyretic	不发热
sparklingly	闪烁
constate	确定
ndea	Defense
guggenheim	fellowship
photoheliograph	太阳
brutality	野蛮的行为
cowhouse	牛房
expositive	评注
professorate	全体教授
diapsid	双窝型
indicatory	指示
ursine	熊
journal	杂志
cytokinin	细胞分裂素
rubrical	朱色
glycogenase	肝淀粉酵素
invocatory	祈愿
unbodied	无实体
oncornavirus	致肿瘤RNA病毒
nardoo	一种苹属植物
ictus	强音
am	是
fm	Micronesia
unific	倾向于联合的
chronically	慢性
chengchow	见Zhengzhou
above	上文的
quebracho	白坚木
perceptible	感觉得到的
stub	连根拔除
panurge	巴汝奇
kilderkin	小桶或其液量
repair	纠正
cameral	有关立法或司法机构之一院
lunisolar	日与月
wearily	无聊地
tamarugo	塔马鲁戈牧豆树
glossotomy	舌切开术
superacid	太酸
xl	特大号
terra	土
panic	惊慌
carport	车棚
repurchase	重新买
firstcomer	最先来者
viale	宽阔街道
altricial	晚成雏
noncommissioned	未经任命
tisiphone	底西福涅
polytheism	多神论
eidograph	缩放绘图仪
prolepsis	预期
radula	齿舌
ethnohistory	人种史学
stagnantly	萧条
deductible	可扣除的
qaranc	亚历山德拉王后皇家陆军护理队
agatize	使化成玛瑙
corroboration	使确实
dossy	好看的
traditionary	传统
chainless	无链的
interlocutory	中间的
possession	着迷
barolo	巴罗洛葡萄酒
authentically	真正
wad	以软物衬填
kroon	克鲁恩
elegantly	优致地
jib	船首三角帆
histiocytic	组织细胞
induce	导致
forgivable	可宽恕的
homochrome	=homochromatic
disenablement	使不能
delustering	去光法
undynamic	精力不够的
docile	驯良
fecit	……作
subzone	亚地区
maebashi	前桥
ticker	滴答响的东西
dud	无用
ataractic	镇静剂
polydirectional	多向性的
glaring	耀眼的
cogent	强有力
womanize	玩女人
excess	过度的
coprological	热衷于色情文学的
cruck	曲木
marburg	disease马尔堡病
basket	篮
simplicity	朴素
dravidic	=Dravidian
seggie	=seg
houseroom	家里的收容能量
roughwrought	经粗加工的
province	省
precipitate	使陷入
barefaced	公然的
electrohorticulture	电气化园艺
czechoslovak	捷克斯洛伐克人
cobwebby	蛛网似
stainless	纯洁
podsolization	=podzolization
postcranial	颅后的
wrapping	包装用
upland	山
destruct	故意或有计划的破坏
fourpenny	价值四便士之英国银币
gentleman	阁下
unsharp	不锐利
diabolic	残忍
conglutinant	粘合
explainable	可解说的
backhanded	反手拍击
jayhawking	盗窃
inequilaterally	不等边地
swansdown	天鹅的绒毛
presession	会议前
storiology	传说学
humorously	幽默
castalian	灵感源泉
defaecate	澄清
doorstep	门阶
spanker	疾走后桅纵帆
copperskin	美国印第安人
tab	短小突出部
quatercentenary	400周年纪念的
broking	掮客业
prevailing	占优势
provencal	普罗旺斯
fidelity	保真度
presurgical	手术前
anode	正极
antidromic	逆行
revolve	旋转
neurocirculatory	神经循环系统的
syllabize	分成各个音节
skylon	云霄塔
kogai	公害
aseismatic	耐震的
monosabio	斗牛士助手
ennyyee	倦怠
uneffectual	=ineffectual
stammer	结巴着说出
japanophile	亲日派
pathetically	哀婉动人
determinatum	受限定部分
ladykin	小女人
tess	泰丝
ymodem	一种文件传输协议
oxaloacetate	草酰乙酸盐
conquistador	征服者
impulsively	有推动力
retractor	牵引器
kebob	=kabob
articulatory	分节
gamester	赌棍
tunny	金枪鱼
festilogy	基督教会节日论文
ratheripe	早生
tog	给穿上
unvitiated	纯洁的
unretarded	未推迟
retinoscope	视网膜镜
running	赛跑的
edwin	男子名
erectly	直立地
gowster	吸大麻的人
nye	=nide
catch	捕捉
findable	可发现
blueprint	制成蓝图
isotherm	等温线
antennal	触角
propellant	推进
whiteout	因暴露于恶劣环境而引起的临时性失明
telephony	电话
