verandah	阳台
sestertius	=sesterce
unacquirable	不可占有
pasticheur	集成曲作者
striated	有条纹
monocephalous	具单头状花序
dbms	System
unwell	有病
dpl	diplomat
wood	木头
motorial	运动的
exemplary	可仿效
petulancy	性急
godwards	对神
nonreturnable	不能退给卖主
semiparasitic	半寄生的
teller	告诉的人
vacuum	产生真空的
timeout	工间休息
excitated	激发
unprescribed	非规定
isohume	等温度线
gag	欺骗
rockbound	多岩石的
leontiasis	狮面
indignant	愤怒的
mutability	易变性
suitably	相称
journalism	报章杂志
upbeat	兴旺
xylophagous	蚀木穿孔的
ridgelike	脊状
paddler	涉泥浆者
magnolia	木兰
anemic	贫血
fluxionary	不定的
scrappy	细小的
recognized	经过验证的
kara	Sea喀拉海
collectedly	冷静
chernozem	黑钙土
ouzo	希腊产的饭后酒之一种
tableau	生动的场面
newsstand	报摊
remex	飞羽
raving	语无伦次的
idiomorphic	整形的
peridiole	小包
buffoon	小丑
psychognosis	心理诊断术
laic	俗人的
incursive	侵入的
acrid	刻薄
percept	知觉的对象
organizable	可变为有机体的
glycose	葡萄糖
acantha	脊椎
comprehensively	包括地
farmyard	农场建筑物周围的空地
shunless	回避不了
sextuple	变成六倍
misandry	对男性之厌恶
disrespect	无礼
humiliate	使丢脸
safedeposit	贵重物品保管设备
hairtician	高级理发师
thitherwards	向那边
debouchment	走出
yeo	=yo
viatic	旅行的
sulfadiazine	磺胺嘧啶
triboelectric	静电的
anergy	无反应力
onus	负担
barostat	恒压器
mirepoix	植物性调味香料
absorptiometer	溶气汁
unharmed	太太平平的
benthon	底栖生物
jawbone	信用
brantail	欧洲红尾鸲
polliwog	蝌蚪
interoperability	合作共事型ぷ鞯哪芰
collectorship	收集
guttersnipe	流浪儿
bonnily	美丽地
presentence	宣判前的
zigzag	蜿蜒曲折
pulverous	满是粉的
isotac	同时解冻线
errata	正误表
radiator	冷却器
scyphistoma	钵口幼虫
intrusion	侵扰
unhip	不符合集团其他成员所遵循的习俗
soot	用煤烟弄脏
knobstick	工贼
atonicity	弛缓
mpp	Parallel
chloroacetic	氯乙酸的
nippy	刺骨
eva	太空人在飞船外的活动
sthenic	精力旺盛
cotillion	沙龙舞
unwell	有病的
aseasonal	四季可用
granitiform	花岗岩状的
fastuously	高傲地
asphyxial	窒息的
lactide	交酯
ballooning	气球操纵
idyll	田园诗
puruloid	脓样的
illusionless	无幻觉的
aethereally	轻飘
atheromatosis	动脉粥样化症
univalent	单价染色体的
thermit	灼热剂
screaming	令人惊愕的
loculus	房
snorter	发出噪音的东西
forementioned	前述的
carragheenin	=carrageenan
dactylic	长短格
chandleress	女杂货商
ophidian	蛇类
behindhand	耽误
laryngoscopy	喉镜检查
moony	月亮的
microprojection	显微映象
triclinic	三斜晶系的
aconitine	乌头碱
volcanically	猛烈
flowing	流畅的
roil	煽动
obcordate	倒心形的
hague	海牙
mooneye	月盲症
subversive	破坏性的
plank	厚木板
timbul	铜鼓
extricable	可解救的
homegrown	自家种植
quell	镇压
flagging	铺砌石板
bur	粘附物
xuthus	苏托斯
liable	很有可能
assyriologist	亚述专家
laloplegia	言语器肌麻痹
azo	含氮的
duodecimal	十二为单位的
encroach	界线
mathematician	数学家
town	城镇
degradative	使下降
avventurina	chance
zacharias	撒迦利亚
iaaf	Federation
drum	打鼓奏
ginza	银座
flexuose	曲折
crick	肌肉抽筋
blighted	毁灭
molecular	由分子组成的
upbeat	弱拍
make	前进
set	规定的
inesculent	不可吃的
cemetery	墓地
fungal	真菌的
stagehand	舞台管理
claimsman	意外险的调查员
rascally	流氓的
caravansarai	商队旅馆
introduce	传入
seminary	学院
calciferol	钙化醇
supposititious	冒充
extrahepatic	肝外的
shenzhen	深圳
khanate	可汗的地位
arciform	弓形的
sublime	卓越的
septennium	七年期
technologically	科技
griddle	矿筛
luminarist	用色鲜明的画家
denucleate	除去的核
disestablishmentarian	主张政教分离找对教会不予承认论/
vapour	水蒸气
apology	道歉
zoophilic	爱护动物的
labile	不安定的
tremella	白木耳
aciduria	酸尿
details	详细资料
archiepiscopacy	大主教的管辖
print	印迹
republicanize	使成共和国
shivery	易碎成片状的
diabolatry	魔鬼崇拜
costectomy	肋骨切除术
great	大的
unpunctuated	缺标点的
meticulous	小心翼翼
skip	蹦
genevra	吉纳夫拉
vagarious	异想天开的
fortunebook	命书
vpd	or
marginal	边缘
sparerib	小排骨
libraire	书商
lich	尸体
confusable	易被混淆的
most	十分
pullout	离去
murky	黑暗
tapioca	木薯粉
sacking	制袋子用的粗麻布
unconfirmed	未经认可的
poop	真实的消息
electrolyte	电解液
stitch	缝
raptured	狂喜的
resumptively	概括地
woozy	虚弱
dnp	dinitrophenol
succulently	多汁
faultfinding	吹毛求疵
true	真实
disengaged	自由的
disestablishmentarian	主张政教分离的
expand	张开
abstinence	戒酒
iupap	International
autarchic	独裁的
yowl	吼声
man	为……配备人手
engineman	火车司机或其助手
restauratrice	饭店女老板
dun	暗褐色
gloomy	阴郁
atomization	雾化
unimpugned	未被指责
mspe	of
consummative	使最终得以实现
foa	Administration援外事务管理署
gioconda	蒙娜丽莎的肖像画
juge	法官
editorial	主笔的
caste	社会等级制度
electropositive	阳性
nonprescription	未经医生处方可以买到的
trimly	整洁地
piperidine	哌啶
sunlike	太阳似的
foamy	起泡沫
terribly	可怕地
subthreshold	低于最低限度的
demonstrator	指示者
unep	Programme
dullard	笨蛋
arthrospore	分节孢子
abracadabra	咒语
bacteric	细菌
garlandry	花环状装饰品
downlink	下行线
caenozoic	新生界的
heteronuclear	异核核糖核酸
twu	Workers
cayenne	辣椒
caliginous	朦胧的
eduction	引出
outworn	废弃
puzzling	使迷惑的
spheroid	球状体
hypothenar	小鱼际的
lanner	其雌鹰
harshen	使荒凉
belgium	比利时
eyestrings	眼腱
pitchometer	螺距规
said	上述
economy	经济实惠
unnecessaries	非必需品
curtail	减少
mallow	锦葵属植物
authenticity	真实性
blaff	烩鱼汤
imaginal	想象
asthma	哮喘
flagged	不能再喝的
compulsive	禁不住
slingman	使用投石环索者
fluviometer	河川水位测量器
apostate	脱党者
defeatist	失败主义者
theorbo	琵琶的一种
glossarial	字辞注解的
matchmaking	做媒
faker	摊贩
uteri	uterus的复数
hassidism	=Hasidism
camphor	樟脑
mass	群众的
usga	States
run	run的过去式和过去分词
helve	柄
incorrect	不正确
secondhand	用旧货
pressburg	=Bratislava
distress	使悲痛
sportfishing	从事垂钓的
dewy	如露的
depressing	抑压
rustily	声音沙哑
assistantship	研究生助教奖学金
hoverpad	气垫船的金属底板
velvety	柔软
runic	古代北欧文字的
aquicultural	溶液培养
retire	退却
melodic	有旋律
follicular	滤泡的
restrictivist	限制
firry	多枞树
hemispheroidal	半球体
undulated	波形
louver	天窗
robustious	粗鲁
ratable	按比例的
eversible	可翻转
afterlife	后半生
crocean	克罗齐的
one	一个人
swabian	斯瓦比亚人的
inconsequence	不合适
whiskers	腮须
incoherently	无条理
twisty	狡猾的
tridimensional	三度
hide	痛打
cultipack	用碎土镇压器击碎土块并压实
hypnotic	易被催眠的
complication	并发症
khrushchev	赫鲁晓夫
discussible	可讨论
laryngeal	喉部
imputation	诋毁
cuspidate	尖端
physiographer	地形学者
unsophisticate	不懂世/
nonpasserine	非雀形目的
deamination	去氨基
vixen	刁妇
medley	拼凑的
wry	歪曲的
apprehensible	可了解
neighborly	睦邻
sheerly	完全地
mistiness	模糊
matron	保姆
changeably	不稳定地
supermanly	超人特有的
galley	船上厨房
workbasket	工具袋
unequalable	比不上的
yaf	美国青年争取自由组织
inviolable	神圣
muddily	污浊
healthy	有益于健康
barkeep	酒吧间招待
baragnosis	重觉丧失
harbourless	无港
embay	使入湾
gantry	构台
convoy	护卫
grunge	乏味的东西
pie	杂乱
sodomite	口交者
perivascular	血管周的
martially	勇敢地
unconsciousness	无意识
dews	distant
nonchromosomal	不以染色体遗传特质
councilman	市议会议员
preproduction	试生产
tumult	吵闹
executive	执行的
fabian	拖延时间
revelator	揭发者
corrosion	腐蚀状态
rumble	辘辘声
disrupture	=disrupt
monotype	单型
trelliswork	格子细工
gaia	=Gaea
micromodule	微型组件
adipose	脂肪的
busses	汽车
capacity	智能
mucosity	粘性
bibliokleptomania	盗书癖
doa	到达前死亡
stop	停止
shaver	修面的人
malapropos	不合时宜的
bicephalous	两头的
outlive	经受住
ccco	Central
plasticizer	可塑剂
apertured	有洞的
fatso	胖家伙
aiff	Audio
mythoi	mythos
flit	飞来飞去
circumspectly	留心
felspathic	像长石的
gadgeteering	精巧机件的发明
dishwatery	乏味的
clathrate	窗格形的
asphaltum	柏油
diagnostician	诊断专家
epee	重剑
proverbs	箴言篇
primordia	的复数
electropaint	电涂
refrigeration	冷却
withy	瘦长而结实
rosery	玫瑰花坛
psychoprison	重精神病院
bedfellow	同床者
geoscience	地球科学
matriclinous	偏母性状
brimless	无边缘
retrieval	重获
athrocytosis	细胞摄物作用
random	胡乱的
complexioned	脸色……的
outlandish	古怪的
gat	的过去式
lawbreaking	违反法律
gimp	用辫带装饰
desulfur	除去硫磺
certiorari	诉讼文件移送命令
feelingless	无感情
seize	查封
delphic	意义不明确的
weasel	抽掉的含义
fed	一种显示技术
counteropening	对侧切口
autarchy	专制
chainbelt	链带
haybag	娘们
practician	熟练者
pki	Infrastructure
ethnic	人种
arthrodic	滑动关节
unjustifiable	不能分辩
aeolic	伊欧里斯
lithotomy	切石术
impeachable	可弹劾
binal	两倍
captious	吹毛求疵
rics	Royal
ratable	应课税
fly	两翼昆虫
disinvite	取消对……之邀请
orange	桔
interlibrary	馆际的
klunky	破旧
champleve	雕刻后填上油漆的
spue	吐出
remonstrator	忠告者
tiptop	非常好
channel	水道
dynastic	朝代
polyandric	一妻多夫的
ringway	road
autoplastic	自体移植的
applicatively	可适用地
crackpot	不切实际
cookie	一种网络服务器传递给浏览器的信息
offensively	讨厌地
elaborate	详细描述
above	在上面
reactionism	反动思想
vegete	健康
preoral	口前的
fecaloid	似渣滓
molelike	似鼹鼠的
exasperater	触怒他人者
artwork	美术品
salimeter	重计
retiform	有交叉线的
somatology	比较体格学
handled	有把手的
phantasmagory	=phantasmagoria
collectivist	集体主义者
withy	瘦长而结实的
mineralogy	矿物学
orator	演说者
sheep	绵羊
inhomogenous	不均一的
fin	露鳍于水面
bilicyanin	胆花青素
diplomatic	外交的
etcetera	等等
sheerhulk	立桅起重船
augmented	扩张
legitimization	合法化
commeasure	可与……相比
ululant	呜呜叫
regather	再聚集
style	设计
candlewood	作火炬用的烛材
expedition	远征
clutter	混乱
vexillary	旗手
conclusive	最后的
waterhead	水坝拦住的水
exorability	容易说服
liveware	活件
pwd	公共工程处
strum	乱弹的声音
primy	在最佳期的
transgress	违法
smacking	发出响声的
laceration	破口
plowland	可耕地
thermolabile	热不稳定的
naggish	有点爱唠叨的
dumortierite	蓝线石
impressive	给人深刻印象的
seduce	诱使
dibbuk	=dybbuk
toughly	固执
unwilled	非自愿的
quakerbird	信天翁
sporangium	孢子囊
crate	板条箱
ho	表示惊讶
zombie	巫毒崇拜
speedlight	电子闪光
proteinic	蛋白质
sottish	愚蠢
softly	温柔地
globalism	全球主义
dimethylmethane	丙烷
partner	当助手
antedate	提早日期
stodge	使填饱
leftist	左翼
xerantic	使干燥的
tannic	丹宁的
mesozoic	中生代的
monthly	月刊
caledonian	古苏格兰人
sacerdotal	祭司制度的
monophthong	单元音
turbulency	动乱
nondisjunction	不分离
nob	打头
retract	缩进
consent	答应
firmer	坚固
bonded	存入保税仓库
page	专栏
distinct	截然不同
ruridecanal	乡村教区司铎的
sidewipe	=sideswipe
puling	哀鸣的
djinni	=jinni
archegone	=archegonium
enamel	涂以瓷釉
telepathize	心灵感应
androcentric	以男性为主的
somnifacient	安眠药
preaching	讲道
medicine	内科学
kaif	精神恍惚
orionid	猎户座流星
lowest	最底下的
guianese	圭亚那人
yokelish	乡土
surgically	如外科手术般
unoiled	未上油的
calculous	结石症的
aldehyde	醛
bloom	繁盛
nurseling	奶妈养育的婴幼儿
tinge	些微气味
dnf	not
rigescent	僵化
digamist	再婚者
observer	观测者
prejob	就业前
assessee	财产价值已被估定之人
flecklessly	完美地
lizbeth	莉兹白
drive	快车道
oilily	圆滑
monophyletic	单源
earthborn	会死
forebode	预兆
diamondback	有菱形斑纹的
illegitimation	认为不法
clx	最高潮
luminaire	光源
preface	写前言
postpose	用在后面
vintage	洒的
cover	保护
residual	剩余
posttraumatic	外伤后的
swagger	吓唬
desiccative	去湿
nbs	National
entomological	昆虫学
longhair	长毛猫
confutation	驳住
sycophantic	阿谀
topgallant	最佳的
iffy	不确定的
pingo	小丘
xenotropic	向异的
canorous	音调优美的
orotund	洪亮
encyclopedic	如百科辞典的
oppugnant	反对的
sile	滑下
oedipus	俄狄浦斯
multimode	多状态
crookery	欺骗
unobjectionable	难反对的
shuttle	穿梭
unlock	显露
decamp	撤营
impayable	无法清偿
whopping	庞大的
cyclo	出租机动三轮车
cyathiform	杯形
normalization	标准化
lesbianism	女性同性恋关系
gownsman	法官
against	反对
homefelt	痛切感到的
salvationist	救世军军人
novel	新奇的
refer	使求助于
conservative	保守的
wonder	奇迹
overdare	使失去勇气
misprise	蔑视
triangulate	分成三角形
segregation	种族隔离
lithophagous	食石
unsightly	不好看
tedious	冗长乏味的
rodster	钓鱼者
kindle	煽动
talbot	塔尔博特提猎狗
afl	of
prag	=Prague
incontrollable	不能控制
blunder	大错
dockside	坞边
equipped	整装
staple	主要产品
untruthful	爱说谎的
lissu	=Lisu
recompose	重新安排
nodulate	生根瘤
eyesome	可爱的
obtrusively	冒失
acetylco	acetyl
ast	美国虹志公司
otiose	没有用
singly	逐一地
caterwauling	猫叫春声
decease	死亡
padang	巴东
allochthonous	外来的
triangular	三人间
vigorous	有力
tuffaceous	凝灰岩
hindermost	最后面的
harvest	成果
spareness	缺乏
greet	映入眼帘
chalkrail	黑板下方的粉笔槽
rhodo	杜鹃花
hyetometer	雨量器
offhanded	即席的
ringdove	斑鸠
mdccclxxxviii	1888
unleavened	未经发酵的
upwhirl	向上旋转
weal	鞭痕
wastry	浪费
careerism	野心
forethoughtful	深谋远虑ness//
dps	Data
tiderip	潮激浪
leadswinging	躲避工作
fleshcolor	肉色
copycat	复印机
merrythought	叉骨
gambia	冈比亚
sig	Group
andromonoecious	雄全同株的
nanosecond	十亿分之一秒
pursy	皱起的
social	爱交际的
frankness	率直
boastful	自负的
assheaded	傻瓜的
dubitate	半信半疑
fijian	斐济的
apnea	呼吸暂停
stick	粘贴
hygeian	卫生
supermundane	世外
productively	有结果地
sjaa	St
overkind	过于友好
farcied	患有马皮疽
supine	懒散的
valued	尊贵
pyrolusite	软锰矿
undivided	未分开
amoebocyte	阿米巴样细胞
fortuneteller	占卜者
unclog	扫除……的阻碍
dusky	忧郁
heterochromosome	异染色体
omnific	创造一切
senary	以六为基础
pitch	投掷
chondroitin	软骨素
unguligrade	蹄行
dexter	右边
lanceolated	枪尖形
eventful	多事的
delicate	病弱的
refractional	折射的
proclamatory	宣言的
hatchway	地板
fixative	防发挥的
vagabond	游民
distribution	分布状态
unsubstantial	薄弱
penitentiary	监禁
tamp	填塞
course	课程
halfling	半便士的银币
vast	辽阔
verticillium	黄萎病
rhodamine	玫瑰精
fleshless	非物质形体的
solo	单独
beauideal	完美的典型
intrigue	私通
larruping	与众不同的
habitually	习惯地
delphinine	翠雀宁
sapele	萨佩莱
assuming	不逊
glede	老鹰
immoralism	对传统道德的漠视
carbonization	碳化
rp	of
halfhourly	三十分钟
volcanically	火山似地
pitch	投
hardly	艰辛
impertinent	不相干的
ocdm	and
wimple	使折叠
baronial	与男爵有关
characterize	表现……的特色
wisp	小束
clypeiform	有额板的
agrologic	农业土壤学
mishandle	虐待
teched	神经不正常
whim	一时的兴致
wadding	纤维填料
redactor	编辑者
accessible	可理解
bowwow	狗吠的声音
picture	画
sebotrophic	刺激泌脂
unreeve	从孔中拉回
squashy	又湿又软的
platitudinarian	说陈词滥调的人
chump	木人
locomotive	火车头
jar	广口瓶
extemporize	即席演说
natural	自然
poke	戳
yokel	庄稼汉
jena	耶拿
symmetry	匀称
paceway	遛马场
inofficial	非官方的
graining	漆木纹
luxuriate	茂盛的生长
phrynin	蟾蜍皮毒蛋白
beau	喜修饰者
cognominal	同名
wrangler	争论者
perigynous	周位排列
reversionary	继承的
quaintly	离奇有趣地
digitated	指状
transeunt	外在的
lockage	水位高度
tedious	冗长乏味
teleview	用电视机收看
msts	Military
coruscant	闪烁
itabira	伊塔比腊
weakly	有病
moisten	变潮湿
adespota	作者不明之作品
reoffer	再提供
swarthy	黑黝黝的
mouth	嘴
inconsolable	无法安慰
parader	列队行进者
ac	交流电
lur	London
grandson	孙子
introduce	介绍
sericin	丝胶
copious	广识的
denish	丹麦人的
curtness	草率
constrained	不舒服
out	显露出来地
mispickel	=arsenopyrite
pictorial	画报
essayistic	随笔的
goon	受雇暴徒
curlew	一种鸟
ajut	突出的
tba	announced应予宣布
misapplication	滥用
fuck	性交
panderess	鸨母
teacherless	无教师
mosaicist	镶嵌细工商
ferocity	暴行
endoergic	吸热的
allopathist	用对抗疗法的医生
skillion	披屋
karyon	核
oapec	阿拉伯石油输出国组织
incept	获得学位
fargoing	范围广泛
sternly	严厉
clumsiness	丑陋
picnicky	郊游
sindonology	都灵尸衣学
divine	神圣的
design	构思
digitizer	数字转换器
invertible	颠倒
dicephalous	双头
immensely	无限地
unconfiding	寡言
cloak	掩护
lace	缚带子
spumescent	起泡沫
banaban	巴纳巴岛的
precaution	预防
locator	土
iatrology	医学
unseriousness	不严肃
micrococcal	微球菌
considered	考虑过
meaning	意义
interconvert	互变
conjurator	灵媒
hygroscopic	吸湿
jeers	操纵帆桁下部索具
asce	Society
hypophloeodal	生成长在树皮下的
graniteware	花岗石纹的法琅铁器
susceptance	电纳
pfd	flotation
sacrament	沉默的
forbidding	令人难亲近的
scabby	结痂
rani	王妃
ministrant	提供帮助者
evolutional	进化
oppressor	压迫者
miee	the
avt	added
pedagogic	教师的
unapproachable	无可匹敌的
profligate	不检点
lyonnaise	用洋葱作配菜烧成的
lapse	堕入
falconry	鹰猎
orangeade	橘子水
vlsm	Variable
savannah	大草原
rigmarole	冗长的废话
mellowness	肥沃
sitting	就座
temper	调和
call	召集
nutsy	痴狂的
writ	书面命令
discursion	漫谈离题
telephonic	用电话传送的
phenomenological	现象
erewhile	不久前
chastening	精练的
corinth	科林斯湾
rudderfish	追船鱼
facticity	确凿性
akimbo	两手叉腰
unlearned	天然的
raa	Academy
thematic	题目
sumph	愠怒的人
calathiform	杯状
inquilinous	寄食
bladdery	有气泡的
device	策略
deflation	放气
backwardly	落后
extramural	单位以外
senna	番泻树
cranny	裂缝
whare	棚屋
reflected	反射
fruitarian	常食水果的人
hydrogenation	加氢
ungava	昂加瓦
gallican	古代Gaul教会的
unworn	没有磨损
tailstock	尾座
norsk	挪威人的
innovationist	改革派
atrabilious	疑心的
geriatric	衰老老人
roose	吹捧
contest	竞赛
colligative	依数的
teheran	德黑兰
expiable	可偿
extension	外延的
soterial	救世
toadfish	豹蟾鱼
thunk	铛
frostbound	不热情的
fete	节日
mesityl	荚基化氧
pacifistic	和平主义
theft	偷
prehominid	猿人的
superjacent	压在上面的
funiculate	有细索的
proteolysis	蛋白质水解
doodad	便宜货
supercarrier	超级航空母舰
confessingly	像忏悔者一般地
fruitlet	小果实
phobia	恐怖症
fluid	流畅
fylfot	万字形
nonessential	非本质
associative	联想
loco	发狂的
vigorous	健壮
spirivalve	螺状的
dominant	占优势的
sibilant	齿擦音
sayest	单数
pinery	菠萝园
loessial	黄土的
unholy	邪恶的
healthy	健康的
rudiment	初步
villainy	道德败坏
impertinent	鲁莽
tappit	有顶饰
private	秘密的
iotp	Internet开放贸易协议
remissible	可宽恕的
kilter	良好状态
efficaciously	有效
rbi	Run
disposal	布置
antitrust	反托拉斯的
pfui	啐
modernday	现代的
vidual	守寡
vortex	中心
nagmaal	圣餐
alacritous	快活的
gingerly	极为小心
increately	原存地
snow	雪
oup	Press牛津大学出版社
handloader	自己装子弹的猎人
kultur	军国主义
blob	水滴
eventuality	可能性
copycat	无主见的家伙
neoorthodox	新正统运动的
caveator	发出警告者
cheapie	廉价品
barycentre	质心
pearlescent	珍珠般
demilitarization	非军事化
tepefy	使微热
shina	希纳语
inorganized	缺乏组织的
polysepalous	离萼
wireless	无线
carl	Carl
planish	精轧
offensively	不愉快
fully	充分地
semideaf	半聋
circle	循环
animated	活泼
roadlouse	小型汽车
unconfiding	不轻信别人
ccitt	国际电话与电报顾问委员会
foaly	怀驹的
metaphosphate	偏磷酸盐
teach	教授
petrographical	岩类学的
coidentity	同一性
hound	猎犬
scant	限制
apopemptic	告别
ashes	文化遗址
thermometrical	温度计的
biofacies	生物相
text	原文
undomesticated	不习惯家庭生活
scopulate	帚形的
archduchess	皇女
lacertine	有蜥蜴状花饰的
refution	辩驳
dogger	荷兰双桅渔船
rubrical	朱色的
striction	收缩
qos	of
recidivate	复返
franciscan	St
horsepower	马力
undemonstrable	难以证明
perigynous	周位排列的
repentant	悔改的
backlist	库存书籍目录
bps	per
call	喊声
retroreflection	回射
fortnightly	隔周
maraca	女人的奶子
yieldance	屈服
woefully	可悲
noddle	头
memento	纪念品
eighthly	第八号
belted	装甲
donnish	装模作样的
trinitarian	信仰三位一体
blessed	受祝福
caldoverde	翡翠汤
rake	搜索
poriferan	海绵动物
degras	油鞣余脂
cameroun	喀麦隆
benedictory	感谢的
newfoundlander	纽芬兰人
hypaesthesia	感觉减退
monocular	单目镜的
xerox	施乐复印机
gyrose	回状的
evadingly	躲躲闪闪
muskellunge	大梭鱼
jal	日本航空公司
picrotoxin	木防己苦毒素
cyclo	三轮人力车
nerc	全国环境研究委员会
scrotum	阴囊
ersatz	假
hemiparetic	偏身轻瘫
cobwebby	蛛网密布的
sarin	沙林
haematolysis	=haemolysis
dolmen	史前墓石牌坊
iconographic	图像材料
masty	肮脏的
absolvent	赦免
theolog	神学院学生
calembour	双关妙语
provostship	provost之职
archdeaconate	副主教的职位
reimport	再进口
menfolks	男成员
furl	卷收
helvetia	瑞士的拉丁名
immunoglobulin	免疫血球素
chook	鸡
camping	帐幕生活
responsive	响应
sup	吃晚饭
rachis	花轴
velocipede	孩童用三轮车
cryptic	神秘的
regatta	赛舟会
unimpassioned	不感情用事
chief	长官
geckotian	守宫科的
mouthless	无口
catechol	苯磷二酚
culminating	终极
removed	远离……
cuvierian	居维叶分类法
phlebosclerosis	慢性静脉炎
pathography	病志
perform	执行
sumerology	苏美尔学
klunky	残旧的
incorrect	错误
liable	有……倾向
bemist	使朦胧
gigavolt	吉伏特
cretinous	白痴病
altisonant	崇高
glossmeter	表面反射性测量器
par	平均
kittenish	嘻耍
entasis	凸肚状
uninterrupted	连续的
rasorial	抓地觅食的
unofficially	非正式
delinquent	失职者
oldster	老人
poke	刺
coatroom	衣帽间
undivulged	未经透露的
inaugurate	开辟
chef	厨师
uncomfortably	困难
polyuria	多尿
extemporaneous	即席
peritonaeum	=peritoneum
glut	充斥
abidjan	阿比让
suddenness	意外
distend	扩张
dualism	二元论
underscore	划线于……下
georgette	一种极薄的透明细纱
bucker	跳跃的马
schizoid	精神分裂症患者
essential	提炼
tea	进茶点
polyptych	三联画屏
lcd	液晶显示屏
vdi	Interface
scepter	王权
lactase	乳糖分解酵素
cripple	削弱
silverbeater	银匠
theatric	剧场的
maddening	发狂
procuration	获得
sandhurst	英国陆军官校所在
purl	反针
buttony	钮扣状的
nautical	船舶的
nomothetic	以法律为根据
bosque	树丛
fan	煽动
tartarous	酒石似的
colligability	可连性
literalize	照字义解释
forebode	预示
uscgr	United
substratal	基本的
periodical	周期的
diapason	调音
sobriquet	绰号
gaga	狂热
otherness	相异
bestraddle	跨
nubile	适婚的
paced	步调
distill	提取
quasifission	拟裂变
habilatory	服饰
multibucket	多斗
mbfr	Mutual
stretch	一段时间
movement	运动
enervate	削弱
episterna	胸骨上端
houselet	小房子
epulosis	结瘢
berkshire	黑白色的猪
malarkey	说大话
explosible	容易爆炸的
nebulated	朦胧的
petitor	请求人
ingulf	吸进
screak	嘎嘎作响
nonideal	非理想
diphyodont	双套牙哺乳动物
frippery	便宜而俗艳的服装
toughly	固执地
transmontane	野蛮
matronage	主妇的身份
referrence	参考
extortionate	过高
poppet	乖孩子
inwit	理解
vectorcardiogram	蛄客
baptismally	圣洗地
serous	血浆的
meridian	顶点
stunt	绝技
outboard	向舷外的
valuer	价格核定人
to	向
unentangled	不曾复杂化的
wfp	Food
oppressively	压迫
enquiring	探听的
gibber	喋喋而言
pudicity	羞怯
spadable	可铲掘
fatted	肥胖
geck	卑鄙的人
herbarium	干燥标本集
spectroheliometer	太阳光谱仪
butler	男管家
paroemiographer	谚语写作者
offhand	唐突
basebred	下贱的
reirradiate	再用辐射
bigot	盲目信仰者
phosgene	光气
blazer	颜色鲜明的运动夹克
antiscriptural	违反圣经
nonscheduled	不定期的
seastrand	=seashore
visitor	访问者
lokoum	=locoum
compensate	补偿
serried	林立的
dupe	愚弄
equinoctial	春分或秋分的
wizard	神汉
undissembling	坦率的
validating	确认
lightkeeper	灯塔的看守人
synchronicity	同时发生
predeterminate	注定
orthoepist	正确发音的研究者
dawning	拂晓
twentymo	二十开的
trouser	女演男角的
therapeutics	疗法
thrombosthenin	血栓收缩蛋白
sugariness	甘味
sincere	诚挚的
myalgia	肌痛
overfired	过烧
dimethyltryptamine	二甲基色胺
polyphyletic	多源的
hip	熟悉内情的
fiercely	厉害地
defector	叛离者
pantopragmatic	爱管闲事的
laced	绑带子
whorl	打转
frgs	Society皇家地理学会会员
swellheaded	骄傲的
unsuspecting	不怀疑
myoinositol	肌醇
lease	租约
bald	光秃的
nasofrontal	鼻额
semplice	无装饰音
dural	硬脊膜
butanone	丁酮
consult	参考
roundly	有力
jeopard	危及
borderer	边境居民
inegalitarian	不均等的
securely	安全
barren	无聊的
flush	活力旺盛
breastplate	腹甲
period	时期
foretooth	前齿
galore	丰富
disagreement	不和
grayer	苍白
acropetal	向顶
froggish	像蛙
toxicosis	中毒
bender	狂欢
tightfitting	紧身的
moat	挖壕围绕
formwork	建筑用模子材料
bucuresti	=Bucharest
exasperating	气死人
undetected	未被识破的
unga	Nations
arginine	精氨酸
joyuce	詹姆士
elephant	象
brazilin	巴西木素
quadrilled	方眼
cyclometer	记转器
deduct	扣除
turboelectric	用涡轮发电机的
gatepost	门柱
preprofessional	职前的
oat	麦片粥
fiery	炽热
diffusive	普及的
intended	已经订婚者
cosmological	宇宙哲学
muff	笨拙的人
understatement	掩饰
inosculate	吻合
workingman	工人
rectificative	矫正
pretersensual	感觉不到
restorative	有助于复元的
dcmg	高级圣迈克尔和圣乔治女勋爵士
allahabad	阿拉哈巴德
klong	运河
fast	很快地
bure	房子
fishermen	渔船
stale	失时效
perfect	精通的完成式的
banaban	巴纳巴岛人的
deboost	推力的减低
noncaloric	热量极低
powerman	动力工作者
scrimpy	缩减的
jipijapa	巴拿马草帽
rrl	远程参考层
prance	后足立地腾跃
rebaptism	新命名
triumphal	凯旋的
respect	不防碍
salutiferous	=salutary
whimsical	反复无常
cytopenia	血球减少
interpellate	质问
overworn	overwear的过去分词
internalize	使内在化
eutomous	有明显解理的
arriero	赶骡人
postirradiation	辐照后
nonpolluting	不会引起污染
gerontocracy	老人政府
elastically	伸缩自如地
lessen	减轻
upas	见血封喉
webbed	作成蜘蛛网状
slashing	鲜明的
capotasto	=capo
roc	大鹏
copperheadism	美国内战时北方人对南方的同情
barkeep	酒吧间老板
jama	睡衣裤
azul	警方
butterscotch	奶油糖果
origin	起源
palmated	掌状
state	州
polyclonal	多元性繁殖系
unwilling	勉强的
melo	=melodrama
flushing	脸红
differentiable	可区分的
primary	第一位的
fabricable	能加工成形的
haemolysin	溶血素
glitzy	闪光
racialism	种族歧视
waterblink	水照云光
coterminous	相连的
kerplunk	扑通声
hedonic	享乐主义学说
cave	挖洞
mohism	墨子哲学
throughother	乱七八糟地
wafery	薄的
clipped	发音清楚
publishing	出版业的
precessional	因岁差而导致的
yeanling	小山羊
catsuit	女式紧身连衣裤
rotte	=rote
regret	懊悔
catchword	口号
tabid	憔瘦
adamite	亚当的后裔
salify	使变咸
unaided	独立的
fatheaded	愚笨的
underwing	后翅
hyaloplasmic	透明质
caritative	博爱
mitriform	主教冠形状
daunt	沮丧
farmergeneral	包税人
narrowband'	NULL)
veritas	真理
boss	老板
nightside	阴面
telephonic	电
onthe	在
digynian	二雌蕊的
verity	真实的陈述
clear	跳过
msy	可以长期保持的最大年开发量
deaminase	脱氨酶
fleam	锯齿口和锯条面所形成的角
combo	社团
facing	衣服等的贴边
coprophilous	嗜粪癖
commonwealth	共和国
depraved	邪恶
malayanize	使马来化
argufy	争论
scratcher	抓扒者
cutoff	新河道
fixative	防发挥
rhizophoraceous	红树科的
gradual	渐进
rollered	装在滑轮上的
regge	雷琪理论的
embed	使插入
overtalk	讲话太多
amoeboid	似变形虫
mosso	活跃的
edacious	狼吞虎咽
lalapalooza	=lollapalooza
judicially	依法判决
walkable	适于步行的
monostomous	具单盘的
aesthetic	有审美感的
complicit	有同谋关系
joyful	快乐
nature	自然
appetiser	=appetizer
prosit	祝成功
morosely	忧郁地
adagissimo	很慢的
spiroid	螺旋形的
graphitoidal	石墨状的
incontinuous	不连续的
obtected	有角质外壳
unquiet	动荡的
priderite	柱红石
holystone	甲板
erlang	厄兰
scarce	不足
trodden	tread的过去分词
firn	积雪
rental	租金收入
plebby	普通
blimp	软式小型飞船
oppressive	压制性
isoteniscope	液体蒸气压力计
primitive	粗糙的
rajahship	君主、王公或酋长的地位
overheat	使过热
nonexistence	无
xvi	16
ems	Electronic
caudle	粥汤
incb	国际麻醉药管制委员会
cogwheel	钝齿轮
depraved	邪恶的
shorten	缩短
transdisciplinary	涉及若干学科
guyanese	圭亚那
romping	嬉戏喧闹
nonconducting	不传导
cacodylic	二甲砷基的
firry	杉树的
jovial	朱庇特
tightrope	拉紧的绳索
langrage	钉弹
dextrose	右旋糖
spectacle	景象
form	表格
mopery	闲荡
sticky	粘
living	逼真
lardon	肥腊肉片
tractable	易处理
regulatory	调整
hula	呼拉圈舞
floorer	打倒
atapi	Interface
iraser	红外激射器
stellated	星状
exhibitioner	获得奖学金学生
foxiness	似狐性
put	赋予
phocine	像海豹
regain	恢复
triskelion	三曲腿图
frontage	前方
orator	请愿人
flub	瞎搞
girly	像少女的
glazed	像玻璃
dragon	严厉而有警觉性的女人
deplete	使衰竭
calciferous	含碳酸钙
hydroxy	氢氧根
following	党羽
gairfowl	auk
geoponic	乡间
poteen	私酿的威士忌
incomparably	无比
cycloparaffin	环烷
isd	International
lowest	最底下
hydrargyric	水银的
dragonnade	武力迫害
malawi	马拉维
draper	布料商
plc	Company
seminarist	=seminarian
expansion	扩张物
epsom	Epsom
everything	pro
hotpot	罐焖土豆烧肉
coeliac	腹的
metapsychical	心理玄学
redheaded	急躁
balanced	平稳
metaplasia	转化
mylohyoid	Ⅰ
squat	蹲伏
drouth	干旱
nom	有名无实的
uniplanar	单平面的
feederliner	支线班机
saltcat	盐块
internauts'	NULL)
idoneous	适合
lacrymal	泪瓶
weatherly	能抢风航行
succous	液
amphibiology	两栖动物学
cainite	诺斯替教之信徒
vpd	Vital
previously	先前
chronologer	历史家
schizophrenic	精神分裂症
unsuspectingly	信任
approbatory	承认的
ananda	完美的祝福
manciple	伙食委员
scheme	设计
nova	新星
zymosis	发酵
fatiguesome	累人
brownnose	拍马屁
chiao	角
exchequer	财源
cercaria	尾蚴
story	故事
egregious	惊人
changeless	不变的
contrafactum	换词歌曲
attrit	削弱
indisposition	小病
watchmaker	表的制造人
unmew	释放
apodictic	明白的
dopy	被麻醉
heaping	堆得很高
cribriform	有小孔
quaggy	泥泞的
dramshop	大型酒吧
fluke	倒霉
paleogeography	古地理学
yammer	气愤的抱怨
dickensian	狄更斯的
closeness	紧闭
aeroballistics	空气弹道学
desmitis	韧带炎
diplophonia	双音
housebreaking	盗取
thinnest	瘦的
pikeperch	梭鲈
diathermanous	透热的
heirdom	继承权
necessity	必需品
wsa	战时航运管理局
survive	幸免于
encyclopaedist	百科全书编纂作者
hypnopaedic	睡眠中教学的
sisterly	姐妹一般
christcross	十字形
subsonic	比音速稍慢
phonemicist	音位学家
depict	描写
eighty	八十个
swivet	狂乱
mazarine	深兰色
bistro	酒馆跑堂者
inflation	胀大
ground	地面
preagricultural	人类开始从事农业前
challis	印花丝毛料
jejune	缺乏营养的
hamza	代表闭锁音的符号
crisp	脆
ostensible	虚假
maniacal	狂乱的
brasflia	巴西利亚
nonfiltered	没有过滤嘴
untogether	混乱
cannabinol	大麻酚
paedagogue	=pedagogue
candle	蜡烛
equipment	固定资产
lanceolate	矛尖形的
tautomerize	现象
icky	粘得讨厌
dun	暗褐色的
pfui	呸
horsey	似马的
amaze	使吃惊
photocall	接受宣传媒体拍照的时间
craterwall	火口壁
dissever	分开
virilocal	居住在男方
ckd	完全分解的
pug	拌
weeksite	水硅钾铀矿
subcelestial	在天下面的
gpi	general
guardrail	护轨
sitting	孵卵中的
shade	渐变
unreconstructible	不能改建的
cosily	惬意地
helichrysum	蜡菊属植物
antidiphtheritic	预防白喉
kibed	患冻疮
eventual	最后
favorable	赞许
gobble	火鸡叫声
petasos	宽边帽
profile	轮廓
salify	使成盐
pacificist	反战主义者
agami	黄胸长脚长颈鸟
ssrc	Science
vacuity	空虚
ems	Mail
nse	国家证券交易所
mna	Nursing
scalper	黄牛党
incb	Narcotics
quietish	有点安静
antibusing	反对用校车接送跨区学童的
biography	传记
pilgrimize	漫游
frigidaire	电冰箱之一种
gainer	得利者
aim	目的
analgesia	痛觉丧失
psilophyte	裸蕨植物
bfr	缓存器欠载
dsrv	vehicle
insufflator	吹药器
icy	盖着冰
defraud	欺骗
nephric	肾
msph	in
policy	方针
laceless	无带子
diverse	变化多
polyzonal	多区域的
quadrisyllabic	四音节词
idolatrize	奉为偶像
synkaryon	受精核
burnout	歇火
etep	Electronic
very	完全
legionary	很多
bigeminy	二联脉
interwreathe	将……交错编扎成圈
pounce	突袭
preindicate	事先表明
hospitaler	宗教慈善团体的职员
equivalve	两壳形式和大小相同的
navigation	导航
sombrous	阴沉的
spherule	小球
yiddish	犹太人的
bobbly	不平的
bonze	僧
lamellibranch	瓣鳃类
allantoid	尿囊
wee	一会儿
zigzag	作Z字形地
gem	宝石
absorbingly	引人入胜
naughtily	无礼
discrimination	辨别力
msfm	of
binding	捆绑物
pertinent	中肯的
polarimeter	偏振器
faulty	不完美
calumniatory	中伤的
acknowiedged	到普遍承认
intrigue	用诡计取
monocular	单筒的
kbe	theBritish
couturiere	女性之女服设计师
arrantly	众目昭彰地
ctd	Development
siamese	暹罗猫
kavakava	=kava
utter	做声
injured	受损害的
enticing	引诱的
countersubject	对题
unselected	未经选择
crisscross	十字形地
tail	尾随
icelandic	冰岛的
christmastime	圣诞节期
mossbanker	=mossbunker
convergent	会集于一点
flutter	悸动
waxen	柔软的
curvy	弯曲
automaticity	自动性
unnecessary	多余的
loverboy	追求女色的人
midpoint	正中央
businesslike	有效率的
deconvolve	去……卷积
inker	墨棒
solutrean	梭鲁特文化
reinforce	加固物
loathe	憎恶
selectron	选数管
sternwards	在船尾
ephemerality	无常的事物
firedragon	喷火龙
discontentedly	不满
dimetric	四角形
infundibular	有漏斗状器官的的
vocative	呼格
multigraph	其商标名
ixia	鸢属科属植物
prayerful	常常祷告的
jesuitically	阴险
corrosible	可侵蚀
betel	萎叶
flagellated	生有鞭毛的
bomb	轰炸
community	社会
paisana	女同胞
forgive	原谅
transom	横窗
leewardmost	最下风
inappreciable	微不足道
lavish	非常大方的
dodgasted	迷惑
mind	头脑
mocker	嘲弄者
scintigram	闪烁图
affected	做作
exemplar	标本
trigger	板机
underclass	下层阶级
plaza	购物中心
rubberlike	如橡胶的
acetify	变酸
selenodesy	月面测量学
casuistry	诡辩
unwary	不警惕的
itinerant	巡回者
achievable	做得成的
nonfarm	非农业品
inarm	拥抱
palaestra	体育场
sixth	六分之一
rive	劈开
unculture	无文化
andromeda	仙女座
delphic	意义不明确
molest	骚乱
discombobulate	使困惑
graveward	向着坟墓地
frolicly	玩乐地
hump	峰丘
retractile	收回
dolly	推移动车
facinorous	极恶的
root	根源
convinced	确信
christhood	救世主的身份
forktailed	尾巴开叉的
fruity	洪亮
suggested	暗示
inclinometer	倾角计
transdisciplinary	学科间的
vain	自负的
emissive	发射
fuegian	火地岛的
gaga	愚蠢的
federative	有外交和国家安全的
auxochrome	助色团
sexivalent	六价
invincible	无敌
stoniness	冷漠
evenfall	傍晚
obsess	使困扰
vlcc	large
monarch	君主
summertree	大梁
drably	无生气地
cultivar	培育植物
microtron	电子回旋加速器
nicish	须慎重对待的
pouched	袋形的
depressor	压器
aforetime	早先的
lamplighter	点燃街灯的灯夫
trottoir	人行道
foxfire	狐火
extirpate	根除
macroscopical	宏观
jazz	爵士乐的
macrocosm	宏观世界
undescribable	难以叙述
deep	纵深的
associate	结交
composition	写作
in	Network
astronavigation	太空航行
stripfilm	片条
heatspot	雀斑
blandish	谄媚
magicube	魔方闪光灯
polak	波兰语的
weird	怪异的
interpandemic	流行病两次暴发之间的
lick	卷过
allantoic	尿囊内
palmitic	采自棕榈的
larrikin	喧闹的
moonstruck	多愁善感
bold	大胆的
con	console
rivalry	竞争
clathrate	插合物
convention	习俗
hyenoid	残忍的
viscosity	粘质
antiwhite	反对白人既成体制
farinose	粉末状的
irreproachable	不可非难的
toxicomania	嗜毒癖
tv	图瓦鲁
vitality	活力
bacteriostat	抑菌剂
accumulator	积聚者
hearted	呈……心情的
unconcerned	不关心
lahore	拉合尔
sunblasted	太阳晒枯的
flectional	可弯曲的
turin	都灵(即托里诺
scission	分裂
incitant	刺激
antiscience	反对科学的
unguardedly	没防备地
picador	骑马斗牛士
benevolently	慷慨地
infructuous	不结果的
dicebox	骰子盒
coenacle	=cenacle
walking	步行的
draughts	国际跳棋
bladdery	有气泡
expressionless	无表情
bravery	勇敢
scan	审视
potpie	肉炖面团
limicole	丝蚓
megamillionaire	亿万富翁
weazand	=weasand
taleteller	搬弄是非者
hereinbefore	在上文中
goodly	优秀的
florist	种花人
virtually	实质上
pathos	感伤
feat	功绩
symptomatic	表明……的症候
sentry	岗哨
qmg	quartermaster
lean	依赖
ammocolous	砂生
aforetime	从前
whisk	挥动
complyingly	遵从地
imperfectly	没完地
trifurcate	分成三叉
shambles	屠宰场
unlively	无生气的
reflect	细想
add	加
recurved	后弯的
drone	懒惰者
liechtensteiner	列支敦士登人
base	基数
churchwarden	陶制的长烟斗
fwpca	Administration联邦水污染控制管理局
something	有点象
carnally	肉体
wring	挤
tacticity	立构规正度
datcha	乡间邸宅
telephoto	电传照像
unsummoned	未被召集的
dantonesque	似丹东的
bullwork	重活
phycoxanthin	藻黄素
trifle	蛋糕
unroost	把……驱逐出
inverseimage	原像
ladronism	有组织的抵抗
evangelic	福音传道
assimilability	可同化性
whitepox	类天花
zyme	病菌
hysteritis	子宫炎
suprahepatic	肝上的
febriferous	产热
incalculable	不可计算的
handclap	拍手
battu	打脚的
virtue	效力
zillion	庞大的数字
dcs	Dorsal
peek	一瞥
fork	餐叉
gdr	Republic
refluence	逆流
ungainly	不雅地
observatory	气象台
versify	作诗
sassaby	南非大羚羊
ambuscade	埋伏
paladin	游侠
actual	真实
perennity	长久
fornication	乱伦
rigmarolish	冗长废话
tsunyi	遵义
apollyon	恶魔
eyebeam	一瞥
stogy	笨重的长靴
zoophytologist	研究植物形动物的学者
cowpea	豇豆
pasquale	帕斯夸里
ataman	首领
fettle	殴打
sclerotomy	巩膜切开术
renew	使更新
limpness	柔弱
undiscipline	无训导
willoughby	威洛比
erlang	占线小时
arrogant	傲慢
laced	绑带子的
infarction	梗死形成
unbent	未弯曲的
inspirational	灵感的
idiosyncratic	特殊的
alternant	交替函数
backhanded	间接
salvageable	可挽救的
tolerance	容忍
alfine	到头了
contrite	深感懊悔
nasty	淫秽
doubtfully	怀疑
great	全部
workmanlike	技巧精湛地
elyseeologist	法国问题专家
yair	=yeah
cologne	科隆香水
welt	贴边
autarchy	独裁
emulatory	竞争
exemplum	例示
flatways	平面朝前
haptoglobin	触珠蛋白
renitent	抵抗压力的
january	一月
anomic	社会道德沦丧
matchmaking	安排比赛
lamellate	薄片形
gemeled	成对
technologic	技术
consolute	会溶质的
work	操作
bulletheaded	圆头的
plc	Public
easiness	温和
lacustrian	湖上住屋
annotate	注释
reexportation	再输出
overtax	使负担过度
leisterer	叉鱼的人
authority	权威
gruel	稀粥
heteroousian	本体互异论者
hematogenous	血性的
toadflax	云兰属植物
kimberlite	金伯利岩
chocho	=choko
spunge	=sponge
aglow	通红
lipography	字母的脱漏
metaprotein	变性蛋白
fine	精炼
andromonoecious	雄花两性花同株
dogmatical	教理的
nicer	良好的
geromorphism	未老先衰症
peel	削
needlessly	不必要
medal	纪念章
undercurrent	潜流
swelldom	上流社会
princekin	小王子
coeliac	腹
narrowly	勉强地
chink	叮当响
gravesian	格雷夫斯风格
heptaglot	使用七种语言的
scrappy	不连贯的
tenny	=tenne
custom	定制
goldfield	采金区
spirit	幽灵
causeless	无显著原因
ecogeographic	生态地理的
might	威力
ammoniate	加氨
table	平地层
shammer	诈欺者
dragsville	令人厌烦的事物
aquicultural	水栽法的
diverticulosis	憩室病
associational	协会
nd	钕
atheoretical	与理论无关的
globalism	全球政策
escapee	逃亡者
liberte	egalite
chaw	咀嚼
tax	税款
afoot	进行中
ultramarine	群青色
asphaltene	沥青烯
plasmolysis	胞浆溶解
bulawayo	布拉瓦约
synapse	神经键
shoreless	没有支撑
irish	爱尔兰人的
irresoluble	不能解释的
rhapsodise	=rhapsodize
moggy	母牛
clocking	孵蛋的
cavern	巨洞
bedraggled	全身泥污的
deindustrialize	解除的工业生产能力
propoxur	残杀威
ciaa	Association大学间中央体育协会
sangfroid	泰然
emergent	自然发生
roast	暴露于某种热力下以得温暖
estheticism	唯美主义
pacesetting	定步速
chrysographed	以金色墨水书写
reasonableness	合理
obscurantic	蒙昧主义
hielamon	木制盾
paddlefish	匙吻鲟
pastureland	牧草地
laparotomy	剖腹手术
recommended	被推荐的
ppm	papers
voluble	健谈的
sororal	姐妹的
coanda	effect柯恩达效应
bother	烦扰
technophobia	技术恐惧
uncultured	无教养
saturnine	阴郁
abuse	辱骂
bakelite	人造树胶
averse	反对的
spermatic	生殖的
cranny	裂隙
echinated	有刺毛
inboard	舷内
staff	全体职员
oso	Observatory
now	既然
archpriest	主牧师
before	与其……宁可
acerbating	使发怒的
malinger	装病
louisianian	路易斯安那州
feedwater	给水
sinusoid	正弦曲线
civil	民事的
sporter	运动用品
equipotential	等位的
galvanometry	电流测定
quadrennially	四年一次地
tridental	=trident
hepatobiliary	肝胆
infuriate	激怒
greenshank	青足鹬
denticulate	有小齿状突
buryat	=Buriat
streamlined	最新型
threatening	胁迫
churchilliana	有关丘吉尔的收藏品
fittest	胜任
lecherous	挑动春情
mayest	may的第二人称单数现在时
wonder	惊愕
gynaecic	女性的
venal	贪污的
gemmule	芽球
psalter	诗篇
obeisance	鞠躬
polite	有礼貌的
convivialist	爱宴饮交际的人
vinaigrette	香料饰盒
maternal	母性的
authority	威信
paraldehyde	三聚乙醛
woodcarving	木刻
magnify	夸张
dghaisa	马耳他平底小划船
sterling	纯正的
construct	建造
metis	杂种动物
last	鞋楦头
netted	用网捕获的
worm	给除虫
pollack	绿鳕
federalism	联邦制度
divulgence	泄露
punditry	专家
ketogenic	生酮
formulation	明确地表达
retrofire	卷舌点火发动
petrophysics	岩石学
retort	反驳
imperception	无感觉
unintelligent	缺乏才智的
lissotrichous	头发直的
paranoea	妄想症
chew	咀嚼
mineral	矿物
openhearted	不客气
effusively	热情洋溢地
anglomaniac	亲英份子
pulseless	无脉动的
scheme	配置
quillet	托辞
villose	象绒毛一样的
virginity	童贞
blacksploitation	=blaxploitation
travel	旅行
psychodrama	心理剧
rhachis	=rachis
bracteal	苞
fecal	糟粕
isodrin	异艾氏剂
stimy	妨碍
biennial	二年一次的
stair	楼梯
general	综合
asexuality	无性
either	随便任一个
poppa	爸
lubber	粗笨
refractable	可折射
pusher	推动者
grimily	污秽地
sustentive	支撑的
labradorian	拉布拉多半岛
unicameral	单院
troop	成群而行
inconceivable	难以相信
splanchnology	内脏学
hefa	Facilities
tristylous	三花柱
reticulitis	蜂窝胃炎
enthalpimetry	热函测量
vermicular	蠕虫的
ingest	摄取
asexual	无性生殖
amendatory	改正
clericalize	在……中提高教权之影响力
everwhich	=whichever
southeastward	往东南
unexceptionable	无懈可击的
conflation	异文合并
flexibly	柔软
acclivitous	上斜的
imp	小鬼
logged	笨拙的
menad	暴怒的女人
suspensibility	可中止
ecc	Code
blob	斑点
triennially	每三年
intranational	一国之内
metaprogram	元程序
underplay	秘密行动
enrolment	登记
retour	归还
treat	对待
instamatic	"傻瓜"照相机
elope	私奔
divine	牧师
delicate	精巧
tokonoma	壁龛
dexiotropous	右旋
disruptive	分裂性的
ass	驴
undecided	未定的
summertime	夏
anthelmintic	驱虫剂
lampoonist	讽刺文作家
filial	当做子女的
yicker	=yikker
genitival	属格的
collet	镶进底座
oarswoman	女桨手
slopseller	廉价现成衣服销售商
kiss	拂
deodorization	除臭
foudroyant	爆发
flicker	扑动翅膀
retiform	网状的
goethe	歌德
tame	没精打彩的、顺从
dollface	娃娃脸
judicatory	审判制度
pruriently	挑逗性地
foregone	先前的
unsccur	Scientific
woolgathering	空想
rough	粗略叙述
ratbag	怪人
snapper	暴燥的人
verb	动词
xpvm	PVM
unsophistication	不懂世故
rangeland	放牧地
lustration	清净
tallinn	塔林
maligner	诽谤者
harmonist	和声学者
transpose	进行变换
inflectional	屈曲的
lett	列托人
kain	实物地租
mspe	体育硕士
ineluctable	无法逃避的
playdom	戏剧界
redemand	要求归还
coroutine'	NULL)
magistracy	地方行政长官
tableaux	舞台造型
figuration	成形
gilbertian	诙谐的
nascence	发生
microbial	由细菌引起的
monde	上流社会
sourdough	酵母
stringhalt	马的跛行症
specially	临时
voluntary	主动的
univac	Automatic
weatherproof	防风雨的
sakawinki	栗鼠猴
gyroscopic	回转仪的
acetum	醋酸溶液
phaedra	菲德拉
slapjack	薄煎饼
belgic	Belgae
japonica	日本产植物
canula	导管
loud	高声
macular	有斑点的
cogged	齿轮的
monarchical	帝王的
crimpy	皱缩了
lustihood	精力充沛
herdic	赫狄克式马车
renew	补充
gyrocompass	旋转罗盘
unfortunate	不幸
airproof	密不透气的
nagger	泼妇
unladen	unlade
depot	仓库
dentation	齿状
noctivagant	夜游
mrs	Sight
funny	滑稽的
inched	有英寸刻度的
fated	宿命
eugenicist	提倡人种改良者
dine	吃饭
drip	水滴
ionic	爱奥尼亚式的
uloid	瘢痕状
hydrogenation	氢化
cargador	监督畜群装运者
lamentableners	可悲
dutiful	恭敬
sanative	治疗病症
impotable	不能饮用的
oarsman	划手
creamer	盛乳皮的盆
populate	板上组装
hyperostotic	骨肥厚
toparch	小王国君主
nok	of
unshaped	粗糙
columbian	一种活字
bull	粗壮如牛的人
supposing	去……吧
conidia	的复数
pectoral	胸饰
dynamiter	炸药使用者
foxed	变酸
cyprinodont	小软鳍鱼科
utopiate	幻觉剂
fulvous	茶色的
nora	的昵称
metropolitan	首都的
reconnect	再接合
slosh	溅泼声
needlework	刺绣
swage	铁模
heterocotylus	=hectocotylus
hypoacid	酸减低的
inaccessible	达不到
rugulose	有许多皱纹的
postulate	基本条件
unwinnable	不能取胜
incapacitation	使无能力
super	冗员
faecal	排泄物的
ox	公牛
wga	of
rinforzando	特别加重
viviparous	胎生
relieved	放心的
ragnarok	世界毁灭
betray	泄露
murmur	低语
catmint	猫薄荷假荆芥
unpolarized	非偏振的
underground	秘密地
kickback	不良后果
hermatypic	造礁的
tex	电汇
parvulus	婴儿
mathematically	算术地
geoduck	巨蚌的一种
discontinuous	不连续
alveolate	蜂窝状的
screwworm	苍蝇的幼虫
achordate	无脊索
chartometer	在地图上测量距离的仪器
colourable	似是而非的
massasauga	侏响尾蛇
worm	蚯蚓
picture	化身
confectioner	糖果店
septimal	七的
eyebeam	一看
hwan	紫蓝子
ectochondral	在软骨表面上
technic	技术
cookstove	烹调用炉
ancipital	剑形的
inconvenient	有困难
ncaa	Association
sierran	锯齿山脊区的
moline	风车式
relator	叙述者
declaim	巧辩
keratoid	角状的
foil	金属薄片
person	人称
belgic	荷兰或比利时
eugenics	优生学
turrethead	转台
insistently	坚持
devastating	全然的
sharpener	磨床
byplay	附属行为
protochordate	原索动物
girondist	Gironde
misdoer	行为不轨者
hemorrhoidectomy	痔切除术
harare	哈拉雷
fcis	Secretaries特许文书协会会员
quarantinable	应隔离的
habitancy	居住
run	熔化
hqmc	Marine
oss	source
lick	克服
ulf	超低频率
yarraman	马
studbook	血统簿
mobbism	无法无天的行为
uncontainable	无法控制的
seepage	渗出的量
certain	可靠
zenaida	塞奈达野鸽
semiarc	半弧
beautician	美容师
slavish	奴隶的
newfashioned	新型
endurant	能耐劳
ldc	Less
thievish	有偷窃习惯
errhine	引涕药
tumbler	一杯量
domical	圆顶式结构的
linksman	高尔夫球员
underclub	使用达不到射距要求的球棒
sanguine	面色红润
victimless	不侵害他人
conquest	战利品
hormonal	激素的
impavidity	无惧
expectorant	除痰剂
admonitory	劝告的
myth	荒诞的说法
dehorn	切去角
frumety	牛奶麦粥
multidimensional	多面的
involve	使陷于
frunze	伏龙芝
apres	在……以后
reviewal	评论
shutter	关闭者
gradient	倾斜
eisegetical	肆意诠释
crushhat	折叠帽
whame	=gadfly
pornography	色情描写
ataractic	镇静剂的
spendable	可花费
longinquity	长久
panmictic	随机交配
currach	沼泽
bodily	身体的
volcanism	火山作用
amniotic	羊膜
samoan	萨摩亚人
gerontic	老年人的
marv	装备机动重返大气层分弹头导弹
striae	细沟
morphodite	=hermaphrodite
acculturate	使适应文化
unpenetrable	难穿入的
jumper	妇女穿的套头外衣
marathonian	马拉松
infirm	柔弱
roadable	兼用汽车的
freeman	享有市民权的人
mesopelagic	中层的
nature	大自然
rfe	Radio
lance	标枪
fading	衰退
charkha	手纺车
starched	硬挺
excise	货物税
serous	浆液的
clothes	各种衣服
icc	国际计算中心
aboil	激烈
granulocyte	粒性白细胞
ghazi	立誓与异教徒战斗的伊斯兰教徒战士
grutch	勉强地给
meltability	可融性
peripherad	向周围
thickheaded	愚蠢的
confer	把……赠与
rejectant	昆虫拒食素
immovable	不改变
ruck	弄皱
tyro	初学者
praenomen	第一个名字
geometrize	研究几何学
state	国营
froufrou	衣服的沙沙声
angary	常征用权
plater	镀金匠
character	印
consequential	相因而生的
haematopoietic	生血
chunderous	令人作呕
unwinnable	攻不破
dedicate	献
plasterboard	石膏板
convenient	方便
banquo	班柯
quotidian	日发虐
plural	复数
telephoto	用远距镜头照相的
pseudorandom	伪随机的
ourself	pro
parleyvoo	法国语
zoan	Tanis的圣经名
ashy	苍白的
remiped	桨足类
fructuous	会结果实
abstersion	洗涤
ratheripe	早熟的
suffixation	加词尾
yell	喊声
sociable	增进友谊的
sampler	取样器
magnanimous	有雅量
anticharm	反粲
inconsonant	不一致的
bourg	有城堡的村镇
tripolar	三极的
smartly	漂亮地
cement	接合剂
owe	欠钱
mahlerian	马勒乐曲
inconsecutive	不连续的
renavigate	再领港
ruffian	无法无天
stringer	上弦匠
rivet	固定
airport	私人飞机降落场
smoky	冒烟
bridewell	拘留所
incondensable	不能凝缩的
braunschweig	=Brunswick
phosphaturia	高磷酸盐尿
complimentary	问候的
samara	翼果
gurdwara	谒师所
socratism	苏格拉底哲学
unexploded	未发射的
racker	行拷刑者
meddler	干涉者
rusty	生锈的
indescribably	不可名状
easement	安心
viniferous	为酿酒而栽培
cloudscape	云景
indocile	难驯服的
saving	节约的
call	必要
pacesetting	定速度
masterwork	名著
nog	根株
pteridoid	如蕨类的
protestant	新教徒的
normally	正常地
abundant	丰富
phonematic	音位的
prevalent	普遍
smsa	Statistical
clangorous	响亮
tongueless	哑的
catadioptric	兼反射光及折射光
goody	身份低微之老妇
spectacularity	壮丽
undercut	砍口
picaroon	海盗
templar	法律家
katanga	加丹加省(扎伊尔沙巴区
lumber	笨重地行动
rad	拉德
corniness	谷类
portly	健壮的
raid	独立磁盘阵列
hangsman	刽子手
hutted	设在小屋里的
udt	Transfer
palatodental	腭齿
lamp	照亮
at	向
ghast	死人般的
tristesse	忧郁
overdaring	有勇无谋的
lay	层面
eastward	向东
overconfident	自负
rubredoxin	红氧蛋白
blackcoat	牧师
unholiness	无信心
hostageship	人质的地位
eduction	排出
demonetarize	不再把……用作货币本位
thymelaeaceous	瑞香科树和灌木
scimitar	单刃刀
economy	节约措施
phonasthenia	发音无力
potheen	私酿的威士忌
driller	钻孔机
westerner	西方人
xiamen	厦门
catamite	娈童
priestly	僧的
stipulation	契约
kechua	奇楚亚人
religionary	宗教
tubifex	水丝蚓
gunning	用枪搜索捕杀
trailside	小径一侧的
glandulous	有腺的
reirradiate	重新用辐射处理
albinism	皮肤变白症
invective	非难
deodorization	防臭
elect	选择
hyperphysically	超肉体地
cluw	Labor
hetaera	古希腊的高级妓女
microgauss	微高斯
unflawed	完美无缺的
evocative	唤出的
section	区
lustring	一种有光泽的丝织物
ungalled	未受伤
contemplate	预期
prosodial	=prosodic
hyalograph	玻璃书写器
playgirl	好寻乐的女子
subjectivism	主观主义
drop	点滴
boatyard	修船厂
professorship	教授之职
thecate	具鞘的
impulsion	冲动
inorganization	缺乏组织
shit	屎
hsien	县
muscle	瘦肉
icj	International
percutaneous	经皮的
fructan	果聚糖
phlebography	静脉造影术
snackery	小吃店
wacky	疯疯癫癫的
giantess	女巨人
prejudice	偏见
crybaby	软弱容易哭的人
forethoughtful	慎值
galactorrhea	乳漏
approximative	接近的
filmic	电影的
upset	颠覆
snaggletoothed	牙齿不齐
egregious	异乎寻常的
coalpit	煤坑
chaste	朴素的
drooly	非常可爱
irritability	易怒
emblaze	照亮
cylix	古希腊的高脚浅杯
bathochrome	向红团
skullduggery	=skulduggery
independence	自主
hit	找到
surd	无道理的
mace	肉豆蔻皮
razzia	掠夺性的军事袭击
jump	突升
passionflower	西番莲科的
conicity	锥形状态
adenomatous	腺瘤
halm	稻草
winegrowing	葡萄种植和葡萄酒酿造业
obediently	忠顺
overlusty	精力过于充沛
wordily	唠叨地
centisecond	厘秒
nigerien	尼日尔人
amok	狂乱
panchreston	万能解释
mmm	Mobil
symptomatic	征候的
squirish	适合乡绅身份的
camomile	甘菊
magnum	大酒瓶
msa	Science
territory	地域
linen	亚麻布
adversative	反意语
membraneous	=membranous
offset	分支
outrigger	桁等
wust	香肠
pathan	住在印度西北国境的阿富汗人
electoral	选举人的
coliform	象大肠菌
gassing	吹嘘
sponsor	保证人
humanize	有教化
osteometry	骨测量法
rough	粗糙地
infold	包
pious	尽责
orthonormal	标准正交
colliery	煤矿
condolent	哀悼
zoologic	关于动物的
distinguished	高贵的
risk	冒……的危险
partyism	党派心
orthopteran	直翅类的昆虫
latrine	厕所
dunnite	高性能炸药
shit	取笑
terminate	终止
mat	席子
cyclical	循环
tannage	鞣革厂
gigot	羊腿形袖子
tab	制表符
justicial	公平
brazier	火盆
inwound	inwind的过去式和过去分词
rfe	自由欧洲广播电台
stray	离群的
introducer	介绍人
pounder	捣杵
hedonistic	快乐主义的
unverbalized	非言语化
loafer	流浪者
pistachio	阿月浑子果实
surprise	诧异
fluxionary	微分
shady	阴暗的
joyful	令人欢欣
ramapithecine	腊玛古猿的
crispate	有皱边儿
dendroclimatic	树木气候学的
virosis	病毒性疾病
remedy	修补
extroverted	外向性
ivba	International
gagbit	马衔
supplejack	熊柳树枝制成的手杖
betta	搏鱼
unchangeably	不易地
prognathous	下巴突出
gairish	=garish
probabilize	使有希望
exalted	兴奋
coulda	have
flecklessly	无斑点
jesu	耶稣基督
preggers	怀孕
infundibular	漏斗形的
bfa	Fine
sansculotte	无裤党
suffragist	妇女政权论者
lubrication	润滑油
parlor	会客室
ebonise	=ebonize
benne	胡麻
boina	扁平帽
tributary	进贡
martiniquan	马提尼克岛的
agedness	高龄
injudicial	不聪明
insufficiency	不足
suffragist	参政权扩大论者
endogenetic	内生
stale	尿
gumweed	plant
augite	斜辉石
earthnut	花生
peacemaking	调停
tonnage	登记吨位
resell	再卖
fentanyl	芬太奴
awanting	短少的
shim	用垫片填
noways	决不……
waggoner	御夫座
misplay	失误
derivational	得来的
venom	放毒
vsat	Aperature
uninucleate	单核的
snowberry	白浆果
scrap	小片
matsah	=matzo
repulsion	严拒
arbitress	女仲裁人
channel	路线
margaric	珍珠的
scale	重
beefeater	伦敦塔卫兵
born	原本
lamellicorn	鳃角类
xvi	罗马数字
producibility	可生产
bulldoze	欺负
homa	=hom
barbette	露天炮塔
interpretable	能翻译
altometer	高度计
last	结论性
affluently	流畅地
megaloblast	巨母红细胞
swag	珍贵物
calciferous	含碳酸钙的
raster	光栅
kanu	African
grasp	掌握
unfaltering	专心
grisly	可怕的
undertow	回头浪
corpsman	陆军医护兵
consanguineous	血缘
applicator	敷药用的器具
hhfa	住宅资产经理处
chlorophyllous	含叶绿素
buttonholder	强留人谈话者
retiring	退休
ligeance	忠诚
littorinid	玉黍螺
disrespectable	不值得尊重
parenchyma	实质
inconsequently	矛盾地
jingling	叮当声
ere	在……以前
zygomorphism	左右相称
pteridology	羊齿植物学
running	连续
rerebrace	上臂护甲
paye	As
cheater	骗子
brunet	深色
brandreth	井栏
ravish	强夺
impayable	无价
garrulous	饶舌
overturn	推翻
elevated	欢欣的
slowly	慢慢
implied	暗指的
posy	铭文
insider	内部的人
ionomer	离子交联聚合物
etymologist	语源学
aesthetics	美术理论
idempotence	幂等性
essential	本质的
corpulent	肥大的
sirupy	糖浆的
feeling	有同情心的
schlepp	傻瓜
anacrusis	诗句开头的非重读音节
katrine	卡特琳
plessimeter	=pleximeter
jackpudding	滑稽之人
churchilliana	丘吉尔纪念品
transmissible	可传送的
commonland	公共用
biopharmaceutical	生蝐s/`baIEJ9fB:mE`镏埔┭
yoicks	唷
pour	涌入
rasping	令人焦躁的
vitta	油管
comus	庆祝的神
psellism	口吃
incisive	激烈的
fragment	碎片
deniable	可否定
scimiter	=scimitar
factotum	杂役
superpersonality	神
joyancy	快乐
bardic	吟游诗人
sailboard	驾帐板冲浪
aquarian	太空时代的
khmer	高棉人
mora	调形
cylinder	柱面
source	源极
elements	原理
dispassion	冷静
langton	兰顿
diffused	普及
procreate	生育
whisker	腮须
whopping	异常
spatula	抹刀
embellishment	润色
belizean	伯利兹
intervallic	音程的
inlayer	镶嵌者
sporangiophore	孢囊梗
bailiff	执行官
corniness	粗野
mega	百万
shipworm	船蛆
hamiltonian	哈密尔敦函数
temporality	此时
rotational	转动的
asperity	粗暴
fluviograph	河川水位自动记录器
vitamer	类维生素
celotomy	疝切开术
housemasterly	像男舍监的
santal	=sandalwood
croquis	速写
consubstantial	同蘬/
nitre	硝酸钾
zoroastrianism	索罗亚斯德教
zoomechanics	=zoodynamics
setiform	似刺毛
excusingly	辩辞
accession	添加
hammy	火腿味
postie	邮递员
add	做加法
contrarily	相反地
miraculin	非洲奇果蛋白
gey	可以
abstentious	有节制的
ohmic	以欧姆测定
astonish	使惊讶
figmentary	幻想的
be	铍
steeliness	顽固
la	People''s
crass	粗糙的
unclos	Nations
subdepot	附属仓库
whither	什么目
communicate	沟通
humification	腐殖质形成
adultly	老成持重
interval	时间间隔
omdurman	乌姆杜尔曼
pasture	草原
unequalable	无比
construable	可做语法分析的
accrete	共生
incog	隐姓埋名的
routine	例行公事
sequential	有顺序
prothetelic	先成的
meum	我的东西
possie	差事
bifid	两半的
kryzhanovskite	水锰绿铁矿
sidle	悄悄贴近
baconian	培根哲学的信仰者
alive	活泼的
forest	森林
hemoglobinuria	血色蛋白尿
expugnable	可攻克
twopenny	低廉的
tenorist	唱次中音者
francophile	崇拜法国的
veteran	富有经验的人
night	死亡
concretive	有凝结力的
psammophilous	喜沙生物的
slavic	斯拉夫人
foolery	愚蠢的行为
vein	矿脉
welldoing	做好事
considering	认为
vervain	马鞭草属的植物
overhaste	过于草率
ramate	有分枝的
brocade	织有金银丝浮花
ovr	改写
eldo	欧洲运载火箭发展组织
rv	Recreational
waterward	向水
triloculate	三室
aspectual	体的
inlayer	镶嵌匠
evenly	均匀地
lithofacies	岩相
now	马上
lymphokine	淋巴激活素
scissor	删除
klutz	木头人
unbent	直的
source	来源
qse	合格的科学家和工程师
cressy	长满水芹
badminton	羽毛球
xenelasia	抗拒外人的条例
charter	宪章
beadsman	替施主祈祷者
pegbox	弦轴箱
sonorant	响音
provocation	激怒
phonology	音韵学
cnaa	Council
bungaloid	到处是平房
riverfront	河边地区
jib	挺杆
mpm	每分钟米数
bitterish	带苦味
unreflecting	不反射
topographer	地形学者
biopotency	生物效能
short	短
arrogant	傲慢的
mump	喃喃的说
xanthospermous	有黄色种子
kinase	激酶
headily	性急地
enounce	说出
federally	同盟地
bosthoon	糊涂虫
haversack	干粮袋
triturate	磨碎的东西
eolian	=Aeolian
choking	窒息的
anticipation	预料
kusso	苦苏
religionism	笃信宗教
explicable	可解释
incendive	引火
watershoot	排水管
ochlocratic	暴民统治的
osteochondritis	骨软骨炎
cerusite	白铅矿
gypper	骗子
pale	失色
deject	使灰心
preimplantation	胚胎植入前
blm	Bureau
ersatz	合成
sampler	刺绣样品
pentagonian	美国国防部工作人员
aspirant	有野心的
isosmotic	等渗压
intestinal	肠
wring	扭
incoherence	语无伦次
w	字母W
unbearable	承受不住的
device	设备
venally	唯利是图地
profligate	放荡者
fuddle	烂醉
casuistry	决疑论
fussock	肥胖而高大的女人
geraniaceous	牻牛儿苗科的
parnassian	法国高蹈派诗人
ssbn	弹道导弹战略核潜艇
finale	最后一场
circumoral	绕着嘴的
abraxas	刻有这种符的玉石
unfirm	不结实
pyrotechnic	令人眼光
turfan	见Turpan
set	Protocol
carbonization	碳化物
unfix	解开
singular	单一的
uncharitably	无慈悲心地
articulatory	关节的
heterozygote	异形接合体
seminar	讨论发表会
hardhearted	无情
frills	虚饰
subdean	副助理主教
corrigenda	正误表
incretion	激素
manipur	曼尼普尔区
hokum	废话
bughouse	精神病院
overweighted	超载的
resorptive	再吸收的
eastward	朝东
health	为健康干杯
excision	逐出教会
neoglacial	新冰川作用
soke	地方司法权
lockdown	一级防范禁闭
weathervision	天气图像传递
animate	生气勃勃
amiably	亲切
psychoenergetic	利用心力的
reversal	反向
supplely	柔软
material	布料
demophil	人民之友
perseverant	能坚持
antipathetic	讨厌
run	管理
alacritous	快活
lampyrid	萤科的
apathetic	缺乏感情
bctv	北京有线电视台
bystander	看热闹的人
sadly	悲痛地
supermalloy	镍铁钼超导磁合金
disinvestment	蚀本
indian	印度人
computative	喜欢计算的
vapor	水汽
rann	Research
appositive	同位格字
communicant	传达消息的
discolored	污染
flapjack	烙饼
apt	灵巧的
bonbonniere	糖果盒
reclosable	能重新盖紧
stratal	层的
instigation	煽动
title	名称
momental	惯量的
oppressive	压迫
back	前的钱
midlothian	中洛锡安郡
myelogram	脊髓选影照片
seedman	=seedsman
soviet	苏维埃
insanity	愚顽
befittingly	适当地
salesite	羟碘铜矿
stationer	文具店
saltatorial	跳跃
iioilo	怡朗
exhilaration	愉快
corpulent	肥胖
storiette	小故事
mildew	生霉
juice	汁
bacteriolysin	溶菌素
eighteenth	十八分之一
telegraph	打电报说
hidropoietic	流汗
stomatitis	口腔炎
haver	说废话
slipslop	伤感的话
inventory	详细目录
crown	花冠
allantoic	尿囊的
unmeaningful	意义
toft	地基
iridaceous	鸢尾属
undermanned	船员不足
lampbrush	chromosome
nearness	靠近
striation	条纹状
idea	概念
disposure	处理
venoclysis	静脉输注
vistadome	有观景车顶的客车车厢
hardcore	无条件的
neighbouring	毗邻
scratch	抓痕
vitellogenous	卵黄的
coidentity	共同一致性
asbolite	钴土
tannic	丹宁
kazakstan	哈萨克
ecofreak	一味关注生态保护的怪人
reprovable	该责备的
siratro	色拉豆
assize	法令
pacchionian	蛛网膜粒
skywards	向着天空
manoeuvre	用策略
collectively	全体地
wikiup	=wickiup
gelid	极冷
bedewed	为……所沾湿的
cytogenics	细胞遗传学
loth	憎恶的
hedonistic	快乐论的
traumatropism	向伤性
jarring	辗轧的
genteelism	上流的谈吐
fosterage	助长
dehiscent	裂开性的
kempt	梳理好的
confine	边界
prodromic	=prodromal
suburb	郊区
lifo	in
caste	社会地位
preincubation	预孵化
reputable	著名
aerate	使暴露于空气中
wen	粉瘤
autorotate	自转
abrasion	磨损
show	放映
sophisticator	诡辩者
quizee	=quizzee
oversleep	睡过头
detectible	可看穿的
pluvian	多雨的
preadamite	亚当以前的人
corsage	装饰女服上身或肩部的小花束
poc	of
uprear	养育
assr	Socialist
pif	程序信息文件
regardant	头朝后看
degrading	可耻的
lappic	拉普兰
machinize	使像机器
zoantharia	六放珊瑚类
screenwriter	电影剧本作家
unguarded	没有防备
albite	钠长石
centriole	中心体
dependency	属地
prosperity	繁荣
indexless	无索引的
reexplore	再勘探
trochilus	埃及斑珩
brassy	象黄铜
prison	监狱
preventive	预防性的
imbecilic	愚笨
connexion	连结
uncalculated	未经事先考虑
ckd	完全拆开的
blusterous	咆哮
scoop	掘
megasporogenesis	大孢子发生
pulpitry	布道
youngling	年轻人
minorca	米诺卡鸡
unaired	不通风
latinesque	如拉丁的
bowyer	制弓匠
ecumenist	泛基督教主义者
ps	推出的一种计算机
arenaceous	多沙
suppurative	足使化脓
chronon	时间子
irenical	和平
heavy	大量
bunny	小兔子
pleiotropic	多向性的
internationalise	使国际化
threescore	六十
surgically	如外科手术般地
floozie	智力不高的妇人或女孩
freezing	冰冻
hammurapi	即Hammurabi
valetudinarian	有病
unselected	未经选择的
hydromancy	水占术
hircine	山羊的
holytide	祭祀日
crybaby	爱哭的人
acqierement	学
superincumbent	自上而下
lawfulness	合法
inappetency	食欲不振
damageable	易损害的
catchall	放各种各样物品的容器
sobering	使冷静的
plashy	湿地的
telephonist	话务员
voyage	航海
adult	成人的
halloa	喂
lamely	一瘸一拐
warp	乖僻
aecium	锈子器
sullen	愠怒的
uncomfortably	困难地
effective	给人深刻印象
unfurnish	搬走的家具
mosasaur	=mosasaurus
steeper	险峻的
goodwood	古德伍德公园附近举行的赛马会
blusterous	虚张声势
beamed	有梁的
broodmare	传种母马
residual	残留
polyphonic	复调的
fibrillate	有原纤维组织的
fleecy	以羊毛盖上的
bearably	忍得住地
cornerways	对角地
torsional	扭力
fissiparous	有分裂能力
interjection	感叹词
afoot	在准备中
airstream	气流
hydraulic	水压
extemporaneous	不用讲稿
annuity	年金
graphotherapy	书写疗法
grasmere	格拉斯米尔
unequivocable	毫不含糊的
anglicist	英国通
mantlerock	风化层
twinkling	闪烁
semibarbaric	半野蛮的
knighthood	骑士的地位、身份
logaoedic	由混合韵律组成的诗行
striptease	跳脱衣舞
governable	可支配的
precapillary	前毛细管
dexterously	敏捷
tinderbox	潜伏着暴乱或战争危险的人
radiate	辐射状
vain	空虚
chivalrous	侠义
redrew	redraw的过去式
changeful	富于变化的
vegete	生气勃勃的
brooklynese	布鲁克林口音
pontifical	主教仪典书
homography	单应性
autocephaly	自治
scaddle	凶猛
unsuccessfully	无用
rube	乡巴佬
fair	女性
glycose	单糖
grossly	非常
dageraad	黎明鱼
mim	假装羞怯
cobwebby	蛛网似的
sketchpad	画板
recollection	记忆
gentleman	男盥洗室
rubicund	红润
pestle	乳钵
irreconcilable	不能协调的
unemployed	未被利用的
malversation	腐败行为
perform	完成任务
leukaemia	白血病
transbus	超级公共汽车
barbarity	残忍
over	上面
resultless	无结果的
uncomely	不清秀的
priggish	自负的
bigeneric	两属的
crochet	钩针编织品
bookkeeper	簿记员
curtailment	缩减
sniff	轻视
verna	弗娜
unforested	未植林的
remembrance	记忆
gilolo	济罗罗岛
golden	黄金
beady	饰有珠子的
saltern	盐厂
immotile	不能游动的
advertence	留意
bloat	腌制
delate	控告
heroicomical	滑稽讽刺
defile	染污
reasonably	相当
supinely	仰卧地
corruptly	可被收买
snuff	烛花
conceptive	有想象的
nonnuclear	非核
territory	领土
intimidator	胁迫者
infirmity	虚弱
sundress	背心裙
unsigned	无符号的
pronouncing	发音的
uncalled	未经邀请的
underclothing	贴身衣裤
lamebrain	呆子
pomeranian	波美拉尼亚种小狗
moonshiny	月照似
lunch	午餐
fmcs	Conciliation
congrats	祝贺
fencing	剑术
every	每一
bleb	疱疹
chronic	慢性的
zigzag	锯齿形
fungin	菌纤维素
dor	发出嗡嗡声的昆虫
unhcr	Commissioner
neurovascular	神经与血管的
unweight	减重
aftersensation	余留感觉
formulable	可用公式表示的
reducible	可还原
whisht	无声
removalist	搬运商
postbellum	战后
screen	屏风
hauler	搬运工
funnelled	漏斗状
caddoan	喀多语
happenchance	偶然事件
jejune	无兴趣
serenely	安详
rdc	Rural
issueless	无结果的
condensibility	可简约性
mill	搅拌
thoughtcrime	思想罪
ozonizer	臭氧发生器
peacekeeping	执行停火协定
nondiscrimination	不歧视的
revalidation	重新生效
jugal	颧骨
diphtheroid	似白喉
tinker	修补
unjustifiable	不合道理的
scutellum	角质鳞片
catbrier	猫藤
pong	难闻的气味
porosity	有孔性
pyrolater	拜火者
atlantean	岛
insurgently	造反
flaccid	软弱
immunise	赋予免疫性
saltire	圣安得鲁十字
argali	原羊
mixer	混频器
smile	微笑
roadster	流浪者
chez	于
jog	轻推
liberative	释放的
oratorize	演讲
frcp	Physicians
soak	泡
hmnzs	New
farthest	最久的
select	选择
exhalant	呼出
topiary	灌木修剪法
romanian	罗马尼亚语
audacious	大胆创新的
unwisdom	愚昧的言行
compensation	赔偿
lenitive	缓和的
lockfast	保险箱
stealth	秘密行动
phono	唱机
protuberance	结节
aniconic	无偶像
time	节拍
brocade	锦缎
formosa	台湾
gooky	肮脏
dcmg	Commander
tan	晒成褐色
dic	Constraint
sterling	英国货币
epigynous	上位的
interfluve	分野
poltfoot	畸形足
counteroffensive	反攻
leapfrog	交替前进
prioress	小女修道院院长
whoop	高声说
lithuria	尿酸尿
analphabetic	非字母式
pipy	笛声的
crankous	易怒
polyanthus	黄花九轮草
place	名次列前
thymelaeaceous	瑞香科树和灌木的
numeration	计算
validly	正当地
photoactinic	光化射线
hajj	麦加朝圣
underprize	低估
waveringly	摇动
aclu	Liberties
graduand	即将接受学位者
caseidin	酪蛋白免疫素
foretell	预示
asteroidean	海盘车类动物的
carry	携带
fetoprotein	胎蛋白
tcp	/TCP/IP软件
pronto	很快地
empiricism	经验论
plss	携带式生命保障系统
shimmery	微微发亮的
multivocal	多义
nomadic	游牧
voltolize	对……作高电压处理
exhaustion	竭尽
zithern	齐特拉琴
bedevil	虐待
epilator	拔毛者
chestnut	栗子
stiffly	僵硬地
triangularity	成三角形
unroost	离开栖息处
telephony	电话学
rumbustious	喧闹的
ustc	Tariff
viricide	杀病毒剂
millinormal	毫克当量的
silicosis	硅肺病
stunner	把人打昏的人
symbolatry	=symbololatry
bungie	橡皮
queenly	女王的
crannied	裂缝
ipsu	Setup
assertorily	确定
contemptibly	卑鄙
acquiescently	顺从
haphazardry	偶然性
wonder	想知道
pert	活跃的
pitt	Street
albata	镍黄铜
solunar	日月共同作用引起
foreran	forerun的过去式
octu	Training
autoput	高速公路
foreboding	不祥之兆的
parament	装饰帘帷
miocene	中新世
houseless	无房屋的
tripack	三底彩色片
unhappen	未发生
piercing	刺骨
hydroxy	羟基的
powwow	巫师
abbreviate	缩短
shoehorn	硬塞进
discontentedness	不平
greatness	巨大
loment	节荚
basra	巴士拉
heliotactic	向日性
voluntarily	以自由意志
umpire	裁判员
symphonism	交响曲
dene	长有森林的溪谷
grittiness	有砂砾
precinct	围
epifocal	震中
twelvepence	先令
safely	确实
bussbar	=bus
driftingly	漂流
lousewort	马先蒿属
lamentable	不快
pleadingly	祈求
breakup	衰弱
elint	电子情报
cryptographical	密码
immigration	移居入境
neighbourless	无邻居
nlaa	全国法律援助协会
administrivia	摘要等的处理工作
shooting	射击
skinny	皮
snugly	贴身
laloplegia	言语机能障碍
constructive	建设性
rhonchus	鼻音
indicative	指示的
dutiful	顺从的
overcrop	连续耕作使土地贫瘠
snore	打鼾
dishoard	抛售囤积货物
soerakarta	=Surakarta
daze	眼花缭乱
miscommunication	错误传达
mistress	主妇
inflictive	使人难过的
skill	技巧
iced	冰冷的
silica	无水硅酸
cineol	桉树脑
whiff	香烟的一口
segregant	=segregate
stonecrop	景天
renouncement	否认
yarn	奇谈
emanative	发射性
sideling	斜的
exciting	令人兴奋的
discolored	污染的
grandeur	庄严
cemetery	墓
quicksand	流沙
belabour	痛打
mathurai	=Madurai
fleetness	快速
demochristian	基督教民主党党员
jiao	角
ragefully	盛怒地
antibacterial	抗菌
vanadious	=vanadous
sling	弹弓
grumbling	喃喃鸣不平的
ecla	拉丁美洲经济委员会
tawdry	俗丽
whipsaw	双重不利的事物
silt	泥沙
leasehold	借贷的
urinette	女用长形小便池
slatternly	不自检点
vegetal	植物的
architectural	建筑上
coordinative	同等
autogenetic	自生
hyperaggressive	高度侵略性
sibiric	西伯利亚各族人民
otary	海狮
onion	加洋葱于
fractographic	金属断面的显微镜观察
approximator	接近者
lassallean	拉萨尔派的成员
suggestibility	被暗示性
preprofessional	为从事职业作准备的
erythrophilous	爱好红色的
malarky	空话
olefin	石蜡
stegomyia	埃及伊蚊
unneighbourly	不喜欢与人交往的
kindle	使着火
upbraidingly	谴责地
proser	散文般
betsy	Elizabeth
meteorolite	陨石
rf	Radio
pitchometer	节距规
japonic	日语
strigous	被硬毛的
leather	皮革
ukase	谕旨
diosmosis	渗透现象
outspend	比花费多
mushily	玉米粥状
liberatory	释放的
accusatorial	责问的
ambivalence	正反感情并存
ultrasound	超频率音响
oviduct	输卵管
squadron	空军中队
damnatory	该死的
pregnant	怀孕的
stick	棍
nannyish	过时
effortless	容易
australite	澳大利亚玻陨石
totty	发昏
cruelty	残酷
unprevailing	徒劳的
record	录音
crustily	粗暴
bachian	巴赫的
roar	怒号
grindstone	旋转研磨机
operatic	歌剧
conglutination	粘连
extraction	抽出
serajevo	=Sarajevo
reactionist	反动分子
theophagy	圣体领食
applique	贴花
illusionless	无幻觉
verus	正确
potable	适于饮用的
dentist	牙科医生
ppcc	Conference
cullion	卑劣的人
parc	Research
theban	底比斯人的
cracky	易破
delomorphous	显形的
pigeonhole	分类架
taps	丧葬号音
empathic	感情移入
oust	剥夺
mikron	=micron
dethronement	废立
dispossessed	被逐出的
fuliginous	煤烟
wisdom	学识
grandioso	雄伟的
filiferous	产丝状物
assertory	确定的
fusionist	联合论的
draft	草拟
botryoid	一束葡萄状的
exoteric	普通
zany	笨人
contextless	无来龙去脉的
semioval	半椭圆形
gentile	非犹太人
usaid	for
enfetter	束缚
syllabically	分成音节地
rule	规则
retort	蒸器
eutrophic	发育营养正常
bassi	低音部
mismatch	使配错
freeload	一种离线浏览主页的工具软件
recalcitrant	反对
federative	联邦
satisfaction	满意
nostologic	老人学的
xenophile	喜爱外国人及其文物者
cembalist	羽管键琴演奏者
surrejoin	第二次辩驳被告
quackish	庸医
fibroid	纤维性
stunt	作惊人表演
disseat	使退位
backhanded	间接的
ciliary	纤毛的
very	真实
claymore	双刃大砍刀
petiole	柄部
mock	仿制品
overmany	过多的
wean	使丢弃
bbb	bed
insider	会员
injunct	命令
offscouring	废物
muley	无角动物
ilk	家族
sha	sidereal
primitive	远古
mycetozoan	变形菌
wipo	Organization
discontinuous	中断的
fluxional	微分
devilwood	木犀
pullulation	充满
brimmer	满杯
orbiculate	球状
exonerative	免罪的
ineluctability	无法逃避
glassworks	玻璃工厂
sha	=shah
scuff	磨损
bordereau	备忘录
far	很
agreeable	适合的
dissected	分割
alogia	失语症
chainbridge	铁链吊桥
rallye	长距离赛车
comforter	羊毛围巾
examination	细查
vivax	疟原虫
cyclopic	独眼巨人的
tekecommunications	远程通信
fibrinous	纤维蛋白
vlbi	very
anglian	盎格鲁族之方言
mucker	遭到失败
unsophisticate	Id/
hawk	放鹰
hit	讽刺
shepherd	牧羊人
pannikin	小盘
bronchopulmonary	支气管肺的
ignitible	=ignitable
antarctic	南极地带
consultation	会诊
ebracteate	无苞
pram	婴儿车
warranty	保证
verily	真正
unmerge	解散
defoliant	脱叶剂
astigmatic	乱视的
prominence	显著
ejaculator	突然叫喊的人
genteelism	假装绅士的谈吐
tangential	切线
chivvy	烦扰
cytostome	入口孔
webwheel	盘式轮
diffidence	缺乏自信
leachable	可滤取
majestic	庄严的
declarative	公布
orca	类逆戟鲸
obeah	非洲黑人间奉行的巫术
centric	中心的
fencing	围墙
cmd	Modulated
hidalgo	西班牙的下级贵族
totemic	图腾的
eighty	八十
studded	镶嵌
altaic	阿尔泰山
mrcp	Royal
spermic	种子
ganda	干达人
gossipmonger	饶舌
yesteryear	过去不久的岁月
barbadian	巴贝多的
guilin	桂林
monography	=monograph
caucus	举行或参加政党领导层秘密的预备会议
fabricate	虚构
sharpshooter	神枪手
crabwise	小心地
aerodrome	飞机场
presentable	象样
drily	冷淡地
subway	地铁
deradicalize	使放弃政治上过激的立场
equivocal	意义不明确
beneficially	受益地
skirl	用风笛演奏
acrid	辛辣
toothy	露出牙齿
hairsbreadth	窄如发丝
apologetically	辩解
boresome	烦人的
slade	and
examinationism	考试论者
marblehearted	铁石心肠
microprogramming	微程序设计
gratuitous	无理由的
spreathed	痛
carpogonial	果胞
balneology	浴疗学
chopfallen	下颚凹陷的
maintainor	犯包揽诉讼罪者
phosphorylate	使磷酸化
hooflet	小蹄
orthodontia	正牙学
excrete	分泌
fable	谎言
jump	上涨
analphabetic	非字母式的
sophist	诡辩者
bedrail	床栏杆
reconcilable	可和解的
vagabond	流氓
dodecagonal	十二边形的
nectared	甘美
centra	centrum
blankness	空虚
heterochthonous	不是土生的
orbiter	盘旋物
airgraph	拍照航空信
critique	批评
doorcase	门框
dissolute	肆意挥霍
triturator	磨粉的人
charlady	零佣的女性
received	被认为标准的
decreasingly	渐渐减少地
benioff	zone贝尼奥夫带
trunk	箱子
ecliptic	黄道的
resolvent	使溶解的
enamine	烯胺
ratable	可估价
sputteringly	结结巴巴地
wadset	典当
farthest	最久
omnisex	包括男性与女性的
slatternly	自甘堕落
impedient	阻碍物
emulable	可仿效的
undeflected	不偏斜的
vagotropic	作用于迷走神经的
usual	通常的
slideway	滑斜面
kicker	善踢的人
clothesbag	放置换洗物的袋子
econometrical	计量经济学
dishy	有魅力
interpretable	能说明的
prolog	=prologue
smileless	没有笑容的
paleohabitat	史前动物栖息
detection	探测
barbados	巴巴多斯岛
proportionably	可使相称地
caravaggiesque	卡拉瓦乔作品的
bodyshell	车身外壳
permanent	持久
antibacterial	抗菌的
orifice	孔
blague	荒唐
bonded	有担保
asp	应用服务提供商
bora	澳洲土人男孩成人仪式
hydrotactic	趋水性的
sap	活力
bicker	闪动
boffo	开心的大笑
mercenary	唯利是图
gph	per
histaminase	组织胺酵素
yell	叫声
unmoved	无动于衷
separate	分散
preterite	过去时态的
evangelicalism	教义的信仰
girth	包围
connected	连接
qcb	队列控制块
magnetogasdynamic	^AsdaI`nAmIks/磁气体动力的
sclc	Christian
nlp	neighborhood
iodine	碘酒
godfather	教父
fratcher	争论
power	激励
espial	观察
pyrogenic	火成的
intercooler	冷热气自动调节机
derelict	被抛弃了
sailcloth	帆布
eradicative	消灭
photoceramics	陶瓷照相法
pseudopodium	假足
athenian	雅典的
buirdly	粗壮
archeolithic	旧时器时代的
patient	忍耐的
panchromatize	使成全色性
bellflower	吊钟花
push	增加
epitaph	墓志铭
cologne	古龙香人
aiche	of
veritably	真实地
robustious	粗野的
bargaining	交易
arcticology	研究南北极的科学
eutrophic	发育营养正常的
calceolaria	蒲包草
ppt	part
juristical	法理学
entad	向心
corking	很好
decollete	低颈露肩的
hump	弓起
inhalatorium	吸入治疗室
batrachoid	似蛙
cc	Cocos
ultrafashionable	极端时髦
driver	起子
vamper	补靴
anklebone	踝骨
liberator	解放者
programmable	可设计
joyously	快乐地
limation	锉
abolish	废除
piecewise	分段地
patriarch	最年长者
nccj	Christians
lamiaceous	属于薄荷科的
corrodibility	可腐蚀性的
extracurricular	业余的
vicarial	代理教区牧师职务
atmospherical	气压的
furl	收下
suxamethonium	司可林
wearisome	使厌倦的
geez	注射
inobservant	不遵守的
sore	剧烈
vigoroso	强地
retia	膜层
hooklet	小钩子
benthamite	功利主义者
certainly	行
deliquescent	溶解性的
eidetic	异常清晰
arrantly	声名狼籍地
rubdown	按摩
yalta	雅尔塔
shindig	吵闹
capsule	太空舱
cubital	尺骨的
upend	颠倒
purpuric	产生紫色
quilled	羽毛状
spherule	小球体
flatling	直挺挺地
frailly	不坚实地
reproachfully	责备
pots	Service
harpins	临时木材
djawa	=Java
fastening	扣紧
embay	围绕
universology	宇宙学
calyces	肾盏
icrp	Protection
nicotiana	烟草
subcrust	地壳下地层
cosmography	宇宙志
rapturousness	着迷
abrupt	生硬
uvea	葡萄膜
synchronous	同时的
auric	似金的
brogan	粗而坚固的短鞋
belgic	人的
salient	突出的
dodgery	诡计
loss	降低
nonorgasmic	不能进入情欲高潮
antipathic	不相容
overtime	加班
sestertia	sestertium的复数
corruptive	使腐败
viewphone	=videophone
sesquipedalian	多音节的
stag	牡鹿
bryony	葫芦科的一种蔓草
weather	迎风
phonotypy	音标印刷术
pyjamas	宽长裤
polak	波兰的
sketchily	写生风格地
gastrin	胃泌激素
whelk	峨螺
vulgarization	卑俗化
super	十分的
underclothed	穿着不暖的
reddish	微红的
deflationary	放出空气
whine	抱怨
talcous	滑石的
twirl	万能钥匙
cuttable	可缩减
evzone	希腊精锐部队的步兵
beslave	奴役
bepuzzlement	困惑
rambling	散漫
unfamiliar	不熟悉的
stand	维持不变
headily	性急
suppleness	柔软
coulisse	有槽木料
curvirostral	具曲喙
complot	图谋
vivarium	植物园
divinely	象神一样地
covenant	立约
barrelage	桶装量
jacobin	雅各宾派及其政策的
veratric	藜芦酸的
quadplex	四倍的
duplicate	副本
rewake	再觉醒
chutzpa	胆大妄为
lovelorn	害相思病的
unfading	不褪色的
monocephalous	具单头状花序的
brimful	满到边际的
awanting	缺乏的
jallopy	破旧汽车
dealer	商人
alacritous	活泼的
singular	非凡的
meshy	网状
corner	角落
townish	城镇的
spherical	球形的
refutatory	驳斥
kingship	君主政体
rue	悲伤
clime	地域
featheriness	羽毛被覆状
buddha	佛
scientific	科学
deuterostome	后口动物
crotcheteer	耽于幼想的人
jildi	忽忙
phenomenon	现象
vanish	消失
parentheses	插曲
scrimmage	并列争球
abortively	失败地
overdare	行事过于胆大
wow	叫声
xenophobic	恐惧外国人的
timpanist	定音鼓手
peristaltic	蠕动的
tumble	翻倒
maxisingle	密纹唱片
binnacle	罗盘箱
disprove	证明……为误
webmaster	WEB站点管理员
colorful	色彩的
rupestrian	由石头构成的
packinghouse	屠宰加工厂
wintry	冷淡的
pictorially	绘画般地
hyperfunction	机能亢进
peradventure	疑惑
inalterable	不能变更
exalted	尊贵
bilabiate	两唇的
purbeck	波倍克
fit	突然发作
relique	遗风
canthus	眦
agamic	无性的
nii	Information
grubber	孜孜工作的人
mizzle	下蒙蒙细雨
supercoil	超螺旋
dts	Theater
sudoriferous	发汗
triton	氚核
gossamer	薄弱
undefended	无防备
nasty	凶相的
rethink	重想
croquet	循环球戏
lecherous	色情的
subline	亚系
fullhearted	热情
subsaturated	不完全饱和的
heroize	使英雄化
cadmiferous	含镉
recalcitrant	反抗的
ebb	弱
maungy	闹别扭
valorously	无畏地
infighting	接近战
seaward	海那一边
trotty	疾走
albuminoid	蛋白似
tactful	机智的
straight	一直
popular	受欢迎的
yieldingness	易弯曲
eternity	来世
exception	反对
pimozide	哌迷清
sensation	感情
linter	剥绒机
cardiac	贲门
balibuntal	棕榈纤维女帽
prosopopoeia	拟声法
unthinking	不留心的
exhaustive	无遗的
outrageous	令人不可容忍
discharger	卸货人
estate	财产
wheeled	用轮子行走的
defatted	脱脂
hypnotically	用催眠术
nonunionist	不属于工会之工人
sacchariferous	产生糖
sanguinity	血色
francophile	亲法的
betray	露出……迹象
execution	杀伤力
sweepstakes	比赛
orion	Diana
redemptive	挽回
owing	由于
dazzle	眩耀
vulvae	女阴
unwitting	不知情
volitant	能飞的
revivalism	复兴倾向
kenyan	肯尼亚共和国
fear	为……担心
confesser	忏悔者
padre	教士
masterstroke	妙举
fastigiate	圆束状的
successivity	依次相继
mean	有意义
faustus	=Faust
time	定期
coed	男女合校大学中的女生
vicarial	代理
work	煅制
cocoa	可可饮料
projecting	突出的
outmoded	过时的
fishermen	渔夫
wired	以线加强的
bivouac	露营地
pure	纯洁的
acromegalic	肢端肥大症患者
grassland	草原
extramundane	超越现世
stanniferous	含锡的
horrific	令人毛骨悚然
greensick	患绿色贫血的
rollock	胡扯!
connivancy	默许
cant	倾斜
apiece	各
indescribable	难以形容
inflect	发生弯曲变化
maximite	马克沁炸药
hypoptyalism	涎液过少
unsoldierly	不英勇的
triaxial	三轴的
duodecimal	十二分之一
reedy	芦苇状的
diathermy	透热疗法
myxasthenia	黏液分泌机能衰弱
saprobe	污水生物
eminent	有名的
flask	长颈瓶
extinguish	压制
undisguised	不戴假面具
innavigable	不能航行的
genicular	生在关节上的
sogat	Graphical
wacky	古怪
sleeping	睡眠
actin	肌动蛋白
solus	单独
stealthy	秘密的
waco	韦科
pretense	自称
gabbroid	似辉长岩的
quantize	使量子化
aphicide	杀蚜虫剂
rusty	生了锈
gainer	胜利者
lynx	猞猁
derail	出轨
hexavalent	有六价的
trimetrical	有三音步的
bullous	大疱的
tyrannic	暴虐的
scindapsus	马来西亚绿萝
electrify	使充电
expellant	驱逐的
waterlogging	涝
vibratory	振动
swale	放火烧
culmiferous	含有碳质页岩的
remarkable	显著
inexpectant	不期待
abnormality	变态
ohioan	俄亥俄州人
spontaneously	本能地
pergana	=pergunnah
possie	职务
perigynous	周位的
pacesetter	先导者
palaver	哄骗
ryazan	梁赞
lively	栩栩如生
grandmother	祖母
ornate	绚丽
filigree	易损之物
dairymaid	酪农场的女工
musjid	=mosque
flavorous	可口
notturno	小夜曲
elimination	消灭
unfastidious	不过分讲究
outen	从…………里面
exculpation	使无罪
exodontics	拔齿学
temple	鬓角
chalone	抑素
gloxinia	大岩桐
unrhythmic	没有节奏
elliptoid	椭圆的
amitrole	氨基三唑
raffinate	剩余液
catalogic	目录
sapor	风味
inconstancy	反复无常
flaxen	亚麻
lithe	易弯
nummulated	钱币形的
pecan	美洲山核桃树
impresario	演出者
baconian	归纳的
amygdule	杏仁孔
attitudinarian	装模作样誌En/
conceivable	可能
unexacting	不需付出很大努力的
roe	鱼卵形黑色斑纹
lipidic	油脂
jejuneness	空洞
quit	停止
thessaly	塞萨利
shopworn	在商店中陈列旧了的
diffusor	=diffuser
inconsistent	不一致的
elucubrate	努力作出
dwarfish	矮小
courthouse	郡政府所在
reformational	改革
ultrastructure	超微结构
demoniacal	狂暴者
otherwhere	在别处
foolish	愚蠢的
averseness	厌恶
chemoprophylactic	化学品预防
adgb	Defence
quadrilateral	四角地
pretty	优美
pressure	电压
demonic	有魔力的
solemnly	庄严地
hypostatization	使人格化
giddy	头晕的
snoopy	爱管闲事
unseen	未经预习的
stipes	甲壳类及昆虫的第一对足的第二节
greediness	贪吃
calfskin	犊皮所制的革
homebred	在家里养大
hogback	陡峭的山地
ocdm	民防国防动员署
hydrostatical	静水力学
scarce	缺乏的
racquetball	短网拍墙球
gastrea	=gastraea
desponding	沮丧
prevoyance	先见
shillaber	道旁小贩
abraxas	古时刻在玉石上避邪的文字
superpotency	效力过高
ymha	Men''s
mesh	以网捕捉
unstable	不牢固的
intomb	安葬于墓中
delusive	迷惑
radicand	被开方数
equicontinuous	同等连续的
sgml	Markup
textured	手摸时有感觉
staple	常用
diencephalon	间脑
infanta	公主
rondavel	圆形茅屋
contractive	有收缩性
pekingology	北京学
cinq	=cinque
curie	居里
spittle	唾沫
semiarboreal	半树栖的
isa	Architecture
philtre	使兴奋
supernaturally	超自然
exotoxic	外毒素的
stygian	阴暗的
incomplete	不完善的
unentertained	未得到娱乐
sitting	就座的
edifying	有益的
yankeeland	美国
ruck	变皱
baor	Rhine
multisensory	多种感觉的
disquisitive	研究的
deferentially	谦恭地
scapular	肩的
colligative	依数
decapitation	撤职
expropriation	征收
napiform	芜菁状
gammer	乡下老太婆
retrospection	回顾
nameless	难以形容
germless	无菌
protest	抗议
declension	格变化
suburbia	郊区
eidetic	异常清晰的
codominant	等显性
medaled	接受奖章的
immaterialism	非物质论
egoboo	自我赏识
hypophoneme	下音位
caste	印度的世袭阶级
pharmaceutics	制药学
stormy	暴风雨的
scrutable	可解读的
viny	葡萄树的
sartorial	裁缝的
molwt	weight
smokeproof	防烟的
immunize	使成为无害
ideography	象形文字使用
forgivingly	慈悲地
ectogenous	体外生活的
flavourful	美味的
unthinking	无思想的
vasostimulant	刺激血管
unfeeling	无情的
haut	高级
hymeneal	结婚典礼
slaveocracy	美国南北战争前南方的奴隶主集团
fallow	休耕的
osteomalacic	骨软化的
bodhran	宝思兰鼓
ergosome	动体
technicality	专门性
radicle	基
potent	有效
babylonish	言语不清的
curare	箭毒马鞍子
reforming	重整
medusa	水母
flagellatory	鞭打的
tumble	使摔倒
sloven	懒散的人
hate	不愿
deign	屈尊
lenore	勒诺
mirable	极好的
sile	流下
masquerade	化装
romanian	罗马尼亚
setup	组织
mortar	用灰泥结合
proclamation	宣布
reproachful	责备
tackle	抓住
goldminer	采金者
underhung	有突出下颚的
outeat	吃得比……多
hazel	淡褐色
autochthonal	土生
denish	丹麦语
cankered	不怀好意的
nanoplankton	=nannoplankton
brace	曲柄的
renegue	拒绝
unload	倾销
yikker	发出重复短促的尖叫声
quarterback	四分卫
pool	郁积
expiate	赎罪
trough	木钵
inlet	水湾
volksdeutscher	德侨
frisian	Friesland人
grafter	收贿者
mfh	Foxhounds
muggins	蠢人
hexasyllable	六音节
interpellation	要求说明
dissociable	自相矛盾
untoward	麻烦的
epidermal	表皮的
sulcate	有槽
shakily	不坚定
extern	外来
sop	面包片
plateau	高地
amerciable	应罚款
shirring	装饰性的褶带
residua	残渣
goluptious	可口的
meshwork	网络
clerestory	天窗
unclarity	含糊
characterless	缺乏特征
pc	巡逻车
roughwrought	粗制的
renovate	革新
mischievous	淘气的
contretemps	不幸的
downright	显明的
clubroom	俱乐部聚会室
invincibility	绝对不败
fasciae	招牌
final	期末考试
xylophagous	蚀木
deed	立契转让
mtu	Mobile
annelid	环节动物
quadrate	长方形的
flocky	毛丛多
specie	硬币
subtilisin	枯草杆菌蛋白酶
omnipresent	同时遍在
manhattanize	使高楼密集
spermatocide	杀精子剂
sleeping	睡着的
xeroform	三溴酚铋
extractable	可引出
indeterminable	不能解决的
mandril	芯棒
hoofer	职业舞蹈家
nonfreezing	不会结冻的
fletch	装上羽毛
sound	健康
candlestick	蜡烛架
ground	面上
ballsy	有胆量的
spindlelegs	细长的腿
donatory	捐赠领收人
sackless	麻木的
lull	使平静
pronumeral	未知数
sargassum	马尾藻类海草
thunder	打雷
ultrasonic	超声
evacuant	排泄药
wisperer	咬耳嚼舌者
mungarian	匈牙利人的
mzee	老人
alackaday	哀哉
dilettantish	业余爱好
alarmedly	惊慌地
clerestory	通风窗
spirit	火力
camptothecin	喜树碱
electoral	选举人
sceptre	授予节杖
cussword	下流的话
bat	装甲兵基础训练
overearnest	过于认真的
leftism	左派观点
pluralist	兼管数个教堂者
sulfureous	硫磺质的
convolve	缠绕
tumular	冢的
positronium	电子偶素
zany	愚蠢
malwa	马尔瓦饮料
levity	不稳定
faltering	蹒跚
lipbrush	唇膏刷
wily	老谋深算的
goldie	金奖唱片集
mikimoto	三木本
serviette	餐巾
mystificatory	使人困惑不解
photochrome	彩色照片
hedgepig	环形筑垒阵地
reflectible	能反照
asp	白杨
golden	极好的
botb	Board
expertise	专家的意见
dogbane	夹竹桃
bloodsucker	剥削者
grouch	心怀不满
oatmeal	麦粥
raid	Indepnedent
haemophiloid	类血友病
impresario	经理
serialize	使连续
daledh	=daleth
lacunaris	多孔的
flaring	发光的
greener	生手
stagger	交错的
albuminose	多胚乳
neocolonial	新殖民主义的
unsharp	不锐利的
conspiratory	阴谋者的
disillusion	醒悟
secretory	能分泌的
mystagogic	传授秘诀
transportation	运送
inauthentic	不可靠的
bioelectrical	生物电的
guff	瞎扯
farmyard	农场建筑物周围的空
monotonize	使单调
reductant	agent
grumbling	出怨言的
calm	镇定
sap	使衰竭
joss	佛像
backplane	底板
comate	有毛的
longshoreman	港口工人
prickle	刺痛
constitutive	构成的
stormy	暴风雨
slubberdegullion	二流子
disagreeably	不愉快地
sbc	单板机
deceive	欺骗
analytics	分析学
labiate	唇形的
desultory	散漫
quavery	震音
airborne	空气传播的
determinatum	受定语
overplay	夸大……的重要性
dynapolis	大城市
ai	insemination
underivative	不乏独创性的
fibre	纤维制品
squalor	贫穷
tearaway	行为鲁莽的
ingrowth	向内生长
wee	微小
vibronic	电子振动
imperil	危害
anabiosis	复苏
aglow	通红的
wishful	想望
workstation	工作站
shroud	寿衣
kickshaw	精美菜肴
circumlittoral	沿海
outstation	分部办事处
jollify	高兴
resignation	辞职
dynamics	动力学
rupicolous	居住在岩石丛中的
wps	由金山软件公司开发
intersect	相交
perpendicular	正交
fat	Allocation
pioneer	先驱
skidder	集材道横木
temperate	有节制
stolen	steal的过去分词
halves	同分数
singularity	奇妙
theirselves	pro
blockade	封锁
jurat	治安推事
nonenforceable	不可实施的
fretted	腐蚀的
realistic	现实的
tenderness	亲切
flush	挥霍的
oklahoman	俄克拉荷马州人
roisterous	作威作福
share	共有
logo	标识语
stagnantly	淤积
laced	加酒的
slaver	唾液
dense	密集
fm	symb
ens	有
xenon	氙
ironing	熨平衣服
poppied	鸦片麻醉
histogram	柱状图
rune	古代北欧使用的文字
voluminous	长篇的
fictile	陶制品
expediency	方便
escarpment	陡斜坡
calcariferous	有距
suprarenal	肾脏上的
whopping	非常地
superior	高傲
psychotoxic	有害的
lobbyist	说客
vraisemblance	可能性
sing	演唱
inappreciative	不欣赏的
goodwill	亲切
rockies	洛矶山脉
pothouse	酒馆
paycheck	付薪水的支票
exposure	方向
stratigraphic	层学
hairpin	束发夹
asio	Input/Output
progenitive	繁殖的
flyspeck	小斑
remember	回忆起
pots	Telephone
mankey	=manky
madras	马德拉斯布
sporicidal	杀孢子
theanthropic	具有神人两性的
cockeyed	斗鸡眼
needful	需要
symbiote	=symbion
comforter	慰问者
vulgarism	粗俗
moorfowl	苏格兰雷鸟
thin	薄的
fat	肥肉
connatural	先天
triplicate	三分之一
magcon	磁选
vexedly	着急
religionist	宗教家
apprenticeship	学徒的年限
wither	使畏缩
damnably	厉害地
alexin	杀菌素
contemplative	沉思的
skipper	船长
newsiness	饶舌
hit	打击
africanist	非洲语言研究者
lop	砍伐
inartistic	缺乏艺术性
marriage	婚姻生活
naughtily	无礼地
flavourful	可口的
flashover	跳火
apophatic	用否定方法所得的
leewardly	动辄要滑向下风处
upu	Postal
telukbetung	直落勿洞
sigmoid	S形的
thermomotor	热发动机
hinterland	腹
gunner	管理军械的准尉
sleepful	睡得很安宁
epulotic	收瘢药
candent	白热
abcd	and
appellate	受理上诉的
ladder	梯子
anaemic	贫血
wilderness	大量
partnership	合股
pusillanimous	优柔寡断的
sassy	时髦
loveliness	可爱
cognizant	认知
unrifled	未在枪膛内制来复线
cenobian	修道士
running	连续的
responaut	靠呼吸器维持呼吸的病人
parentheses	插入语
fortifiable	可以弄巩固
fulcrum	叶附属物
pyrex	其商标名
distemperedness	不健全
reluctation	表示勉强
ignimbrite	熔灰岩
horsepox	马痘
trustily	忠实
scenic	舞台的
gmbh	Gesellschaft
juncaceous	灯心草科
redoubted	可惧
trickish	欺骗的
stockbrokerage	证券交易
stupefactive	使人麻木
molecule	些微
bishopric	主教辖区
fondly	怜爱
towardly	温顺
lou	卢
afterburner	喷射引擎等的加力燃烧室
sled	乘雪橇
histotomy	组织切开术
roundabout	迂回
britannia	大不列颠之古拉丁文名
smriti	传承
welsher	骗人
blossom	兴旺期
dogdom	养狗界
pervious	能被通过
troublous	动乱不安
mesh	网孔
amvets	第二次世界大战美国退伍军人协会
cinematic	电影的
flexure	弯曲部分
clodhopping	粗鲁
increately	原存
volatilizable	可发散的
gun	手枪
working	劳动
rifleman	步枪射手
microdetector	灵敏电流计
railroading	铁路建设
benignantly	仁慈
mousey	像老鼠
oscillograph	示波器
jones	琼斯
waste	荒
louvered	像百叶窗板一般安排的
feldspathic	长石质
normothermia	体温正常
outseg	主张比……更强烈的种族隔离政策
captive	被迷住
indefeasible	难使无效
detritivorous	食粪的
always	永远
talking	说话
tautologist	反复用同义字的人
copiously	丰富地
wail	痛快
kevazingo	一种非洲西部的树
mcluhanesque	麦克卢恩学说
shaikh	族长
denunciate	谴责
vauntful	自负的
diversely	各色各样
obvious	明显的
threadlike	线状
outlook	风光
falafel	沙拉三明治
clear	清楚的
kenspeckle	显著
pauline	使徒保罗
fitch	臭猫毛
jnd	Noticeable
goatee	山羊胡子
rhinostegnosis	鼻狭窄
artel	合作社
sacral	荐骨的
censorial	监察
subaltern	次的
tumpline	前额
serenade	唱小夜曲
emulsive	可榨出油来
point	指向
racerunner	鞭尾蜥
unsuitable	不适合
unconspicuous	不明显
netlike	网状的
preoccupant	抢先占据的
bullpen	候补队员区
lettered	有学问
australasia	澳大拉西亚
infraction	侵害
digress	离题
schanz	小堡垒
instate	任命
veil	面罩
condyloid	髁状
trotskyist	托洛茨基分子
shop	购货
paralympics	原为脊髓病患者举行的运动会
haematoblast	成血细胞
hoofbound	兽蹄因病而感到疼痛紧缩的
refutatory	辩驳的
inbuilt	嵌入
neuter	中性的
hardhattism	强硬保守主义
tercom	terrain
pharmacy	制药业
autobiographic	自传体的
humpy	多隆肉的一般
nom	有名无实
unplaced	没有入选的
stage	舞台
with	就
anonymuncule	无足轻重的匿名作者
nuncio	罗马教廷大使
starflower	开星状花的植物
leafage	叶子
holobenthic	终生在海底或靠近海底生活
pretonic	重读音节前的音节
tailorship	裁缝业
vagile	漫游的
baor	英国驻莱茵军
idyllist	田园诗人
salvage	救难的奖金
episcopalian	主教制度
xanthone	一种化学原料
bounteously	丰富
tarsal	跗骨的
individualise	使个体化
nother	不同的
half	一半
yafa	=Jaffa
uxoriously	疼爱妻子
befallen	落到
jazz	跳爵士舞
service	服务
univalve	单瓣
pyxides	宝石盒
covenanter	盟约者
exploration	探测
eruptive	喷火的
gab	空谈
chirognomy	手相术
callboy	唤演员按时上台之人
rap	叩击
plosive	爆破音的
arrastra	用来磨碎金或银的研磨机
topnotch	第一流
admirer	赞赏者
period	学时
goldminer	金矿工人
felicitousness	恰当
trunk	干线的
olibanum	=frankincense
nitric	含氮的
fantastically	空想地
floorer	打败
evolutionary	进化的
demanding	过分要求的
pompous	华而不实的
warrior	勇士
pregnable	可受孕
toffee	胡说
excursion	漂移
positronium	正电子素
ayrshire	苏格兰西南部一州
corollaceous	花冠的
nucleoprotein	核蛋白质
fishfag	卖鱼女
bitumastic	沥青砂胶的
backstop	支持物
plummet	重荷
khanga	肯加布
scorer	刻划痕迹的人
transcontinental	横贯大陆的
surfeit	使饮食过度
rangey	=rangy
killick	石锚
cadence	节奏
bloop	将棒球打到内外野之间
screwball	奇妙
tracheal	呼吸管的
anubis	导引亡灵之神
argentine	银色
highness	高度
monotrichous	单鞭毛的
technocrat	专家政治论者
separatory	使分离
persecute	迫害
orthophoto	正色摄影
uscg	Coast
chemotherapeutant	化学治疗剂
fosbury	福斯贝利式跳高
naxalite	纳萨尔派分子
torsibility	可扭性
aeromarine	海上飞行
comb	梳子
phytol	植醇
corporate	法人的
repulse	严拒
derivative	引出的
hyperaggressive	咄咄逼人的
pleochroism	多色性
shush	嘘声
muster	集聚
copemate	同志
twitch	痉挛
lumberyard	木材堆置场
supersensuous	超感觉
leprology	麻风学
lulu	俊秀
remember	铭记
acquired	后天通过自己的努力得到的
bonny	漂亮的
wildfowl	野禽
filling	供应
anisometropia	屈光参差症
complaint	委屈
diagrammatic	图表
resplend	发亮
biyearly	每年两次
apocalyptical	天启的
issuable	争论的
dominance	统治
sumptuously	奢侈
authoritative	权威
smooth	平稳的
unvaryingly	恒久地
folkloric	民间传说
belted	佩礼带的
ordure	排泄物
relatival	关系词
canalicular	小管的
listeriosis	李氏杆菌病
overbore	overbear
nutter	疯狂之人
specially	临时地
comptometer	其商标名
impervious	不让进入
contrafactual	违反事实
menses	月经期
anisotropic	各向异性的
florid	华丽
down	开阔的高
pontoon	浮码头
isoantibody	同族抗体
cordwain	科尔多瓦皮
meniscoid	新月形的
vasculitic	血管炎的
shrubby	灌木
hazy	模糊
lanigerous	羊毛状
dinky	不足道的
leucocyte	白血球
monologue	独脚戏
cry	哭声
sunlike	非常明亮
antipathetic	嫌恶
fmcs	Mediation
withoutdoors	=outdoors
ranchman	大农场经营者
intragalactic	星系内的
protostellar	形成恒星的
gemmulation	生芽
handgrip	有力的握手
intensify	加强
rsd	of
solubility	溶度
smallholding	小农地
impressionistic	印象主义
displace	置换
hindustani	印度人
aphthong	不读音字母
numerical	数字的
blat	叫
evadingly	躲躲闪闪地
rigor	严厉
realizing	清晰生动地
busybody	好事的人
beylik	土耳其省都辖区
greasy	多脂
budget	做预算
swimgloat	继续奋发的喜悦
foliature	=foliage
hydroacoustic	水底传音的
noteworthy	值得注目
myosis	瞳孔缩小
cenobian	寺院的
karakalpak	卡拉卡尔帕克人
diaphanous	精致
recognise	承认
planetology	行星学
fany	Yeomanry急救护士队
set	移动到
period	句点
sweepup	大扫除
concourse	群众
australopithecus	南猿
cymiferous	生长聚伞花序的
jaap	乡巴佬
biparental	双亲的
woops	=vomit
slowly	迟缓地
segar	=cigar
laddish	男孩的
yha	Youth
csce	Conference
finis	终
concur	同时发生
moneychanger	货币兑换商
unedified	未被启发的
phenylalanine	苯基丙氨酸
excusably	可宽恕地
whisker	使有须状物
jerrycan	五加仑装之汽油罐
masan	马山
rotfl	on
undertook	undertake的过去式
fishwoman	粗野的女人
hydrangea	八仙花属
kaiserdom	政权
monocarpellary	单心皮的
smug	自鸣得意的
oke	好的
befringe	饰以边
unpardoned	不被原谅
retroussage	油墨移印
gentelmancommoner	特别自费生
beatlemania	披头士狂
aerify	掺气于
remorselessly	冷酷地
cragged	崎岖的
synonymous	同义
tubate	形成管
misname	给……取名不当
cardiophobia	心脏病恐怖症
teachableness	可教性
vindaloo	咖喱肉
generic	类
muslim	穆斯林
empire	帝权
miswrite	把……写得不当
hilly	多坡
homeopathist	同种疗法医师
unheated	未加热
contagium	接触传染物
needless	不需要
cockchafer	小金虫
nucleophilic	亲核的
mantic	预言
emmeniopathy	月经病
alienist	精神病医生
ddvp	敌敌畏
revisionary	校订的
siren	响着警报器行驶
ephemeral	短命
laudatory	赞美的
aigrette	白鹭
privilege	特别待遇
grubstake	食物物质的援助
devilled	蘸了很多芥末的
geographical	理
rude	无礼
ucky	令人厌恶的
hardy	难
exhortative	劝勉
lighting	点火
outsung	的过去分词
uninquiring	不打听的
frostbiting	驾滑冰船
pomatum	=pomade
bellboy	侍者
nucleal	=nuclear
astrictive	止血
scurrilously	下流
tubicorn	有洞角的
napalm	凝固汽油
via	通过
aerobee	高空探测初期用的一种火箭
retinene	维生素A醛
grate	壁炉
filly	活泼的
nonmonetary	非金融的
apatetic	拟色的
restfully	平安地
dimension	尺寸
disgustedly	厌烦地
newsvendor	书报摊贩
ailurophilia	爱猫癖
contrive	图谋
subhumid	半湿润气候
incrust	覆以皮
probably	或许
tache	搭扣
irgb	Red
unexpressive	=inexpressive
miscible	易混合的
depressed	降低
raptatorial	食肉的
riometer	宇宙噪声测量器
ribbing	田垄
tartufe	=Tartuffe
eudiometrical	量气管的
mobile	机动的
burnoose	=burnous
fissile	可分裂
ascertainment	探查
bpd	barrels
haft	装上柄
argute	尖
lamination	迭片结构
oeec	Organization
landlordly	房东
implacability	不安静
butcherly	无人性的地
foresighted	有先见之明
limitrophe	位于边界上
nudibranch	裸鳃亚目动物
unread	无学问
sadistic	残酷成性的
liminary	卷头的
transcurrent	横推的
skulker	偷偷隐躲起来的人
palaver	阿谀
abasement	降低
baptismal	洗礼
belibel	诽谤
glowworm	萤火虫
unshed	未吐露
lateral	侧面的
afloat	传播
mispleading	申诉
striking	惊人
intransitivize	使成为不及物
seclusive	爱孤独的
carpetweed	粟米草
detergent	清洁剂
fortyfold	四十倍的
smear	涂污
yammer	哭泣
soundless	无声
effectuate	完成
worked	处理过的
benares	贝拿勒斯(印度东北部城市瓦腊纳西
legendary	传奇文学
talocalcanean	距的
hesitance	踌躇
ectotropic	外生
lorryhop	沿途免费搭乘卡车旅行
byronic	拜伦的
adsorbent	吸附
yperite	芥子气
introductive	介绍
vicarial	教区牧师的
saxicavous	钻岩的
baculine	棒
doited	昏头的
grandfatherly	祖父似的
turnstone	翻石鹬
defence	答辩、辩护
kcps	千赫
chickenlivered	胆小
upward	向上的
blithe	高兴
amaldar	代理商
counterproof	反转打样
nervine	有镇定作用的
cosmonaut	航天员
victoriously	胜利地
strange	生疏
yore	昔时
plump	沉重地
fallen	的过去分词
typhlosole	纵褶
premarketing	上市销售以前的
existent	现存的
stonework	做石工的场所
orbicular	环状的
sputter	劈啪声
coypu	南美洲产的一种水栖动物
criminal	犯罪的
poculiform	杯状
lurcher	奸细
flunk	失败
naxos	纳克索斯岛
quinnat	大鳞大麻哈鱼
radicular	小根的
land	地带
hunchbacked	驼背的
unquestionable	毫无疑问的
malformed	难看
theses	指挥棒的朝下挥动
dysphoric	烦躁不安
fend	谋生
seafaring	水手工作的
sysop	站长
cap	帽子
icaaaa	Athletes
madid	泪汪汪的
gmat	time格林尼治天文平时
ambiguously	引起歧异
loose	释放
retiform	有交叉线
glareproof	防眩的
malassimilation	同化不良
diligent	勤勉
razzberry	=raspberry
drogue	浮标
grist	尤指磨成粉用谷物
pumiceous	轻石
cryology	冷藏学
cynicism	冷嘲热讽
yaf	for
literarily	文学上地
mealie	玉米
isopycnic	等密
visualizer	观察仪
scene	景色
validate	验证
radiological	放射线学
auditor	计员
potatory	耽于饮酒
osier	柳条做
matlo	水手
nonscheduled	不定期
rattling	极佳
observable	引人注目的
delation	告发
marrate	叙述
extensor	伸肌
morality	道德
oleo	人造黄油
prehnite	葡萄石
purpuric	有紫色的
somnambulant	患梦游症的
reichsmark	马克
musky	麝香似
unpleasure	不满足
sanguine	红腊笔
sheepskin	羊皮
humous	腐殖质
thalli	菌体
esteem	尊敬
natsopa	Assistants
deoxidate	=deoxidize
ostracism	放逐
unavoidably	无可奈何地
synallagmatic	双务
somatotopical	躯体特定区的
antimeric	体辐的
mutiny	造反
vicarious	代理人
pellicular	薄皮的
unmitre	摘除……的主教冠
courtliness	恳挚谦恭
irbm	ballistic
mucky	粪肥
ocellus	眼孔班
yellowwood	香槐
bantin	=banteng
imperceptive	无知觉能力
dunhuang	敦煌
biaxial	二轴的
groovy	很帅
worktable	缝纫桌
goatmoth	柳木蠹蛾
antiquarianize	沉迷于收集古物
hakeem	学者
saving	搭救
unsized	未上浆
apocope	字尾音消失
soul	精神
cdgps	Global
merton	默顿
husbandage	船舶管理费
equalizer	平衡装置
ginnery	轧棉厂
cornuted	妻子与人通奸
fuliginosity	黑褐阴沉的状态
manipulator	操纵者
george	男子名
captation	沽名钓誉
troglodyte	穴居人
argent	象银的
eleusinian	市的
predestine	注定
platitudinarian	平凡
scissor	截取
shutterbug	摄影爱好者
gloomy	阴郁的
roofed	屋顶的
formicate	群集
ostentatious	卖弄
haulabout	煤船
spiniform	脊柱形的
emotionalism	诉诸感情
hortative	劝告的
hallway	走廊
charge	控诉
repellant	=repellent
dicta	格言
burse	钱包
fidgety	不沉着
chronical	=chronic
cauterant	烙铁
calumnious	中伤
invisibility	看不见的东西
nachschlag	后倚音
downright	率直的
anticlastic	鞍形面的
schvartze	黑人
pock	麻子
iocu	国际消费者联盟组织
villeinage	隶农土地保有条件
liegeman	臣下
banefully	有毒地
monica	莫尼卡
donum	德南
hideously	非常讨厌地
rural	乡村风味的
unsheltered	无居所的
compound	混合
design	纲要
perch	杆
partizan	敌后游击队员
tabard	一种粗大衣
unselective	没有选择性的
batta	战时津贴
wscf	Christian
absquatulater	开小差者
feverous	发烧
demagoguery	散布谣言
chateau	城堡
harmlessly	无害
uncivilly	无礼地
atactic	不规则的
berwick	贝里克郡
doublethink	思想矛盾
succinctly	简便
leatheroid	人造革
mamillate	有乳头状突出物
chesterfieldian	温文儒雅
psat	Preliminary
controllable	可操纵的
oenophile	酒品尝家
creel	线轴架
pyramidal	锥体的
basketballer	篮球
cove	小湾
idolum	幻象
clabber	凝结
unbutton	解开钮扣
comeliness	好看
wee	极小的空间
whoopee	欢闹
fibrotic	纤维变性
corruption	贪污
signee	签名者
tangential	切线的
untorn	未撕开
separation	分开
ascosporous	囊孢子的
rehearse	排演
distributive	分布的
gamogenesis	两性生殖
loose	不精确
intermarry	通婚
posturize	使摆出特定姿势
tackle	捉住
brainwashing	洗脑
cornball	不懂世故
dirty	卑鄙
dividend	被除数
microplankton	小型浮游生物
jinnee	神灵
lithology	岩性
victoriously	获胜
ssid	Radio
recessive	逆行
stoical	不以苦乐为意的
redoubtable	可怕的
nobbily	华丽
outline	略述
trunk	躯干
barbiturate	巴比妥酸盐
volutin	异染质
slaggy	熔渣的
tuatara	大蜥蜴
falconer	以鹰狩猎者
swale	沼泽地
lineable	=linable
ambush	伏兵
participate	参与
embassage	大使
flourish	华饰
standing	常备
windchest	风箱
ascanius	阿斯卡尼俄斯
prelexical	词前的
frontlet	额
tarmacadam	柏油路材料
trigynous	具三雌蕊
atwitter	紧张的
immunize	使免疫
bifocal	双焦点的
vanda	万带兰
indeterminate	不确的
cephalate	有头
granddam	祖母
predicability	可断定
logy	呆呆的
severalfold	有几部分分
miraculous	不可思议的
scale	比例尺
arithmetic	算法
tripterous	三翅
female	妇女
tetrachloromethane	=carbon
alongside	在旁
fecaloid	粪便状
supervise	监督
sonofabitch	a
sackless	软弱无能的
osf	Francis
expositive	评注的
catarrhal	卡他的
oni	Intelligence
nehemias	=Nehemiah
bum	闹饮
radiesthesia	感应力学
spontaneously	自然地
ragger	新闻记者
convivial	欢宴的
exhaust	耗尽
mut	无足轻重的人
niellist	乌银镶嵌师
griselda	顺从而有耐心的女人
ashtray	烟灰缸
cotemporaneous	同时代
freak	畸形人
sphenoid	楔状骨
libertine	自由思想家
forgetfully	不注意地
intermetallic	金属间的
echolocation	回声定位法
ncte	of
retort	反击
aperitive	有轻泻效应的
torture	使弯曲
corruptive	腐败性的
rowton	罗顿屋
loanword	借用词
hermit	隐居者
succous	体液的
argyrol	含银液
decampment	撤营
pasture	牧
antimicrobial	抗菌
tribromoethanol	三溴乙醇
abstemious	有节制的
incarnadine	肉色的
fertility	肥沃
tulwar	曲刀
ultraleft	极左的
husk	削皮
inobservantness	怠慢
rhythmicity	节奏性
antibiotic	抗生的
iridaceous	鸢尾科的
digenetic	世代交替
hypotrophy	不足生长
indeterministic	非命运论者的
jar	刺激
hushpuppy	油炸玉米饼
responsibility	职责
spicebush	山胡椒
pyloric	幽门的
vow	誓约
cremation	火葬
tweet	自录音再现装置发出的高音
lectorship	大学讲师教职
booby	呆子
hostage	抵押品
adrenocorticotro	亲肾上腺皮rophic/E`dri:nEJrophic
sepsis	脓血症
irreciprocal	非互惠
maniple	饰带
nonresistant	不抵抗
russetish	略带红褐色的
graininess	多粒的
aeroplane	飞机
irreproachable	无缺点的
futhorc	北欧古字母表
flintiness	冷酷
poltfooted	足畸形
downright	彻底
remorseless	不屈不挠的
procurement	获得
shekel	古希伯来或巴比伦的衡量单位
pine	憔悴
vellum	犊皮纸的
hope	盼望
wassat	=what''s
scanning	扫描
ducky	可喜的
cellulosic	有纤维质的
biomathematics	生物数学
scaphocephaly	舟状头
npl	国家物理实验所
corsetiere	女服胸衣商
undefiled	纯粹
destructor	垃圾焚毁炉
superrat	超常鼠
tribromoethyl	alcohol=tribromoethanol
ruthenium	钌
haematogenesis	生血
detached	分离的
erven	erf的复数
recapitulation	摘要重述
iba	Authority
speediness	迅速
lecherous	淫荡
scar	结疤
natiform	臀形的
rush	闯
cap	amplitude
explicative	阐明
assentor	赞同者
wassailer	祝酒者
loop	使成环
rate	价格
unknown	不知道的
gnathonic	谄媚
malodorous	有恶臭的
vermouth	苦艾酒
bromate	使与溴化合
gallnut	没食子
ponce	靠妓女为生的人
thatchy	多茅草的
bachelor	文理学士
pungent	严厉的
presenile	未老先衰的
spiritualization	精神化
litigant	诉讼人
yokefellow	配偶
archduke	大公
occultism	神秘论
stale	走味
lagging	绝缘层材料
escap	for
cespitose	丛生
craze	狂热
stoke	司炉
featly	伶俐地
urc	Citation
isogamous	同配生殖
bowls	保龄球
correlativity	相互关系
moneygrubbing	积蓄钱财的
transthoracic	经胸廓
freewheel	凭惯性前进
sapphiric	蓝宝石质的
steatite	块
hardtop	有金属顶盖的
nomad	游牧
ekistics	城高及区域的规划学
predicament	困境
typothetae	印刷业同业协会
britches	裤子
mitred	戴着主教冠的
jadishly	毫无价值地
appreciatory	欣赏力
saponated	与皂化合
toddy	棕榈汁
eelworm	线虫
unsound	不佳
dense	浓厚
mozzarella	色白味淡的
mutiny	反抗
broma	去油可可豆
irruptive	突入的
fortifiable	可以弄巩固的
plug	堵
definitive	权威性
swede	蕉青甘蓝
creophagy	食肉
harebrained	轻率的
dentary	牙齿
franciscan	圣芳济会
shopman	小商人
thersitical	谩骂的
sig	Interest
arrogancy	自大
acaudal	无尾的
chordoma	脊索瘤
canape	夹鱼子或小鱼的烤面包
briny	咸
exceeding	极度的
vantage	优势
droning	发嗡嗡声
eht	extra
lilongwe	利隆圭
criterion	规范
outset	开始
zigzag	弯弯曲曲
protege	被保护人
eel	油滑的人
microcosmic	微观
photoglyph	照相凹版
tripleheaded	三头
loofah	丝瓜
humanize	赋予人性
depreciate	降低
fixing	设备
navigation	航行
atremble	颤抖的
characterization	描述
compounder	部分还款者
humbly	谦恭地
gutty	挑动性
hypotyposis	生动的叙述
assimilative	同化力
enchylema	透明质
unpatterned	未形成模式的
jungian	易雍
scotticism	苏格兰方言
sloppy	肥大的
womanlike	女人似的
vernation	多叶卷叠式
maduro	色深味浓的烟草做
unwitting	不知情的
gangtooth	暴牙
paraplegic	截瘫患者
grisly	可怕
plowshare	犁头
doltish	愚钝的
mild	淡味
tensignal	以10开头的信号电码信号
aversion	厌恶
gotter	to
remonstrant	抗议的
attachable	可附上的
wimple	泛细浪
twine	细绳
pupillage	学生的身份
undulance	起伏
sulphisoxazole	磺胺二甲基异噁唑
scrappy	细小
presurgical	手术前的
anisodont	牙齿高低不齐
overmodest	过分谦虚
cantilever	悬臂
amort	无生气
ligule	舌叶
lippen	信托
cashoo	=catechu
conjugated	成对的
gwtw	With
hcl	of
snugly	整洁地
hight	名叫
centricity	中心
cracker	爆竹
causal	表示原因或理由
etypic	由某种形态转变
substantive	实词
clericalism	任圣职者不正常的政治势力
androphobia	憎恶男性病
histophysiological	组织生理组织生理学的
color	颜色
candid	公正的
noninitially	不是起首字母
bumptious	傲慢的
serve	供应
annihilable	可毁坏
khalifat	职权及领域
skein	群
nervy	有勇气
weeklong	为时一周的
facilitate	使便利
neoanthropic	智人的
pale	用栅栏围
habutai	全丝薄软绸
binge	狂欢
repristination	恢复原状
latter	较后的
goluptious	香喷喷
twine	合股线
flimsy	没有价值的
undoubtedly	确
mucin	粘液素
cladode	扁平的叶状茎
flory	θ温度
