dover	多佛
unfortunate	不合宜
drawerful	一抽屉之量
disrespectful	无礼的
columelliform	似小柱的
dog	狗
dendroid	树木状
charta	包药粉用的小纸包
orcinol	苔黑素
filmstrip	幻灯影片
pawnshop	当铺
valvelet	=valvule
bioorganic	生物有机
quietus	偿清
straighten	伸直
hydrophilic	吸水
able	有才能的
jadishly	毫无价值
nonbank	与银行无关
amblyoscope	弱视矫正器
jibe	嘲笑
meagerly	瘦
wga	America美国作家协会
malt	麦芽
umbral	有荫影
ethnic	种族的
psalmodic	唱赞美诗的
steepled	尖塔状的
rakish	轻快
flubdubbed	笨拙的
cozily	安乐地
capitoline	Capitol的山丘
underwrite	承诺支付
shoehorn	鞋拔
nephropexy	肾固定术
field	担任场外队员
lithophyl	叶子的化石
congest	拥挤
surmullet	金色羊鱼
quintessential	精萃
cribrose	筛状的
outsole	外底
brcs	British
superstitiously	被邪教所支配
gramdan	赠地
rebel	造反者
subversive	颠覆破坏分子
flagellant	执鞭抽打者
hateable	可恨
silentious	习惯性沉默的
anopheles	疟蚊
lush	繁荣的
worldling	俗物
confuse	搞乱
thistledown	非常轻的
astringe	使收缩
uneconomical	不经济
elevenfold	十一倍地
somatotype	体型分类
document	文献
circumfuse	充溢
ringside	马戏团
fidgety	不安
he	他
printer	打印机
tectonomagnetism	构造磁性
philip	菲利普
heft	分量
simpai	黑冠猴
incog	隐姓埋名
piscary	捕鱼权
phosphorescent	磷光性的
judgement	评价
expatiate	细说
intranational	国内的
academy	学术团体
western	来自西方的人
refute	驳倒
flauntiness	虚华
supervise	管理
rejective	拒绝的
produce	出示
flavobacterium	产黄菌属
crepitant	捻发音的
strawy	稻草一样的
diplomata	diploma的复数
phytocide	植物枯死剂
awake	觉醒
creatureliness	动物或人有的特质
indignant	愤怒
enervated	衰弱的
situated	位于
faculative	偶发的
serried	重叠罗列
congou	工夫茶
unappealing	无吸引力的
eventual	可能
systematism	系统化
mfh	of
simple	简朴的
enforceable	可实施的
installment	部分
tout	吹捧
conferva	黄丝藻
invalid	有病的
lucubration	苦心而成的著作
staminody	变成雄蕊
bibliographical	著书目录的
boomtown	新兴都市
columbium	铌
inhumorous	不滑稽
unlicked	没舔干的
laboursome	吃力
magic	巫术
blessed	受祝福的
equilibrist	杂技表演师
flickering	摇曳的
xerothermic	干热
saucebox	冒失鬼
deseam	除去表面上的缺陷
fodgel	丰满健美
tigrine	似虎的
uncdf	联合国资本开发基金
fracture	骨折
compliment	称赞
seaway	海上航道
echinodermata	棘皮类
surgical	手术上的
contextless	无来龙去脉
trashiness	碎屑
syntactically	依照句法地
dernier	最后的
annoying	恼人的
ece	Economic
esc	/ESC/Page
tig	追到
photoelectroluminescence	光电发光
myrmidon	盲目执行主子命令的人
spoiler	损坏者
ridgelike	脊状的
dogra	多格拉族
social	社交的
krad	=kilorad
inculpable	无罪的
headstream	发源
instanton	瞬子
wolfish	残忍
hyperostosis	骨肥厚
strepitant	=strepitous
monoclonal	单克隆的
hoop	篮
saprolite	残余土
broncho	野马
escharotic	苛性剂
goddam	讨厌的
mischievous	恶作剧
anthocarpous	掺花果
obtained	获
quizzy	爱查问
insalubrity	有碍健康
msts	Service
runproof	不会渗化
abreast	并排地
pmla	Modern
propagation	动植物
trencher	木制食盘的
thistly	有刺的
chinaman	中国人
methoxychlor	甲氧滴滴涕
sacroiliac	骶骨关节病
remonstrative	抗议
easiest	容易的
bloodiness	残酷
underemployed	未充分就业
homorganic	以同一器官发出的
constellate	形成星座
pitch	用沥青涂
counterintelligence	反情报
catchall	包罗万象的
thankful	感激
gyniatry	=gyniatrics
lustration	洁净
devilment	如魔鬼般的行为
hoof	踢
absurdist	荒诞主义者
dicrotism	二波脉
agassiz	trawl阿格赛兹拖网
sciaenid	=sciaenoid
teletranscription	电视屏幕录像
superphysical	已知物理定律所不能解释
rendezvous	集合点
aaronic	亚伦的
plumate	似羽毛
hologynic	全雌遗传的
hairtail	带鱼
phonetically	按照发音
screed	样板
yird	陆
regis	里吉斯
dynast	王朝的君主
performance	成绩
deovolente	如蒙上帝恩允
ocean	许多
aestival	夏季
approbatory	承认
amplitude	广阔
unwillingness	不情愿
goto	转到
underslung	装于车轴之弹簧上
evidential	提供证据的
exuviae	脱落的皮
attainture	耻辱
thunderhead	雷雨云砧
coleopteron	鞘翅目昆虫
whisk	毛掸子
metagalactic	总星系的
blanch	漂白
malodorant	难闻的东西
amidol	阿米酚
ungrateful	不领情
bergamot	梨的一种
actionable	可控告
adventuresome	冒险性的
uc	upper
os	西洋旧历
ironhanded	铁腕
cockchafer	金龟子
aasvogel	南非秃鹫
ingoing	就任
graunchy	艰难的
exorbitant	过度
unbred	粗鲁的
industrialized	工业化的
dct	离散余弦变换
tiptop	最高点
course	路线
eradicative	消灭的
furry	有舌苔的
unplaced	无处居住的
insurgently	汹涌地
convect	借对流传热
drosky	无顶四轮马车
negrophobia	黑人恐惧症
waxiness	蜡质
alba	Toledo
untransferable	不可转移
feulgen	福尔根反应
unexpectedly	出乎意料
uto	Organization
sallenders	马膝湿疹
unimolecular	单分子的
horselaugh	纵声大笑
phytocide	除草剂
ciliate	有纤毛的
vegetation	生长、呆板单调的生活
sinfonia	交响乐
trochelminth	担轮动物
ripsnorting	了不起
hypopiesis	低血压
raughty	愉快的
cowish	胆怯
hurl	用力投掷
brae	山坡
satisfy	确保
mitred	斜拼接的
costumier	服饰供应商
panzer	装甲车
heathy	石南丛生的
deemster	法官
connect	联合
transigent	妥协
grimly	冷酷地
temporal	当时
octillion	千的九次方
fictile	可塑造性
paly	发青
backing	衬背
revolutionize	宣传革命
bir	国内税收局
dawning	黎明
towaway	拖走扣押
foamback	泡沫塑料衬里
florid	红润的
desulphurize	去硫
villain	坏人
egotistical	任性
fractionary	微少的
generalization	概括
ornamental	装饰物
imaginable	可能的
usia	United
pinocytotic	胞饮作用形成的
exorcise	驱邪
ribby	贫穷的
debug	除错
transeunt	超出己身之外的
fimbriate	使有毛缘
threaten	威胁
ruleless	无规则的
archimage	大魔法师
budding	萌芽
aaup	Association
lustful	渴望的
bordetela	博德特氏菌
chromatically	上色
dread	惧怕
subacid	略带酸味
ocotillo	墨西哥刺木
haidarabad	=Hyderabad
utopian	理想化的
muzzle	枪口
obstructive	妨碍物
devilment	恶作剧
bloated	发胀
disconformity	矛盾
castrative	产生阉割效果
elena	埃琳娜
cannikin	小杯
incidence	影响范围
quickening	胎动初觉
bloodless	不流血
russian	俄语
subaltern	下的
scummy	浮渣般
vacillatingly	犹豫
rasc	Corps
trihedron	三面体
einsteinian	爱因斯坦
illuminating	照明的
usha	United
seaward	向海
cyrenaicism	昔兰尼学派的快乐论
flowering	开花
sisyphean	永远做不完的
screen	包庇
diplont	二倍性生物
delivery	引渡
suffer	忍受
preparation	准备
callous	起老茧
clergy	神职人员
dendrite	模树石
ascesis	苦行
turnsick	蹒跚病
electrodialysis	电渗析
opium	鸦片
expansionary	膨胀
contention	争辩
braless	不戴胸罩
regard	尊敬
maguey	其纤维
noiseless	无声的
laryngectomy	喉头切除术
wafery	象薄脆饼似的
tsade	=sadhe
unreflecting	不反省的
brassage	铸造货币费
etna	酒精灯煮水器
aristocracy	贵族政府
cerebric	脑
admonish	警告
somatosensory	体觉的
curlicue	花体
nc	Numerical
rebel	叛乱
smear	中伤
ecliptical	黄道
haut	豪华的
neorican	新波多黎各人
leasehold	借贷
exocarp	外果皮
hibernation	过冬
coot	笨蛋
bifilar	双丝
fingerful	少量
lullaby	唱催眠曲使入睡
gravitate	吸引
formulaic	用俗套话堆砌成的
turnix	quail
zollverein	商业同盟
dpg	acid
ligule	舌状
direct	指挥
circumplanetary	围绕行星的
antidiuretic	尿分泌抑制剂
mainly	主要地
combustibility	可燃性
millionocracy	财阀政治
micromeritics	粉末工艺学
mattery	流脓
remorsefully	极为懊悔地
planetary	行星
shoreless	没有岸的
bovarism	包法利式的浪漫人生观
nephrostome	肾口
expectative	预期
piety	虔诚
phi	21
rhomboidal	长菱形
northernmost	最北的
grasp	抓紧
rear	后面
confusedly	慌乱
mugho	矮生山松
plant	设备
dogwood	山茱萸
telford	泰尔福特路面
bootlick	拍马屁
whorish	妓女般
immovability	不变
frgs	Fellow
extramural	单位以外的
autogamic	自花受粉的
cynwulf	=Cynewulf
mortgage	抵押
coverage	复盖
power	使……有力量
supersonic	超音波的
sootiness	烟熏
disseizee	不动产被强占者
telerecording	电视影片播放的节目
drone	雄蜂
asterisk	星号
scansorial	适合于攀登的
title	用作书名的
jointer	刨接缝的长刨
compensation	补偿
dissectional	仔细分析
rutilant	发亮
flashback	闪回
endemic	方
tam	一种便帽
fruitwood	果树材
optical	眼
endeavor	尽力
xylocaine	利多卡因
variorum	集注本
ricksha	人力车
melphalan	左旋溶肉瘤素
hairy	多毛
sheugh	犁沟
volant	迅速的
motley	五颜六色
shockingly	怕人
secondhand	间接
faulted	有毛病的
theropod	兽脚亚目
briny	海水
sick	追击
hodographic	矢端曲线的
tensile	张力
theosophy	接神论
sins	ship''s
pussyfoot	谨慎行事
vellicative	能拔的
comic	喜剧
constringency	收敛
homozygote	同型接合子
cautious	小心
unwary	粗心的
univalve	单壳的
tanniferous	含丹宁酸的
ingenuously	正直
onion	因洋葱掉泪
apopemptic	临别的
egoistical	利已主义的
illyrian	伊利里亚人的
wistfulness	渴望
avirulent	无毒力
gulf	使深深卷入
knightly	骑士般
subhead	副标题
papula	丘疹
sermon	布道
iodometry	滴定碘法
noviciate	见习
livre	里弗
infantine	小孩似
munificent	慷慨
pyelitis	肾盂炎
declarative	公布的
dubiety	可疑性
exigence	苛求
clipped	发音清楚的
vicky	维姬
veiny	纹理状
phylogeny	发展史
extramundane	物质界以外
concourse	集合
dissemble	假装不知道
laudator	称赞者
flanneled	穿法兰绒衣服
laconical	=laconic
uraemia	尿毒症
mispronounce	发错音
godlike	与神相称
hypostasis	原质
conchoid	蚌线
kharakteristika	=karakteristika
conamore	热心地
unduly	过度
tabes	消瘦
adrenocorticotro	hormone//rophin/E`dri:nEJropic/E`dri:nEJ9ropin/E`dri:
connectedly	有关联地
hamam	公共澡堂
manioc	树薯粉
grieved	伤心的
laminose	薄板
cumbersome	笨重
instant	方便的
disclaim	放弃
cess	税
hence	从此
elusive	难捉摸
deprecatory	反对
recent	新近的
influential	有势力
irradiancy	发光
arouse	唤起
controvertible	可争论的
insensibly	徐徐地
rhinopharynx	咽之鼻部
differentiability	可微性
sunny	快乐
afterwards	然后
explicit	清楚的
short	简短
armenian	亚美尼亚的
astronomic	天文学的
balcony	阳台
glomeration	成球状
conflagration	大火灾
bodoni	博多尼活字字体
bloomy	有粉衣的
fencing	辩论
lamaster	逃犯
towable	可牵引的
sexual	性
overripe	过熟
jasper	碧玉
predicatively	断然地
wonder	奇妙的
bibliographic	著书目录
unbrotherly	非兄弟般的
update	校正
transportation	运)n/
arithmetization	算术化
geegee	劣等赛马
suggest	建议
korean	韩国人
kootenay	库特奈语
grisette	女店员
dummkopf	笨蛋
mbfr	相互均衡裁军
cabalism	犹太神秘哲学
epigenous	生长于叶面的
trisomic	二倍加一的
replay	重新表演
radiomimetic	拟辐射
clintonia	七筋菇属植物
potass	碳酸钾
anandrous	无雄蕊
accessible	可到达
canaliculus	细管
blondine	把色
baton	指挥棒
piggyback	骑在背肩上的
deambulatory	散步
lixivium	灰汁
atonicity	张力缺乏
artificer	发明者
erect	直立的
compulsive	强制
dissociate	分离
criminal	犯罪
sheller	脱壳机
mna	of
cargo	船货
outburst	爆发、喷出
imploringly	哀求
oleic	自由采取
longhair	知识分子的
eminent	显赫的
bha	hydroxyanisole
usrc	States
specific	明确的
waterflooding	注水
disquietude	忧虑
moslemic	伊斯兰教义的
whencesoever	无论从什么地方
moonship	探月太空船
molelike	似鼹鼠
negev	内盖夫
time	定时的
urc	Resource
disharmonize	使不和谐
crasher	不速之客
ric	of
sullen	沉沉不乐
soporific	催眠
fateful	预言性的
sightseer	观光客
autobike	摩托车
epagoge	归纳论证
rhetorical	带修辞色彩的
vengeful	报复的
diastatic	脱离
borazon	一氮化硼
plenteous	丰饶的
grindingly	苛刻地
melchiades	Saint
phytotron	人工气候室
aim	目标
unaverage	不寻常的
astuteness	机敏
denominational	派EnElIzEm/
centralia	澳大利亚的中部偏僻地区
eft	小蜥蜴
declensional	词形变化的
nasty	令人厌恶的
papyraceous	纸草的
iv	静脉内
unappealable	不可上诉的
wheelbase	轴距
inscriptive	题写
howsoever	无论如何
offhand	即时
downlink	向下链路
nasty	淫秽的
pelias	珀利阿斯
ungreeted	未致意
pectinated	栉齿形
perfidiously	不忠实
befallen	发生
crim	=criminal
untapped	未使用
electroetching	电蚀刻
usurpatory	夺取
acerbity	酸
dead	熄灭
tourniquet	止血带
conically	成圆锥形地
triangulable	可三角剖分
apocynaceous	夹竹桃科的
qualm	疑虑
imaginably	可想象
leadenhearted	铁石心肠
wisperer	窃窃私语者
coagulatory	凝结
ultimateness	结论
ubi	在那里
heathfowl	grouse
slatternly	不自检点的
permanent	永久
rio	Information
trunk	箱形
northwesterly	从西北来
tartar	牙垢
dutiful	守本分的
allopatric	单独地发生
queerness	奇妙
lathyritic	山黧豆中毒
bifunctional	具有两种不同功能
sexagenarian	六十岁的
indent	凹痕
parodos	合唱队登场的通道
scilly	of
hypoxia	组织缺氧
skeletony	梗概
guts	飞碟游戏
machiavellism	马基雅弗利主义
puff	骄傲
endopolyploid	内多倍体
tannage	鞣熟的皮革
thermoduric	耐热的
querulously	抱怨
bequest	遗赠
trituration	研碎
monody	挽诗
slimming	减食疗法
dissected	切开
proctorize	以训导长身份谴责学生
contract	感染
creel	鱼篮
make	产生
unstrained	不勉强的
vistula	=Wisla
eely	似鳗的
melitopol	美利托波尔
adversarial	对抗的
cheering	喝彩
tired	累的
graphitoidal	似石墨的
amido	氨基的
smarmy	虚情假意的
dapple	有斑纹
periclase	方镁石
supercool	过度冷却
dustbinman	垃圾工
legatine	使节
dijon	第戎
mendacious	说谎
cartridge	弹药筒
emi	Magnetic
mere	纯粹的
fallage	砍下的树枝
freckling	斑点
climate	风土
alimentative	提供营养
hoverheight	垫升高度
sensorimotor	感觉运动的
canner	罐头制造商
eurycephalic	阔头
dioptric	视力矫正用的
ostentation	卖弄
deucalion	丢卡利翁
cmh	Congressional
crepuscular	拂晓的
instant	方便
giggly	吃吃笑
senarius	六音步的诗
dishonorable	不名誉
comic	滑稽演员
snide	暗讽的
incalculably	无数
maybe	大概
geophone	地震检波器
nugget	天然金块
polyphonic	对位法的
remorseless	冷酷
guff	胡说
sobeit	设或
erasmian	伊拉斯谟
negligent	粗心大意的
gaulish	高卢语
gibblegabble	=gibberish
disciform	盘状的
australopithecine	更新纪灵长动物的
frisbee	n
imperviable	不能渗透
moa	恐鸟
idly	懒惰
superciliary	眼睛上方的
requiem	悲歌
hermes	heavy
table	表格
interceder	调解者
ornate	绚丽的
preludial	序幕的
gouge	圆凿
geometer	几何学者
diabolic	魔鬼似的
monumental	不朽的
umbilic	脐带的
unshirted	不穿衬衫的
blastocele	囊胚腔
figurable	能定形
foreglimpse	启示
crosscurrent	横流
bleak	寒冷
cinephile	n电影爱好者
labyrinthine	曲折
arthroplastic	关节形成术的
tankbuster	反坦克飞机
inoxidized	未经氧化的
kinaesthetic	动觉
hyperpiesia	原发性高血压病
riband	丝带
setenant	连在一起面值不同的
disarm	解除武装
swith	迅速
millionth	百万分之一
rampage	狂暴
jipijapa	巴拿马草
strategus	将军
evacuant	泻剂
lease	租赁物
immensely	非常
sachet	香袋
powder	粉
pack	一群
benthamism	边沁学说
torsibility	抗扭力
tritiate	给……涂氚
dulotic	奴役现象的
roselite	玫瑰砷酸钙石
nuts	热衷
locomotory	移动的
generalship	将才
birchen	桦木制的
rescript	官方命令
asymmetric	不对称的
precipitator	催促的人
diffrangible	可绕射的
communicative	畅谈的
virginity	未婚女子的独身生活
grasp	抓住
umbra	蚀时的地球
bipolar	有两极
perennial	永久的
blotchy	有泡
hyposmia	嗅觉减退
hornpipe	从前流行的一种木笛
canonship	牧师或僧侣之职位
serried	密集的
pedantry	炫学
fairness	美好
holistic	整体
drawbench	拉丝机
tussar	=tussa
anisaldehyde	对甲氧基苯甲醛
legume	豆类
spile	插上插管
excursion	游览
corporatist	组合主义者
toxophily	射箭
ittf	Federation
illusion	幻想
weird	超自然
overspill	溢落的东西
campanological	铸钟学的
impetrate	祈求
testacean	有壳类
trowel	用泥铲涂
dissected	多裂的
pipeless	无管的
tritural	适合于粉化的
hatchway	天花板出入口
conception	概念
psychiater	研究精神病之学者
breastplate	胸革带
washy	脆弱的
jubbulpore	=Jabalpur
infertility	不肥沃
bender	弯曲物
mangalore	芒格洛尔
strait	地峡
mammiform	乳房形的
substitutional	取代
rattled	慌乱的
msa	农业科学硕士
worshiper	参加礼拜者
favorite	宠爱的
pleistocene	洪积世
supportable	可援助
dovish	稳健的
conj	连接词
bantingism	班亭氏疗法
berate	申斥
compassable	可完成
animally	肉体上
locknut	防松螺母
jacksy	屁股
araneidan	真蜘蛛类的
frailish	不太坚固
aic	of
benty	多硬草
unnumbered	没有数的
trichotomous	=trichotomic
drownproofing	浮水法
gumming	树胶分泌
dunce	劣学生
mortice	榫接
infiltrate	渗透
incompatibly	不相容
didactical	教训
osmolality	同渗重摩
fatuous	愚笨
unpeaceful	不和平
unit	个体
fasciated	带化
indetermination	不确定
professional	职业的
reformational	改革的
aspca	American
casting	铸造
substratal	基础的
speculative	投机的
replant	使复位
odeum	音乐厅
lactalbumin	乳白蛋白
calculated	计算出的
miscreated	残废
pretence	伪装
oofy	富有
addie	艾迪
trump	出王牌
depauperize	消灭贫穷
convocation	召集
midlittoral	中沿岸带的
trustfully	深信不疑
uncalculating	没有心计
nonelectrolyte	非电解质
mitch	逃学
vitellogenic	=vitellogenous
arsenopyrite	含砷黄铁矿
bacterial	细菌
unreported	未报告
mirage	幻想
nonsensical	无意义
somatotrophic	生长激素
marginal	记在页边的
voyeuristic	喜好窥阴
cassia	肉桂
purser	主计官
neurogenesis	神经形成
flexible	易曲
emendation	修订
implacental	无胎盘
decolonize	使非殖民化
pst	Pacific
veracious	说实话的
lats	背阔肌
undoubtedly	无庸置疑地
philanthropize	行善
thyroiditis	甲状腺炎
feeze	激动
unpunishable	不能受惩罚的
unlearned	无教育的
narrow	严密的
braggart	吹牛
decharge	浅滩
deck	一副
yield	屈服
surnominal	姓
pouch	小袋
blocky	短而结实的
isooctane	异辛烷
quinquepartite	分成五部的
menfolk	男人们
wga	Writers
tardily	缓慢
indefatigably	不厌倦地
postulate	要求
timaru	提马鲁
whoremonger	拉皮条者
sensitive	敏感
ccpit	for
clonesome	模仿别人的
wooly	羊毛内衣
bagman	中间人
emotively	动情地
coulisse	侧面布景
dissuade	劝阻
unhesitatingly	坚定地
unprescribed	非规定的
creodont	古肉食哺乳动物类
bec	经济学士
jonah	约拿书
offput	使气恼
waveform	波形
dismantle	拆除
siderophilin	=transferrin
ring	按铃
manageable	易管理
abidingly	不变地
resigned	顺从的
jat	贾特人
snubby	短而往上翘
grave	雕刻
yucatecan	尤卡坦人的
manual	实际占有的
toothsome	美味的
peregrin	外侨
transfect	使转染
unconditioned	无条件
pandybat	惩戒皮带
rantipole	粗野的
aclinic	水平的
gracia	格雷西亚
weird	超乎事理之外的
shred	撕碎
reflorescent	再开花
murderous	杀人
dlp	数码光输处理器
geologize	调查地质
foraminiferal	有孔虫目的
multihull	多船体的
unaffected	未被感动
forepassed	过去的
story	小说
annuity	养老金
pulmonary	肺部
vector	带菌者
closet	壁橱
apsis	拱点
skeleton	纲要
harmlessly	无害地
blanky	=blankety
trawl	拖网
rebellious	反抗
rah	好哇的欢呼声
owl	枭
stray	漂泊游荡
dandriff	头皮屑
cecile	塞西尔
indebted	负债的
cloud	污点
circumlunar	月球周围的
sandblast	喷沙器
scrap	残余物
mellowy	=mellow
wham	重打
filemot	褐色
malacology	软体动物学
sdcd	Disc
defogger	除雾器:
lot	划分
underhand	欺瞒
polyconic	多圆锥的
lavishly	浪费地
ionicity	离子性
usga	Association
westralian	西澳大利亚
snowball	打雪仗
omicron	希腊字母第
pollster	整理民意测验结果的人
stormy	暴怒
statuesque	轮廓清晰的
validly	正当
paced	步伐的
reelingly	旋转地
piezometry	压力计使用
noontime	中午
brim	使满溢
spanless	不可测量的
contracted	收缩了的
dewiness	潮湿
sneery	讥讽的
promiscuously	混杂
oleoresin	油性树脂
dneprodzerzhinsk	第聂伯罗捷尔任斯克
sinuate	弯弯曲曲的
disclaimation	弃权
delivery	分娩
epsom	州的市镇
toby	托比
eacm	Common
flakey	疯疯癫癫
italicize	用斜体字排字
crabbily	固执
rowdydowdy	吵闹的
adulterate	掺假的
outweary	使筋疲力尽
whacking	巨大
asphodel	常春花
ashiver	发抖
tetrachotomous	四叉
tributary	进贡国
unostentatious	朴素
filter	走漏
sod	草
double	双重
verruca	赘肉
suety	板油一样
pose	矫揉造作
willing	反应迅速的
posttranslational	遗传翻译后
ahemeral	不足一天的
lawlike	似法律的
uncommon	不凡的
obtected	有角质外壳的
vile	简陋
meditative	冥想的
swerve	突然转向
oneness	单一
skinful	满满一皮囊
irak	伊拉克的
foil	贴箔于
tuck	缝摺
provencal	普罗旺斯的
cozily	舒服
poof	吹熄蜡烛的声音
decrypt	解释明白
furry	毛皮的
excrete	排泄
nongreen	非绿色
transferrer	转让给人
moldy	腐臭
punctum	凹陷
coverley	de
brede	编带
descendiblity	遗传
grandisonian	葛兰狄生式
effectively	有力地
boniface	小餐馆老板
circumambience	四周
stripper	清除的人
album	签名纪念册
whiff	轻轻地吹
sacrament	圣礼
heater	发热器
insurgence	暴动
broil	酷热
vsam	Sequential
renumber	重编号
flickery	闪烁的
newfangled	新奇的
printless	无印痕的
consider	照顾
digital	数位
cartelization	组成卡特尔
pndb	decibel噪声分贝
ensoul	赋予灵魂
landscaping	景观美化
tuck	挤进
cliquy	私党
publication	发行
cuckold	使戴绿帽子
carlin	老妇人
whitetail	白尾鹿
agrimony	大麻叶泽兰
multivalent	多化合价
zilch	小人物
superempirical	超经验的
desertion	逃亡
lettish	列托语
lippy	出言不逊的
izzat	威望
trm	trademark
douai	Douai
floodwood	浮木
emptiness	无知
webbed	作成蜘蛛网状的
wri	war
skeletony	骨瘦如柴
premeditated	预想
chimney	烟囱
wild	野性
predeterminate	注定的
safekeep	保护
antlion	蚁蛉
ventrad	向前侧
tachiol	氟化银
saceur	欧洲盟军最高司令
transferable	可传递的
gossypose	密三糖
shoshonean	肖肖尼语
intergeneric	属间的
incompatibility	不相容
repat	被遣返回国者
escargot	食用蜗牛
sixpenny	不值钱
chromophilia	易染性
acquirement	习得
slime	粘液
deictic	直证的
abasia	步行不能
pert	活跃
cernet	China
padrone	旅馆老板
vivific	使活跃的
floridness	鲜丽
diandrous	有两个雄蕊的
impermissible	不允许的
joint	合办的
smice	冰雾
bivvy	临时营帐
parody	模仿滑稽作品
corporate	法人
spat	蚝卵
covert	在丈夫保护下
impecuniosity	身无分文
quit	解除
proportional	均衡的
monopolistic	独占
inadvertently	不注意地
untamable	不能制服的
path	小径
capitol	州议会大厦
inerrability	无误
hydrostat	水压调节器
ventrodorsal	腹背的
varoom	呜呜声
wot	wit的第1、3人称单数现在式
waster	次品
increscence	渐增加
eucalyptol	桉树脑
superradiant	超发光的
charming	迷人的
rail	围栏
methodologist	方法学家
lubber	笨拙
uncorrupt	无讹误
scrap	零碎
nih	全国卫生研究所
stearic	似硬脂的
reciprocitarian	支持通商互惠者
chapfallen	沮丧
vasopressin	抗利尿激素
kinsey	金赛教授
dispersal	驱散
lie	展开
aaup	of
appersonation	对一个知名人物下意识做的假想
deviously	弯曲
xenia	齐妮亚
apa	addressable
nonlethal	不致命
canicule	七八月期的酷暑
pertinence	有关性
prankster	顽皮的人
incarnadine	粉红色
subtropics	亚热带地方
bioplast	原生质细胞
fiz	有泡沫的饮料
heartstrings	心弦
harmaline	二氢骆驼蓬碱
baltic	波罗的海诸国的
heeler	制做鞋跟的工人
slue	极多
toon	红椿木
superstitious	迷信
discursiveness	漫谈离题
quercitol	栎醇
volatility	挥发性
preparative	准备的事物
braid	编织
inspan	套轭于
nog	支架
jollification	欢乐
nitid	明亮
blackguardly	粗鄙
shelly	由壳而成
arghan	波罗叶纤维
sark	内衣
nominate	任命
crystal	结晶状的
banaras	巴纳拉斯(印度东北部城市瓦腊纳西
precautionary	预防
piping	吹笛的
enthalpimetry	测焓
veritas	真相
optional	可选择
coalescence	接合
undersurface	底面
grammaticalize	将……作为语法要求
biwa	Lake
abrasive	研磨的
enthronization	授予主教职
hepatocele	肝脏脱出
testaceous	有贝壳
ase	Exchange
outcast	流浪者
lachrymal	啜泣
sylvan	有森林
outspread	伸展
radioprotective	辐射防护的
defrost	除霜
eclamptic	惊厥的
concomitant	伴随
idol	谬论
coarseness	劣等
tristful	悲哀的
phytocidal	除草的
narcose	昏睡
irremediable	不能治疗的
scrummage	排成争球队形
grallatores	涉水禽类
scraggy	凸凹不平的
hyperconscious	a知觉太过敏锐
finery	服饰
incondite	结构拙劣
fatuous	愚笨的
mia	in
rearwards	在后面
crusher	镇服人的事实
schlep	搬运
teutonism	条顿风尚
peart	有精神的
castigatory	修订的
ripely	圆通
airstop	降落场
bookworm	书呆子
infamy	丑行
carvacrol	香荆芥酚
puncher	穿孔者
treadwheel	踏车
grade	评级
geocide	地球的毁灭
abm	反弹道导弹
maltreatment	虐待
novelty	新奇的事物
lucidity	透明
winterkill	冻死
cushy	轻松而容易赚钱的
style	字体
dairy	奶制品
iou	you
immotile	不能游动
oa	Operational
osteography	骨论
endocytic	内吞作用
ferrule	套圈
kiddywink	小孩
uar	United
unsteadily	不稳定地
rumpless	无尾
balanced	和谐的
market	行情
replacer	复原者
chokebore	口径逐渐收小之枪
seromucous	浆液粘液性
follicular	卵泡的
narrow	勉强
dulcite	卫矛醇
pyromancy	火占卜
dynamic	动力学
voila	瞧
onrush	突击
expressly	清楚地
crimp	诱骗别人去当兵
nuance	细微差别
conjugated	成对
amphigamous	无性器官
sawtooth	锐齿
outrageous	蛮横
hemiola	三比二
cytochalasin	细胞松弛素
platinoid	假铂
quarrier	凿石匠
conversant	亲近的
galbraithian	加尔布雷思的信徒
flimsy	薄纸稿纸
gravitation	地心吸力
illuminable	可启发的
saccharase	蔗糖酶
emulatory	好胜的
prolificacy	生产力
vast	大量的
kairouan	Kairwan
crewmate	同机工作的机员
aneurismal	动脉瘤
sequence	次序
opern	歌剧院
poignant	令人痛苦
sinarquist	辛那其主义分子
desist	终止
spiritualism	灵性
handraulic	手动
coz	堂兄弟姊妹
haemospasia	血液诱导法
autumn	成熟期
rattlebrained	头脑空虚的
avocet	反嘴鹊
fingerful	一撮
purportedly	据称
pyromancy	火卜
catchwork	截水渠
minor	辅修
impolitely	没规矩地
supravital	体外活体
staphylorrhaphy	软腭缝术
secondhand	旧的
sparkproof	=sparkless
ferry	渡船
alimony	生活费
baptist	施洗者
extramental	精神以外
swaybacked	弄伤了背的
orderless	无条理
gain	得到
rally	恢复健康
egoistical	自私自利的
kitwe	基特韦
son	儿子
warrant	保证
hyperconscious	过于敏感的
moorcock	雄苏格兰雷鸟
slash	砍伤
reconstructive	重建
ccpit	International
squam	渔夫戴的油布帽
kinkled	有小纽结
grandmotherly	慈祥
flocculent	丛毛状的
economy	经济制度的状况
infirmarian	疗养所主管人
table	石板
landaulet	小型之
ring	铃声
sillily	愚蠢地
kindly	温和
unsophisticate	不懂世故的人
juridic	司法上的
snowdrift	随风飘飞的雪
leary	猜疑的
horrific	恐怖
literarily	文学上
coward	懦弱的人
paramountcy	最高权威
gastarbeiter	客籍工人
ferocity	残忍
lustreless	无光彩的
saponifiable	可皂化的
jaffna	贾夫纳
inordinate	紊乱的
french	法国人的
odiousness	可恨
ruffly	起皱
abortive	异常终止
romance	虚构
medicine	内服药
gentian	龙胆属的植物
carl	老粗
unholy	邪恶
armload	一抱之量
ghast	可怕
earthborn	会死的
naomi	女子名
vile	卑鄙
usphs	Public
corruptionist	行贿的人
papistic	天主教
oaw	Assisted
hypopselaphesia	触觉迟钝
protuberance	瘤
lunatic	极端愚蠢
pug	泥料
moodiness	闷闷不乐
stable	稳定的
haltere	=halter
tycoon	企业界大亨
macle	双晶
antiutopian	反面乌托邦
quaternate	由四个组成的
congregational	公理教会
withdrawal	收回
orbicularis	轮匝肌
pathogenic	发病
mikvah	正统犹太教的浸礼池
britannic	英国的
proprietor	所有者
hebrewwise	从右向左地
contortion	扭弯
wail	悲叹
broadbrimmed	宽边
conoid	劈锥曲面
anticlimactic	突降法
jackal	走狗
fantasticism	奇想
rebeldom	叛区
thyristor	半导体闸流管
pericardial	心包的
fenestrated	有窗
cadenza	华彩乐段
laboratorian	实验室工作人员
hemic	血性的
orthopedist	整形外科医师
materfamilias	家庭主妇
inlet	插入物
gleam	使闪烁
mohave	莫哈维族
odeum	剧场
mns	Science
fashionable	流行的
triassic	三叠纪的
jus	法律认可的权利
supervise	指导
vehicle	传达手段
summit	政府首脑的
untruthful	不诚实
intraocular	眼内的
cardinal	最重要的
indubitable	明白
unmarried	未婚
misalliance	不适当的婚姻
riverine	河流的
ingeminate	重申
hawk	鹰
frowsy	懒散的
raticide	杀鼠药
feracity	多产
inversely	倒转地
chanceless	无可能性
piedmontese	皮埃蒙特的
scout	觅
bryophyte	苔藓类的植物
aapss	Science
permissively	许可地
klondike	克朗代克河
carbuncled	用红玉的
offhanded	即席
gratifying	悦人
squirearch	乡绅
calumnious	毁谤
windcharger	小风车发电机
wgmc	Gmc
dielectrophoresis	介电泳
drypoint	铜版雕刻
woodruffite	纤锌锰矿
ethnohistorian	人种史学
simple	天真
lonely	寂寞
evenly	平坦
snubby	短而往上翘的
abruptness	粗鲁无理
dutiful	孝敬的
spaeman	预言者
ecstasize	入迷
cragged	峭壁多
waybread	宽叶车前
semolina	粗粒小麦粉
loliginid	枪乌贼科的
misspend	浪费
improperly	不适当地
kalif	=caliph
flooding	泛滥
mareograph	自动记潮仪
dividend	年息
someways	以某种方式
skullcap	并头草属的植物
seam	接合
balladmonger	民谣作者
swingeing	激烈的
diazonium	重盐
subspeciation	亚种形成
equal	平静的
hellebore	藜芦
fistuliform	管状的
dichogamous	雌雄异熟的
obstipation	顽强便秘
elephantiac	象皮病的
heigh	嗨!
cotidal	同潮的
phenomenological	现象的
blackguardly	流氓
lay	短叙事诗
armigerous	有佩带徽章资格
fluently	通畅地
undying	永恒的
fancifully	梦想地
facilitation	简易化
bootie	=bootee
comically	诙谐
militate	产生作用或影响
shadbush	唐棣
prepotent	优势
prospect	勘探
coequality	同等地位
petrograd	彼得格勒(苏联西北部港市列宁格勒
downtonian	当顿
potentiostatic	在稳压器控制下的
crotchet	奇想
luminesce	发冷光
reactivity	反动
etcaeteras	其余
mouthless	无口的
bladder	气泡
inobservant	不注意
volute	螺旋形
bunglesome	拙劣
motile	运动型
hesternal	昨天
strabismal	斜视
irrigable	可灌溉的
pruine	=prune
unmutilated	未丧失肢体的
antibaryon	反重子
commonplace	平凡的
since	以前
monanthous	单式的
demonolatry	崇拜鬼神
shakable	可摇动
eudaemonics	幸福学
characterless	平凡的
glitter	闪烁
relapse	复发
chemotactic	趋化现象
stress	强调
miniskirt	超短裙
uneducational	无深造作用的
officer	警官
pewit	田凫的鸣声
boatswain	水手长
gunhouse	炮室
mister	先生
nuke	核能发电厂
oaklet	小橡树
functionary	职务
euripus	潮急
magnetohydrodynamic	[用作刀
neutrodyne	中和式高频调谐放大器的
falsehearted	不忠实
novate	用新事物代替
pushpin	图钉
subemployment	就业不足
gpi	insane
oscillation	振动
dispersal	疏散
garter	吊袜带
faveolus	小凹
coyotillo	鼠李科之有毒灌木
efficaciously	灵验地
mustard	芥末
dirt	污垢
vasodilating	引起血管舒张
abode	住所
biodynamical	生物动力
suppurative	化脓促进剂
slentando	渐慢的
cutcha	暂时的
race	与……赛跑
alforja	鞍袋
caenozoic	新生界
swimmingly	顺畅地
flap	拍打
figurable	能成形
flagging	铺石材料
inceptive	开端
smudgily	为除虫而升的熏火
reagin	反应素
rifle	来复线
egp	Exterior
surfeit	过食
tame	制服
unsuccessfully	失败
flutter	使焦急
celticist	研究凯尔特文化的人
clidomancy	钥匙占卜
struthonian	不敢正视现实的
ecru	淡褐色
ruckle	弄绉
havel	哈弗尔河
grumblingly	喃喃报怨着
undone	undo的过去分词
transmountain	越过山
gliosis	神经胶质过多症
dextrorotation	右旋
aquiline	象鹰的
lachrymal	泪腺
deliquescence	潮解
brotherly	充满情谊的
subdiscipline	分科
saunter	漫步
cacuminal	翘舌音的
cultrate	小刀状的
fatuous	自满的
obstinacy	固执
undetermined	未解决
sothic	天狼星的
lace	饰带
dst	Self
nes	不另说明
flub	做得不好
fanged	有牙根
humidity	湿度沼泽中的肥沃高地
diagonalize	与……斜向地成一行
subrogation	代位
prudential	谨慎
first	首先
decubital	卧姿
material	肉体
puncturable	可穿孔
couchant	蹲着
globuliferous	产生极小球体或小滴
hierarchism	圣职阶级制度
lespedeza	胡枝子属
madid	潮湿
fullback	后卫
nouny	多名词的
organized	有组织的参加工会
scent	臭迹
continentalism	大陆派
flatfish	比目鱼
msha	Master
alphahelical	单螺旋结构的
voluptuary	酒色之徒
tithonia	肿柄菊
information	消息
huffish	生气的
guiltily	有罪地
heavyish	稍重
bhoodan	Vinoba
muscologist	苔藓植物学家
slipslop	淡
tarboard	柏油纸板
effusive	感情横溢
hypersphere	超球面
nur	Union
unsccur	联合国资源保护及利用科学会议
chiffonade	细切的蔬菜
blinding	使失去判断力
botheration	忧虑
sexisyllabic	六个音节的
platypusary	鸭嘴兽圈养地
zoomorphosed	似动物造型的
egression	外出
sessile	无柄的
virtue	英勇
man	Network
telepathize	使通灵
culpable	有罪的
primitive	简单的
goddamn	诅咒
alembicated	过分精炼的
johnsonian	约翰逊
blagueur	喜欢编造夸张故事的人
scruple	审慎
keynotes	关键提示
pettifog	诡辩
unobvious	不显著
aonb	Beauty
tubal	管形
astyanax	阿斯蒂阿纳克斯
love	爱好
exocrine	外分泌的
statutory	法定的
trigonal	三角形的
delia	迪莉娅
fortuitism	偶然论
suspensible	可悬吊的
dirty	恶劣的
purebred	纯种的
mach	采用微内核技术
conformity	符合
wittiness	机智
lithostratigraphic	9lIWEJstrE`tfIk/
uncomplex	不复杂
farinose	含粉的
thankless	忘恩负义
hydrophobia	狂犬病
please	中……的意
prattle	胡说
captious	挑剔
invidiously	惹人怨恨地
verdigris	铜绿
melena	黑粪症
oceanographic	有关海洋学
haemodynamics	血液动力学
nobbily	时髦
sleuth	做侦探
unjust	不公平
owing	未付的
palearctic	=Palaearctic
orville	奥维尔
tet	春节
mackman	作淫媒者
insensibly	极微
varioloid	假性天花的
whopper	特大物
allpowerful	最强大的
mediatize	使成为附属
hematothermal	温血
pure	完美的
nefarious	穷凶极恶
telepathize	使心灵感应
verandah	走廊
to	于……
echo	回声
muslim	穆罕默德信徒
windjammer	帆船水手
abroach	开口
unlink	解开……的环节
scent	使充满气味
bravest	勇敢的
fallacious	谬误的
terror	可怕的人
flattery	捧场话
honestly	真诚地
collectanea	文选
camisade	夜间奇袭
enactive	法律制定
appurtenant	隶属的
chaung	河道
postboat	客运班船
anautogenous	需吸血后产卵的
encincture	围绕
substitutional	代用
tablet	小块
unartistic	与艺术无关
celt	Celt
borrowed	虚构
platiniferous	含铂
ambler	以溜步法走的马
topi	遮阳帽
med	Mediterranean
andante	缓慢的曲子
masticatory	咀嚼
improvise	临时准备
unguiculated	=unguiculate
squall	尖声叫着
french	法语的
yukin	月琴
transmitter	传导物
parthenogenesis	单性生殖
jerez	赫雷斯
religiose	狂信
hirtellous	具微硬毛的
os	孔
bogie	可怕的人
vortex	旋涡
soigne	整洁的
salvatore	塞尔瓦托
mettlesome	精神饱满的
deference	尊重
drag	拖
mindoro	民都洛岛
document	档案
globulet	极小的一滴
raptorial	捕食生物的
punk	朋客
congratulatory	庆祝
airconditioned	装有空气调节器
ringbolt	带环螺栓
latticed	装有格子的
alastair	阿拉斯泰尔
dump	倾卸
sexploiter	色情电影
costive	行动迟缓
sufferable	可忍耐的
extemporaneous	善于即席讲话的
plough	犁耕
russia	俄罗斯
mir	米尔
tacmar	Array
orb	沿着轨道移动
poe	进口港
proof	防……
tame	平淡
landowning	拥有土地的
spcc	Prevension
sabotage	对……采取破坏行动
faddish	趋于时尚的
patina	光泽
unsophistication	天真
travesty	滑稽模仿
hydrothermal	热液的
meanwhile	其间
sompa	桑珀测定法
operable	可操作
indices	的复数
unarguable	无可争辩
folly	傻念头
antiulcer	抗溃疡
visually	在视觉上地
solicitudinous	关心的
hirtellous	具微硬毛
calefaction	温暖
pentameter	五步格诗
hallucinosis	幻觉病
impersonalize	使失去人格性
uncharming	不可爱
chieftaincy	酋长或首领的地位
funereal	送葬的
cep	Circular
lame	僵痛
departure	离开
panderess	老鸨
furor	激情
mordacity	辛辣
greyhound	美国灰狗长途汽车
talcous	含滑石
awake	觉悟
nira	National
minimal	最小
cabriole	弯曲的脚
vindicative	辩明的
efflorescent	开花
calculatedly	故意地
indagate	研究
cloudwards	朝着云地
acropathy	四肢病
antiulcer	抗溃疡的
royalty	王权
speechify	演说似的地说个不完
parsee	印度拜火教徒
impleadable	控诉的
unwilled	非故意的
downsizing	减少规模
norse	挪威人的
wolfy	狼一样凶残的
definitive	权威性的
mechanical	机械的
equiprobably	等概率地
auctorial	作者
planster	策划者
metathesize	换位
sheeny	有光泽的
scullion	卑鄙的人
sphacelous	患脱疽的
quickie	速成
unhidden	公开
skean	双刃短剑
catching	传染的
inkhorn	墨水壶
placeman	禄虫
phew	呸表示不快的声音
dryly	冷淡地
chromomere	染色体小粒
international	国际性组织
oxbridge	牛津与剑桥两大学
pinnatipartite	羽状深裂
oscillator	振荡器
refashionment	重作
coprozoic	寄生在粪便中的
pandean	牧羊神
nominate	推荐
corticated	有皮层的
scutch	将麻
nuppence	不名一文
hexapodic	六音步诗句
micropublishing	缩微出版
galley	大型划船
semiglazed	略上釉
violinmaker	小提琴制作人
dr	Distributed
vinylon	维尼纶
apagogic	反证法的
computer	电脑
consolatory	慰问
geranial	牻牛儿醛
chaw	一满口
augustly	威严地
embrown	使成淡黑
limpingly	跛行地
disagreement	争执
extracurricular	课外的
monomerous	一基数
superannuable	退休后可领取养老金的
sesquialtera	=hemiola
roric	露水
damascene	大马士革的
choragic	合唱团指挥的
mousseux	起泡的
repute	认为
remorseful	悔恨的
scrubby	树丛繁盛
capsule	胶囊
mottlement	云纹状
lace	扎带子
ultraleft	极左
sporotrichosis	分支孢菌病
tolerance	规定公差
severalty	单独保有
gee	字母G
highly	非常
torus	花托
apolitically	不关心政治地
weenie	微小的
ecospecies	生态种
veronese	意大利之维罗纳Verona
chemotaxis	趋化现象
twu	美国运输工人联合会
doglike	忠实的
bodhidharma	菩提达摩
vexillar	旗瓣的
tsutsugamushi	disease恙虫病
telestich	各行最后的字母可缀合成一名的短诗
infundibulate	似漏斗状器官
pilsener	高级啤酒
malversation	渎职
oath	宣誓
flatware	扁平的餐具
promulgate	发布
presenile	过早衰老
achromatous	淡色的
errand	差事
fob	骗人
illegitimacy	不法
thio	硫代的
impitoyable	大品酒杯
carbonaceous	碳质
vaporimeter	蒸气计
antiwhite	反对人
underhand	下投的
defendant	辩护的
spinsterhood	独身
screaming	令人惊愕
spectrally	幽灵似
baronial	宏大的
filature	纺丝
subcommission	专门委员会
mild	适度
ope	自由进出
cubiform	立方形
demimondaine	名声不好的女人
coprological	淫秽
desponding	沮丧的
flappy	飞扬
disgorge	吐出
whippet	轻型战车
pony	小型的
extemporaneous	善于即席讲话
soigne	整洁
gastrolith	胃石
counsellor	辅导员
hexapodic	六音步诗句的
scraggly	锯齿状
lapidate	以石投击
aphakia	无晶状体
uncontroverted	无可置疑
cancrivorous	食蟹
kersey	一种粗绒布
polak	=Polack
neurodepressive	抑制神经的
putresce	变得腐败
ausgleich	条约
tawie	易对付
leiotrichous	有直发
krewe	克鲁
spa	矿泉
frustrated	落空
unicameral	一院的
candlepin	保龄球中所用的细长的棒
wobbly	摆动的
dronish	混日子的
monadic	单孢体的
ganoid	珐琅质
testamentary	遗嘱
crackers	精神错乱
nautili	的复数
irrepressible	抑制不住
whys	目的
bodyshell	车架
mitigative	缓和的
oriental	东方人最优质的
precessional	岁差的
hornwork	角堡
unanimously	全体一致
dialogically	问答体
romano	罗马诺干酪
voter	有投票权者
yogism	瑜珈主义
hep	消息很灵通的
instantaneous	即刻
livingstone	利文斯敦
suppose	假使……结果会怎样
whelk	海螺
coteau	山谷的一侧
troublous	动乱的
randomly	未加计划
vomit	呕吐
thinnish	有点薄的
pepsine	助消化药
activity	活动性
unhinge	使动摇
observantly	敏锐地
wide	远离目标
zonally	区域地
lionhearted	豪胆
rearwards	向后面
lance	长矛
eared	有把的
crop	收割
cardinal	最重要
dessertspoon	餐后甜点匙
biloquialism	=bidialectalism
canicular	天狼星的
tricentenary	三百年
superfluity	额外
sunniness	活泼
kashubian	卡舒比语
underserved	服务不周到的
parapeted	有胸墙的
crowstep	屋侧山形墙头墙级
euclidean	欧几里得几何学的
attenuation	变薄
depot	补给站
pronucleus	前核
lipoidal	类似脂肪
dissentient	反对的
strafe	用机枪扫射
extra	特别地
aeolian	Aeolus
ringlead	当……的头目
jerque	检查
postcranial	颅后
laborite	英国工党党员
loimic	疫病的
surfing	网络冲浪
ins	Insert的简写
souse	腌制
dushanbe	杜尚别
cyanine	蓝色素
injurious	有害的
putrefy	堕落
gumminess	黏性
ah	哈
dominating	独裁的
crappy	蹩脚
appositeness	适当
squat	蹲着的
eeoc	均等就业机会委员会
handling	处理
not	不
splash	斑点
remote	偏僻的
gleg	敏捷而反应快的
duumviri	duumvir
octachord	八弦琴
anthracite	无烟煤
cretaceous	白垩系
overlusty	过分强健
breechblock	螺体
unreligious	非宗教的
revilement	诽谤
aircondition	设以空气调节装置
several	个别
honeyfuggle	骗奸未成年少女
luxate	使脱臼
unbent	直
tenor	誊本
pity	同情
locomotory	运动
draught	气流
photomagnetic	光磁的
follow	沿……而行
textual	本文的
dm	医学博士
premeditated	预谋的
helical	螺旋状的
atwain	成双
dicot	=dicotyledon
freeborn	生而自由
deathlike	死了一样
dixie	美国南部各州
anatomical	解剖学的
plf	pounds
classically	拟古
spadicose	肉穗花序的
orca	逆戟鲸
grolier	格罗里埃式装订
collate	比较
my	pro
unproposed	未提出
solatia	慰藉物
bracing	支撑
insecticidal	杀虫剂
luck	好运
illuminating	启蒙
asap	p
everyway	无论怎样看法
evolutional	进化的
semihexagonal	半六角形的
diamagnetize	使抗磁
caravanserai	=caravansary
drudgingly	辛劳地
yammer	抱怨
tinnient	发丁零声的
rpg	Play
pvm	Virtual
inscript	=inscription
fondly	情柔
collyria	洗眼剂
derange	使精神错乱
zamouse	萨姆斯野牛
oppressively	压迫地
ossie	=Australian
fulsome	过度
superfetate	异期复孕
roadstead	碇泊处
chaqueta	牛仔所穿的厚外套
excel	优秀
denarius	便士
suitability	合适
hydrometry	液体比重测定法
jehovic	耶和华的
fasciated	簇生
haemolysis	红血球融解
briton	英国人
syllogistically	演绎式
sulpician	稣尔比斯会会员
erective	建立
snaky	多蛇
quad	嵌块
pia	International
incitant	兴奋剂
spline	用花键联接
mnas	国家科学院会员
ultima	最终
drinamyl	紫心片
singularly	异乎寻常
setterwort	熊足嚏根草
slothfulness	怠惰
recumbently	靠着地
codominant	共显性
downbent	向下弯曲的
psychogony	精神的起源与发育
falconet	小鹰
consequent	作为结果的
firmer	坚硬
achillean	勇敢的
unspoiled	未损坏的
platypusary	鸭嘴兽圈养
gph	hour
masty	讨人厌的
difform	不相似
vitaceous	葡萄属植物
reliant	信赖自己的
translation	转化
charnel	阴森
tyrannic	压制的
hodge	英国庄稼汉
toadeating	拍马的
sirach	西拉书
cambridgeshire	剑桥郡
legman	采访助手
sooty	煤烟熏黑的
tablet	写字板
emptier	排空装置
antirheumatic	治疗风湿病
portico	柱廊
functionary	职员
cotransduction	共转导
sad	悲哀的
crumple	崩溃
lateral	横
historic	有历史性的
stanch	不透水的
lettercard	简便邮简
price	问……的价格
kathartic	=cathartic
despiritualize	使失去精神性
araucan	阿劳干语组的印第安语
microskirt	超超短裙
disleave	使失去叶子
extortive	敲诈的
innumerable	数不清的
uncommunicative	拘礼的
nice	挑剔的
wally	好
traversing	通过
flashback	急转
deliria	妄想
basta	够了!足了!
millionaire	大富豪
heterozygous	杂合的
engraft	嫁接
lick	轻轻拍打
implosive	闭塞的
appetent	本能欲求的
riveter	打铆机
otherguess	完全不同种类
awl	锥子
chance	运气
jota	霍塔舞
rap	轻敲
polydemic	广居的
nonrestraint	无禁止
underline	作……的衬里
autographically	亲笔地
dia	Defense
smtp	Message
malaprop	用词错误可笑
starter	起动器
tianjin	天津
unconsolidated	非层状
exhaustible	被取尽的
treat	治疗
implosive	内破发音
frcp	of
tuft	一丛
falconer	养鹰者
rodman	持枪歹徒
plicate	有皱襞
electrolytic	由电解产生
clearly	明朗地
unbelievably	难以置信地
tolerable	可以
irradiancy	光辉
illinoisan	伊利诺斯州的
decumbent	匍匐的
bantamweight	最轻量级的选手
creedal	教义
dissipated	闲游浪荡的
tinnily	锡地
lyrical	抒情诗调
skibobber	连橇运动员
neurovascular	神经与血管
clearly	无疑地
adrift	随波逐流
unfamiliar	不熟悉
swart	黑黝黝的
fake	欺骗
incent	刺激……采取行动
scanty	缺乏的
consummative	最后完成的
pauline	使徒保罗的
apical	顶点
allegiance	效忠
clypeiform	有唇基
modelly	具有模特儿特点的
devour	吞没
zinnia	百日草属植物
nes	s
sanguicolous	血寄生
degenerative	退步
spunk	勇气
project	设计
favelado	棚户区居民
cutcha	晒干的
arthropoda	节足动物门
harshness	粗糙的事物
nhg	High
americanologist	研究美国政府方针政策的专家
worry	苦恼
hypophosphate	连二磷酸盐
misplay	错误玩法
whaling	一阵痛打
spheroidic	类似球体
snatchy	断断续续的
phosphatic	磷酸盐
gimmal	双连环
osbert	奥斯伯特
haematocryal	冷血
laciniate	有细长裂片的
untrodden	未受践踏的
pulsator	震动器
halftone	中间色
contessa	女伯爵
semiferal	半野
plead	为……辩护
cutup	出洋相以引起注意的人
ruleless	无规律
undefended	无论据
epizootic	流行于家畜的
phorate	三九一一
ominous	预兆
undissembling	真诚的
anywhere	无论何处
corruptibly	可被收买
piratic	海盗
affinitive	密切相关
unselected	非精选
sibilation	咝咝作响
aboriginal	土著
uninspired	缺乏创见
champleve	雕刻后填上油漆
plasmapause	等离子体层顶
unescorted	无人护送的
fissile	裂变的
hamstring	腿筋
matthew	马太
formulization	把……作成公式
indicative	可表示
andantino	微急的节拍或曲子
cavalier	骑士
moldproof	防霉的
doctrinaire	教条主义者
bootleg	私卖
gratification	满意
robustly	要用体力
chozrim	回家园的以色列人
fleeceable	易受欺诈
patter	喋喋不休地说
topwork	整顶嫁接
fisherman	渔夫
whoopee	喧闹
commeasurable	可成比例的
imbecilic	低能
duvet	用羽毛
phonevision	有线电视
pituitous	黏液的
antiutopian	反面乌托邦的
spirillum	螺旋菌
predicability	可断定为……的属性
automatic	无意识
synectic	共同研讨
vesiculate	小泡
dumdum	达姆弹
signed	有正负之分
flyflap	蝇拍
miscreated	丑的
rascaldom	恶棍
cinerator	火葬炉
nonet	九重奏曲
irruptive	深入的
ineligible	不合格的
uneven	奇数
wired	杂志
schism	分裂
quaternate	由四个组成
arbitrament	仲裁
dizzyingly	灿烂
emanant	发射的
unobtainable	难获
sentiment	观点
titman	最小的猪
imperforated	未穿孔
involute	恢复原状
cardiocirculatory	心脏和循环系统的
inflation	通货膨胀
renascent	新生
exoatmospheric	外大气层
grain	颗粒
misascription	错误归属
agonizingly	苦闷
nonferrous	不含铁
whist	安静地
haemoid	像血的
catercornered	对角线的斜放的
sibylic	=sibylline
coquetry	卖弄风骚
exploratory	探测的
extrema	extremum的复数
ratten	毁坏
pigeonhearted	害羞
antemortem	临死前
judaism	犹太教
steeper	陡峭
stalinabad	斯大林纳巴德
theremin	泰勒明电子琴
constable	警官
frontage	临街
cryoextraction	冷冻摘出术
labyrinthian	错综复杂
pattern	模仿
chloral	三氯乙醛
intervolve	互相牵连
hemiplegy	半身不遂
motiveless	无目的的
diversion	转移
make	增大
lixivia	碱汁
nepotism	起用亲戚
spitcher	击沉
hempie	似麻的
hip	忧郁
murderous	杀人的
whomp	发撞击声
prognostic	预兆的
cockeyed	荒唐
nurture	给与营养物
baganda	巴干达人
fastuously	炫耀地
mamillate	乳头状
antienergistic	逆能的
cuddly	喜爱抚的
nudge	用肘轻推
apt	倾向是
throat	喉咙
wobbegong	shark
refution	反驳的言论或意见
tritural	用于研磨
intrastate	州内
photoactive	活
hyperverbal	极其罗唆
nutcracker	胡桃钳
feeling	情绪
feculent	肮脏的
enveigle	拐骗
amercement	罚金
impressionist	印象主义者
effectively	有效
abaddon	地狱
greensick	患萎黄病的
unright	非正义
protonate	给……加质子
hamitic	哈姆族语
homeric	荷马
slip	塞入
replant	再植
lithophilous	生长在多石环境
compelled	强迫
zoomimic	模仿动物行动的
undisposed	无倾向的
spline	花键
louse	寄生虫
remelting	重熔
knub	肿瘤
flicker	闪动
ledge	矿层
actinism	光化度
hexabasic	六碱
microvillus	微绒毛
estaminet	咖啡馆
assumption	设想
inscriptive	铭文
niobite	铌铁矿
colonel	团长
aimlessly	没目标地
redressment	=redress
impromptu	即席演出
drugpusher	贩麻醉药者
cacomagician	用妖术害人的巫师
charolais	夏洛来牛
eruptive	疹
characterful	表现性格
weird	不可思议
ultrathin	极细的
towardly	乐意
falsification	串改
flier	快船
taratantara	喇叭声
uraeus	蛇形标记
hygeian	卫生的
lane	航线
sexennial	持续六年的
koblenz	科布伦次
elapse	消逝
romanticise	=romanticize
detectible	可看穿
zain	纯暗色马
hypsography	地形起伏
rotfl	笑得在地板上打滚
turgescence	膨压
ek	Kodak柯达公司
takingly	传染
extracapsular	囊外
toluate	甲苯甲酸盐
inchoate	不完全
lucre	钱财
waveringly	摇摆
tyne	泰恩河
lunate	新月状
surjective	满射的
encephalitogen	`dVenIk/
keystone	重点
brawn	腕力
modestly	谨慎
latitude	范围
linkman	前卫
parturifacient	催生的
charry	炭的
mammalia	哺乳动物
mystical	奥秘
hand	支配
twig	小枝
extortionist	勒索钱财
undefiled	纯粹的
cherub	小天使
smacker	发出咂咂声的人
broad	宽阔地
congest	使充血
hoop	箍
menu	菜单
authoritative	有权威的
iris	虹彩
incentive	激励的
spoliation	掠夺
sncc	Student
chargeable	可以控诉的
fashionmonger	赶时髦的人
faggot	捆
intangibly	无形
photoflash	使用闪光灯
awninged	挂有帆布篷的
proverbially	众所周知的
mucolytic	黏液溶解的
ricket	大错
moony	月亮
make	制造
sclerosing	硬化型的
tyrannously	压制地
backmarker	从起点起跑的运动员
prussia	普鲁士
supplemental	追加
unsuspicious	不怀疑的
disclaimation	否认
monoaminergic	单胺能的
flannelette	棉织法兰绒
succinct	简洁
loculus	室
anhydration	除去水分
freebooting	掠夺
diverting	令人快乐
gopura	华饰庙门
bidarka	皮筏子
labyrinth	难解的事物
semioccasional	偶尔的
mass	质量
augmentor	起扩大推力增强装置
peg	钉木钉
unrounded	不圆唇的
unmotherly	与母亲身份不相符的
yauld	敏捷
synergetic	协作
half	不完全
funny	有趣
extent	程度
radiotelephone	打无线电话
roumania	罗马尼亚
artifactitious	人工制品的
mantid	螳螂
blepharoplast	毛基体
pachyderm	厚皮类动物
sachet	小袋
antependium	装饰
multilobate	多裂片
chainless	无束缚
baccivorous	食浆果
rascal	坏蛋
bacteremic	菌血症的
drakensberg	德拉肯斯堡山脉(即夸特兰巴山脉
abstinence	节制
ariboflavinosis	核黄素缺乏病
pucka	份量充足
insensitive	感觉迟钝
kennel	阴沟
campylotropous	弯生
worry	折磨
servohydraulic	伺服液压控制
nasa	and
tumult	拥挤
prefatory	前言
glitter	闪光
enervation	削弱
rush	急流
identifier	检验人
recording	录音带
denlture	假齿
particularization	细说
tuc	Congress
coleopteron	甲虫
pythonic	预言的
gradatim	渐渐
obscurantist	反启蒙主义者
longshanks	千鸟类之涉禽
echolocation	回声定位能力
best	最好地
highjack	抢劫
nuke	核武器
phew	哟
scarab	圣甲虫
synapte	连祷
formation	构成
interdisciplinary	各学科间
vitiator	损害的人
angus	爱神
sobranje	国民议会
coordination	同等
mix	混合
ligure	紫玛瑙
lycian	利西亚语
hydrocinnamic	aldehyde
unnerve	使失常
hierurgy	礼拜式
malingerer	装病以逃避责任者
meliorable	可改善的
residually	残余
yokefellow	伙伴
pretor	长官
capillary	毛状的
ciliolate	有纤毛的
pds	Process
isolecithal	=homolecithal
savoury	香喷喷
phoney	骗人的东西
seriate	连续的
colorimeter	色度计
appetent	本能欲求
vertimeter	升降速度计
overhaul	检查
lamia	妖妇
pentazocine	镇痛新
millenarianism	信千福年
molucan	摩鹿加群岛的
puff	蓬松
macrolith	棒状石器
demagoguery	煽动行为
mortar	灰泥
agley	弯曲地
misogynic	嫌忌女人的
licity	合法地
sunbrowned	被太阳晒黑
byronic	拜伦风格的
guilt	罪行
pivot	中心点
stanch	忠实的
grown	grow的过去分词
jonquil	长寿花
shopping	买东西
overhappy	过于快乐
carbonous	碳的
hemipod	quail
sustain	支撑
commonsensible	常识
travesty	滑稽的转写
pathbreaking	开创性
wrong	坏事
rebel	反抗的
trichoma	毛状体
factoried	多工厂的
consistorial	监督法院的
subseptate	稍具隔膜的
lophodont	脊牙型
bengali	孟加拉人
hypnotize	使恍惚
prepsychotic	精神变态前
glibly	流畅
rampage	发怒
scurrility	谈吐卑劣粗俗
arbitration	仲裁
entreprenant	有上进心的
corruptible	可以贿赂
paralytic	瘫痪的
pergola	棚架
multiprobe	多星球探测器
percuss	轻叩
activise	使活泼
unsling	从悬挂处取下
leastwise	至少
superabundance	多余
personality	诽谤、人身攻击
expressionist	表现主义
hma	Memory
vaginated	有鞘的
keenness	敏锐
subgroup	隶属的小组织
hide	隐瞒
suctorial	吸
cityward	朝向都市的
velskoon	=veldschoen
gainsay	否认
wednesday	星期三
roofscape	屋顶风景
anginal	咽炎的
thalamostriate	连接丘脑和纹状体的
decasyllabic	十音节
turnery	车工工艺
depreciation	轻视
parian	帕罗斯岛的
antianxiety	抗焦虑
nameable	可指名的
pelagian	远洋
circular	圆形
snig	小鳗鱼
gentilism	异教
suboesophageal	食管下的
acrr	American
lamenting	悲伤
overwinter	过冬
germinal	幼芽
feedingstuff	饲料
penitential	忏悔
pleurisy	肋膜炎
openable	能开的
georgette	乔其纱
wandering	蜿蜒
unitary	单式
peculator	挪用公款者
maintainable	可维持的
fastish	尚快
buggy	尤指旧汽车
psychograph	心理描绘图
karlsbad	=Karlovy
crossly	横地
microstation	微型工作站
howff	常去之地方
poliovirus	脊髓灰质炎病毒
chrp	Platform
unfinishable	结束不了的
sphygmogram	脉搏曲线
plush	豪华的
bootprint	靴印
unwilling	不愿意的
stellular	星点花样
chagrin	委屈
sdcd	高密度光盘
illustrative	例证性的
transformative	变形的
sestet	六行诗节
multisession	多区段
water	水生的
accompanying	附随
albescent	带白的
discifloral	盘状花的
windowy	洞多的
loon	笨蛋
bally	讨厌的
tartarian	鞑靼的
expeditiously	迅速
caravansarai	大旅舍
humic	从腐殖质中提取的
copartnership	合作
cologne	科隆
pyaemic	毒血症
corresponding	相应的
globuliferous	产生极小球体或小滴的
volitant	活动的
impossible	不会发生的
axman	用斧者
slowly	慢慢地
switzerland	瑞士
machinability	切削性
torture	折磨
zebec	小型三桅船
intermissive	=intermittent
hefa	Act
intrepid	勇猛的
mistress	情妇
xanthein	黄色色素
slosh	泥泞
unparalleled	空前的
grocer	食品商
glazer	加光工人
transcontinental	横穿大路的列车
sniff	吸气声
loosely	松散
landholding	土地所有的
vernally	青春
la	老挝人民共和国
housewarming	乔迁庆宴
elate	使得意
virilism	男性化现象
untransferable	不可转移的
libido	性的冲动
ssbn	Submarine
put	移动
disturbing	烦扰的
cervicitis	子宫颈炎
rehumanize	使改邪归正
flavodoxin	黄素氧
touch	涉及
sublunar	月下
dlitt	文学博士
unhappy	不快乐的
beachbound	往海滨去的
scalp	头皮
unrig	卸除船上索具
bhc	六氯
obelisk	短剑号
lithoprint	石版印刷
bloodiness	血污
underwater	在水下的
reconcilably	不矛盾
feoff	采邑
unholy	不合理的
flannel	用法兰绒包
llewellyn	卢埃林
providence	神的眷顾
unaccented	不发重音
monition	告诫书
pulldown	折叠式的
sailor	海员
vulturine	贪婪
inconsolable	极为伤心的
paramagnetic	顺磁性的
lamaster	逃兵
unfixed	解脱的
pyrolysis	高温分解
ringway	=ring
millier	ton
doing	干
fuzz	使模糊
pulsate	有规律的跳动
hospitably	亲切
cryolite	冰晶石
nhk	日本广播协会
subdivisible	可以细别
diametric	直径的
radius	范围
chlorotic	变色病的
interlacustrine	湖间
typhonic	台风
vertiginous	迅速变化的
unliquefied	未液化的
eruptive	暴发
devolatilization	液化作用
vehement	猛烈的
begirt	被围的
cryptological	暗号
uncloister	使自由
pretersensual	超感觉的
worthful	宝贵的
hindustani	印度斯坦语
zadar	扎达尔(旧称扎拉
figwort	元参科的植物
limit	界限
aptotic	固定
unstriped	非横纹
flickering	忽隐忽现的
hypaethral	户外
condescension	谦虚
cryptological	暗号的
functionary	官员
autolatry	自我崇拜
schizophreniform	精神分裂症样
pert	无礼的
biosensor	生物传感器
overlay	覆盖
jingling	叮当响
subaquatic	半水生的
sheikh	n教长
indolently	不痛地
bitterly	苦苦地
contretemps	不幸
netlike	形成网壮
imply	意味
cosher	给好吃的东西
unusual	与众不同
incitant	刺激的
alamein	阿拉曼
tedious	单调乏味
incoherence	无内聚力
inadvertently	不注意
pinyin	拼音
dipartite	区分
crenate	圆锯齿状
martially	勇敢
tuc	Union
unsoldierly	非军人
twine	缠绕
ringtoss	投环游戏
inexcusable	没法辩解
overset	推翻
pervasion	渗透
compaction	压紧
expect	期待
gimcracky	华而不实
homologate	批准
rowdyish	粗暴的
ditto	与前同地
septuplicate	一式七分
encyclopaedic	百科全书式
keitloa	非洲犀
by	经
demarcative	分界
fizz	兴奋
submetallic	亚金属
cruiseway	供乘船游览用的河道
parmigiano	用帕尔马干酪调制
zonetime	区时
smack	少量
kk	KK音标
jin	神灵
caver	探察洞穴的人
lopsided	倾向一方
amethyst	紫色
polynomial	由
logarithmize	查对数
conclusion	结束
idc	Internet
trimonthly	每三个月一次
monospermy	单精受精
scissor	剪刀
wobbler	思想动摇的人
glassine	薄玻璃纸
endomixis	内合
galactose	半乳糖
impromptu	未经准备
zooplankton	浮游动物
involute	纷乱
gridder	足球选手
ccsa	Common
romeo	罗密欧
aerotactic	趋氧性
facility	敏捷
ultraminiaturize	使成为tFEraIzd/
tommyrot	瞎说
patternize	把……构成图案
swellish	漂亮
cs	铯
judea	南部
protractor	量角器
mild	淡味的
heartrending	令人心碎
brimstony	似硫黄
gerrymander	为本党利益改划选举区分
operon	操纵子
resupinate	颠倒
martyrologist	殉教史研究者
corresponsively	反应地
hydrofoil	水翼
silvical	森林学
vote	表决
pathogenicity	致病性
autobiographic	自传的
birdie	小鸟
inexactitude	不正确
rsvp	请回复
cragged	峭壁多的
sulphinyl	亚硫酰基
indecomposable	不能分解
kampar	金宝
hyperaggressive	咄咄逼人
kerchiefed	围着头巾的
trunk	树干
joshua	约书亚书
postponement	延缓
jaguarundi	美洲山猫
tcp	/用于网络的一组通讯协议
semicivilized	半文明的
arroyo	峡谷
vsat	Terminal
commissary	委员
wll	Local
gsm	for
moneyless	一文不名
cuspidor	痰盂
gerontophil	嗜耄癖的
yell	呼喊
bitterness	苦味
scapegrace	不可救药的恶棍
stipple	点画
pittypat	劈劈拍拍地
disposal	配置
mischance	灾难
pet	生气
accelerometer	加速计
static	静态
notional	实义
pda	Digital
benne	胡麻子
semispherical	=hemispheric
angiography	血管造影术
lunatic	大傻瓜
conscienceless	没良心
glogg	格拉格
guzzle	喝酒化掉
special	专用的
contrary	执拗
against	逆着
mao	毛式服装
tray	碟
innuendo	暗讽
ludicrous	愚蠢
voltaic	电流
ankylose	使僵硬
bottom	查明真相
alleviative	减轻
garniture	装饰品
undismayed	不泄气的
shit	对……胡扯
gelatiniform	胶状
eminence	显赫
reman	重新获得勇气
ferruginous	铁锈的
latinesque	如拉丁
solaceful	带来安慰
undereducated	未受良好教育
disbursement	支出
japanophile	崇拜日本的人
frisco	Francisco
conduplicate	折合状的
oatcake	燕麦硬饼
co2	二氧化碳
agglutinative	会胶合的
pug	拳师
unspeakably	无法形容地
laver	紫菜类
solar	日光
suited	适合的
couth	有礼貌的
guevarist	格瓦拉主义者
freckle	雀斑
earnings	收入
doeskin	一种类似母鹿皮细软白织品
sequestered	幽静的
sempre	一直
pettifogging	讼棍的
gearchange	lever
bronchogenic	影响支气管的
theist	一神论者
unbeliever	不轻信者
tampan	波斯锐绿蜱
anterolateral	在前面偏一边
oaec	for
adenalgia	腺痛
seabed	海床
tolerable	可容忍的
wallflower	桂足香
executioner	死刑执行人
taking	迷人的
watering	灌溉的
pokey	破旧的
powerpoint	微软公司生产的制作幻灯片和简报的软件
dissector	解剖器
file	列队行进
cymose	聚伞花序
tracheitis	气管炎
zincify	包以锌
cssr	Socialist
experiment	做试验
vdi	Virtual
imbrute	堕落
trichloroacetaldehyde	三氯乙醛
bivariate	双变的
yunnan	云南
strobic	旋转的
tsinghai	青海
cilice	粗毛布所制衬衣
handtailor	定制
menthene	薄荷烯
userid	在电子邮件地址中@符号之前的名称
dead	不流动的
implicit	固有
fairly	清楚
spaniard	西班牙人
restitution	归还
cardiotonic	强心剂
scissile	易裂开
panellist	小组辩论
unsuccessful	不成功
flatling	以的扁平面打击
primitive	原始的
pickwickian	匹克威克的
resist	反抗
cyprian	放纵的
embassage	使命
irrepressibly	无法抑制地
annoyingly	烦人
strychnin	番木鳖碱
jingoism	沙文主义
bargainor	出让人
pgup	pageup
polemical	好辩的
syphilitic	感染梅毒的
getaway	逃走
roubaix	鲁贝
tufty	簇生的
zonta	职业妇女的互助福利俱乐部
musing	冥想的
rerecording	再录音
repressurize	对……再增压
vanadinite	钒铅矿
arras	挂毯
femininely	娇弱
dawdler	游手好闲的人
fibrotic	纤维化
vapidly	无趣地
trotty	快步的
striate	加条纹
sty	猪圈
iodic	碘的
westralian	西澳大利亚的
unforensic	不适于公开辩论
chaste	贞洁的
witch	女巫
varia	杂集
percent	百分数
karman	cannula
nymphomaniacal	女色情狂的
effortful	充满努力的
mating	杂交
isogamy	同配生殖
iontophoresis	离子电渗疗法
elegance	典雅
irremovability	无法移动
sebe	by
nephalist	禁酒主义者
tannage	鞣革
otp	Open
fly	飞越
baskerville	巴斯克维尔体
overnight	整夜
plumbiferous	产铅
neoterize	造新字
glare	闪耀
unpeg	拔木栓
wealthy	富有的
phase	相
tumorous	肿瘤性的
radicle	原子团
joint	接合处
quibblingly	推诿
magnesite	菱镁矿
adas	Development
underpinner	支柱
bimetal	=bimetallic
stiffly	顽固地
slabber	口水
luxuriously	奢侈地
firer	开炮者
wbs	south
praetorian	执政官阶级的人
halfback	中卫
illuminable	可被照明的
rhinoplasty	鼻整形术
somal	神经元体细胞的
tell	传闻
arrogation	篡夺
testudo	保护物
junket	野餐
governable	可控制的
duplicate	复写
verdin	黄头小山雀
when	……的时候
laryngectomize	为……作喉头切除术
expire	终止
frg	Republic
alawite	阿拉维派教徒
exarchate	之职
mnas	National
odorously	芳香地
zoonosis	动物寄生物病
drafty	通风良好
sociable	好交际
cetrimide	溴化十六烷基三甲铵
scalenotomy	斜角肌切开术
endorsement	背书
relatively	相关地
filespec'	NULL)
molecular	分子的
engage	接合
extraparliamentary	国会权力以外的
scapement	擒纵轮
tangerine	橘子
trevira	特雷维拉
unifactorial	单基因的
spadicose	生肉穗花序
defer	推迟
loan	借出
sleepful	睡眠的
custodes	的复数
catty	狡猾
bacillus	细菌
campy	不自然的
aluminothermics	铝冶术
fcis	Chartered
degenerative	退化
economist	节约者
estrepement	使土地枯竭
beluga	白鲸
cryptic	隐藏
fungo	为练习守备所击的飞球
prayerful	常常祷告
image	作……的像
variceal	脉管曲张的
stolidly	迟钝
clarification	澄清
ageusia	味觉的丧失
exteriorize	将器官由腹取出
belgravia	嗜好等
justiciary	高等法院法官
while	一会儿
insistency	强迫
numega	Check的系统软件公司
pyroligneous	焦木
cicala	=cicada
descendant	后代
wise	告诉
bedel	捧持校长权标的属员
rotund	圆形的
accuse	非难
strafford	斯特拉福德
snipe	香烟屁股
sequitur	结论
cowpox	牛痘
functionary	职务的
seromuscular	浆膜肌膜的
diapsid	具双窝
boundlessly	无穷
superpersonality	超人格存在
headgear	头饰
advanced	年老
set	事先做好的
unsocial	不善交际
busily	忙碌地
evadingly	逃避地
voltammeter	电压电流两用表
behaviouristic	行动主义
blur	弄污
antiperiodic	抗周期性病药
frugally	节省地
procellous	狂暴的
pussycat	猫
outshoot	伸出
extract	求根
farinose	具粉的
probabilize	使成为可能
misbound	装订失当的
extrahepatic	肝外
stratovolcano	成层火山
silt	淤塞
caffeol	咖啡醇
sternly	坚决地
corporation	公司
milter	产卵期的雄鱼
devise	设计
tinned	罐头的
synoecete	=synoekete
visitorial	巡察
europatent	欧洲发明专利
streptovaricin	曲线链丝菌素
discrete	不连续
springwater	天然泉水
reasoningly	推论
resplendently	灿烂地
alow	在船底
ashlaring	镶墙石板
gawky	笨拙
wiretapper	搭线窃听者
certain	可靠的
hundredthly	第一百个地
fond	宠爱
braise	炖
feoff	授予封
leadenhearted	没有恻隐之心的
skurfing	=skateboarding
defrock	解除僧职
alfafoetoprotein	=alphafetoprotein
disengaged	闲散的
zigzag	曲折的
labradorian	拉布拉多半岛的
raid	of
reputably	卓越地
corollar	花冠的
ctd	Committee
dissension	争执
skillfully	技术好
sutlej	萨特累季河
paradoxical	荒谬的
rotl	罗特尔
efficient	有效率的
arid	无趣的
bailiff	主管家
considerate	考虑周到
sacrifice	献出
mystery	神秘
eighth	第八
annihilable	可毁坏的
collage	抽象拚贴画
zoom	缩放
unhidden	不隐藏的
shoogle	来回摇
wba	Association
radionuclide	放射性核
marengo	油炸后加西红柿和蘑菇一起炖的
megaric	=Megarian
flecklessly	无斑点地
schooling	学费
parapeted	有胸墙
sigri	炉灶
sustentive	支撑
immunosuppress	咭种萍
undersell	以低于市价售出
gemmaceous	像芽体
unemployment	失业
isometry	等容
diminishable	可缩减
plenism	物质空间论
harmonically	调和
moravian	摩拉维亚的
arbitration	公断
quelea	红嘴奎利亚雀
undignified	不庄重的
animalize	使动物化
shark	骗子内行
intracranial	颅骨内
indistinctly	不明了
civvies	平民
intraspinal	脊柱内
spaceplane	航天飞机
competitory	竞争
dictum	法官的附带意见
reusage	重复使用
miocene	中新世的
flakey	古怪的
stannic	锡
metoestrum	后情期
psid	per
redaction	编写
uncustomed	未经海关通过的
fatten	长肥
tribalism	部落制
knowledgeble	博学
chromophoric	发色团的
biomere	生物层段
cashmere	山羊绒
usable	便于使用
ineluctable	不可避免的
bromidic	平庸
grillage	格排垛
zombiism	蛇神崇拜
wimshurst	维姆胡斯特起电机
umw	Workers
dioestrous	有间情期
casually	随便
ademption	撤消遗赠
coralberry	珊瑚莓果
discommender	反对者
musket	步枪
unconsummated	未实现的
sterling	纯银制
grot	洞穴
contagion	传染病
matchmaker	安排体育比赛的人
introductive	序文
abiogenetic	自然发生
assay	化验
afternoon	下午
wistful	想望
divinity	神性
piscina	浴池
choplogic	好辩
unmoving	不感动人
scirrhous	硬癌
versification	诗律
calcicolous	钙生
ranking	队
worth	值钱
ornithologic	鸟类学
lent	四旬斋
caput	头
cumulus	积云
concern	关系到
depressing	阴沉的
saving	节俭的
peril	危险
ramallah	拉马拉
infant	婴儿的
bibliotheca	藏书
virosis	患病毒性疾病
conciliationism	Ist/
huffish	发怒的
gesticulation	姿势
infernally	可憎
coryphee	芭蕾舞的首席舞手
oblomov	奥勃洛莫夫(俄国作家冈察洛夫
reflorescent	再开花的
corvette	轻巡洋舰
impecuniosity	没有钱
junius	朱尼厄斯
overchoice	过多的选择余
indicial	指标的
atelic	未完成的
coly	鼠鸟
converted	修改的
militarise	军国化
saphenous	隐静脉的
frowst	闷居室内
blaze	公开宣布
selenologist	月球学家
planish	打平
restis	索状体
autochthon	土生的动植物
bondon	软乳酪
crass	粗糙
kingdom	王国
consilient	符合
surveillant	监督
wearily	疲倦
inapparent	不显著的
leguminous	豆科
ground	土地的
sweltering	闷热的
spumous	泡沫状
vsat	Small
euphemize	委婉地说
echinoid	海胆状的
cement	水泥
volley	进行群射
hearten	激励
luxurious	奢侈
sapor	味觉
expect	盼望
felting	制毯法
batman	勤务员
scoline	琥珀胆碱
subaltern	次长
downcast	悲哀的
espousal	拥护
paycheck	薪水
garrison	驻军
locator	土地
linseed	亚麻仁
nonresident	不住在任所的
hors	……之外
winterless	无冬天征象
remittal	免除
luny	=loony
force	力量
pearly	珍珠似
seacopter	水上直升飞机
springer	蹦跳的人
imploringly	恳求地
locky	成束
lodestar	北极星
asianic	小亚细亚的
melilot	草木犀属植物
unidentifiable	无法鉴定的
trisome	三体细胞
garmenture	服装
jams	宽短裤
beloved	心爱的
lanolated	有羊毛脂
autogeny	单性生殖
cementitious	似水泥
extorsively	敲诈地
binary	二元的
scissor	剪取
bacteriostasis	细菌抑制
kreisler	克莱斯勒
indicate	显示
tex	telegraph
felibre	普罗旺斯作家学会会员
copperbelt	铜带
corbelled	以承材支撑
enormous	巨大
dooda	激动
negativistic	否定论
softpanel'	NULL)
propeller	尤指轮船
chenar	=chinar
athambia	沉着
hit	击中
exiguity	些须
honorific	尊敬
caseate	干酪化
dampish	稍湿的
paymistress	工薪女出纳员
amnionic	羊膜的
standing	常设的
meridian	正午
cacodorous	有恶臭
unclimbable	不可攀登
rambling	流浪性
assumingly	无礼地
reexplore	重新探测
solubilisation	=solubilization
offender	罪犯
apices	见
triangulate	对……作三角测量
balladry	民谣
innate	先天
hemipterous	半翅类的
spck	Knowledge
remembrance	记忆力
castalian	诗之泉
vegetal	植物
melodrama	情节剧
hedgepig	棱型拒马障碍物
melaleuca	白千层属灌木
powerfully	强烈
dubitant	半信半疑
homonymy	歧义
irradiation	照射
surname	姓
extra	特佳的
sayest	say的第二人称
morningtide	早晨
diffusive	扩及的
toploftical	=toplofty
bachian	巴赫音乐的
heredity	形质遗传
recollected	冷静
trihydric	三羟的
quizzy	爱打听的
motorial	发动的
commanding	指挥的
babylonish	巴比伦
rational	理性
parky	寒冷
spuriously	伪造
complication	因素
eff	v弄糟
inarticulacy	拙于辞令
decoy	猎鸟时以引诱别的鸟集于一地的真鸟或假鸟
forenoon	上午
miocene	中新统的
qiviut	北极麝牛身上的绒毛
kosciusko	是澳大利亚山脉
trommel	矿石筛
middlescent	中年期的
dialyze	透析
cuso	Canadian
albescent	变白
biodegradable	生物所能分解的
crepuscular	黄昏的
cryptography	密码系统
thievery	赃物
annunciatory	可预告作用
disyoke	使脱离桎
athena	雅典娜
discard	丢弃
land	登岸
uno	联合国组织
patinize	=patinate
towardly	乐意地
legality	合法
polydipsia	烦渴
mohist	墨子信徒
sublimely	卓越地
segregative	易分离
alky	酒精
venerable	庄严
destructivity	破坏能力
ac	锕
psyche	精神
effulgent	光辉灿烂
irremediable	不能治疗
unsmart	不机智
rebeldom	起义者
moslemic	伊斯兰教
tayside	泰赛德区
decreasingly	渐减地
overestimate	评价过高
tartar	难对付的人
aeronautical	航空学的
depositional	沉积
chymic	化学的
nickelous	二价镍的
unaware	没觉察到
sulfamethoxypyridazine	sulphamethoxypyridazine
akala	生于夏威夷的一种灌木或攀藤
illume	照明
bicuspidate	有两个尖头
frank	率直的
extinguishable	可绝灭
recapitalize	调整……的资本
and	然后
standardbearer	掌旗官
anomic	没有目的的
subjectless	无题的
remunerative	有报酬的
ute	轻便小货车
molluscoidal	似拟软体动物
herm	头像方碑
recalcitration	顽抗
jady	如玉
elaborate	精心制作的
slicer	刨煤机
basle	=Basel
nonnegotiable	不可谈判的
cig	雪茄烟
sigmoidoscope	S
objectionable	引起反对
shoddy	假冒的
enslave	奴役
dumbstruck	吓得发懵
pentagrid	五栅管
ranine	蛙科动物的
tricolor	三基色
piglet	小猪
exstipulate	无托叶的
platemaker	制版机
counteroffensive	反击
whisk	扫
voluminous	庞大
sacrifice	祭品
subjoin	附加
footpad	拦路贼
moslemic	穆斯林的
water	使湿
steep	急剧升降
share	分享
overfulfil	超额完成
deserved	当然的
pursuable	可追赶
flaring	花哨的
queue	行列
laxativeness	放肆
fallol	做作
sequentially	继续地
if	要是
guzzle	狂饮
raughty	愉快
accountant	会计师
slowly	迟缓
serpentine	蜿蜒的
evangelism	福音传道
episcopalian	主教派
proficiency	熟练
weathercock	风标
freemasonry	同病相怜
exultant	欢跃
whiff	喷气
postbag	邮袋
direction	方向
paint	油漆
subjoinder	添加的东西
medium	媒体
checkered	多变
description	描述
sheerly	完全
acesodyne	止痛药
uncommunicative	沉默寡言的
abduce	把……引开
hardhat	主张使用暴力的保守份子
depressive	郁闷的
wrinkly	易生皱纹的
tricksy	欺骗
hesitantly	迟疑地
difform	不同形状的
illustrational	举例说明的
straighten	弄直
crustaceous	硬皮
reconvence	再聚会
immediate	知觉
nitrid	=nitride
inorganization	无组织
computerite	电脑技术人员
funky	胆战心惊
greaten	使变大
asset	有用的东西
faulty	有过失
africanism	非洲民族主义
reject	拒绝
astrodome	天文航行舱
footling	愚昧
essentiality	重要性
feeling	富于感情的
serif	衬线
thermolabile	感热的
stouten	坚定
operation	工作
cantonment	宿营地
widest	广阔的
beechwood	山毛榉材
bungler	经验不够的人
avdp	avoirdupois
mcluhanize	使麦克卢恩化
man	雇工
captivation	着迷
great	重大的
usom	美国援外使团
clinometer	倾斜仪
uncontemplated	意外的
betty	贝蒂
phosphomonoesterase	磷酸单酯酶
gertie	格蒂
teletype	打字电报通讯
jeffersonian	Jefferson
insinuating	曲意巴结的
melton	麦尔登呢
unlearned	无学问的
wodginite	锡锰钽矿
crushing	决定性
photophobe	避光生物
gangsterdom	强盗或流氓行为
foremost	最先的
barefoot	赤脚
locomotive	机车
yaud	老而无用的马
dogberry	山茱萸的果实
aryan	雅利安语系的
palpebrate	有眼睑的
extremity	穷困
reprehensibly	应受斥责
christen	命名为
technetronic	电子技术所支配的
attestor	证人
grandfatherly	慈祥
receptacle	插座
hell	狂饮
polyhalite	杂卤石
aggiornamento	现代化
cottontail	棉尾兔
peace	静寂
untearable	不能撕开
drearily	厌倦地
rotissomat	电热轮转自动烤肉器
counterworker	敌手
chivalrous	有武士风度
scholastic	学校的
estate	阶层
arraignment	传讯
race	急流
stadtholder	=stadholder
goggle	瞪眼
innerspring	内装弹簧
triradiate	向三方射出
minbar	敏拜尔
withal	依然
supervisory	监督
immortal	不朽
fighting	战斗
aclinic	无倾角的
queenie	奎尼
internationally	在国际间
shield	遮蔽
jilin	吉林
felonious	重罪的
neanderthaloid	有尼安德特人体形特征
excommunication	逐出教会
bhajan	祈祷歌
victual	给……供应储备食物
perpent	=perpend
violetta	维奥莱塔
chemiloon	连有短裤的女用内衣
filial	子女的
stalactical	钟乳石的
kennel	置于狗窝
pool	池
sclaff	轻拍声
debacle	溃裂
sciurine	像松鼠
tanrec	=tenrec
minuteness	微小
proletariate	劳动阶级
californicate	使加利福尼亚化
warp	使不正常
clamshell	蛤壳式挖泥机
dependence	信赖
successional	连续性的
hallstattian	铁器时代初期文化的
favorite	喜爱的
oppression	压迫
slab	板层
conceptualize	使有概念
osculatory	接触
orbiculate	完整
geat	耶阿特人
olio	杂录
bairam	拜兰节
fireworks	烟火
pocket	据为己有
karma	因缘
yamato	大和民族的
decrease	减少之量
amassment	积蓄
storting	挪威议会
rondelet	短回旋诗体
literalness	无修饰
exploitability	可利用性
polygonal	多角形的
concelebration	共祝圣餐
shameless	不知羞耻的
restlessly	慌张
denudation	裸露
reactance	电抗
anguilla	安圭拉岛
vain	自负
clan	党派
pleonastic	重复
bloodsucking	吸血动物的
procryptic	原隐色
consubstantial	同质的
unorganized	无条理
peg	销子
soundless	无声的
fiche	微缩胶片
jackknife	vi对折
gremial	司教用覆膝盖布
supe	=super
ruthless	残忍
generalizable	可概括
fibrolane	菲帛罗兰
ponce	为妓女拉客的人
coati	长鼻浣熊
enigmatical	不可思议的
nbs	of
washeteria	自助洗衣店
party	党
obtuse	圆头
adverbial	状语
levan	果聚糖
origination	发源
antifungal	抗真菌的
diligently	坚持不懈地
exosmic	渗入
take	占领
sequential	有顺序的
crabbed	潦草的
suzerain	领主
anthroposociology	人类社会学
shortchange	欺骗
una	United
membranate	膜
gax	gaseous
borderland	边陲
trombone	长号
acinaciform	弯刀状
damsel	年轻女人
afterdinner	宴会后的
thunderbolt	突发事件
outrigger	舷外支架
matronly	主妇似的
deathsman	死刑执行人
fany	First
idolater	皈依者
pressure	压力
alabamian	阿拉巴马州
apologist	辩护者
exertive	使努力
laguey	麻烦的
ligamentum	韧带
superdense	超密的
conceptism	警名派
genially	和蔼地
aerify	使气化
ree	筛
doest	do的第二人称单数现在式
conjuring	魔术
euclidian	欧几里得的
satire	讽刺
hypocytosis	血细胞减少
firebox	燃烧室
babbitt	巴比特
baalim	Baal的复数
oreography	=orography
cardiometer	心力计
serac	冰塔
garden	园
intentness	集中
spottiness	遍处斑点
ribose	核糖
spiny	多剌的
ragpicker	拾破烂的人
hexaemeric	创世之六天记述的
undermost	最低地
spyglass	小望远镜
icrp	International
mimicry	模仿
sinaitic	西奈山
unobserved	无人遵守
punctilio	拘泥形式
catchlight	光滑或潮湿面所反射的亮光
stilt	使踏上高
hydromedusan	水螅水母
reportable	可报告
superphysical	超物质世界
alien	外侨
ernestine	欧内斯廷
slipcase	书套
bunch	捆成一束
prior	在前的
frondescence	发叶过程
bribeable	=bribable
phenolase	酚酶
landwind	breeze
indefeasible	不能废弃的
vaticanist	教皇至上论者
flattering	谄媚
superorder	总目
pickax	镐
tundzha	登萨河
nasa	Aeronautics
bulky	大的
leasing	说谎
scuff	以足擦地
run	跑
avowable	可明言
lacunule	小孔
raccoon	浣熊毛皮
deathlike	死了一样的
epiphyll	叶附生植物
bonesetter	正骨大夫
rumour	谣言
transmigrant	迁移者
hypersomnia	睡眠过度
poky	迟钝的
delaney	clause
cover	藉口
demulsify	反乳化
thrust	冲
coronae	光圈
material	肉体的
typhoidal	类伤寒的
triacetate	三醋酸基的
preservatize	用防腐剂处理
temporary	暂时的
uscgr	Reserve美国海岸警卫队后备队
bicorporeal	有两个身体
calloused	变得无情
aficionado	狂热爱好者
anathematise	诅咒
opioid	peptide
picket	放哨
mither	=mother
foist	偷偷插入
daylong	整天的
centrifugalize	利用离心机而分离
syllepsis	一语双叙法
hoop	环绕
univac	Universal
weftwise	纬向
percutaneous	经由皮肤的
microbial	微生物
customable	可征关税的
faultily	有缺点地
pasiphae	帕西法厄
sedimentation	沉降
obvert	将换置
titrimetry	滴定测量
iil	integrated
shall	将
criminatory	控告
egoistically	任性地
infelicific	不带来幸福的
excess	过度
remit	汇款
inedibility	不适于食用
fzs	Fellow
passe	凋谢
monocular	单眼用
covalence	共价
crabwise	横斜
enchantment	魔法
roguish	无赖
dyscrasite	安银矿
savour	品尝
unquiet	动荡
gurk	打嗝
outer	外部
qintar	昆塔
verism	真实主义
wire	用金属丝卷起
impassable	不能通行
couchy	茅草
miraculous	奇迹
ruralise	=ruralize
stownlins	偷偷地
spasmolytic	解痉
trisection	三等分
discarnate	脱离肉体
kasbah	土民区
nodulous	有小瘤的
pronation	手掌向下
underlay	铺在……下面
matripotestal	以女族长为权威的
fricassee	炖重汁肉丁
declaratory	宣言
televisionless	无电视机
abo	土著居民的
antichrist	基督的敌人
halloween	诸圣日前夕
relieve	救济
kanamycin	卡那徽素
reimport	再输入的东西
resiniferous	生树脂的
heartrending	伤心的
uppermost	至上的
poetical	诗
effectually	有法律效力地
laith	不想
wicket	售票窗
flapdoodle	梦话
picketboat	侦察艇
mesocolon	结肠系膜
crannog	湖中人工岛上之住宅
heliograph	照相制版
showman	玩杂耍的人
presternum	胸骨柄
wbs	by
proportionately	相称地
mawsie	羊毛衫
bdtr	Burst
sensualist	感觉论者
scopolamine	东莨菪碱
nummular	硬币形的
demonic	有魔力
kindergarten	初级的
moot	提出……供讨论
telecontrol	遥控
ceriferous	产蜡
queerish	奇怪
neck	脖子
shlock	=schlock
tripleheaded	三头的
lauryl	alcohol月桂醇
largo	缓慢地
addle	使腐坏
beerslinger	酒吧侍者
pelagian	洋面的
quitclaim	放弃合法权利
excoriation	苛责
condensable	可压缩
tricksy	顽皮
lacunose	多孔的
pharmaceutic	调药的
fireclay	耐火土
indefensible	不能防卫
bicorporal	有两个主要部分
wizardly	神汉的
lively	真实的
bridie	布赖迪
oleic	油
ectotrophic	外生
eduction	离析
divagation	误入歧途
sausage	腊肠
pneumatically	由空气作用
whencesoever	无论如何
remissible	可宽恕
nira	全国工业复兴法
mamillate	乳头状的
nonvolatile	非易失性的
lokanta	酒家
cornerways	斜
gushy	流出
kula	库拉
cycas	苏铁
crosscourt	斜线地
whole	全部
embog	使陷入泥沼
uddered	有乳腺
alley	小路
menstrual	每月
trestlework	叉架工程
cragginess	崎岖
impelling	强有力的
nwbw	west
repetend	循环节
sweetening	使味道变甜的物
system	体制
unfailingly	无穷尽地
swash	冲洗
leafleteer	发传单的人
abolishment	革除
collect	集中
fasching	嘉年华会
mow	扫除
babesiasis	焦虫病
dislikeful	令人嫌恶的
hydrometallurgical	9haIdrEJme`tAltE`l\:dVIkEl/adjEdVI/
nongraduate	非毕业生
distress	使忧伤
lightweight	不能胜任者
extravaganza	内容狂妄的作品
cheer	欢呼
lovelace	浪子
reciprocitarian	互惠
impayable	极贵重
drizzly	下毛毛雨
stop	阻止
notarization	公证
atomix	Development
resemblance	类同之处
slab	厚片
lasecon	激射光转换器
temporal	颞
pantomime	舞剧
disapprove	不赞成
bulltrout	鳟鱼
employless	无业
alternate	交替
bernadine	伯娜丁
sixer	得6分的一击
quadrilled	形成许多大小相同的方格
choice	精选
pleurotomy	胸膜切开术
krilium	土壤改良剂
umbrageously	易怒
faggot	束薪
bndd	and
bultery	伙食房
scrupulously	小心翼翼
emblematize	象征
glaucoma	绿内障
ingathering	收入
biradial	两侧辐射对称
att	Telegraph
lop	垂耳兔
interline	印刷于行间
spadefoot	锄足蟾
occident	西方
renew	更新
earthworm	蚯蚓
rigorous	严厉
publication	出版
barrage	阻塞
ecc	Error
vivat	=viva
persecutor	迫害者
peloid	疗效泥
monacid	=monoacid
welter	翻滚
barology	重力论
coacher	教练
hydrophanous	浸入水中变透明
hogwild	如痴如狂的
copyread	对……作文字编辑工作
degressively	递减
isolated	单独
ablactate	使断奶
shophar	=shofar
popinjay	花花公子
timeball	标准报时球
beauteously	美丽地
basal	基础
opaque	不传热
shoulder	侧翼
departmentalise	=lIzEm/
subcaudal	尾下
ebony	乌梅
helpless	无能
fairly	公正
effluvial	恶臭的
enos	以挪士
diseuse	独白艺人
mrbm	missile
commemorative	纪念的
retinued	在随员簇拥下
succous	液的
candied	甜蜜的
ncaa	Athletic
salacity	好色
hitchy	蹒跚的
parhelion	假日
exegetical	解经的
animality	兽性
impedimenta	妨碍行进或运动的东西
marcobrunner	莱茵河流域产的白葡萄酒
distilment	蒸馏液
nigritude	黑
personality	名人
desolately	寂寞
gap	隔阂
gainings	收入
strove	strive的过去式
gasifiable	可气化
hermia	赫米厄
unabridged	完整
gullible	易受骗的
optoacoustic	光声的
scale	生水垢
lark	骑马玩乐
complexity	复杂
untread	退回
english	英格兰的
santalaceous	檀香科的
routinize	使惯例化
operational	操作的
strange	不惯
pompom	对空速射炮
acarpous	无果实的
peer	凝视
quenchable	可抑制的
occupational	占领的
rhabdocoele	单肠目涡虫
fieldfare	一种鸟
pedlary	破烂
illuvium	淀积层
mastership	主人身份
inextirpable	无法消灭的
regenerate	更新的
chemnitz	开姆尼斯
daughterly	女儿似的
jocularity	打趣
numbing	使麻木
foully	下流
morigeration	谄媚
subsonic	比音速稍慢的
deceitfully	骗人地
ghastfulness	恐怖
flanerie	无所事事
shelvy	渐渐倾斜的
imagination	空想
venation	脉络
autarchic	专制国家
sncc	Coordinating
alme	歌女
cry	哭
vibratory	振动性的
seigneur	诸侯
duff	虚饰以欺骗人
decamp	逃亡
floriated	花形
electropolar	电极化的
unhcr	联合国难民事务高级专员
stanton	斯坦顿
crusade	改革运动
parlement	最高法院
arborescent	树木状
hotfoot	恶作剧
telecopter	空中电视台
hessian	粗麻布
yapped	卷边装钉的
prebiotic	生命起源以前
pharmacological	药理学
unsocial	不合群
portray	描绘
instrumentally	有益地
guiana	圭亚那地区
talkativeness	饶舌
triploid	三倍体的
fightback	反攻
count	注意
waterman	船夫
diatomite	硅藻土
blabber	多嘴的人
cheops	基奥普斯
subfamily	亚科
dimorph	二形之一
infective	会传染
tintinnabular	丁当响的
amiably	和蔼可亲
gracefully	温文地
metapsychic	心理玄学的
pardonably	可宽恕
remontant	一季多次开花
multicenter	多通道
morphological	语形学的
siphonal	水管的
uprise	起义
ichorous	脓水
coacher	拉车的马
unvouched	未被证明的
outlive	比……长命
ideological	意识形态
logman	采运工
polymorphism	多态现象
ruthlessly	残忍
roman	罗马的
arthrodic	滑动关节的
worthless	无益
macrodont	巨牙的
mac	Access
eskimology	爱斯基摩学
collarband	领子
exploitability	可剥削性
temporality	暂时
noumenon	实体
chockablock	塞满
beachside	=beachfront
hugeness	巨大
captious	挑剔的
superbomber	超级轰炸机
biotype	生物型
pelter	大降
primiparous	初产
workaholic	工作第一的人
crayonist	蜡笔画家
amos	阿摩司书
direct	直接的
backwardation	交割延期费
dantist	但丁学者
superficies	表面现象
cayuse	印第安种的小马
ips	inches
churchillian	邱吉尔作风
fujitsu	全球最大的计算机公司之一
dilettantish	一知半解
outfit	机构
tactic	排列
pinup	钉在墙上的东西
kronos	克隆那斯
caducei	MERCURY的手杖
actualize	实施
imperviously	透不过
coralliferous	产珊瑚
eucalypti	桉树
choreology	舞谱学
udometric	以雨量计测定的
devouringly	贪婪地
archly	顽皮地
meclizine	=meclozine
constabular	警察的
criminative	使负罪的
mensurable	可测量
pronouncing	表示发音
gainings	利益
bestow	给予
lightpen	光笔
psychologic	心理上
tsangpo	River
goddamnit	天杀!
xerophytism	适旱性
potecary	药剂师
mitis	可锻铁
forecast	预测
smartweed	荨麻
mononucleate	单核
trouper	戏团演员
mode	时尚
gallantly	献殷勤
eyen	eye的复数
omnisexual	包括男性与女性的
realgar	雄黄
repleader	第二次申诉
kerr	克尔
misgive	疑虑
alternating	交互的
brilliantly	灿烂
deltoideus	muscle
trochal	轮状的
synod	大会
intercommunion	各教派间举行的圣餐
absorptiometer	吸收测定器
quaggy	泥泞
felloe	外轮
polling	投票表决
compassable	可完成的
ultrastable	超稳定
nettlesome	恼人
bierhaus	小酒店
natural	普通
sociocentric	群体中心论的
hexagram	六角星形
extractant	提炼物
grovy	树丛般的
secondhand	间接获
exlex	法律以外
stargazer	空想家
excremental	排泄物的
mortimer	莫蒂默
tanalized	用防腐剂处理过的
staminiferous	具雄蕊
diffidently	踌躇
chorioallantois	尿囊绒膜
adjt	adjutant
pygmyisn	像矮人的
judgement	看法
jell	成胶状
dentirostral	喙边有齿状突起
undefiled	洁净的
untapped	未使用的
irgb	强度红绿蓝编码
obstructive	阻碍的
fiduciary	受信托的
miami	迈阿密
ascap	Publishers
exorbitant	昂贵
dividual	分开的
rancorous	怀恶意的
clavus	垂直紫条
condescend	屈尊
ejectamenta	渣滓
tetraploid	四倍体的
satirist	讽刺作家
mellita	mellitum
ltjg	Junior
advisor	指导老师
karaite	圣经派信徒
alternately	交替
mental	智力
mesolithic	中石器时代
barranco	深峡谷
hematocyst	血囊肿
desecrate	把供俗用
geanticlinal	具地背斜
peach	桃子
through	直达地
intragenic	基因内的
dedicatory	献呈
smoketight	烟密的
eternal	永远
hygeia	司健康的女神
tintinnabular	铃
fictionalize	使小说化
electrotonic	电紧张的
overwrite	写在……上面
residue	残数
removable	可移动
westerveldite	砷钴镍铁矿
fullhearted	充满感情
relique	遗俗
phlebogram	静脉搏动描记图
dissatisfied	不满意的
bundle	捆
unpregnant	不恰当的
arterial	动脉的
temperately	节制地
brethren	弟兄们
introspectionism	内省论
rhizopus	根霉属菌
evulse	拉出
overcharge	超载
horselaugh	傻笑
refreshing	凉爽
general	概括
moderatorship	教政组织首脑的职权
event	结果
undisturbed	没受到干扰的
farinose	具粉
subclavian	锁骨下动脉的
oso	Solar
snaggletoothed	牙齿不齐的
orangey	=orangy
tundrite	硅钛铌铈矿
snack	一份
faulty	不完美的
impairer	伤害者
uncorrected	未订正
dogmatize	武断地提出
unwedded	没有结婚的
hyte	疯狂
inequivalve	两片壳不等瓣的
sialkot	锡亚尔科特
unmerciful	无情
triumphal	胜利
rebuttable	可反驳的
corpulency	肥胖
convention	惯例
repaint	重画
unforced	非被强迫的
seity	自我性
centering	定中心
synergetic	协作的
incapacious	狭小
inerrant	无误
postscript	附言
filiopietistic	过分表示孝敬
palship	友谊
become	变
oap	Age
pectoral	胸的
therapeusis	=therapeutics
faint	模糊
unsubmissive	不柔顺的
thrustful	有强大推进力
hetairism	=hetaerism
flexible	灵活的
passible	易动情的
expiator	偿罪者
anchorite	隐士
megavoltage	兆伏数
conscribe	征召入伍
abactinal	无触角
numhead	=numbhead
spindle	长得细长
wart	瘤
discursion	推论
stripfilm	片带
rimal	裂缝
fusicoccin	壳梭孢素
mitred	戴着主教冠
whomsoever	pro
casually	临时地
eutomous	有明显解理
synergetic	协同
circumgalactic	围绕星系的
plumage	鸟类羽毛
presswoman	女新闻工作者
divinization	偶像化
founderous	泥泞的
jarring	不和谐
teeming	丰富的
dissectional	剖析的
cathodal	阴极
centralized	集中的
matinee	妇女便装之一种
galley	军舰
nodulous	有小结节
eclecticism	折衷主义
impiety	不尊敬
toolshed	工具室
snopes	不择手段的商人
cnd	核裁军运动
acquiesce	默许
metoestrum	动情后期
superciliary	眉毛的
coma	昏迷
debridement	扩创术
alberich	尼伯龙之首领
pgdn	pagedown
floodtime	涨潮期间
featurish	像特写文章
sparing	节俭
symptom	征兆
brightness	亮度
titaniferous	含钛
lienable	可留置
clx	climax
some	大约
sedentary	不移栖的
stereotype	老套
uncreased	未起褶痕
dunghill	卑贱的地位
endergonic	吸能
fold	包
gillaroo	爱尔兰鲑
foamy	泡沫的
priam	普里阿摩斯
corresponsively	相当
achlorhydria	胃酸缺乏
meiosis	成熟分裂
gusset	甲胄
might	能
impalpably	难以理解地
unduly	不适当地
fjp	Federation
fucoxanthin	岩藻黄质
minitance	战斗
sulphurous	硫磺
tinnient	丁当响
factum	呈文
vulva	阴户
deadish	无生气
wareroom	商品展销室
smokeless	无烟的
mulierty	婚生
hypophysitis	下垂体炎
essayistic	小品的
areaway	通道
girly	合适少女
lodgeable	适合居住
reversely	反对地
belletrism	纯文学至上主义
sillily	糊涂
externe	=extern
froglet	幼蛙
copernican	哥白尼学说
caterwaul	发尖叫声
distribution	分发
fingerling	极小之物
susceptivity	敏感
programme	程序
nonrecurrent	不复发的
prentice	学徒
asternal	不连胸骨
humidifier	湿润器
shoofly	糖馅饼
oap	养老金
hognose	切削刃磨圆
kendal	肯德尔耳绿色粗呢
outback	内地的
inhibitory	抑制
sewing	裁缝
crop	农作物
reason	劝说
faro	一种纸牌游戏
unsaddle	解下马鞍
savoury	风味极佳的
ittf	International
nick	刻痕
eosinophil	嗜曙红细胞
ailment	不安
voyageable	能航海的
deacidify	降低……的酸度
fluidonics	流控技术
error	错误
pterylography	羽区研究
scrobiculate	具粒陷
floc	棉丛
suffer	经历
pnr	of
wave	飘动
sempervivum	长生花
thoroughpaced	十足
dalian	大连
extemporaneous	不用讲稿的
stenciller	刻模版工
underinflated	充气不足
rhyme	把……写成诗
gneissose	像片麻岩
septisyllable	七音节的词
worthful	宝贵
tope	翅鲨
clerihew	克莱里休4行打油诗
cyberculture	电脑化文明
adventureful	奇遇的
pillwort	美洲线叶苹
capable	有可能的
rebellion	叛乱
legged	有腿
libri	liber的复数
kayser	凯塞
leon	利昂
spectrotype	抗原谱
presurmise	预先推测
multiphoton	多光子
electropositive	金属
landwind	=land
ditto	很相似的东西
trunk	树干的
toronto	多伦多
capitalize	变成资本
decasyllabic	十音节的
basting	疏缝用线
hexadecimal	十六进制
squeg	作极不规则的振荡
infertile	贫瘠
atabal	铜鼓
saleable	=salable
ependymary	室管膜的
freemartin	和雄犊双生的雌犊
exclamatory	惊叹
pledge	保证
substitutional	代用的
ottava	=octave
documentary	纪录片
mendacious	说谎的
sweeping	广泛
unbutton	解开……的钮扣
remint	改铸
isauxesis	=isogony
deadish	无生气的
canvass	游说
borland	以开发计算机语言及软件开发工具而著称
revelatory	启示的
impenitent	顽固的
treacle	过分甜蜜的声调
sack	洗劫
spinate	有脊的
daily	每日的
petty	小器
hymenopterous	膜翅类的
stealthily	悄悄地
rainsquall	暴风雨
aid	资助
break	打破
gizmo	小发明
eisa	扩展工业标准结构
vagotropic	向迷走神经的
countercharge	反诉
drumlin	冰堆丘
cobweb	蜘蛛网
ingenuously	正直地
idiogram	染色体组型
sukhumi	苏呼米
ectoparasite	皮外寄生物
jaundiced	有偏见的
fellmonger	生毛褪毛商
footy	保管很差的
easygoing	逍遥自在的
entry	对房屋的侵入
fortune	命运
perennial	长期的
echovirus	virus艾柯病毒
register	记录
nonfarm	非农场
parochialism	狭隘
duff	半腐烂的落叶堆
sfx	cinematography
naughtily	顽皮
odonate	蜻蜓目昆虫
sdh	同步数字系列
felicitous	恰当的
eyesome	可爱
strigilation	刮身板的刮擦
cissoid	蔓叶线的
molise	莫利塞
teething	出牙期
zoomimic	模仿动物行动
nix	女水妖
scraggly	零乱的
indeterminate	不确
ducat	从前流通于欧洲各国的钱币达克特
hemic	血的
viewer	电视观众
hyperemia	=hyperaemia
klutz	傻瓜
northeasterner	住在东北部的人
catlike	偷偷摸摸的
misprise	轻视
frogface	蛙状面孔
crested	有纹章的
nephrotoxic	足以危害肾脏的
ontologist	存在论者
contravene	抵触
cotentin	Peninsula
thunderous	打雷的
silkaline	仿丝薄棉布
unsccur	the
ducky	极为愉快
elucidation	说明
crowded	塞满的
leaflike	成薄片的
sulk	愠怒的人
gonogenesis	精子发生
flivver	失败
puzzledom	困境
chapped	有裂痕的
stingy	缺乏
assr	Soviet
raffle	抽彩售货
monotechnic	单科的
vindicability	可证明性
glacieret	小冰河
homoscedastic	同方差的
householder	户主
conidial	无性孢子的
roily	搅乱的
proverbialist	使用谚语的人
kimberley	金伯利
extractor	抽出者
venin	蛇毒素
usable	可用
waterman	桨手
gigameter	百万公里
yield	生长
precessional	因岁差而导致
qarnns	Alexandra''s
lacustrian	湖
scarp	悬崖
referendary	谘询官
zoologic	动物学
underproduce	使生产供不应求
weanling	刚断奶的
megacity	大城市
credulously	轻信
comical	滑稽
rfe	Europe
subapostolic	十二门徒后的时期的
blastema	胚轴原
bps	比特/秒
plural	复数的
boatel	水上旅馆
ghastful	恐怖的
infamous	声名狼籍
gdi	图形设备接口
altho	纵使
causerie	文艺随笔
waveless	无波的
loosen	放松
untaa	United
phrenetic	狂热的
wont	使习惯于
phlogistic	炎症性
allosteric	变构
cheliceral	前肢之螯的
trinary	三倍的
stoutly	刚强地
chemigraphically	化学镌版术
simulacrum	模拟物
lengthen	延长
fecund	肥沃
aheap	堆积
quincuncial	五点梅花状排列
tetartohedral	具有四分之一结晶体对称面
duotone	两色网版的一种
expiration	终止
toast	烤火
deposable	可供证的
devouringly	贪婪
redoubted	可敬的
slade	Process
dobla	多卜拉
pia	Pakistan
chloroacetone	氯丙酮
tricklet	细流
potty	微不足道
eaux	eau
blatant	俗丽
rectificative	整流的
science	科学
hogskin	猪皮
orotund	夸大的
bustee	贫民窟
extraofficial	职务以外的
alphametic	字母算术
leachability	可滤取
affixation	加词缀法
infectious	有感染力的
denominational	使教疟鸬
counterpunch	迎击
cauliflower	花椰菜
flee	逃避
kermes	胭脂
graticule	格子线
sultriness	纵情声色
fall	变成
witted	智力……
infighting	混战
parenthetic	附加说明
softhearted	好心肠的
tan	日晒后的颜色
exasperating	激怒人
hwan	青紫色
conicity	锥形
cahoot	合谋
credibly	可信
groundout	被杀出局
jcl	作业控制语言
unaccustomed	不习惯
encampment	宿营
gapemouthed	张大嘴的
netcropper'	NULL)
whopping	非常
trustiness	可信任
flub	失策
diaplasis	复位
hoodlum	恶棍
sunward	朝着太阳
multiparous	非初产的
northwestern	来自西北的
hospitality	好客
downhearted	垂头丧气的
gesticulatory	做着手势的
terpsichorean	舞蹈家
precostal	肋前的
handle	口实
respirometric	呼吸运动的
saint	圣人
striking	罢工的
gwadar	瓜达尔
groundless	无根据的
playreader	剧本读评人
tocometer	=tocodynamometer
accentuate	着重强调
rosepoint	玫瑰花纹网地花边
affront	公开侮辱
muck	粪肥
esophagean	=esophageal
tan	棕褐色的
unreaped	没有收获的
lunate	半月形的
quadrinomial	四项的
gramma	=grama
jolo	霍洛岛
hetaerae	妾
udsl	单方向DSL
impotency	无力
parsimonious	节俭的
party	政党
equatorial	赤道
hematinic	补血的
owllight	微明
je	六月的简写
foreshow	预示
hectic	狂热的
evolution	发展
zincous	阳极的
colosseum	罗马圆形大剧场
eightieth	八十分之一
activist	行动主义分子
cluster	丛
vibratiuncle	轻微颤动
sprigtail	针尾鸭
alive	活着的
astir	活动的
abject	可怜的
erotological	色情文艺的
converge	集中于一点
factrix	女代理人
tricarpellary	三心皮
domainal	=domanial
liminary	开头的
foreseer	有先见之明的人
quick	核心
araeosystyle	对柱式的
nautilus	缸鱼
competent	胜任
hoppingly	卖力地
brutish	粗野
scourway	冲刷水道
halfway	部分的
explosibility	容易爆炸
gammon	腌
tumorous	肿胀的
equal	不相上下的
reestimate	重新估计
sanctification	神灵化
baldicoot	秃头之人
parade	阅兵
jillaroo	牧场女徒工
joisted	托梁
penetrative	渗透的
temperateness	节制
penetrameter	=penetrometer
antagonistic	反对
riskful	危险重重
honeybee	蜜蜂
floriferous	有花
guileless	坦率的
rudesby	粗人
sunfed	for
inquisitorial	严格审问的
refreshant	提神清凉饮料
eventless	平静的
lav	Light
ohmic	欧姆的
pyemic	脓血症的
legatine	具有使者职权
pwd	Department
telephone	电话
untold	未透露的
choledochostomy	总胆管造口术
strip	条
biker	骑摩托车的人
thistly	象蓟的
desiccator	使干燥的人
relation	关系
encore	经要求而再唱
compensate	付报酬
perennially	永久地
understrength	人员不足
fatigueless	不会疲劳
vesuvian	突然爆发的
mobese	职业罪犯的切口
sfa	Scottish
logic	逻辑性
lacerant	令人痛苦
extracondensed	特狭活体
ftp	Protocol
agreeable	使人愉快
trigram	三线形
flotant	空中飞翔的
hestia	赫斯提
nondollar	非美元的
fitter	适当
welsbach	burner韦耳斯拔煤气喷嘴
moonstruck	耽于幻想的
verderer	皇室护林官
unskillful	不灵巧的
yeuk	痒
sorceress	女魔法师
conventioner	与会者
reasoned	理由充分的
mesophile	=mesophilic
flyspeck	蝇粪留下的污点
dungy	肮脏的
barky	含有树皮的
trilemma	三难困难
avt	付加价值税
fleuret	小花形装饰
legalization	合法化
gable	尖顶屋两端的山形墙
chemotactically	趋药性地
creasy	有折痕
kneeboss	护膝
wsb	Wage
launcher	发射者
captainship	统率者的资格
wattle	编条
grape	葡萄
demeter	得墨忒耳
pet	宠爱的
extensible	可延长
corresponsive	反应
workable	可使用的
mishook	Ⅰ
effortful	需要努力
promptive	激起
flank	胁
libratory	保持平衡的
resection	切除术
towering	高耸
automatous	机械
gray	老
harquebusier	火绳枪兵
polyembryony	多胚
digitate	有指的
cohabitation	同居
benedictional	使人幸福
preatomic	原子弹使用前
disparlure	环氧十九烷
paleoclimatology	=palaeoclimatology
raised	发酵
unattended	未敷裹
gastrointestinal	胃与肠的
deponent	立誓词者
pyriform	梨形
undersexed	性能力弱
countryfolk	乡下人
root	使立定不动
marianao	马里亚瑙
demo	演示
colossal	庞大的
lameness	僵而疼痛的
premiership	总理
prima	第一的
impersonal	非个人
running	奔跑的
intercalary	插在中间的
mpls	Multiprotocol
obcordate	倒心形
viscoelasticity	黏弹性
fretted	附有弦马的
dispersibility	可分散性
morphophonemics	词素音位学
convulsively	痉挛性地
deed	行为
adoptive	收养关系
humorous	富幽默感的
usurious	进行高利剥削
setoff	衬托物
multihull	多船体船
etruscan	伊特鲁里亚
bobbly	圆块状的
abegging	无人问津
wise	知道
setdown	叱责
phallocrat	男权主义者
rondure	圆形物
felstone	霏细岩
unretarded	未被妨碍的
crumble	崩溃
nuchal	项
stabbing	刺穿的
reconcile	使和解
suitability	适宜性
jot	摘要记载下来
very	非常
unknit	解开
sesquioxide	三氧二某化合物
babbling	婴儿发出的咿哑声
conciliative	融和的
acronical	薄暮
biotical	关于生命的
fusion	熔化
infula	主教冠带
clubbable	适合俱乐部会员资格的
nisus	努力
maintainability	可维护性
implacable	不缓和的
snifty	卑视
conclusive	决定性的
circumference	周围
piccaninny	黑人的小孩
toolhead	刀夹
amygdale	杏仁孔
amendment	改善
misbegot	私生
puller	拉的人
bubble	幻想的计划
illusage	折磨
fudge	纸中另版插印记事
topmost	顶端
biogeocoenology	生物地理群落学
pediculus	虱
bloodsucker	水蛭
sumptuosity	奢侈品
muciferous	分泌黏液的
dreamy	空幻的
lao	老挝人的
ial	英特尔架构实验室
accessible	易受影响的
dagger	短剑
corolitic	树叶纹装饰
ue	America
promptive	激起的
relegation	驱逐
rayon	人造纤维
arithmetize	用算术算出
peritectoid	包析
osmoregulation	渗透调节
unmoved	无动于衷的
prognosticate	预言
brassard	臂章
streptococci	streptococcus
untasted	未体验过
harlot	妓女
wide	远离目标地
subeconomic	不经济
eupatrid	贵族
helium	氦
unstiffen	使不僵硬
preceptive	教训性
unashamed	不知耻的
mairie	市政厅
hermeneutics	解释学
egis	保护
encourage	鼓励
portulacaceous	半枝莲
follow	跟随
gushy	易动感情的
emissive	放射性的
masturbate	进行手淫
blastochyle	囊胚腔液
elongate	拉长
pathophysiology	病理生理学
safeguard	维护
hag	劈
fictitious	小说中的
corkage	拔瓶塞
raucously	沙哑地
pride	自尊
salic	撒利族的
rap	火箭助推炮弹
afterwar	战后的
uninspired	未赋予灵感
farthing	极少量
lobe	圆裂片
arsenious	含砷
ore	矿石
cagy	=cagey
multilist	多重表列
buttonless	没有钮扣
brutehood	野蛮
monition	忠告
severely	严格地
uppermost	最主要
chirurgery	外科
succursal	附属的
owing	未付
gibbet	绞刑架
telegu	=Telugu
arrowheaded	箭头形
mendicancy	托钵
elisor	行政官
underwrought	的过去式和过去分词
squall	暴风
stellate	星形的
inviolateness	未受侵犯
puky	令人恶心的
fluky	变化无常的
copier	复印机
unsolvable	不能溶解的
aluminosilicate	铝矽酸盐
leggy	腿过长的
bundook	来复枪
ailurophobia	对猫的极度厌恶
haematoblast	血小板
laxation	松懈
perennial	四季不断的
alcoran	古兰经
out	通过
unnoteworthy	不值得注意的
lampbrush	灯刷染色体
resting	休眠
riyadh	利雅得
skokiaan	非法酿造的威士忌酒
siena	锡耶纳
undirected	无收件人姓名的
pekingology	中国政策研究
mystification	弄不清楚
seriate	连续
morbid	病态的
umbelliferous	伞状花科的
cesium	铯
furcate	叉形的
inosculate	连接
turmeric	姜黄根
internuncial	中间人的
christmasy	有圣诞节气氛的
fruity	果味的
katzenjammer	沮丧
quixotic	狂想家的
klister	湿雪蜡
localizer	定位信标
cosmopolitism	大同思想
foldboater	折叠式舟艇驾驶者
aarnet	Australian
serious	严肃的
nightcap	睡前饮料
quadraphony	四声道立体声
disaffiliate	退出
microstomatous	小口的
halfway	在半途
cyprus	塞浦路斯
cedilla	变音符号
flexure	屈曲
apocalyptic	启示录
libelous	损害名誉
galbraithian	具有加尔布雷思学说特点的
transfiguration	变形
resplendent	华丽的
diverticulum	支囊
deflorate	过了开花期
cfs	per
spreathed	痛的
becharm	使迷醉
jacobus	一世时代的金币
pericardiac	心包的
hypertensive	高血压的
housecleaner	打扫房屋
squash	挤进
seafaring	航海事业
dictagraph	窃听器
crevice	裂缝
chatellany	职位或辖区
nosogenetic	发病原理的
letdown	减退
ferromagnesian	含有铁与镁
hexatone	六声音阶
unharmed	未受伤害
ghosty	鬼的
reptilia	爬虫类
pressural	机械压力的
browningesque	勃朗宁风格
ber	Encoding
mesenchymatous	间叶细胞样
exhibitionism	喜出风头癖
about	忙于
bag	袋子
bases	见base
interscholastic	学校间
alibi	犯罪现场
paramilitarism	准军国主义
etherealize	使脱俗
pyrogenic	火成
triboelectricity	摩擦电
canting	伪善的
deurbanize	非都市化
rheumatoid	风湿症的
crossable	可交配
chosen	choose的过去分词
homogenize	使均匀
ashy	灰烬的
assaultiveness	喜好攻击
exhaustibility	可竭尽性
electroengineering	电机工程
germinability	发芽性
chemism	化学机制
eldo	Launcher
dadaist	达达主义的艺术家
extraventricular	室外
matt	马特
intrazonal	隐域性的
apparition	离奇出现的东西
aca	Associate
withindoors	=indoors
nodular	小节的
fattypuff	一身肥肉的人
kindly	好意的
decenary	征收什一税
swingeing	猛烈
princess	公主
vaporise	=vaporize
streptococcic	链球菌的
strickle	刮型器
discrepancy	差异
jokingly	开玩笑地
trainload	列车载重
purin	咖啡碱
lingy	遍生石南的
anechoic	无反响
subah	=subahdar
journalism	新闻业
defendant	为自己辩护的
squinny	斜视
evolutive	演化的
unacquirable	学不到的
cankered	腐烂的
tectum	顶盖
led	Emitting
ratafee	果汁兴奋剂
unkink	松开
bisync	Binary
significant	有意义
eighteenth	第十八
overcharge	过重的负担
clepe	命名为
rail	铺铁轨
anonymous	匿名
bounteously	慷慨
optimize	使最优化
nephrotic	肾病
highflying	高飞的
absolutize	使……变成绝对
bedeswoman	女乞丐
discontentedly	不平
other	另外地
jadish	精疲力竭的
dunghill	堆肥
cockleboat	小舟
hipped	着迷的
aetiology	原因论
daleth	希伯来文字母第四个
xerothermic	适于干热环境的
tintinnabulous	=tintinnabular
linty	有棉毛
complacence	满足
monoculture	单作
recherche	罕有
atlantic	大西洋的
episcopacy	主教的职位
ineffectively	无用
flaccid	软弱的
tousle	搅乱
lancinating	刺痛
valetudinarian	9vAlItjU
dovish	稳健
timbal	铜鼓
sensitize	使具有感光性
msgm	in
rational	合理
shcherbakovite	硅铌钡钠石
felicitous	极为适当的
theocratic	神权
ritzy	豪华
shapoo	中亚细亚的山羊
nomad	流浪者
skinfold	皮肤褶
unsightly	难看的
headwork	脑力劳动
ccco	Committee
compellation	称呼他人姓名
carbonate	碳酸盐
recitative	叙述的
subsistent	存在
sedgeland	苔草地
uncopiable	无法模仿的
monophonic	单频道的
prop	螺旋桨
parachor	等张比容
weak	不牢固
fulvous	黄褐色
tonnage	排水量
mesocecum	盲肠系膜
madras	一种结实耐用的丝绸
dolorous	悲痛的
exonerate	证明无罪
susceptibility	感情
echelon	梯阵
shinkansen	新干线
admensuration	分配
hovertrain	气垫列车
eelgrass	鳗草
metaphorize	使用隐喻
gnawing	咬
jumper	跳跃者
drillship	钻探船
resist	抵抗
unbarbered	未剃须
enzootic	地方性动物病的
dryly	冷淡
volumenometer	体积计
drift	漂流
oculate	具单眼
unverbalized	未用言辞表达
dextrocular	右眼优于左眼的
gadgetry	小玩意
feb	二月
clamant	吵闹
tetrasyllabic	四音节的
bellow	吼叫
cystoscopy	膀胱镜检查
anastatic	锌版术的
unswerving	始终不渝
hereof	于此
sanguine	有望
appellant	上诉的
repair	修理
uninvoked	未被恳求的
pentose	戊糖
antependium	桌布
peculiarly	特有
hemicellulose	半纤维素
overhear	无意中听到
stp	Shielded
improver	改良物
unutterably	非言语所能表达地
resumptive	概括的
rhamnaceous	鼠李科
palmitic	采自棕榈
offal	头
comptometer	高速度计算机之一种
inobservant	不遵守
belibel	谗
squeal	激烈抗议
scut	可鄙的家伙
vaesite	方硫镍矿
whence	何处
elective	随意选择的
revokable	可取消的
livingness	鲜明
vitrifacture	玻璃制造
custom	承接定做活
dysprosium	镝
aerogram	航空邮件
omit	省略
reelingly	摇晃
instant	刻不容缓的
laniate	撕开
incept	接收
ululate	嚎
interlope	干涉他人之事
moravian	摩拉维亚教徒
soubriquet	浑名
merchant	店主
through	从头到尾
banister	栏杆的支柱
briery	多刺的
smd	Sacred
polyzoarium	苔藓虫的群体
lorrie	洛丽
substantive	有实质的
submerge	掩没
exaction	勒索
totally	完全地
kernel	核心
thecate	具鞘
tartar	鞑靼人
lauretta	劳蕾塔
imperfect	未完成
megavolt	兆伏
java	一种新型的计算机语言
truehearted	真挚
awing	飞翔地
animative	令人振奋
stoma	气孔
deterrable	可防止
tentaculiform	触手状
monocarp	一次结实植物
department	学部
biquadrate	双二次
deadman	木桩或水泥桩
carabid	步行虫
nyse	York
sanbornite	硅钡石
cock	阴茎
exegete	注释家
connatural	同性质
labouring	操劳
bland	刺激性少
sublunar	上
conscriptive	涉及征召或征用的
slide	滑
pro	正面地
gruel	使极度紧张
consumedly	大大
volubility	流利
sportscaster	担任比赛实况转播或说明的广播员
piercer	放卵管
hypopselaphesia	触觉减退
unswerving	坚定
bailey	城壁
spaceworthy	能作航天飞行
wheezy	气喘声的
touching	令人同情的
majagua	牙买加黄槿
ethnography	人种志
vasoconstrictor	血管收缩神经
rootle	搜索
callable	随时可偿还
familiarly	亲密地
metrication	施行公制度量衡
rio	de
bewigged	戴假发的
earthborn	地中长出的
aleuronic	糊粉
liquorice	由甘草根熬成的精
tumble	滚动
cdd	公共数字字典
dicer	帽子
website	WWW的站点
aquiline	弯曲
simple	率直
itt	Telephone
riproaring	喧嚣
skinny	小
doozy	非常显眼的
detension	松驰
renature	使复性
memorization	默记
catchall	包罗甚广的话
adventurously	爱冒险
resultingly	由于
branching	分歧
hyalinize	透明样化
hosiery	针织品
spiry	尖端
hydrotherapeutic	`haIdrEJ9Wer`pjU:tIk/
tempt	诱惑
fakement	蒙骗
ghyll	峡谷
waster	挥霍者
sourish	微酸的
tetrahydrofurfuryl	四氢化糠基
rhetorician	雄辩家
schottische	polka
appreciate	赏识
kopek	苏联的货币单位
gemini	双子座
unmercenary	不是仅仅为金钱的
motorcar	汽车
assure	断然地说
geminiflorous	二花合生
brahmanism	婆罗门教
hornlessness	无角
vicissitudinous	有变化的
bms	Black
namma	水井
sutural	缝口
windrow	干草列
polyzonal	多圈
expellant	排毒药
oxycalcium	由氧钙产生的
hydrophobe	狂犬病患者
psalter	圣诗集
eupatorium	泽兰属植物
laboratory	实验室
fractionary	分数
horopter	同视点
levallois	文化期
retrospectively	回顾地
dirty	弄脏
overemphasize	过分强调
semeiography	症状记录
necessitous	贫困的
cooperancy	合作
perishingly	厉害地
phthisic	痨
assibilate	使成咝擦音
louche	声名狼籍
lectorate	大学讲师教职
maine	缅因州
bathymetric	深测术的
tipi	=tepee
immigration	外来的移民
turbinate	鼻甲骨
asymptotic	渐近
fingerling	小东西
photronic	光电池的
aeolic	伊欧里斯人的
unfair	不公平的
wollongong	伍伦贡
essentic	表露感情
pedosphere	土界
vividness	活泼
underlease	转借
otb	offtrack
lumberjack	伐木工人
ablutionary	洗礼的
jiminy	敬畏时所用的感叹词
fishbone	鱼骨
magistrate	地方官员
lymphogranuloma	淋皉AnjJ9lEJmE`tEJs腿庋恐
stylistic	格式上
chummage	房租
unbroken	完整
dionysius	戴奥尼夏
inp	Number
jingoish	沙文主义的
mabe	and
instigation	n
reveler	摆设酒宴者
tanglesome	杂乱的
syphilitic	梅毒
empyemata'	NULL)
lumberly	笨重的
familiarity	通晓
wise	方式
babirusa	野猪
galilee	加利利
diazo	重氮基
mitral	礼冠的
weak	淡的
fatling	肥畜
antileukemie	抗白血病的
landau	同型的旧式汽车
zills	一对金属圆片
ungulate	有蹄类动物
pyramid	金字塔
periselenium	=perilune
cytotropic	细胞互向性
dahoon	美国冬青
sound	有效彻底
turgescent	肿的
obvert	将……之正面转向
heptanone	庚酮
terminally	一定时期地
fix	修理
serta	sertum的复数
doodling	乱画之物
erect	使竖立
killing	杀害
consistorial	宗教法院
cruiserweight	重量级拳击手
reblossom	再开花
unswear	违背誓言
facility	便利
cantonal	州的
costermonger	水果
appetite	食欲
bulky	容量大
aciduric	耐酸的
flambe	烧过
extractible	可提取的
originate	发明
maulana	毛拉
untrue	不忠实的
yanam	亚南
haar	哈雾
undoubled	不再握紧的
crispen	使鲜脆
lease	延续的一段时间
clubhand	畸形手
bipinnate	两羽状的
vacuous	茫然若失
passional	热情的
regurgitate	反刍
phleboid	静脉似
yttrialite	硅钍钇矿
jussive	祈使的
auscultator	听诊器
moulage	印痕
kilojoule	千焦耳
chlamydeous	有花被
chemosensory	化学感应的
kissinger	基辛格
piquant	兴奋的
hough	足部的脚腕
cankered	溃疡
mobster	歹徒
precalculus	学习微积分前必修
luffa	丝瓜
equal	均等
flintily	无情地
scrimpy	不足的
socially	在社会地位上
guage	进度指示
sickly	多病
inexpectant	未预期
quadratic	二次方程式
impar	不成对
delphi	Borland公司出品的面向对象开发软件包
arrowheaded	镞状的
incontrollably	不能控制地
hydrostat	水位计
novelle	中篇小说
caressing	表现爱情的
adoptionist	信仰耶稣是上帝义子学说的人
oxter	腋下
subofficer	下级军官
extemporize	即兴演奏
unconditional	无条件
nutter	拾坚果的人
underripe	未全熟
skunk	使惨败
strange	陌生的
insuperability	不能克服
transpose	转置阵
cystic	胆囊的
semipostal	附捐邮票
endoscopic	内窥镜
fustigate	用棍棒打
synsepalous	=gamosepalous
lopstick	棒状树
samarkand	撒马尔罕
flameout	熄火
extender	混合剂
proselyte	使改宗教信仰
pastelist	粉笔着色画家
joyful	兴高彩烈
depraved	颓废的
filigree	金银丝细工
bevy	一群人
entailment	继承人之限制
scale	攀登
keening	哀恸
inconducive	没有帮助
epicondyle	上髁
crablike	似蟹行般
cdsl	Client
pig	猪
uprise	起床
blastie	侏儒
asp	Provider
laze	闲散
rack	在饲草架装满干草
teemless	贫瘠
brainfag	脑疲劳
drudgery	苦工
vector	向量
pottage	肉汁
nonvocoid	非元音性音
chemotactically	趋化现象
wand	棒
umbilici	核心
famine	饥饿
conversion	变换
underspin	下旋
expressionistic	表现主义的
cheek	臀部
nauseating	恶心的
unconstraint	无拘无束
israelitic	犹太人
brazenly	厚脸皮
panniculus	膜
funked	发霉的
harmine	肉叶芸香碱
reforger	新造
millwright	造水车木匠
yardage	按码计算
incongruent	不一致的
resorcin	间笨二酚
matlock	马特洛克
premalignant	癌变前
microscopic	用显微镜可见的
semicontinuous	半连续
diachrony	历时分析
remove	迁移
unreversed	非反向
kaiserin	皇后
unmeasured	不可测量的
vasoconstrictor	血管收缩的
infamy	丑名
descriptive	描述的
songbird	女歌手
savage	粗鲁的人
mganga	土医生
juvenal	羽毛未丰
gat	get
lustful	贪欲
gravitas	庄严
bruce	布鲁斯
tchick	催马快跑所发之声
maker	上帝
interpolatory	撺改的
laminae	层
pyrometry	测高温
cairn	堆石界标
evangelic	福音
toughly	坚强
syntheses	综合体
bumf	公文
discomposure	心乱
sbn	标准书号
discoverture	未婚
figmentary	幻想
subapical	接近顶点的
natationist	游泳者
desolately	寂寞地
atomism	原子说
underwrite	签在……下
devalorize	使贬值
refluence	退潮
favonian	吉祥
triamcinolone	氟羟氢化泼尼松
fullface	黑体铅字
factually	确实
unwitnessed	未注意到的
intragroup	社会团体内部
ishikari	石狩湾
enregister	登记
katana	武士刀
millstone	粉碎器
chestful	一满箱之东西
doby	=adobe
neocosmic	新宇宙
electronic	电子的
radiator	辐射体
civil	全民的
tufty	多穗
corba	Object
eutomous	容易解裂
asi	airspeed
plotty	情节错综复杂
agazed	受惊吓
quatercentennial	400周年纪念的
jitterbug	神经质的人
tubicorn	有空角的
unevoked	非强制执行
churrigueresque	具有西班牙巴洛克建筑风格
manichaeus	即
remarkably	引人注目地
saturate	浸透
custom	习惯
being	生命
ravc	Corps
cassette	盒式磁带
isacoustic	等声强
autoinjector	自我注射器
arboraceous	树木状的
creepy	爬行的
