chrysograph	中世纪时代用金色或金银色墨水所写的文件
mcmlxxxiv	1984
visitatorial	访问的
dislikable	可厌
homolecithal	均卵黄的
kibitka	俄国有篷顶的乡下雪车
vasoactive	血管活性
acceptation	意义
lipophilic	亲脂性的
poseur	装腔作势的人
tomo	灰岩坑
defendant	辩护
benedictive	祈求式的
disembroil	排解纠纷
catalog	目录册
underclothed	穿得单薄的
italicise	=italicize
avertable	可避开的
hsh	His
pinfish	菱体兔牙鲷
kinaestheses	kinaesthesis的复数
roc	要求工作能力
cqd	遇险
reflectingly	反射地
tepid	温热
vasoligation	输精管结扎
fashioned	……式的
theophoric	神"
lmg	light
matrilateral	母系的
kneed	有节
contrarily	反对
bimeby	渐渐地
root	根本
repressurize	对……重新加压
defeat	使失败
rarest	最珍贵的
isoenzyme	同功酶
peacebreaking	破坏和平
susceptibility	感受性
clavel	壁炉架
bedaze	令茫然
clava	棒状体
jumbly	混杂
crenelated	在墙上打枪眼
asti	=Asti
energetic	精力充沛的
snorty	流鼻涕
deboost	减低推力
tridigitate	有三趾的
scandal	丑闻
revive	再生效
admirably	美好地
virtue	贞操
heavily	很重
trifle	琐事
phonometer	音波测定器
indiscriminating	不区别on/`IndIs9krImI`ve/9IndIs`krImIneItIN/
victorianism	特征等
pit	使留疤痕
grinningly	露齿而笑
criminal	罪犯
uprise	暴动
underlip	下唇
amphigenous	生于叶子两旁的
damoiselle	处女
bonkers	精神不正常
forsworn	伪誓
apterous	无翼
gain	财物的增加
colorimetric	色度
psychosomatry	心对身
steering	掌舵
renitent	顽强
appreciatory	感激的
prospectus	样张
brimless	无边缘的
xograph	立体影像
scintillate	发出火花
vive	活泼的
nunciature	罗马教皇使节之职
unhandily	不灵巧
operationalize	使开始运转
unpracticed	不熟练的
pellagra	陪拉格病
cercopithecoid	猕猴科之动物
chirography	笔迹
interoperability	协性测试
jolliness	高兴
assiduity	勤勉
extra	不包括在价目内的
racemiferous	有串状花
caledonian	苏格兰人
fail	不及格者
sweetmouth	讨好
unobtainable	难获得的
rightly	正确
photoreaction	光反应
invaluable	无价的
framer	制定者
masterly	精巧的
vestibular	前庭
tektite	熔融石
boletus	牛肝菌属真菌
recallable	可回忆的
become	相称
palm	与……握手
glucosuria	糖尿
co2	carbon
fricative	摩擦产生
undernutrition	营养不良
abuliding	酝酿中的
plutocratic	有钱有势
lampblack	灯烟
phosphorescent	发出磷光的
perinephrium	肾周膜
unido	Industrial
incapable	不能
theist	有神论者
trihydrate	三水合物
frcp	College
cyclothymia	躁狂抑郁精神病
subcuticular	角质层下的
brute	残忍的人
hebdomad	七天
asthenosphere	岩流圈
zebrawood	热带美洲产树木之一
pb	plumbum
readset	读集
cursely	该被诅咒地
droogie	少年犯
unshaped	形状不美
hircine	山羊般的
fiz	发嘶嘶声
cycloheximide	环己酰亚胺
gibing	讥刺的
pertinacious	固执
ssfdc	Floppy
forehoof	前蹄
colourable	可着色的
vries	弗里斯
reiterative	反复
pigeonhole	鸽巢
ostracism	排斥
rapidity	速度
garlandry	花环
lenape	德拉瓦族
agrobiology	土壤生物学
streuth	=strewth
sidle	挨近
limb	翼
unfordable	不能涉水而过的
thankworthy	值得感谢的
teethridge	牙床
luxuriously	豪华地
metaphorize	用隐喻讲话
natter	唠叨
aposteriori	后天的
hdcd	Compact
flavescent	稍带黄色的
miniaturization	小型化
paraparesis	下身轻瘫
unverifiable	无法核实的
limbal	缘
roadway	路面
bumble	拙劣地做
slough	泥沼
doglike	顽强
dehortative	劝阻的
unwieldiness	笨拙
mortal	非常大
fainty	昏晕
sebacic	癸二酸
uar	Republic
unsubmissive	不顺从的
neighborly	邻居似的
collarette	女用领巾
concomitance	共存
deadish	钝浊
nightmare	梦魇
exacting	严格
canephora	=canephor
postboat	邮政船
incrassation	肥厚
diphtheroid	似白喉的
waec	African
foliicolous	叶上生的
leu	罗马尼亚的货币单位
elusive	难捉摸的
serotoninergic	=serotonergic
forespent	=forspent
evaporative	成为蒸气的
sandhiller	沙岗人
pericarditis	心包炎
wringing	湿透的
graniform	谷粒状
agp	加速图形端口
eviscerate	除去主要部分
coryphee	芭蕾舞演员
okra	秋葵荚
tornadic	龙卷风的
brightness	明亮
batrachia	蛙类
pyopericardium	心包积脓
asp	Application
ticklish	易痒的
comose	多毛的
pellagrous	玉蜀黍疹的
legato	连奏地
defensibility	防卫的可能性
alphanumeric	文字数字的
aspirator	吸出器
universal	世界
careenage	船底修理费
innuendo	暗示
fun	有趣的人或事物
similize	用直喻法
mamillated	有乳头的
rejigger	重新装备
aioli	蒜泥蛋黄酱
noncellulosic	合成纤维的
agorot	agora
sweetly	含糖地
isolator	隔离的人
sepulchral	坟墓
polyethnic	多民族
employless	无业的
categorial	范畴
transparence	透明
bulbous	球根长成的
seajack	在海上劫持
rswc	with
negaton	=negatron
busybody	爱管闲事的人
valval	=valvular
cabalistic	犹太教神秘哲学的
clad	穿衣的
ketolic	有酮醇官能团
rap	拍
heroin	海洛因
pinnatilobed	裂的
phylactic	防护
expeditioner	探险队员
calque	语义转借
fid	大型木钉
lacunal	有孔的
mumps	腮腺炎
arrestee	被捕者
peptide	缩氨酸
dative	与格的
contemplate	凝视
precipitinogen	沉淀素原
fantasia	幻想曲
portamento	延音
bitsy	小的
waif	流浪儿童
atelier	工作室
expect	预期
eminent	杰出的
pubis	耻骨
chernobyl	切尔诺贝利
cambium	新生组织
annuitant	领受养老金者
chromogenic	发色
fulminous	雷电的
washomat	自助洗衣店
pretty	漂亮的
unnoted	不引人注意
vesicate	发水泡
prophylactic	预防疾病
ambagious	迂远
assistant	辅助的
afford	提供
oner	无比的人
workhand	佣工
shortbread	用面粉
incommensurable	不配比较的
emersonian	爱默生的
thundercloud	雷雨云
lithic	膀胱结石的
inseverably	不可切断地
heterometabolic	9hetErEJmE`tAbClIk/
adat	传统法律
annelida	环虫类
conn	指挥操舵
chubby	丰满的
stanchly	坚强
tutsan	土三金丝桃
muezzin	报告祷告时刻的人
larvikite	歪碱正长岩
suburbicarian	设在罗马近郊的
axonometric	轴测法的
punctuate	加标点于
awesome	引起敬畏的
handmade	手工的
accompanying	附随的
thalassocracy	制海权
borneol	冰片
enfranchise	给予选举权
wolfkin	幼狼
leptocephalus	鳗的柳叶状幼体
alternate	轮流的
wolfess	勾引男子的骚女人
purposeful	有目
seaway	波涛汹涌的海面
woodcut	木刻
tidiness	整齐
marsupialization	袋形缝术
vindicative	辩护的
pilocarpin	毛果芸香碱
monetary	金钱的
concretive	有凝结力
serious	严重的
choosey	慎重选择
erotology	色情文学
racegoer	经常去看赛马或赛车的人
halitosis	口臭
saturated	渗透
trend	趋势
nasality	鼻声
ecclesiae	教堂
pix	照片
impurity	杂质
ensconce	隐藏
unhcr	High
hackneyed	陈腐的
fortuna	福耳图那
daffodil	水仙花色的
tenable	可维持的
interspace	中间
faculty	能力
conveyorize	在……装设转运带
trailhead	小道的起点
hora	霍拉舞
randomness	随意
somatology	人体学
rigorous	严格的
amphitheater	似圆形剧场的场所
tamarillo	番茄
dioptase	绿铜矿
mimosa	含羞草
dishonor	使蒙羞
indisputability	无争辩的余地
impious	不虔诚
feignedly	装聋作哑地
cbu	集束炸弹
twitch	攫取
uvea	眼色素层
gassy	气状的
parma	中度紫色
unmerge	使分开
humongous	极大
rural	田园
wicker	柳条制
infect	感染
concretion	凝固物
verse	诗
alyssum	十字花科的一年生植物
article	表达清晰
mononucleated	单核
travolater	自动人行道
telautography	电报传真术
photoinduction	光感生
irdp	ICMP路由发现协议
fleece	绒头织物
xeromorphous	旱性结构
tribal	种族
vsat	VSAT卫星通信系统
resolved	下定决心的
unthoughtful	粗心的
retrain	再教育
translatorese	=translationese
provisionally	临时地
perionychium	甲周皮
width	有一定宽度的东西
lecturee	听演讲者
levy	征兵
heartfelt	衷心
morphometrics	形态特征
budgetary	预算
khark	=Kharg
midships	在船中央部
piripiri	刺果薇
pellagra	糙皮病患者
villainy	恶行
hargeisa	哈尔格萨
tumbler	打滚的人
adlet	小广告
lubricious	滑的
biota	生物区
abstractive	摘要式的
almsdeed	慈善
thoroughpaced	十足的
encyclopedic	百科全书式的
transcontinental	大陆那边
nllst	for
hairstylist	发式专家
vouch	断定
drawn	拔出
unspell	使从着魔状态解脱出来
rate	速度
pionium	π介子素
friendliness	友善
deplethoric	贫血的
influent	支流
norwegian	挪威的
ryegrass	黑麦草
plu	us
nice	和蔼的
hypogastrium	下腹中部
portreeve	市长
transgression	海侵
vespertilian	蝙蝠
plectognath	愈颌目的
garroter	勒杀抢劫的强盗
photoinduced	光致
diagonalize	使对角线化
birotation	=mutarotation
pessimal	最坏的
faculative	任意的
razorjob	无情的攻击
mpp	Processing
sequela	后继者
convoy	护送
attribute	品质
enterologic	肠病学的
space	隔开
modulator	调节器
scandal	丑行
homoiothermous	恒温动物的
sere	演替系列
pda	Personal
fluvioglacial	冰水生成
pecuniary	金钱
usmcr	美国海军陆战队后备队
rusticate	使定居乡下
shift	转换
jugum	轭
retell	重讲
muhtar	=mukhtar
sephardic	西班牙系犹太人
humoristic	滑稽
apolar	无极
begot	beget的过去式
bedrabble	使污浊
savate	踢打术
sunbath	日光浴
pertinency	相关性
tea	给……沏茶
superjacent	上覆的
resting	不动
discardable'	NULL)
northwestern	来自西北
kemalist	基马尔主义的
inner	内心的
unexpected	意外的
drag	缓慢而费力地行动
unep	Environment
acidhead	嗜用迷幻药者
bedew	沾湿
haggai	哈该
matthew	马太福音
politesse	客气
fool	奶油拌水果
perplexed	困惑
wither	枯萎
vitally	紧要地
broadway	纵贯纽约市的大街道
reliance	依靠
lively	栩栩如生的
soliloquy	自言自语
envious	羡慕的
hesitant	犹豫不决
obsecration	恳求
gymnastic	训练课程
final	决定性
imbrown	=embrown
polyglandular	多腺的
conspectus	概论
deuteronomic	预言性的
weariful	令人厌倦的
legroom	放脚空间
downhill	倾斜的
ley	草地
tricksy	恶作剧的
ceremony	仪式
rumpbone	骶骨
bla	Arts
tmo	order
rgs	Royal
eyer	注视的人
homebred	国产的
theatrician	戏剧专家
fade	枯萎
radiograph	X光照片
xenomania	外国迷
russety	枯叶色的
racemulose	小串状花序
mineable	=minable
owly	像猫头鹰的
raft	橡皮船
tripartite	分成三部分的
protomorphic	原始形式的
vile	低廉的
ced	经济发展委员会
cer	Canonical
gimel	希伯来文第三个字母
tile	瓦片
wriggler	孑孓
dizygous	两合子
cavelike	似坑洞的
naissance	产生
receptionist	传达员
domestically	合乎国内
aquarium	水族馆
sideling	斜着
enigma	谜
woodsy	树林中的
halfway	不彻底的
unchristian	非基督教
bamboozlement	哄骗
congener	同种的
mhs	消息处理服务
entomb	埋葬
insusceptible	不易受影响
toadeater	谄媚者
garibaldist	加里波第的拥护者
shaky	颤抖的
saury	秋刀鱼
reconcilable	可调和的
dispersion	散布
grassquit	草雀
ambiquity	不定性
conference	会议
medically	医药上
sightworthy	值得参观
turk	土耳其马
unseaworthy	经不住海上风浪的
inoperable	手术不能治愈
vibratiuncle	小振动
bizonal	二地区
endearment	亲爱
superpersonal	超个人的
ducking	钻入水中
tractable	易处理的
contrariously	不利
impregnation	受精
inverter	变极器
best	极
spectacle	光景
tench	丁鲷
pill	口服避孕药
echard	无效水量
lymphomatosis	淋巴瘤病
primrose	樱草色
urinal	尿壶
rewardless	徒劳的
noctambulous	=noctambulant
chalcedonic	石髓
cold	使人战栗的
vj	Video
unbiblical	不按照
saskatoon	七度
moody	忧悒
mitigatory	平静的
bathypelagic	居于深海区
fondly	盲目轻信
ppcc	人民政治协商会议
iatrochemist	化学疗法者
revivalism	信仰复兴运动
elephantiac	象皮病患者
underprivilege	相对贫困
unfortunately	不幸地
quadriplegic	四肢瘫痪者
pomiferous	结梨果状果实的
disarrange	打乱
msha	医院管理学硕士
ambivalent	矛盾
attrit	消耗敌人的行动
woody	木制的
transdenominational	=transconfessional
subaqueous	水下用
pessimism	悲观
unornamented	无装饰的
lowland	低地的
apogee	远地点
dour	不爱讲话的
excavation	挖掘成的洞
avertable	可避开
dodecahedral	十二面体的
globalization	全球性
discutient	消肿
erogenous	性感
chipping	碎屑
letterhead	信笺上方的印刷文字
follow	追随
trypsinize	使胰蛋白酶化
miniminded	没有头脑
tic	痉挛
valetudinarian	无病呻吟者/的人
hurdies	屁股
luetically	梅毒
treason	叛逆
photoactive	光
spongioblast	成胶质细胞
chonju	全州
zodiac	黄道带
fremd	陌生的
coaly	多煤的
prevue	概说
angelical	天使的
fatuity	愚昧
pontifex	大祭司
theory	……论
irascibility	易怒
currently	通常
tuppence	微不足道的东西
ductility	顺从
disciform	圆形的
swither	踌躇
apophysis	突起
conscientiously	良心上
predecessor	原有事物
cacophonous	发音不和谐的
unmeasurable	无法计量
labiovelar	唇软颚音
concern	关系
woodcarving	木雕
sound	海峡
triac	三端双向可控硅开关元件
gracile	纤弱
gyrate	旋涡状的
okapi	霍加皮
remontant	四季开花蔷薇
orgeat	杏仁糖浆
datel	数据用户电报
forbiddance	禁止
ataractic	安定药
doggo	一动也不动
daniel	丹尼尔
geographical	地理的
faulty	不完善的
wearable	衣服
loose	放任
inviolate	未亵渎
chattily	饶舌地
related	叙述的
circumstanced	在……情况下
wasteful	浪费的
unsmirched	干净的
cytotechnician	细胞学技士
unpresentable	不像样的
inundatory	压倒性
dished	中凹
microlithic	细石器
innumerable	数不清
nomad	游牧民
cinqfoil	=cinquefoil
phlegmatical	迟钝
puree	菜肴的一种
antidiuretic	抗利尿剂
vain	无益
emulant	对手
tudor	都铎王朝
cariosity	蛀牙
maturity	成热
sncf	Fer法国国营铁路公司
aspirant	有抱负者
discriminative	有区别地
commemorable	该记住
carelessly	不注意地
magical	不可思议的
coagulative	凝固物
comecon	经济互助会
coralline	珊瑚
flub	搞坏
participialize	将变成分词形式
discreetly	谨慎
bayberry	月桂树的果实
rugulose	有许多皱纹
closemouthed	沉默寡言
tollhouse	通行税征收处
fluxmeter	磁通计
unfaithful	不准确
elfland	小妖精国
digametic	异配子
attributive	归因
fluoridization	用氟化物处理
tabour	小鼓
cesarian	凯撒的
subcenter	次中心区
calescence	渐增温
featly	伶俐
pleat	使……打褶
slue	=slew
hyp	忧郁
auspice	支持
afraid	害怕
outpouring	流露
fundament	臀部
anaphrodisia	性欲缺失
vectorgraph	立体电影
unspeakably	无法形容
polydomous	多巢的
chirpy	嚓嚓叫的
ferreous	含铁
lwl	waterline水线长度
vitligo	白癜风
halide	卤化物的
gratifying	令人满足
fond	喜欢
inimically	抵触地
gnawing	不断的苦痛
excise	消费税
cordage	薪炭材的堆积数
relate	叙述
palingenist	=palingenesist
ceraceous	蜡质
dicephalous	有两个头
younger	较年轻
kilobar	千巴
mesoscale	中尺度
multipotent	能产生多种效果
incommensurable	不配比较
hushpuppy	南部乡下
intreat	恳求
poker	纸牌戏
ppcc	Political
unfrequent	不常见
circular	圆形的
ectocrine	外界微量影响物
tokushima	德岛
tonsorial	理发师的
reedman	簧乐器乐师
nas	Attached
before	在前
histomorphology	组织形态学
flint	极硬的东西
etyma	词源
flowery	绚丽的
bookstand	书架
leverage	杠杆作用
genevan	加尔文教
polonize	使波兰化
jacaranda	紫薇科蓝花楹属
takeup	拿起
calculably	可计算
ectoskeleton	皮骨骼
ensconce	安置
aphaeresis	非重读字首的省略
discommode	使不自由
chanciness	偶然性
blissout	欣喜若狂
preclusive	妨碍的
budless	无蕾
endopolyploid	内多倍体的
freemasonic	互助团
nocuousness	有毒
xylophilous	适木
cochair	担任……的联合主席
clod	掷土块
implicit	不怀疑
paedomorphism	稚态
bowlder	巨砾
grained	除去毛的
vane	风信旗
unwarmed	未温热过
prompting	激励
everyday	平常
squeezable	可压挤
maceration	因绝食而衰弱
bronchogenic	影响支气管
accomplish	达到
incunabulist	古刊本鉴定家
independently	独立
lay	位置
fun	开玩笑
stralsund	斯特拉尔松
hungerly	面有饥色的
levelheaded	稳健的
pacemaker	领跑者
videotex	可视数据
disheveled	不整洁
key	提供线索
concupiscent	贪欲
dotted	星罗棋布的
seismotic	地震的
fibroin	蚕丝蛋白
solo	独奏曲
europeanize	使欧化
stump	难住
antithyroid	抗甲腺的
implacable	不缓和
polyzonal	多环带的
anadenia	腺功能不健全
grab	抢夺
bulletin	公告
indwell	存在于
byr	years
soil	弄脏
returf	再铺绿草
tillable	适于耕种的
stale	疲倦
brace	支柱
anthophilous	爱花的
soluble	可溶的
enlighten	启发
preventible	可预防的
sf	Francisco旧金山
intermediary	媒介的
manikin	人体模型
headworker	脑力劳动者
anapestic	抑抑扬格
formulaic	用俗套话堆砌成
freeload	吃白食
expressive	有表现力的
time	记时的
phenolic	酚
lignocaine	二乙氨基
obviate	避免
frigidaria	保持低温房间
mithraism	密特拉教
portly	魁伟
badass	到处惹是生非的
mend	改良
heroise	=heroize
cumber	阻碍
friarbird	采蜜鸟
lowermost	最低的
convolution	盘旋
denucleate	使去核
cornily	产谷
bergall	青鲈
pelt	猛落
nsm	Material
volumen	羊皮纸书卷
knurr	木球
jacketing	击
religiose	笃信宗教
chaser	猎人
emendatory	修订
rubricate	以红色书写
qualmish	似要作呕
deduction	演绎
pharmacognosy	生药学
skeptically	怀疑地
postbellum	战后的
hecatomb	百牲祭
sanguinopurulent	含脓血
dray	一种撬
semicomatose	半昏迷的
experiential	经验的
furred	毛皮制的
rabelaisian	法国讽刺作家拉伯雷的
goethean	歌德
helpful	有帮助
orthography	正字法
hose	长筒袜
humanness	为人
kirghizian	吉尔吉斯人
peregrin	外国
xtra	电讯术语
advertizing	广告业
unionization	联合
disaffect	使成为敌人
sacrificially	牺牲
southernly	=southerly
ration	配给量
teravolt	太
dissuasion	劝阻
preludial	序言的
hilly	陡
terpsichorean	舞蹈
dolefulness	悲哀
calfhood	幼犊状态
flank	侧腹
deport	举止
lexical	词汇的
feel	有知觉
koorajong	=kurrajong
chervonets	俄国以前的货币单位
plump	突然地
carbonylic	羰基
virulent	恶性的
apparente	明显的
featherheaded	轻率
ferocious	残忍的
eleatic	埃里亚派之信徒
feastful	过节
predicatively	肯定地
slatternly	自甘堕落的
gonogenesis	卵子发生
glabella	眉间
abroad	心里没有谱
corps	技术兵种
hayfork	自动堆积干草的机器
summarization	摘要
bracer	保护带
emotivity	激起感情
submental	颏下
biennially	二年一次
shmutz	=schmutz
gooney	=gooney
excerpt	摘录
immigrant	侨民
hardy	艰苦
eulogise	=eulogize
sessional	开庭的
challie	有印花之轻质毛料
commissariat	军需部门
superannuation	退休金
tributary	支流的
unseriousness	不认真
obligatory	义不容辞的
rapc	Corps皇家陆军财务队
projectionist	电视播放员
commutate	整流
annulment	判决无效
volitive	表示意志的
decidedly	断然
carman	电车的车长
unfilial	不孝
amharic	阿姆哈拉语
fddi	Distributed
unplaced	无处居住
readopt	重新采取
clamorously	吵闹地
seismic	震
cloistral	隐居
unquestioning	不加疑问的
chorizon	C层
enallage	语法形式替代
hurdle	活动篱笆
discarnate	无形的
paigle	黄花九轮草
calf	小牛皮
bristled	多刺毛
rouge	口红
slipform	用滑动模板铺筑
tamer	驯服手
charlene	沙琳
paisleyite	支持北爱尔兰天主教徒和新教徒实行分离的人
rallyingly	挖苦地
universal	通用
blacksnake	黑蛇
plus	正的
nanny	保姆
harmonistic	调和的
mohammedan	回教的
dwc	载重吨位
vfd	志愿消防队
podded	富裕
posttension	对……后加拉力
mabe	Agricultural
minacious	威吓的
inexpiable	不能抵偿的
introspectionism	内省者
malignity	狠毒
unwitnessed	未察觉到的
jap	日本人的
half	不完全的
subornative	买通的
zarzuela	说唱剧
uptodate	直到现代
condolatory	慰问的
drillmaster	教练
bloodily	残忍
base	出发点
gelly	=gelignite
presbyope	老视者
banteringly	嘲弄地
boned	去骨的
sociocentric	群体中心论
hendecahedral	十一面体
topcap	顶盖
broiling	似烧
squally	可怕
choker	宽领带
artifact	人造物品
lassitude	疲乏
userkit	连机辅助设备
excelsior	细刨花
safing	能立即恢复安全状态
quenchable	可抑制
alum	明矾
incretionary	激素
fallow	休耕
lathi	包铁粗杖
predacity	掠夺性
inscient	无知的
alary	翼状
humourless	缺乏幽默感的
pipelike	管状
leaven	影响
mover	原动力
monophonematic	单音素的
pothecary	药商
paybox	出纳室
patient	耐心的
quash	取消
voltolization	无声放电处理
bloomer	挫折
napalm	凝固汽油弹
hickey	器械
erda	能源研究开发署
precensor	事先审查
viscounty	地位
aviary	鸟类饲养场
materiality	物质性
erratic	奇怪的
landworker	农夫
hardcase	强悍的
merge	吞没
assonance	类音
disrupt	破坏
herbiferous	生草的
defeat	击败
iaz	高射炮防空禁区
whip	鞭子
cockateel	鸡尾鹦鹉
epochmaking	极重要
mulct	处以罚金
unspeakable	不能以言语表达的
iyft	Informtion
nutso	发疯的
stere	立方公尺
astroarchaeology	=archaeoastronomy
pesky	讨厌
wonder	怀疑
serific	制丝的
leonis	Leo的所有格
fearless	不怕
latifundio	大庄园
aerology	高空气象学
smoothie	举止优雅的人
endophilic	生态上与人及其所处环境有关联
willing	反应迅速
synoptic	概要
strobic	似旋转的
plaga	斑点
vesicular	由小泡组成
proenzyme	酶原
joggle	摇曳
magh	印度历的11月
quaveringly	颤音
cod	COD
significance	意义
kilolitre	公升
weatherproof	使防风雨
aptness	适合性
nymphomania	慕雄
ungainly	笨拙地
shelfful	一个架所装之量
pubes	柔毛
venturous	好冒险
etherealize	灵化
nomenclaturist	术语定名者
demonstrator	论证者
ukrainian	乌克兰人
sirupy	象糖浆的
beluchistan	=Baluchistan
hexahydrated	六水合物的
preventable	可阻止的
wisp	小捆
teleplasm	灵的外质
skint	穷光蛋的
recitative	叙述
meagrely	瘦
shakuhachi	尺八
geckotian	守宫科
urgent	紧急
transilient	突变的
stepwise	逐步
po	钋
unorderly	混乱
banxring	=tree
groin	交叉拱
unapparent	不清楚的
synthesise	=synthesize
inurement	习惯
psychrophilic	好寒性的
driftlessness	无目标
pursiness	喘气
namaqua	=Nama
asprawl	伸开手足躺卧
epanisognathous	上齿比下齿窄
sean	肖恩
mount	装配
misanthropy	厌恶人类
seam	衔接口
rummy	危险的
smooth	流畅的
assiduity	刻苦
yumpie	=Yuppie
heavy	沉重地
metencephalon	后脑
ah	伊斯兰教纪元
definition	解说
forbidding	可怕的
endogeny	内生
funneled	漏斗状
lemuralia	驱亡魂节
sassy	无礼
intropunitive	自责型
insole	鞋垫
retrospection	追溯
jook	躲藏
catachresis	词形更改
phylogenic	动植物种类史
routine	程序
felicitously	适切地
mac	Millitary
countercharge	反告
terrestrial	陆地
bella	伊莎贝拉的昵称
colorized	彩色
thoroughpin	肿胀
astute	机敏的
excrescence	瘤
proud	骄傲
hoodlum	强盗
diatropic	横向性的
penates	家财
cheapo	=cheap
coxa	髋
rival	对手
inflectional	抑扬
ccsa	switching
diverge	分歧
gravesian	格雷夫斯风格的
essay	评论
bedell	捧持校长权标的属员
obscenity	淫秽
everlasting	永恒的
felonry	犯人们
factice	油胶
biaxial	二轴
glomerule	丝球体
owly	像鸮的
christocentric	以基督教义为中心的
overdoor	装在门上方的
imputable	可归罪的
carnalize	好色
osteological	骨学上
chirology	手之研究
launching	下水
smug	自鸣得意
dextranase	葡聚糖酶
endurant	能耐劳的
burdensome	难以承担的
pail	提桶
cyclopentane	环戊烷
delegable	可授给
whorish	妓女的
uncreased	未弄皱的
penuchle	=pinochle
interminably	无限
virulent	恶毒
sulfurate	如硫磺的
caterwaul	叫春
careenage	倾船修理厂
aquatic	水上的
hpgc	heading
chemotropic	向药性的
fountainous	泉源
balanced	和谐
castellated	造成城形
trawlnet	拖捞网
leaf	页
fruity	果味
microcosmic	微观的
clubbable	适合俱乐部会员资格
ebullient	冒泡
tentacula	tentaculum的复数
assumably	多半
pennyworth	价值一便士的东西
attemper	令缓和
incorruption	不腐败
sequestrate	没收
hear	听取
ogee	S形
shahaptian	=Sahaptin
inexpressive	缺乏表情的
anarchic	无政府主义
ulu	乌卢刀
unquestionably	无疑地
garroter	绞杀者
matrilineage	母系家族
shinto	日本之神道教
rancorous	深恨的
filially	孝顺
fetter	羁绊
khalifat	哈里发的职位
baseball	棒球
foucquet	即
plop	扑通一声
thingamy	某人
tchotchke	=tsatske
retroactivity	追溯既往
chemosterilize	绝育
pillow	枕垫
rented	租金的
orthoptist	视轴矫正医师
antisabbatarian	反对守安息日的
fuguist	赋格曲之作曲家
stuka	斯图卡式俯冲轰炸机
rozzer	警察
primidone	去氧苯巴比妥
custodial	保管
unplantable	不可种植
fineness	出色
youthy	年轻
continual	持续不断
insula	脑岛
albigenses	阿比尔教派
aggie	农科大学生
tuck	打摺
twine	编饰
sailorman	船员
unenlightened	不文明的
arioso	好听
aquarian	宝瓶座时段生的人
resist	忍得住
heterotrophy	不是自养
impeditive	阻碍的
fable	讲故事
guido	太空飞行工程师
sessioneer	musician
contrariant	敌对
indispensable	绝对必要
roselike	像玫瑰的
regional	地方地
substantive	独立存在的实体
peduncle	花梗
charge	收费
dts	Digital
talca	塔尔卡
clastic	碎屑状
schlep	笨蛋
base	卑鄙
wobble	变度
episode	一段情节
synaxis	感恩祭
key	要害
ichthyotoxism	鱼中毒
apodictic	绝然的
reaphook	镰刀
corymbous	伞房花序的
woody	木本
restrainedly	谨慎地
cellulated	细胞状
monopodial	单轴的
antipathetic	嫌恶的
acardiac	无心畸形的
secundum	按照
angolan	安哥拉人
jacqueminot	一种红透的蔷薇
numbing	使失去感觉
motorbus	公共汽车
golly	呀!
blankness	空白
crocky	破旧的
euphonize	使声音悦耳
stereometry	求积法
downmost	最下面
deuteranomaly	绿色弱
boldface	黑体字
underground	地铁
oogonium	藏卵器
arbalist	劲弩
obscurantic	蒙昧主义的
shelter	掩体
aspherical	非球面
neoterism	新语
puny	微不足道的
rilievo	浮雕
chemigraphic	化学镌版术的
nameable	可命名
treasure	珍惜
blacktop	柏油路
boycott	联合抵制
dippy	脑筋不正常
puddingheaded	愚钝的
hypoacusis	听觉迟钝、减退
projectual	投射教材
irrelevantly	不合适地
duressor	强迫者
shoddy	赝品
pancuronium	巴夫龙
hexamethylenetetramine	四氮六甲圜
aesthete	审美家
erotogenic	性感应区
smart	敏捷的
radiochromatogram	`reIdIEJ9kJmEtE^rAm/
keystone	要旨
moulder	腐朽
iso	for
potiphar	波提乏
soberminded	持重
unrenewable	无法回收利用
putrid	非常讨厌的
indeliberate	未经考虑的
deportee	被判充军之人
chickenlivered	胆小的
dint	击出凹痕
pronominal	代名词性质
summarily	草率
seedbed	发源
vacuation	排空
malee	=mali
second	另一个
pompier	救火员用的
turkophil	偏爱土耳其风尚的人
masochism	受虐色情狂
browsability	索得率
foreman	领班
astronomer	天文学家
fille	少女
juvenal	雏鸟的
pedestrian	呆板的
inp	Prices
adventuress	女投机家
sensitive	感光的
unventilated	不通风的
novation	更新
settler	移民者
dextral	用右手的
coelome	体腔
benthamite	边沁学说者
intragroup	社会团体成员之间的
reciter	朗诵者
adoptive	采用的
ecliptic	黄道
preshrunk	加以防缩加工的的
autarchic	独裁
cosmopolitan	全球的
powerlifting	力量举重
winnow	精选
skittle	九柱游戏用的小柱
epyllion	短叙事诗
eclipse	蒙蔽
nonnutritive	与营养无关
gentlest	优雅的
chitlin	circuit
parmigiano	用帕尔马干酪调制的
bijugate	有二对小叶的
zoopathology	动物病理学
divisibility	可除尽
ittf	Tennis
sceptical	怀疑
uncorrupt	不腐败
pop	瞪大
unwarily	不注意
acusector	电针
limp	柔软的
palindrome	回文
nethermore	较低
eosinophil	嗜曙红
hesitantly	踌躇地
pipestem	烟筒杆
aliped	有翼肢的
seismogram	震动图
tributary	附庸国
sibling	同属
obdurately	顽固地
oktastylos	=octastylos
zonerefine	区域精炼
suffragist	主张扩大参政权
supposititious	私生
acknowiedged	被普遍认可
firer	发火器
unmirthful	严肃的
geomorphology	地形学
prayerful	虔诚的
clamant	喧嚣
grouse	埋怨
codicil	遗嘱的附录
wizzled	干瘪
lordship	统治
pictish	皮克特族
leftish	左倾的
expressive	表现
jobmaster	出租马匹
eguttulate	无斑点
nondescript	无可名状的
solidus	古代罗马金币的一种
lapsible	应消失
spreading	撒布
embark	上飞机
anoxemic	血缺氧的
eftsoon	即刻
contemptuous	轻蔑的
waterworks	供水系统
intentional	故意
formic	蚁的
bogus	假
palmated	有蹼
equally	相等地
unwedded	未婚
quatercentennial	400周年纪念
rattlepated	愚蠢多嘴
oary	有桨的
delian	的ll
zany	滑稽
speakerine	电台女播音员
loculation	形成小腔或小室
effusiveness	唠叨
covered	掩藏着
macroptic	视物显大症
expresser	表达者
bread	面包
toxicoid	有毒化学物质
blintze	薄饼卷
misanthrope	厌恶人类的人
circumstantial	旁謎ty/`s\:kEm9stAnl/
paleornithology	鸟类化石学
sarcomata	恶性毒瘤
aculeate	有刺
actualistic	现实主义的
tranquilite	静海石
exposure	揭露
bloodwort	美洲血根草
fast	快速的
merriment	嬉戏
downcycle	下降性循环
silverless	不用银制的
telomerization	反应
tactually	触觉器官地
guy	盖伊
exemplary	可仿效的
duotype	双色网目版
toxoplasma	弓浆虫
illuminometer	照明光度计
sclerite	骨片
frankhearted	坦白的
sherpa	夏尔巴人
down	降下
casement	窗扉
cylindric	圆柱状
cookshop	小餐馆
spotty	发疹的
oddly	古怪地
underage	未成年
heterogeny	异型生殖
berliozian	柏辽兹乐曲迷
plebby	平庸
bluff	绝壁的
ichthyoid	成鱼形
unsound	不安全
animalistic	色情的
extortive	逼取
thaumaturgist	术士
inviolable	不可亵渎
worship	礼拜
unchurch	剥夺教会会员资格
nabob	在印度发财的欧洲人
grisliness	恐怖
nongovernmental	非政府的
microdot	微粒的
episode	插话
negligible	不予重视的
negligible	可以忽略的
wahhabism	瓦哈比教派的教义和习俗
monticle	小丘陵
sapient	装聪明样
international	世界的
mass	集中
irenic	和平主义的
cadence	韵律
supersonic	超声频
lav	轻型装甲车
weal	在……上抽打出条壮鞭痕
gunner	炮手
splashboard	挡泥板
countermortar	反迫的
tun	装入大桶
nodose	有节
epistolary	书信
pneumatic	装满空气
ataxia	混乱
grungy	丑
feed	吃东西
gun	向……开枪
pombe	非洲酒
am	A
scrupulousness	小心翼翼
catspaw	受人利用者
trochus	圆锥形螺壳
tail	后面来的
oldwomanish	婆婆妈妈的
ocherous	赭色的
commodious	宽敞
radon	氡
respect	尊重
cognitive	认识的
trembly	发抖的
bloat	膨胀
protonema	丝状体
unita	争取安哥拉彻底独立全国同盟
jiessie	杰西
heavy	沉重
fomes	传毒物
plenteous	丰富
fick	principle
fernery	蕨类丛生之处
floriferous	开花
cadet	军官学校学生
penult	倒数第二个
neutral	非彩色
encampment	露营
conflicting	相冲突的
coneflower	金花菊
unforensic	不适于法庭的
desecrate	污辱
unpretending	不装模作样
seaward	朝海
unsleeping	未入睡的
beidaihe	北戴河
dlemocrat	民主党党员
vexillate	有旗瓣
renegue	否认
orthogonalize	使成为正交
kersey	该粗绒布制裤子
hyperdactylia	多趾
colonel	陆军上校
byzantine	拜占庭式的
improperly	不正确
junk	舢板
evidential	证据
oversweep	扫过
londony	有伦敦特色的
indent	印凹痕
wart	瑕疵
sweetly	含糖
felonious	凶恶的
ruling	主导
early	在初期
woodskin	制造小划子的树皮
tempt	考验
northeastwardly	向东北的
innumerable	无数的
fungicide	杀真菌剂
scantily	缺乏地
unprejudiced	无偏见
moony	恍惚
infuse	泡
returnee	返回者
grinding	碾的
keffiyeh	阿拉伯人的头巾
lookup	查找
oct	十月
emporium	商业中心
sanborn	桑伯恩
jalap	泻药
gammadion	万字形
rhombencephalon	后脑
sonometer	听力计
electric	导电
codetta	小尾声
record	标明
aftersales	出售以后的
adfreeze	使冰冻黏附
avarice	贪财
aut	University
rapture	使狂喜
teachable	可教
postiche	画蛇添足的
faint	模糊的
succinct	紧身的
trigenic	三基因
cushat	斑鸠
plunderbund	掠夺联盟
hornless	无号角
molder	制模工
wicked	刻毒的
patrimony	继承物
towery	高耸的
nostologic	老年医学
authoritative	命令的
perspective	透视图
oxazepam	氯羟氧二氮草
oversoul	上帝
redefect	再度投奔
curvaceous	曲线美
compendiary	简略
spree	无节制的狂热行为
faubourg	郊外
synarthrodial	不动关节
satanic	恶魔
cuspy	整洁
monophyodont	不换性齿
leigh	利
superfine	特级
unreprieved	未缓解
reconnoissance	=reconnaissance
glisteningly	闪烁地
bassein	勃生
diffrangible	可绕射
divestiture	脱衣
intellectual	显示智力的
poise	姿势
acceptant	容易接受
narcoma	昏睡
cogency	力量
raconteur	健谈者
enterochromaffin	肠嗜铬细胞
wrecking	打捞业
costermonger	鱼叫卖小贩
bolton	可用螺栓固定
aphakia	缺少晶状体
unentangled	不纠缠
qei	inveniendum
amendatory	改善
scramasax	大刀
aeneas	特洛伊战争中的勇士
honkers	喝醉的
hyperthymia	心情激越
neighboring	邻近的
willingness	自动自发
repopulate	使人重新住入
usaid	美国国际开发署
indwelling	内在
unjelled	未定形
baronetage	从男爵
pileum	鸟冠
sulphonic	酸性硫酸基的
trilobed	=trilobate
druidic	督伊德教
rainbow	五彩缤纷的排列
abecedarium	入门书
aneurism	动脉瘤
mechanical	机械制的
cockroach	蟑螂
carry	射程
caucasian	白种人
cechy	=Bohemia
rampant	蔓生
valedictory	告别的
irgb	Green
seminal	种子的
hazel	榛树
lot	许多
merchant	批发商
mould	模具
tackey	=tacky
ewer	大口水罐
resonatory	引起共鸣的
noctiflorous	夜间开花的
insincerely	无诚意
steamboat	汽船
singing	歌声
lucidly	透明
quirkiness	诡诈
aether	太空
interwound	interwind的过去式和过去分词
villainous	坏人似的
pilaf	肉饭
dpg	diphosphoglyceric
liked	喜欢
illusage	糟蹋
wroth	激怒
flashboard	插板
preterhuman	超人的
undistinguished	平凡的
ameristic	非分裂组织
quadrilateral	四角
indecorously	无礼地
salvage	打捞
meritocrat	精英管理班子的一员
nuzzer	=nazar
seasonably	应时
kamet	喀美特峰
huskiness	粗嘎声
maintop	主桅楼
quench	淬火
nonparty	无党派
digitalize	以洋地黄治疗
fluently	通畅
bayreuth	拜罗伊特
laminated	薄板状
resonator	共鸣器
braid	编织物
bitonal	双调的
bond	公债
willow	柳木制的
endosteum	骨内膜
distress	不幸
upswept	朝上梳
peat	泥炭块
sumptuously	豪华地
gotcha	you
mount	乘马
naturalise	移植
fusion	熔合
indexless	无索引
pirozhki	=piroshki
sulfate	以硫酸或硫酸盐处理
resell	转售
vouch	证明
exosmosis	渗入
zygosperm	接合孢子
undefiled	洁净
proprietorship	所有权
hilly	多坡的
assignments	分配
ort	残屑
source	原始资料
chairman	会长
excavation	出土文物
hula	草裙舞
inhospitably	冷淡
coseismal	同震曲线
resentfluness	充满愤恨
ninette	尼内特
reformable	可改革的
staves	杖
bonded	以债券作保证
shave	削
nutgall	没食子
densify	使硬化
catachrestic	用词不当的
poplar	白杨
fecula	淀粉
hobbledehoy	青少年
flic	警察
silkscreen	用丝网印刷术印制
underripe	部分成熟
some	若干
activated	有活性的
mts	Moving
allegedly	依其申述
thowless	无生气
maxilla	上颌骨
expeditiously	迅速地
ultranationalism	极端民族lIst/
caffeic	咖啡
tribunitian	=tribunitial
kiddywink	小家伙
covert	掩蔽处
volant	会飞的
snuffy	讨厌
marasmic	衰弱
pattern	式样
inhuman	野蛮的
britannic	英国
baneberry	一种有毒植物
extramitochondrial	细胞中的线粒体之外的
mfp	Multiple
hydrargyric	汞
tergum	背板
knowledge	学问
ken	视野
presentational	表象的
conidia	conidium
fated	受命运支配的
experience	经历
federal	同盟的
continued	继续的
squamulose	有小鳞片的
insinuation	暗示
linkup	连接
pet	亲昵的
indicate	需要
envenomation	毒液螫入
hazard	冒……的危险
haemagglutinate	`hi:mE9^lU:teIt/
unfinished	未完成的
flabellinerved	神经呈扇形排列的
semiplastic	半塑性
mutably	无常
lallation	音
exotoxic	外毒素
pioneer	倡导者
antiunion	反对工会
dankly	透水
psychoneurotic	精神神经症的
leaky	漏的
pathologic	病态
uscf	United
jacquerie	扎克雷起义
recipe	处方
unfastidious	不苛求的
polytheist	多神论者
guarantee	保证书
moneygrubbing	积蓄钱财
saddlebow	鞍的前穹
proof	证明用的
pignus	典质
trashy	垃圾似的
kieselgur	硅藻土
radiodermatitis	放射性皮肤炎
very	特别
prey	掠夺
lanthanide	间的稀土元素
audio	声音
fluvioglacial	冰水
signalise	=signalize
quatrefoil	四叶片的叶子
redid	再做
niddering	卑鄙
checkout	校验
dmd	数字微镜装置
bergsonian	柏格森主义的
intercommunion	相互通讯
peridental	=periodontal
liquid	透明的
medicare	医疗保险制度
overcome	征服
nocuous	有害的
clever	机灵
trinomial	三名法
formerly	原来
misnomer	用词不当
miserable	痛苦
liquor	汁
provocate	激怒
twinborn	孪生的
weld	焊缝
silkworm	蚕
unsuitable	不相称的
kashmirian	克什米尔人
dutiable	应纳关税的
overearnest	过于热切的
ringdove	斑尾林鸽
phytocidal	除草
ribby	多肋骨状物
interprovincial	省际
pulvinus	叶枕
landowner	土地所有者
colourman	图画颜料商人
unaffected	未受影响
quadriceps	四头肌
oviparous	卵生
rotatory	使回转的
vouge	戟
adrenotropic	亲肾上腺
presidiary	驻防
sugarbush	枫林
medaled	佩带徽章
tradesman	零售商
coralline	产生珊瑚的
salted	盐味的
ruttish	淫荡的
thriftlessly	挥霍地
remex	鸟的拨风羽
royston	crow
pneumoconiosis	肺尘症
weatherproof	防风雨
flakelet	小薄片
section	部件
photoelectric	光电子照相装置的
sketch	绘略图
processable	适合加工
charactery	表达意思的文字
count	有价值
bedbug	臭虫
tracheate	用气管呼吸
eunomic	守法
cmtc	Camp
psychologic	心理学的
sarcelle	白眉鸭
vulnerable	易受……的攻击
mismatch	错配
manx	马恩岛的
rude	粗鲁无礼
runtishly	矮小
rackabones	骨瘦如柴的人
dedicated	献身
spigot	栓
protuberance	突出
unselective	没有选择力的
supremely	无上地
spr	for
zoogeny	动物发生论
testily	易怒
indisputability	明白
beaten	打败了
gilthead	乌颊鱼
yieldance	让步
accordatura	基调
quernstone	磨石
dealation	脱翅昆虫
cultivated	耕耘
forbidden	禁止
muffle	头巾
phobos	火卫一
pathogenesis	发病机理
cruelly	残忍
indefatigably	不屈不挠
advance	前面
blancmange	牛奶冻
senior	高级的
melange	混合物
hartshorn	鹿角
gnarled	粗糙的
trypanocidal	杀锥虫的
dumb	无声音
castaly	诗之泉
substitutionary	=substitutional
refractive	折射
agglutinative	会粘着
abyssinian	阿比西尼亚人
bilocular	两室
raffle	杂物
contrariwise	反之
outcrossing	远交
anatomist	解剖学家
jostle	挤拥
rear	举起
horseplayer	常赌马之人
triamcinolone	去炎松
telecamera	电视摄影机
bangup	把锁上
wholesale	趸售
pinfish	重牙鲷
eternally	常常
optimistical	乐观
fateful	重大
colugo	猫猴
congenetic	同源
tickie	=tickey
eguttulate	无斑点的
pensionable	可领退休金的
flycatcher	捕蝇草
prelature	=prelacy
resolutive	使分解的
peremptory	断然的
depth	深刻
catling	肠线
batch	一批
etcetera	附加物
lionship	名士地位
attachable	可连接的
asepticism	无菌外科学说
unbrotherly	不亲切的
orgasm	兴奋的高潮
elysian	象天堂
tmv	tobacco
crackled	有裂痕
scary	引起惊慌
anuretic	无尿症
joltheaded	笨头
epoxide	环氧化物
syllogism	三段论法
preconception	偏见
pedunculate	有肉茎的
underhung	轨上
borecole	羽衣甘蓝类
heartwood	心材
assistant	助手
rollered	具有滑轮
elegancy	优美
microphyte	微小植物
fitfully	发作地
avail	有益于
ccco	非战主义者中央委员会
cassette	盒子
patroclinous	=patriclinous
allium	葱属植物
sixain	六行诗节
pipelike	管子似的
haemoid	血样
roc	Capability
plinth	方形底座
hysteric	过度狂燥
metaxylem	后生木质部
formal	正式的
amerasian	美亚混血的
beholden	对……表示感谢
ko	击倒
tardy	拖拉非
oaw	光学辅助温氏技术
npv	net
cherrapunji	乞拉朋齐
quits	两相抵消的
kalpak	黑毡帽
recitative	吟诵
neuroanatomy	神经解剖学
bup	Press英国合众社
slip	Protocol
nimblewit	聪明的人
abirritation	缓和作用
command	克制
govern	支配
shearhog	第一次剪毛后的羊
holometabolous	全变形
extraterritorial	治外法的
warrior	尚武的
buzkashi	buz
bosnywash	波纽华地区
divert	转向
psychogenesis	心理发生
dispreader	向四方张开
untraceable	难以寻找
associative	结合
morphological	形态学
vertiginous	眩晕
brushland	灌木林地
swellish	时髦
hymenopteran	属于膜翅目
raft	大量
liza	莉莎
atishoo	阿嚏
tanglesome	杂乱
oligodendrocyte	少突细胞
jacinth	橘红色
grum	阴郁的
consummate	至上
methylase	甲基化酶
stretta	加快结尾段
ponderance	分量
occidentally	西方地
courier	旅行从仆
externalise	=externalize
unconsciously	无意中
weldment	焊件
livorno	里窝那
atmospheric	大气
driftingly	飘动
reenlist	延长服役
breadless	无食
sisterhood	姐妹之谊
sacrosanct	极神圣
fasciae	饰带
your	你
age	上年纪
circumlunar	绕月球运动的
uncertainty	不确定
guillotine	断头台
medicament	药物
gundog	猎犬
duvetyn	混纺毛织品的一种
cuttloefish	乌贼
frequentation	时常出入
vitiator	使失效的人
infinitely	无限地
pyramid	角锥、棱椎
floppy	懒散
ferric	三价铁的
horny	角状的
doddery	衰老
doer	实干家
remonstrant	抗议
score	获
sumptuosity	奢华
http	Protocol
skitter	掠过水面
hemodilution	血液稀释
curd	凝结物
unsoldierly	不适于军人的
potty	微不足道的
sulfurate	硫磺
ophite	辉绿岩之一种
revisable	可修改
inconvincible	无法使人信服的
honorary	道义上
interlocutory	对话体的
cdma2000	码分多址系统标准2000
study	学科
causalgia	灼痛
xanthism	黄色素过多症
awanting	短少
diarist	负日记专责的人
prehistory	史前史
basilar	基部
solidungulate	单蹄
gothamite	Gotham的人
pulchritudinous	标致
braunite	褐锰矿
dank	潮湿
polarization	偏振
salary	给……加薪
superplastic	超塑性的
argonautic	号船员的
catechize	盘问
napoli	=Naples
afterdamp	余留的毒气
bally	讨厌
remembrance	纪念品
reform	重组
maid	女仆
protoporcelain	原始瓷器
loop	翻筋斗
organically	有机地
dolichocephal	长头现象
oleate	油酸盐
symmetrization	使平衡
sawfly	叶蜂
raunchy	淫秽的
measled	患麻疹
minicalculator	袖珍电子计算器
lipopolysaccharide	脂多糖
contracted	已定约的
nix	禁止
hernioplasty	疝根治手术
domestically	家庭式
plasmogamy	胞质配合
sonderclass	特种竞赛用小快艇
calla	荷兰海芋
beltane	西洋旧历五月一日
bicorne	双角帽
accuse	谴责
keystone	拱心石
irritant	刺激物
dispatchbox	公文递送箱
periphonic	全向声系统
gustiness	阵风
recurrent	循环的
psn	处理器序列号
kiddie	小孩
insanitation	卫生设施的缺乏
mettlesome	勇敢
peritectic	包晶
interarticular	关节间
goanese	果阿的
unspiritual	非宗教
commonwealth	国民整体
mensual	=monthly
interbreed	杂种繁殖
dualistic	二元的
cremate	焚化
dastardly	懦弱
paganism	不信教
pedagogic	教师
sonagraph	=sonograph
indicative	可表示的
position	位置
desponding	意志消沉
soporific	安眠药
sclerosing	致硬化
oophore	=oophyte
douai	Version
deambulatory	散步的
obscenity	猥亵
himalaya	Himalayas
dogbane	毒狗草
graticule	显微镜的计数线
homicidal	杀人
hearse	柩车
pelt	投掷
unconstrained	不受拘束的
evolving	展开
zirconolite	钛锆钍矿
cone	锥形物
sexiness	性感
metamorphic	变形
gamecock	斗鸡
resume	概略
gare	低级毛织品
slipstream	气流
platitudinarian	平凡的
burger	碎肉夹饼
cockily	逞能地
hearted	有……之心的
dopplerite	天然沥青
rile	激怒
suborbicular	近似圆形的
pileup	堆积
saucer	茶碟
stroud	粗呢毯子
voluble	缠绕的
bagasse	甘蔗渣
grain	谷类
sundress	太阳裙
quicksandy	似流沙的
haematimeter	血球计
jampan	四抬轿
photoinduced	光诱导
rachiodont	具脊齿的
systematically	有系统地
irish	爱尔兰语
rounding	圆
ems	扩展内存规范
biopoesis	无生源说
ingoing	进入的
orient	上升的
echo	发回声
inbreed	生育
subinfeudation	领地分封
reclusive	隐居的
disrepair	失修
speciosity	华而不实
scholasticism	烦琐哲学
abominable	令人憎恶
carrion	似腐肉的
culminating	最后
prejudicious	有损害
unsleeping	未入睡
phonematic	音位学
phonomotor	声动机
phansigar	谋财害命的暴徒
bdellium	宝石
bandeau	细带
leniently	温和
prevention	防止
module	指令舱
abridgment	节略
external	表面的
tasse	腿甲
hoodlum	无赖
shearbill	剪嘴鸥
arciform	拱状的
sear	烤焦
copier	临摹者
rapc	Pay
favorably	亲切
opalesque	发乳白光的
salty	咸味浓
rudderless	无舵的
precatory	恳求的
skinful	一肚子
shabbiness	破旧
parallel	类似的
hlf	Lung
synchronously	同时地
pithead	坑口
hydrometric	液体比重测定的
distinct	截然不同的
digitate	趾状的
irridenta	=irredenta
gnotobiotics	限菌生物学
libidinous	性欲
piezoelectricity	压电
candied	糖果的
bonded	有担保的
shereef	穆罕默德的后裔
etaerio	聚心皮果
conversant	亲近
feraghan	费尔干纳地毯
bekaa	贝卡
redefector	再度投奔
epineurium	神经外膜
minipark	小公园
oecd	and
citybred	在城市
gaolbird	流氓
semiarid	半干旱的
instead	抵作
disk	圆盘状物
fzs	of
autocatalytic	自身催化
messenger	使者
adversarial	对手的
compulsive	由强迫产生的
approbatory	认可
disablement	无能力
overreach	走过头
ironmould	染上墨水迹
subsensible	比感觉范围更深
elementary	自然力
brambly	荆棘多
prosperously	幸运地
farkleberry	一种白莓
epicurean	伊壁鸠鲁
hmf	HerMajesty''s
pseudo	假
dossier	卷宗
yellowwood	产黄色木材的各种树
bathless	不洗澡
varistor	变阻器
fancywork	钩编织品
bedtick	褥套
parsonian	帕森斯社会学理论的
sidekick	伙伴
nightcap	睡帽
sensuously	感觉上
gingersnap	姜饼
inscience	无知
diane	黛安
skibby	日本人
bacteriolytic	杀菌
shoeless	未钉蹄铁
severalty	各别
unsure	不确定
uppiled	堆积起来
heterozygosis	异型结合
leavy	叶茂盛的
pesterous	讨厌
subtransparent	半透明
adenoidal	腺状肿的
prejob	职前
magnipotent	强有力
pressural	机械压力
nullipara	从未生育过的人
luxuriate	生活奢侈
indisciplinable	无法控制
diminutive	小型的
place	职位
gnn	Navigator
reform	革新
intersubjective	主体间
irredentism	民族统一主义
film	电影
dishwatery	乏味
vengefully	复仇心切
opec	Organization
bobbly	不平
jarvis	贾维斯
mow	谷堆
monobloc	单块
furibund	狂怒
niobous	三价铌的
avocation	副业
bipolar	有两极的
germanium	锗
caitiff	胆小的
pullulation	产生
azotic	氮
shakespeariana	=Shakespeareana
corinne	科琳
skyline	地平线
barren	不孕的
patagonian	南美南端地方
trochoid	车轮状的
ersatz	代用的
jest	嘲笑
cancroid	一种皮肤癌
vamplate	铁片护手
trainee	新兵
impartial	不偏不倚的
choline	维生素Ｂ复合体之一
homesite	家
nim	偷
noncompliance	不顺从
margaric	珍珠般
elastomeric	人造橡胶
rubrication	红字
nudicaul	茎上无叶的
quarterdeck	后甲板
figmentary	虚构
pebbly	多卵石的
shawmist	肖姆管演奏者
pulpous	纸浆状的
troostite	屈氏体
recessional	撤回的
unreserved	坦白的
unlikeliness	不大可能
subarid	半干燥
fast	牢的
ntfs	新技术文件系统
encirclement	环绕
aequian	埃桂语
comparable	可比较的
negrophobia	憎恶黑人
swayless	不摇摆的
pitchout	横传
clumsiness	简陋
golden	贵重
kamagraphy	卡马油画复制法
ceuca	Customs
fermium	镄
searchless	无法探究的
summoner	召唤者
fluster	使激动
doorsill	门槛
crumb	碎屑
hatching	影线
squeal	长声尖叫
applaud	赞同
inseverable	不可切断的
sweetsop	番荔枝的果实
bluebeard	乱取妻妾然后将她们杀害的男人
transferable	可转移的
kerchief	方巾
okra	黄秋葵
sozin	防卫蛋白
totemic	图腾
impoundment	扣留
winey	=winy
uglily	难看地
hub	中心
satchel	小背包
chilliness	严寒
zoetrope	西洋镜
accumulate	堆积
presentative	有推荐权
dago	西班牙人
recommendatory	推荐
semidigested	半消化
kendo	剑道
piscina	养鱼池塘
disarrangement	混乱
broadwise	横地
vexation	恼怒
nouadhibou	努瓦迪布
figurable	能定形的
eliminator	消除者
ternate	三个一套
inexcitable	冷静的
butcher	屠宰
autopista	track]
curtailment	缩短
stupid	麻木
dicer	玩掷骰子游戏者
keratometric	角膜散光计
reforge	新造
pose	引起
sedimentologic	/
unlively	不活跃
diametral	直径
subarea	分区
fontange	方当伊高头饰
moory	=moorish
appurtenant	附属
touse	骚动
dolesman	接受布施者
being	在
netfs	Service
bullhead	大头鱼
update	修正
dermatological	皮肤病学
indemnification	保障
tough	忍受
noogenic	心理发生的
triloculate	三室的
ablepsia	视觉缺失
makeshift	凑合的
goth	粗野的人
instigation	鼓动
infrequent	很少发生
stimulus	促进因素
monumental	纪念物
perjured	伪证的
transformative	变化
grouchy	不满的
clearsighted	聪明
firebrand	放火者
radicalization	激进化
vermiculated	蠕虫
sagely	贤明
salve	药膏
quinquecentennial	=quincentenary
survivorship	生存者对共有财产中死者权利部分的享有权
cotton	棉线
unnumbered	无数
polymorphic	多形态
scrag	脖子
alastrim	类天花
diaspora	散居在外的人
spirited	英勇的
nancified	女性化
jaygee	海军中尉
orthohydrogen	反转氢
cruces	难题
cayuga	卡尤加族
vehement	热烈的
iodophor	碘递体
rubeosis	发红
fact	实际
pyemia	毒血症
faddish	流行
maas	马斯河(上游为默兹河
carnation	康乃馨
recidivism	累犯
osmotic	渗透的
tmv	virus
fortlike	像城堡
thin	变淡
fenny	沼泽
plastics	整形外科
wallflower	桂香香水
fidgety	不沉着的
jazz	喧闹
priapism	淫荡行为
jager	贼鸥
diluent	冲淡
flotage	漂浮物
gdr	German
dialysis	透析
anaphoric	首语重复法的
erelong	不久
cerebrospinal	脑脊髓
cast	投掷
eleemosynary	施舍的
farthest	的最高级
coloury	品质优良的
antimonial	锑
wonderland	奇境
soaraway	进展神速的
soil	温床
overgreat	过大的
coevality	同时代
msie	Engineering
elise	伊莉斯
joyful	兴高彩烈的
informing	提供情报的
unprompted	未经鼓动的
johnson	约翰逊
amazedly	惊奇
jalopy	破旧车
xxv	罗马数字
indiscrete	不分开的
foreclose	妨碍
spat	口角
trample	轻视
fliting	争吵
jackaroo	无经验者
nabber	抓人者
romeo	热恋的男子
duodenostomy	十二指肠切除术
homologous	相应的
railfan	=railwayac
voguish	时髦
epipetalous	花瓣上着生
unheard	未听到
or	运筹学研究
gnaw	使苦恼
calamander	柿木
cuttle	墨鱼
inby	近于……
feracious	多产
pyritic	硫化铁矿
prearrangement	预备
motile	能动
dislocation	混乱
burdensome	烦累
upbind	围裹
duffel	粗呢
hessite	碲银矿
pulsometer	脉搏计
msphe	Engineering
jurisprudent	法理学家
unalienated	未让渡
poll	投票
defrock	剥去法衣
unmatched	无比
spacefarer	宇宙飞行员
draconic	严峻的
interfascicular	束间
osteocyte	骨细胞
omphalos	圆锥形石
sidereal	恒星
ruthenious	亚钌
binal	孪生的
cardigan	开襟羊毛衫
pedantic	书生气的
remilitarization	重新武装
fiddle	小提琴
apologetically	道歉
belemnoid	形像匕首的
downbent	弯腰驼背
mudflap	挡泥垂布
allegorist	寓言作家
reedy	似笛声的
halfheartedly	无兴趣
mystique	秘法
ambidexterity	怀二心
passman	普通及格学生
yerevan	耶烈万
meaning	内涵
procacious	大胆
stole	steal的过去式
stakhanovite	斯达汉诺夫运动
admetus	阿德墨托斯
yesteryear	不久以前
purserette	女事务长
isoprenoid	类异戊二烯
situate	使处于
ghaut	山路
aspheric	非球面
astragali	紫云英属
trivialize	使琐碎
cryophysics	=cryogenics
primula	樱草属
thinnet	细电缆网
radiogenic	由放射能产生
auric	似金
doloroso	悲痛的
idle	无用
queenliness	象女王
nomothetic	以法律为根据的
thromboplastin	促凝血酶原激酶
west	西部
imbecilic	愚笨的
previsional	有先见之明的
carefree	轻松愉快的
eserine	=physostigmine
impleadable	控告
france	法兰西
sexualist	性论者
picture	像
obovoid	倒卵球形
seedy	多种子
granuliform	具颗粒状结构的
obispo	四角羊
underlit	照明不足
fairly	相当
skish	旱地垂钓游戏
tiglinic	=tiglic
hautbois	=hautboy
obfusticated	=obfuscated
baroque	巴洛克式
punge	=punji
dismayful	令人惊愕
veins	纹理
recognizance	保证金
underwork	次要工作
arteritis	动脉炎
slaver	谄媚
hypothenuse	斜边
broad	显著
formerly	以前
dihedral	两面角
gasbag	废话连篇的人
reclassification	重新安排等级
semischolastic	半教育的
spectre	鬼性
unconstraint	自由自在
exchequer	国库
troostite	锰硅锌矿
swingby	绕行星变轨
cyclopic	庞大的
lavishness	过度
convulsant	发厥药
irrationally	无理性地
circle	派系
understate	有意轻描淡写
luminary	发光体
diphtheria	白喉
glary	闪耀的
xanthochroic	金发白种人的
lanigerous	有细毛的
finny	有鳍的
taper	逐渐减少
extramural	校际比赛的
indrawal	吸入
shona	=Mashona
spanking	疾行
irradiative	会发光
mitred	斜接
humanization	人类化
cap	帽
browbeat	恫吓
sabbatarian	严守星期日为安息日的人
imbody	使肉体化
habilatory	衣服的
standish	墨水台
rosewater	有玫瑰香水味
noisy	聒噪的
stromatolite	叠层
afghani	阿富汗尼
papable	适于并可能继承教皇职位的
wavellite	银星石
cultivatable	可耕种的
numeral	数字
musically	音乐上
congener	同类
dissipated	消散的
hamulus	钩
adiabatic	隔热的
winning	动人的
knob	鼓起
hawk	散播
discrimination	识别力
williewaught	一大口
honolulu	火奴鲁鲁
epiglottal	会厌
tripartizan	=tripartisan
moss	苔
usng	National
faint	暗淡
capitulation	投降条约
undoubled	不再握紧
guildhall	同业公会集会所
premonish	预先警告
untamed	不能抑制的
lambaste	严责
balibuntal	一种棕榈纤维
neuropathic	神经病的
endowment	捐赠的基金
curd	凝乳
quarterstaff	铁头木棒
short	松脆的
squirely	乡绅的
pratie	马铃薯
centrobaric	重心
prf	frequency脉冲重复频率
degasify	排除……的气
ecc	纠错码
karachai	卡拉柴语
cospar	on
sycophant	奉承
infaust	不利
thermogravimetry	热重
ordinary	普通的
talus	斜面
impolitely	无礼地
floodplain	漫滩
twinned	一胎双生的
velutinous	有绒毛的
supplemental	补足的
deprecative	=deprecatory
nuts	热衷的
wilkes	威尔克斯
exploration	探察术
amatory	情人
bandy	交换
arabis	筷子芥
poeticise	=poeticize
unthoughtful	未深思
hyperhepatia	肝功能亢进
humorous	异想天开
newbie	网络新手
drily	冷淡
concerted	商议定的
drop	交往
haircloth	马尾织品
gynaecoid	具女性特点的
cerigo	=Kithira
irv	警官
hep	蔷薇之实
bagged	松弛下垂的
maintainable	可维持
fimbriate	有毛缘的
abustle	熙来攘往
fluorescent	莹光的
cairo	开罗
mozzetta	=mozetta
indigenization	本国化
unashamed	不害羞的
past	往时
bimonthly	双月
wholesomely	有益健康
weal	杖痕
prove	证实
nidifugous	孵出后立即离巢的
masseuse	女按摩师
dimorphemic	双词素
unphysiological	不符合生理规律的
defilement	污秽
assaultable	可攻击的
expedite	迅速
sporades	斯波拉提群岛
ferromolybdenum	铁铜齐
roisterous	饮酒取乐
escolar	玉梭鱼
transpositional	变换的
detailed	逐条
agitato	兴奋
underwater	水面下的水
nasial	鼻根的
melting	混合的
stuffless	无实质性东西的
multivitamin	多种维生素
paiute	居于美国印第安人的一部族
atlantean	力大无双的
locomobile	自力推动车辆
ephemera	生命极短促之物
rendering	粉刷
slyboots	恶作剧者
apologized	道歉
plectognath	愈颌目
lignification	木化
unprizable	无多大价值的
unsuspected	无嫌疑
dour	严厉
franco	免费
smooth	平坦
triumphant	成功
odontalgic	牙痛
lopsided	不平衡
agog	热切的
tensiometry	张力测量学
preservative	防腐剂
indolence	懒散
fanatic	狂热
surrender	放弃
acetometer	醋酸计
unacquirable	不可占有的
airy	通风
gangdom	黑社会
prankster	爱开玩笑的人
orangeism	奥兰治党主义
outgo	支出
luminol	发光氨
ultrasonic	超声的
sleuth	足迹
abominable	讨厌
antiparallel	反平行的
hawk	捕捉
champleve	雕刻七宝
voces	vox
portliness	威风
glial	神经胶质的
electrochronograph	电动精密记时计
scrappy	斗志旺盛的
replay	重赛
phthisic	结核病
sound	宣告
postvaccinal	接种后
officialize	置在政府机关管辖下
ever	在任何时候
disassembly	解体
horae	时序女神
anemophilous	风媒
nipa	尼巴酒
unput	未放置
exaggerate	夸张
zooplastic	动物组织移植术
fairing	市场上买的礼物
immensurable	不可衡量的
winebottle	酒瓶
celaeno	昴星团
xcviii	98
land	使到达
iotp	Open
dpt	tetanus
cbpi	加拿大商业期刊索引
groovy	常规
uneconomical	不经济的
ppb	per
telomere	端粒
eclipse	引起日蚀
impetuous	激烈的
baneful	使人苦恼
quackupuncture	冒牌针刺
clinographic	斜射
stimulant	刺激物
tcs	交通管制站
aw	阿鲁巴
rosarium	玫瑰园
affixation	附加法
cocker	娇养
convincing	有力
voltolization	电聚
capapie	全身
mycelia	的复数
meteorologic	气象学的
asiatic	亚洲
commons	公共用
slander	诽谤
corrupt	腐烂
foolproof	十分安全
eva	伊娃
barotolerance	耐高压性
underwear	内衣裤
calisthenic	美容体操
scar	创伤
cystiform	胞状的
bowel	同情心
orb	天体
signal	发信号
occlusive	闭塞
homochronous	同期发生
turbinate	螺旋形介壳
undp	Program
impressure	感觉
pietist	假装虔诚的人
topstitch	在外面的缝旁缝一道针迹
clonally	无性系地
wrackful	毁坏
foreignize	外国化
disorganized	紊乱的
lcp	Link
accredited	可接受的
pipy	管状
fray	打架
rodent	咬
exteriority	外在性
hominine	类人
legumen	荚
leafy	叶状
caudate	有尾状附属物
taskmaster	工头
ontologize	以本体论表达
depressible	可抑压
chive	细香葱
puff	鼓吹
archdeaconship	副主教的职位
beccafico	小候鸟的一种
ensiform	剑形的
orotund	响朗的
inequivalve	两片壳不等瓣
presto	迅速的
exemplarily	作为模范地
frigging	要命
migration	移植
decline	衰败
asti	spumante
evacuation	走开
flukicide	杀吸虫剂
reengine	更换……的发动机
threefold	三倍
labial	风琴管
desolation	荒凉
ramet	无性系分株
montanian	=Montanan
annullable	可废止
odiousness	讨厌
barefaced	不隐瞒
xenium	赠与宾客的礼物
constitutive	制定的
renown	使有声望
unacted	未演出
dup	打开
cafe	咖啡馆
tusser	=tussa
irretraceable	不能回头
epibolic	外包的
fille	女佣
idolater	崇拜者
bimeby	渐渐
sleepcoat	男睡衣
raffish	艳俗
overquantification	过于着重数量
bashfully	羞怯地
hairdo	发式
iffy	可疑的
favous	形似蜂巢
leniently	温和地
unholy	不洁净的
prolate	扁长
sublunary	月下的
sncf	Nationale
salpingitis	输卵管炎
super	非常
page	翻书页
dexterous	灵巧的
regard	问候
coshery	饮宴
speechless	不能说话的
saturn	杀草丹
mestranol	炔雌醇甲醚
frankhearted	无隐
theandric	神人的
incondite	生硬的
xylography	木版术
landward	向陆地
means	手段
diploma	文凭
pettifogging	诡辩
annum	年
ascidian	海鞘类
corepressor	辅抑制物
systematically	系统
wearable	耐磨的
ornithosis	鸟疫
smegma	阴垢
xanthogenate	黄原酸盐
imperceptible	觉察不到的
thrust	口头攻击
rubenesque	=Rubensesque
zig	转弯
cpc	Communist
interested	有权益
therewith	与此
westing	西行
payt	payment
expropriation	征用
gaga	愚蠢
rickle	将……堆成一堆
asthenopia	弱视
blocky	短而结实
toadeating	谄媚的
depose	宣誓作证
jurisprudent	精通法律的
charmed	着迷
cosecant	余割
desirable	值得要
trail	踪迹
odontophorous	有舌突起的
deferentially	谦恭
gipsydom	流浪汉的势力范围
transdisciplinary	涉及若干学科的
drillmaster	训练员
duluth	德卢斯
polystomatous	多口孔的
qbe	实例查询
pristane	朴日斯烷
dredlock	=dreadlock
frondescent	长树叶
aurora	黎明的女神
castiron	强壮
ethnarch	部落
musketoon	短火枪
plowshoe	=ploughshoe
azeotropy	共沸现象
refiner	精炼者
pliers	钳子
lentic	静水的
fruitage	结果
disk	圆盘
secateur	剪
calk	装尖铁
bidonville	临时搭建的简陋棚户区
msbc	Building
pernicious	有害
exacting	吃力
wahabee	瓦哈比教派的教徒
walrus	海象
sadducee	撒都该教派
psoriasis	牛皮癣
shirttail	幼小的
situated	被置于境遇
sandfrac	沙水压裂
conversancy	熟练
pert	鲁莽
placet	赞成
sniff	用力吸气
carline	女人
consuelo	康斯薇洛
unsaid	不说
quindecemvir	十五人团体中的一人
charge	主管
uneven	不平坦的
nefarious	穷凶极恶的
ruddily	呈现赤红色
felonious	重罪
verbose	详细的
fruitage	水果
pigsticker	猎野猪的人
zooty	花哩花哨
hydrobromide	溴化氢物
leonid	狮子座流星群
blocky	斑驳
einkanter	单面鹅卵石
glyoxal	乙二醛
super	特大的
ftp	文件传送输协议
yikker	叽叽喳喳
galleon	大型帆船
filter	滤过
bifilar	双股的
it	Italy
cementite	碳化铁
misinput	错误输入
bawdily	淫秽地
pubescence	到达青春期
aircrewman	空勤组员
workhorse	重负荷机器
rationalist	唯理论者
passthrough	通过
unretarded	未受阻止
runner	信使
varicocele	精索静脉曲张
dactyl	长短格
maillot	女游泳衣
lallation	将
vindicative	惩罚
sweepingly	扫荡
ruefully	悲伤
invest	授予
electrodermal	皮电性质的
tankette	小坦克
refutatory	驳斥的
kilted	打褶的
rapaciously	强取地
unswerving	坚定的
anthropophagi	食人肉者
voiced	有声
diapsid	双窝类
zaire	非洲扎伊尔货币名称
phyllotactical	叶序
kibitzer	乱出点子的人
trichromic	三色的
conferment	授予
coolish	微凉
meconic	罂粟
antique	过时的
tenfold	成十倍
roseate	玫瑰色
logos	理念
retroflected	=retroflexed
reif	抢夺
sunscald	日灼病
superjacent	上覆
intracity	市内的
hangchow	杭州
unconfiding	寡言的
antistrophe	反用
theater	阶梯教室
fleshless	无肉体的
atapi	AT附件包接口
afterwit	事后聪明
ottawa	渥太华
verel	维勒尔
unwound	松散
afterwar	战后
kuskokwim	卡斯科奎姆河
overbrilliant	过于华丽的
augmented	增音
cormorant	贪婪的人
eugenicist	优生学家
filiform	丝状的
rasp	粗锉刀
execute	完成
buccal	颊
instant	即时
anteprohibition	禁令前的
misbehave	行为不端
set	树立
keratoid	角质的
legibility	易理解
onyxis	嵌甲
dichasial	歧聚伞花序的
huntsmanship	狩猎本领
procacious	冒失
canicular	酷暑期的
flutist	横笛吹奏者
diffrangible	可分解的
felv	feline
ghostlike	灵魂似的
aiff	File
lobscouser	水手
nitrolic	硝基亚硝基化成物的
rfc	Request
hoagie	sandwich
forward	早的
unitary	单式的
inapparent	不明显
renovascular	肾血管
unidentifiable	无法识别
hecatomb	大祭
hysterotomy	子宫切开
gastronomy	烹饪法
legend	图例
kirmess	庙会
thermoremanent	热剩磁的
methodical	有方法的
substitute	代替
mudroom	沾泥物品寄存室
accession	增加
maximalist	俄国多数派成员
transitively	及物
vodkatini	=vodka
uniat	东仪天主教会的
blew	blow的过去式和过去分词
natatorial	游泳
film	拍成电影
restlessly	不安地
swordplay	针锋相对的争论
romaji	罗马字
nacrite	珍珠陶土
liveryman	出租马车的人
checktaker	收票员
raver	说胡话的人
rainless	无雨的
corba	Broker
hullo	呼喂
unfortunately	不幸
enantiosis	反语
paunch	瘤胃
buggy	臭虫成灾的
aurae	气味
automatous	机械的
sulphurweed	药用前胡
goanese	果阿
houseperson	管家的人
tussal	与咳嗽有关
babbling	胡说
tactual	凭感觉的
spaghetti	意大利式细面条
dopant	搀杂剂
neighbourhood	邻居关系
semicentenary	50年
wiriness	筋肉横生
proportional	相称的
swamy	=swami
dolphinarium	海豚馆
ductless	无管
qei	quod
staggeringly	蹒跚
gppm	Minutes
rightfully	正当地
monacal	=monastic
matrilateral	姑表关系的
test	测试
eec	Control
incog	隐姓埋名者
visitant	幽魂
sisyphean	永远做不完
entrenous	只限于咱俩之间
anamnestic	记忆
vapidly	无趣
subcellular	亚细胞的
dindle	震动
basilic	重要的
hornbill	犀鸟
paranormal	超过正常范围
abac	诺模图
inshrine	安放在神龛内
fishweir	鱼梁
rebbitzin	拉比之妻
criminative	控告
nephridial	肾
carbonous	碳
sanctified	认可的
saccharin	糖精
mischievous	有害
familarity	亲密的行为
lobulate	分成小裂片的
mollah	=mullah
erythritol	赤藻糖醇
biparasitic	双重寄生的
downstreet	去闹市区
wrong	不公正
by	在附近
anthroposcopy	相术
mean	中庸
evocative	唤出
caip	计算机辅助索引程序
sittable	可坐的
far	很晚
oberhausen	奥伯豪森
warmish	稍为温暖
lilacky	丁香紫的
upright	竖立
nurture	养育
concertgoer	常参加音乐会者
climber	攀缘植物
succursal	次要
ironsmith	锻工
arraign	传讯
tasteful	有鉴赏力的
photobotany	光植物学
unlatch	未栓上
sootlike	似煤烟的
drinamyl	德林纳米片
odds	不均
inefficiency	无能
thesaurus	辞典
comedic	喜剧
conarium	松果体
keramic	陶质的
diligent	勤勉的
volte	次
undo	取消
yahveh	耶和华
galla	盖拉族人的
antiscriptural	反对圣经的
platform	讲台
atmospherical	空气
infirm	不坚固的
tanalized	用防腐剂处理过
okayama	冈山
mandir	寺庙
pitted	去核
choreography	舞蹈术
kvetch	吹毛求疵的人
chaikovski	柴可夫斯基
tret	添量
theocentric	以上帝为中心的
cynegetics	打猎
discutient	消散
riviera	里维埃拉
jimp	缺乏的
merge	合并
gazel	=gazelle
suitably	合适
trickiness	欺骗
martellato	槌弓奏法的
demology	人口学
memoir	论文集
shock	禾束堆
phyllo	制成极薄层的生面
wry	扭曲
monophyletic	单元
evaluable	可估值的
incessancy	连续性
yielding	易受影响
hereditable	可遗传
cuttlefish	墨鱼
market	市场
swindler	骗子
versatile	多面手
intrada	引子
ploy	趣味
reprovision	补充粮食
cedrol	雪松醇
flageolet	音栓之一种
aerotherapeutics	空气疗法
touch	点缀
soldier	士兵
patripotestal	父权的
impossible	难以忍受的
aonb	Area
inflation	暴涨
grainfield	谷物用
visive	可看见
yodle	反复用真假嗓音互换唱歌
patriline	父系
gemmiferous	产宝石的
ankle	踝
random	任意
chautauqua	有关文化讲习集会
polypectomy	息肉切除术
rustily	锈蚀地
hyaluronidase	透明质酸酶
maoritanga	毛利人文化和风俗习惯
skidder	集材机
cisc	set
xanthine	黄嘌呤
bole	树身
molecule	分子
pilocarpin	匹鲁卡品
abranchial	无鳃
witt	威特
suasive	劝说的
manner	礼貌
sgml	for
magyar	匈牙利人
dll	Library
raft	筏
diopside	透辉石
laureate	佩戴桂冠
aeronomy	上层圈气流研究
maladministration	暴政
thersitical	破口大骂的
macroscopical	肉眼可见
blithesome	高兴的
joycean	乔伊斯
cloze	完形
photoionization	光化电离
pashalic	的领地
clouted	缀补
twirl	捻弄
spigot	龙头
tubificid	颤蚓
briny	盐水的
carlovingian	加洛林王朝的
spotty	发疹
hydraulic	水压的
scurry	急跑
goat	替罪羊
tachyphylaxis	快速抗药反应
unsound	不健全
endothermal	吸热的
endsville	首屈一指
adolf	阿道夫
continual	连续
acalycine	无花萼的
xenocurrency	国外货币
beethovenian	贝多芬的
fraktur	德文尖角体的活字
cutie	讨人喜欢的女人
dimply	有酒窝的
bidet	坐浴盆
pejoration	变坏
guy	Guy
tuck	折成摺子
pollock	鳕鱼类
aldolase	醛缩酶
volute	涡形
sublimate	纯净化的
persistent	持久稳固的
teller	检票员
hominy	玉米粥
standing	固定
devour	贪听
spur	疾驰
acquisitive	可学到的
bicornuate	新月状的
alpine	阿尔卑斯山的
cirsectomy	静脉曲张截除术
inspiratory	吸入的
reaction	反应
kiddywinky	=kiddywink
overextend	过分扩张
klepto	=kleptomaniac
overhung	从上悬垂的
dpi	inch
damned	十分
corpse	尸体
cornrow	梳成一排排辫子
nasute	鼻形兵蚁
aquiferous	含水的
wiredrawing	制造铁丝
sambhar	=sambar
fleshpots	豪华的餐厅
kinetosome	动体
ketogenic	能转化为酮
fluky	幸中的
extended	伸出的
bronchopulmonary	支气管肺
assuming	僭越的
rafferty	完全不讲章法
osb	of
grubstreet	文丐的
tenesmus	里急后重
separation	分离
strain	扭伤
hateable	可恨的
defendant	被告
afrikaans	南非的公用荷兰语
presidial	驻防军
plumulate	有漂亮羽毛的
swale	烧焦
incooperative	不愿意合作
unshapely	不好看
bdtr	Transfer
conjecture	猜想
glittery	闪烁
dicoumarin	双香豆素
paten	圣餐碟
cytopathy	细胞病
slough	蜕的皮
unapproachable	不可亲的
smart	厉害
berm	城墙与外濠间之狭道
lowlife	下层的人
lifeful	充满生气
japanese	日语
corporealize	使物质化
striction	约束
entreaty	恳求
yamalka	=yarmulke
else	其他的
cyanogenesis	生氰
fmc	Federal
jacquette	杰凯特
circularize	分发传单
nepali	尼泊尔语
scythe	用镰割
bricole	间接的一击
mixotrophic	兼养
tufty	丛生
addictive	上瘾
knap	丘顶
damascene	大马士革人的
anisotropism'	NULL)
aquarium	玻璃缸
dilate	使扩大
bolt	闪电
mythographer	神话讲述者
ferment	发酵
rounder	作圆之人
suggest	使想起
rustically	简朴
robustious	强壮
doxycycline	强力霉素
vector	无线电导引
montanic	山区的
blankness	单调
pertinency	有关性
trooper	骑兵
transgress	越界
meliorative	改良性的
psychosexuality	精神性欲
unannounced	未经宣布的
squire	护卫
marl	泥灰
submissively	服从地
subocular	眼下的
ebullient	热情洋溢
gec	Electric
discerption	断片
prohibitory	禁止
proteiform	形式多变的
psalmodic	赞美诗篇的
impermeable	不能渗透
percurrent	到顶的
misspoken	读错
leptosomatic	瘦弱型
hg	汞
parabolical	寓言似的
att	Telephone
underline	加下划线
machicoulis	枪眼
ruthful	悲哀
arthrodial	滑动关节的
funicle	细绳
satyromania	=satyriasis
haunted	鬼魂出没
bicuculline	荷包牡丹碱
algorism	十进制
assuredness	确实
salimeter	盐度计
survive	生还
psammite	粗粒碎屑岩
satanic	恶魔的
neutral	中立者
genuine	诚恳的
penally	用刑罚
clippie	女售票员
container	集装箱
metagon	后植核酸
dreamily	朦胧
ceraceous	蜡质的
unhang	取下悬挂物
nevermore	决不再
viminal	维米纳尔山
addictive	上瘾的
upas	见血封喉的毒汁
whisk	打蛋器
radiosymmetrical	辐射对称的
sociopath	反社会的人
palliative	减轻
undefined	不明确的
intertestamental	写于基督教新约与旧约之间的
notoriety	恶名
bajree	珍珠粟
neckguard	盔甲之护颈
kavass	卫士
calendarian	日历
ringmaster	表演指导者
helminthoid	肠虫状
brocade	织锦
rfc	For
sickly	令人作呕
reason	说服
dynatron	中间子
hymn	唱赞美歌
cheezit	当心
echelon	排成梯队
cordotomy	脊髓索切开术
neutrodyne	中和式高频调谐放大器
tientsin	天津
upward	向上
demagoguery	群众煽动
requiem	安灵曲
crt	阴极射线管
bouvet	lsland
probate	遗嘱检验
tierce	中号桶
everlasting	耐用的
outpensioner	院外领年金者
garbage	垃圾
nehemiah	尼希米记
cid	英雄
countercheck	阻挡
outrageous	无耻的
effective	有生力量
prosecutor	检举人
iciness	如冰
appropriable	可侵吞的
indistinguishable	无差眀ly//
unpolled	未登记的
routeway	通道
angulated	使有角
nih	National
assets	资产
emeerate	=emirate
impenitent	顽固的人
despotic	专制的
liquid	流体
retiral	退休
laloplegia	语器麻痹
limay	利迈河
bongo	非洲产大羚羊
whiteboard	白色书写板
hypothecation	担保契约
eld	高龄
unduplicated	无复制品
christly	如耶稣一样
actualite	当前话题
quarterfinal	四分之一决赛的
appropriator	私用者
peruvian	秘鲁的
drag	拖拉
sialid	泥蛉
mutably	无常地
obtained	获得
parallel	平行面
larn	记住
tropism	定向
yarmulke	圆顶小帽
maleficence	罪行
crappy	没价值
thin	稀疏的
pneumatic	汽力的
praties	马铃薯
lycopene	番茄红素
easygoing	懒散的
microphotograph	/
theoretics	理论
toboggan	乘橇滑下
quintette	五重奏
sycophant	拍马
bhojpuri	比哈尔方言
cry	喊
unaware	不知道
arsonist	纵火犯人
coyote	一种产于北美大草原的小狼
adultness	老成
discredit	不名誉
communicative	爱说话的
leaden	铅灰色的
prow	勇敢
ukaea	Energy
malaguena	Malaga
vagabond	浪荡的
sprue	口炎性腹泻
flicflac	碰腿
squashy	又湿又软
bellman	传达员
dhtml	HTML
pinpoint	查明
folliculitis	滤胞炎
forbidden	严禁
theosophical	通晓神智学的
weanling	断了奶的婴儿
torque	扭矩
simple	率直的
hmnzs	Zealand
paling	木栅
agravic	无重力区
tong	帮会
outfield	偏远的田园
sasquatch	北美野人
teratogenicity	致畸性
gushy	易动感情
rumbustiously	难驯地
licente	莱森梯
kinkcough	百日咳
fictitious	习惯上假定的
mozambique	莫桑比克
derealize	使不真实
gfwc	General
appropriator	专有者
unluckily	令人遗憾的
ulyanovsk	乌里扬诺夫斯克
fieriness	猛烈
altercate	口角
humorless	非常严肃
voluntary	自发
floccillation	摸索
ours	我们
certify	保证
laddic	拉蒂克多孔磁心
accessorius	副神经
dastardliness	卑鄙的行为
tactic	按顺序
quadrireme	每边有四对桨的一种古船
immolate	献祭
leak	使渗漏
lively	活跃的
furious	狂暴
beltway	环形公路
stoss	向冰川面的
godless	不信神
equational	均分
arid	贫瘠
pubic	阴部的
unhitch	放松
oilily	光滑
feeling	仁慈
cursive	草书体
trondhjem	=Trondheim
twinge	剧痛
terracotta	赤土陶器
extraordinaire	非凡
portwide	港口范围
rumour	传闻
sputter	急语
iliac	髂骨
paragraphia	错写
payroll	薪水册
meetinghouse	礼拜堂
imbosom	拥抱
excommunicable	应革出教会的
defecator	清净器
hallstatt	初期铁器时代
nitric	氮
frogfish	襞鱼科
inappositely	不适合地
frolicsome	爱闹着玩
frump	守旧者
dps	disintegrations
ixtle	=istle
birthroot	直立延龄草
andrew	安德鲁
hyaloid	透明
kyrie	=Kyrie
accomplice	帮凶
landgraviate	伯爵的地位
scup	变色窄牙鲷
antagonistical	反对
magnificence	华丽
chivalrous	有武士风度的
aloud	大声地
unsigned	无正负之分
lacune	缝隙
concerted	商议定
canonically	宗规上地
shmeer	=schmeer
yarwhelp	=godwit
sgml	Standard
notchwing	卷叶蛾
trona	天然碱
isogonal	=isogonic
hydrotherapy	水治疗法
phosphorylation	磷酸化
cornelian	光玉髓
rylean	赖尔方法的
agressire	攻击
nonnatural	违背自然
nuclei	nucleus
electric	电气
lymphocytotic	淋巴球增多的
effect	结果
gamely	不屈地
impracticability	无法实施
hypoploidy	亚倍性
flabellinerved	神经呈扇形排列
inexplorable	无法研究的
sycophant	拍马屁的人
metabolize	产生代谢变化
ascogonial	产囊体的
retroflexed	向后弯曲
takoradi	塔科腊迪
cyclothymia	躁忧性气质
casually	偶然
mixblood	混血儿
excommunicate	逐出教会
selene	月之女神
decet	=decimet
ethnobotanist	民族植物学
moulin	冰川锅穴
inherently	固有
rebel	叛乱者
chaffingly	嘲笑地
snakeless	无蛇
depth	深度
interrogative	表示疑问的
cynomolgus	食蟹猴
embryogenic	胚胎发生的
repeal	废止
chief	首要
lumbrical	蚓状肌
unrepulsive	不令人厌恶的
taws	皮鞭的一种
autotoxicosis	自体中毒
telestereoscope	立体望远镜
consilient	符合的
gentleman	有身分的人
adjunction	添加
tcp	Protocol
oaves	oaf的复数
lowermost	最底下
fisheater	天主教徒
hullabaloo	喧哗
creamer	撇取乳酪的人或器具
hakka	客家
empress	皇太后
plicate	有褶
popedom	权限
palmatifid	掌状半裂
acpi	and
alkalescent	碱性的
commuterland	月票市民集居的郊区
semiautomated	半自动
riot	放纵
notionate	倔强的
fining	澄清剂
tack	抢风航行
stuporous	昏迷
royal	皇家的
pubescent	思春期
chalklike	似粉笔
accidentalist	偶然论的
laysister	干杂活的俗人修女
discriminatorily	歧视
indefatigability	不疲劳
midnoon	中午
bevy	一群鸟
omniphibious	全能着陆的
msj	Journalism
gallop	急急忙忙地说
weight	重力
trifle	少量
nymph	居于山林水泽的仙女
cleanliness	洁癖
distrainer	扣押人
flatter	使高兴
ciliate	有睫毛的
horsebreaker	驯马师
wacky	乖僻
brelogue	系于表链上的小饰物
mezzanine	包厢
servia	的旧称
thirteen	十三
piliform	长毛状的
salute	敬礼
hematimeter	血球计
quibblingly	吹毛求疵地
compliment	恭维
reedy	脆弱的
leavisian	利维斯派
verbally	用言辞地
fill	填方
fco	Commonwealth
multianalysis	多元分析
coopery	制桶工厂
bighearted	宽大
bargeman	游艇船员
unlash	解开
winefat	=winepress
guy	家伙
criticise	批评
nonessential	非本质的
arioso	好听的
paly	苍白的
supercrescent	寄生的
centile	百分位数
untruthful	虚伪的
winnow	簸
probusing	赞成用校车接送的
sunnily	快活
redemptive	赎回
niobous	三价铌
ragbag	装破布的袋
english	英语
sadism	虐待狂
repulsion	排斥
gmt	Greenwich
brook	小溪
pontiff	罗马教皇
misty	有薄雾的
crossruff	同一方的人互相出王牌
inveiglement	诱骗
tenderness	柔和
clastic	可分解的
antipruritic	止痒的
spiffing	漂亮的
paragraph	段
fiction	小说
liquor	液体
pauldron	肩甲
amusedly	愉快地
fretted	焦躁的
pressure	压迫
calycoid	似杯状小体
aidance	协助
murderous	造成死亡的
rootedness	牢不可破
sidelight	间接说明
str	潜艇用热中子反应堆
exiguity	稀少
stead	好处
expiator	补偿者
truehearted	诚实
repellence	反击性
toughly	能吃苦耐劳
inscriptionless	无碑铭
tack	附加
mammet	=maumet
inchmeal	逐渐地
ramie	苎麻
unostentatious	朴素地
surrender	使投降
torc	金属饰环
fillagree	华而不实的事物
cayuga	卡尤加族的
nauseated	作呕的
level	水平的
benthamic	边沁学说的
supernormal	异于寻常
straitjacket	紧身衣
mystical	神秘的
concertante	适于发挥高度技巧的
creationism	特别创造说
orthoptist	两眼斜视校正医师
receivership	破产事物官职
drugstore	杂货店
indwelling	留置
flank	腰窝肉
admirably	美好
humanistic	人文主义
deregister	从登记簿上注销:
mauretanian	=Mauritanian
skycoach	普通客机
undignified	不庄重
sacrifice	献身
neckwear	围巾之类
peonage	当劳役偿债的制度
uplift	道德提高
ascap	作者与出版者协会
culpability	有过失
washiness	稀薄
circulative	促进循环
preface	序文
virilescence	男性化
graphitoidal	石墨状
islamite	伊斯兰教徒
successful	成功的
sacking	口袋布
recrementitious	无用
delivery	递送
intimist	喜欢描写个人情感的画家
busby	毛皮制高帽子
iciness	冰冷的性质
evensong	晚课
semischolastic	半学术的
ballotage	决选投票
matriarch	高雅的老妇人
whichever	任何一个
passivate	使钝化
paramaribo	帕拉马里博
chief	领袖
banter	善意地取笑
moor	停泊
thrust	插
minor	次要
hylology	材料学
scoff	贪吃
trail	形迹
methaemoglobin	高铁血红蛋白
isoparametric	等参
thumbprint	拇指的指纹
proleg	幼虫的腹脚
traipse	走过
egregious	过分的
acrimoniously	毒辣
closest	最靠近的
multicentre	涉及多个中心
arithmetize	使用算术
matraca	木制机械响鼓
bridgeward	看桥者
intranational	民族内的
haemodynamics	血液动力
achromate	色盲患者
aestivate	夏眠
verapamil	戊脉安
indistinction	无差别
semifitted	半紧身
bastaard	混血儿
onboard	随车携带
brute	残忍
penghu	澎湖
sagebrush	山艾树
iatric	药物
monofunctional	单功能的
inexact	不精确的
irkutsk	伊尔库次克
multicellular	多细胞
insinuating	暗示的
timidly	胆小
are	是
nouny	使用许多名词的
daybook	日记簿
unweakened	未减弱的
loamy	肥沃
pivot	支点
ordonnance	配置
cobaltammine	钴氨化合物
radiogenic	适于无线电广播的
midrib	中脉
syndesmophyte	韧带骨赘
peroxid	过氧化氢
immediate	直接的
lustful	好色的
junketing	宴请
cardhouse	势必倒塌的建筑
recurved	内弯的
acceleratory	加速的
giles	圣伊莱斯
loathly	不情愿
scantily	吝啬地
inebriate	灌醉
calorie	卡路里
cribwork	迭状木框
anticonvulsant	抗惊厥
very	恰好的
bacchus	酒神
slovene	斯洛文尼亚人
reproachable	应责备的
idolatrous	崇拜偶像
calices	calix的复数
rashly	轻率地
savour	风味
prepared	准备好的
rivalrousness	竞争性
acritical	无极期
abo	当
cathartic	泻药
geomorphic	似地球形状
unprophetic	非正确预见
engineer	技师
calling	邀请
momentary	刹那间的
refutatory	辩驳
anzac	澳洲
balneal	浴室的
quartziferous	含石英的
vilifier	诋毁者
herodian	希律一世的
junta	小集团
meteorologic	气象
leaflet	小叶
flagitious	凶恶的
glare	眩目的光
bobsledding	滑大雪橇运动
ingratiatory	逢迎
phototroph	光养生物
twaddle	胡说八道地讲
iocu	Organization
involucrate	有花被
gemmiferous	发芽
rockfall	落石
dogged	顽固的
manavelins	各式设备
californiate	以都市化和工业化毁坏的自然景色
enarthrosis	杵臼关节
safranin	盐基性红色染料
serioso	严肃的
hereinafter	在下文中
micelle	胶态离子
kirkman	苏格兰教会会员
contractibility	收缩
stealthy	鬼鬼祟祟的
outwardness	客观的存在
tittivate	打扮
deathplace	死亡地
eventuality	可能发生的事
negrohead	块状粗劣橡胶
septennial	七年一次的
pallium	大脑皮层
snubber	斥责者
fastidiously	一丝不苟地
cartelization	组成企业联盟
rarely	很少地
eyepiece	目镜
afterbody	后体
execratively	诅咒
toric	环面
postembryonal	胚后期
scrubby	多短硬毛
ruminatively	反复思考
exserviee	退役
filling	纬纱
sulfazin	=sulphazin
chagrin	气愤
subterhuman	亚于人类的
bailiff	监守者
leisured	有闲的
remit	赦免
without	不
cryotherapy	冷冻疗法
originate	发生
vibraphonist	电颤演奏家
benefit	有助于
spiteful	怀恨
empyreumatic	焦臭
distractingly	精神涣散地
nutsy	发狂
sedgy	莎草密茂的
pride	自豪
impish	顽皮的
dishonor	玷辱
rye	吉普赛绅士
exactitude	严格
carking	烦人
uniat	东仪天主教会的信徒
astigmatic	纠正散光
tumbril	双轮运货车
hippophobia	恐马
silklike	似丝的
labour	悉心完成
negotiability	流通性
rearer	用后脚站立之马
literal	文字的
gaberdine	华达呢
dubiosity	=dubiety
enrank	将……排成行列
incorporable	可包含
realgar	二硫化二砷
cochleate	状如蜗牛壳的
sallet	盔的一种
gfr	Federal
duumviri	的复数
youngling	年轻
piscatorial	渔业的
fencing	买卖
slot	狭通道
overestimate	估计的过高
clapstick	=clapperboard
psid	磅/平方英寸
politer	有礼貌的
ablare	吵闹地
supersedure	接替
affine	仿射的
jigaboo	黑人
flamdoodle	吹牛
uart	Receiver
submissively	服从
phantasmal	幻影
constellate	使心群集
throatily	喉音
more	更多的
ahead	在前面
susceptive	感受性强
lingonberry	越橘
hygrometric	吸湿性
stash	中断
espouse	赞成
scant	将近的
accusal	罪名
aspect	外表
ovular	胚珠
sagittate	镞型的
enthrallment	奴役
supernatural	神奇人物
khond	冈德语
ornithoid	鸟状
panmictic	随机交配的
misbeliever	信仰错误者
traditional	惯例的
antiparkinsonian	抗帕金森病
stencil	模版
holding	支持
sturgeon	鲟鱼
wally	令人喜爱的
turnabout	反击
share	部分
substantialism	实体论
pit	深坑
sf	强调
promorphology	原形学
thumbnail	拇指甲
toco	体罚
microchip	微芯片
lachrymation	流泪
fenian	芬尼亚会
exercitor	船主
disproval	反驳
rehash	旧调重弹的作品
cohorts	军团
onomasticon	专有名称词典
taxameter	自动计程器
lamely	一瘸一拐地
parentally	像双亲地
sinuous	错综复杂
repent	悔改
devastatingly	破坏性
glazed	光滑
eunomia	=eunomy
scaddle	凶猛的
cold	失去知觉
unsmirched	清洁的
yesterevening	在昨晚
dumpy	矮沙发
ageing	变老
watering	浇水
defy	不服从
capriform	如山羊的
hymenium	子囊层
aidman	救护兵
troutlet	小鲑鱼
mergui	丹老
compress	摘要叙述
jallopy	破旧飞机
participatory	供人分享的
atrociously	残酷地
abye	赎
baaskaap	白人统治
crossbreed	杂交
tackboard	布告板
superload	=live
reedy	芦苇做的
saith	单数
verrucose	疣的
push	攻击
untamable	不可驯养
accrete	使依附
contemporaneity	同一时期
permissively	自由地
coarctate	压在一起的
histogenetic	组织发生
exuberance	茂盛
stupefactive	致昏迷的
faggy	女性化的
blower	爱吹牛的人
dizzy	使人晕眩的
crooknecked	曲颈
commy	共产主义者
manana	明天
praiseful	赞扬
pokey	无趣的
annam	安南
derogation	减损
atmometric	蒸发计量学的
usurpatory	侵占
seigniorage	君主特权
tuck	食物
prolific	多产
refinement	精致
opposeless	难抵抗
hades	冥府
chickling	雏鸡
fearless	无畏的
unloveliness	不漂亮
doozy	非常出色的人的
mutinous	反抗的
carbine	轻型半自动或自动步枪
err	做错
levkas	莱夫卡斯岛
gamey	=gamy
viscerotonia	内脏强健型
snapshot	急射
catonian	严厉的
invalid	残废者
mut	人
demurely	认真地
visceralization	内脏感染
syphilitic	梅毒的
repose	静止
overvalue	对……定价过高
soppy	湿透的
tinge	色调
ordinance	法令
unsought	未寻求
incrassation	增厚
ccd	Device
sapric	含极腐烂生物
wafd	华夫脱党
physiographic	地文学的
patulous	扩展
saccharize	使糖化
homophonic	同音的
ertebolle	新石器时代文化的
exorable	可说服的
pachyderm	迟钝的人
ovipara	卵生动物
shamash	=shamas
inexpedience	不适当
dde	Data
lydian	吕底亚语
electrodeposit	电镀
bargainor	卖方
novelette	中篇小说
cynosural	引人注目的
echo	回波
ziram	福美锌
sunburnt	起晒斑的
pulpous	果肉状
calcarious	=calcareous
call	叫牌
avail	有利
phallical	阴茎的
adjustive	调整
neostyle	复写器
limn	描写
squally	起风暴
semilethal	半致死
hardcore	中坚分子
metaphorical	隐喻性的
chip	芯片
plasmolysis	胞浆分离
hebrides	赫布里底群岛(被小明奇海峡分为内赫布里底群岛
slosh	溅
upstairs	楼上
gritstone	砂岩
thy	pro
pleasurable	合意的
jerk	牛肉干
mhz	兆赫
gigglish	好咯咯笑
solubilize	增溶
atelectasis	肺膨胀不全
sportfishing	消遣性钓鱼
pattern	形成图案
mishap	灾祸
cingulum	带状之物
mend	修补
pestle	杵
taymyr	=Taimyr
mavrodaphne	马弗罗达夫尼酒
parade	检阅
biliverdin	胆绿素
breakwater	防浪堤
mbfr	Force
cineangiogram	血管荧光电影记录
chromomere	染色粒
graeae	格里伊三姐妹
longshoreman	码头装卸工人
madid	湿润
apostatic	背教的
antipodal	正相反的
colter	犁刀
tubificid	颤蚓科环节动物
scissorsbill	愚笨的人
waziristan	瓦齐里斯坦
homochronous	同期发生的
affection	影响
catalufa	彩色大眼鱼
backless	无后盾
stably	稳定
helianthus	向日葵属的植物
sebaceous	脂肪质的
palatal	上腭音
limited	缺乏创见
nympholept	狂热者
distinguishability	可识别性
serous	浆液
prefrontal	额叶前部
misinformation	误传
abreast	并肩
zebu	瘤牛
narrowly	精细地
obovate	倒卵形
epistemic	认识
exoneration	免除
hurtlingly	疾驰
wider	宽的
subtersurface	表面下的
bowels	内脏
schoolmarm	女教师
frosting	霜状白糖
tappit	有冠的
discussible	可议论
mercurian	水星人
mephistopheles	恶魔似的人
hyperphysical	与物质无关的
worthy	有价值
eliminate	除去
outcross	使异型杂交
corporately	共同地
understrength	力量不足
tail	尾部
smsa	Metropolitan
recessionary	衰退期
soterial	救世的
digitated	有指
service	服现役
insusceptibly	无感觉地
scission	分开
irresoluble	不能解决的
distribution	发行
hillside	山坡
uninventive	才能
sassy	厚脸皮
sleigh	用雪橇运输
tramontane	来自群山彼边
verse	诗篇
impoverish	使枯竭
plowhead	=ploughhead
add	补充说
agress	攻击
renunciate	抛弃
lovelorn	失恋的
aftershaft	后羽干
towards	对
sideling	斜
beautyberry	紫珠
sinless	清白的
acronically	ally
fruitlessly	徒劳地
cashew	腰果树
buy	买卖
peaky	多峰
sixfold	六倍的
teleological	目的论
hobart	霍巴特
burglarious	窃盗的
recommendable	可取的
jackladder	木踏板绳梯
abound	充满
edaphology	土壤生态学
nightside	夜面
quick	急剧
mouthful	满口
uraemic	尿毒症的
ivba	Volleyball
appointor	财产受益人
aseismatic	抗震
skillful	熟练
pseudo	冒充的
yva	长江流域管理机构
adducent	内收
zacharias	扎卡赖亚斯
prior	预先
chimeric	荒诞不经的
strengthen	巩固
sparganum	裂头蚴
america	美国
rowdydowdy	喧嚷的
cyclothymic	循环性精神病患
gag	压制言论自由
buddhahood	成为佛陀的状态
underfinanced	财力不足
halt	停止
flightless	不能飞的
run	追究
polyclonal	多细胞系
wit	智力
simonize	把……擦亮
flaring	引人注目
sunk	凹陷
grits	粗玉米粉
opisthion	颅后点
indiscernible	看不见
juke	用假动作诱使离位
epistle	使徒书
thunderhead	圆块积云
rcaf	Force
devise	遗赠
thankfulness	感谢
computerate	非计算机盲
crass	粗鲁
constable	治安官
cauterant	灼烧
sectile	可切
vow	立誓
anamorphism	岩石变性
telekinesis	心灵遥感
bir	Inland
nonproficient	不熟练地的
present	出席的
encoignure	墙角柜
oracle	主要生产数据库产品
golden	金黄色的
rammish	腥臊味的
flavorful	充满……味道的
cyclophosphamide	癌得星
calk	填充……以防漏
matrimonial	与婚姻有关的
fairly	还算
reinaugurate	为……重新举行就职仪式
glenoid	浅窝的
atopic	遗传性过敏症
diuresis	多尿
cavitate	空化
nonconforming	非一致性
rookery	海豹等之穴
lustre	=luster
discipular	信徒的
orgone	生命力
charry	似炭的
reassurance	放心
demetrius	德米特里厄斯
great	强烈
backformation	逆序造词
poor	卑鄙的
arytenoidal	杓状
undistinguished	普通
conakry	科纳克里
chauffeur	司机
queue	排队等待
adjuratory	恳求的
rhyming	押韵
cagy	小心的
weiner	=wiener
iconodulic	崇拜偶像的
kbe	Empire
fog	以雾笼罩
nychthemeral	随昼夜差异而变化
crankery	怪诞念头
knucklejoint	指节铰接
teiid	臼齿蜥
monoacidic	一酸
leptoprosopic	面孔狭窄的
elegancy	优雅
parachute	降落伞
troublous	动乱
affine	仿射
prizefighting	职业拳击
guitar	弹吉他
knightlike	正义
arrhizal	没有根的
satellization	卫星国化
freak	畸形的动物或植物
abase	降低
edo	Extended
indigested	杂乱的
ointment	药膏
esplanade	游憩场
cupping	杯吸法
phytoplankton	浮游植物
afield	离开
customary	惯例
adulterate	掺杂
rosinweed	松香草
kraal	关着栏栅的部落
maker	制造者
sidetrack	使受牵制
dislikable	可憎
monist	一元论者
portacaval	门腔静脉的
atmospherical	空气的
choleraic	霍乱性
backstop	挡网
azury	青色的
straight	直
conglomeration	混合物
earnest	真挚
embassy	大使馆
vasostimulant	促血管舒缩剂
procne	普洛克涅
parturition	分娩
vinify	用……酿酒
orins	Institute
sanguine	血红色
adamite	人
aspirant	有野心者
accoucheur	产科男医师
might	力量
unconfessed	未供认
semiconsciousness	半意识
topology	拓扑学
boa	蟒蛇
furring	皮毛衬里
upriver	上游
cashmere	羊绒
deposition	革职
boathook	钩竿
ltjg	Lieutenant
calced	穿鞋
razee	拆除上层甲板的船
assuredness	确信
residually	剩下
hyperconscious	过于敏感
dustup	骚动
iupap	and
garnishry	装饰
agonisingly	烦恼地
neontology	近代生物学
audacious	卤莽的
hawaiian	夏威夷人
oary	桨状
primordial	原始的
gemeled	成对的
wort	麦芽汁
fecal	渣滓的
cense	燃香
hoarstone	灰色的古石
upswept	向上斜
ceramide	神经酰胺
diabolology	魔鬼学
scrofulosis	瘰疬质
flatways	平面朝前地
struggling	苦斗的
unveracious	不讲真话的
ashur	Assyria
colidar	相干光雷达
lay	外行
quotidian	每日的
ladrone	强盗
ampoule	一次用量的针剂
condemnation	谴责
hyperkinesis	=hyperkinesia
tress	把梳理成绺
tetrasepalous	四萼片
whitecap	浪端的白泡沫
unaptly	迟钝地
antirheumatic	防风湿病的
erotogenic	引起性欲的
anamorphosis	失真的形象
equal	对手
tcb	taking
basketfish	筐蛇尾
revisory	修订
tabasheer	竹黄
vertiginous	不稳定
pe	Product
wander	徘徊
signorina	未婚女子
outlast	比……长久
gasometric	气体定量分析学的
nim	夺取
brokenhearted	心碎的
concise	简练
mamelon	圆丘
malodorous	有恶臭
unleash	释放
aborigines	群
swank	打扮漂亮的
phthisical	肺结核
boeotian	迟钝
carabin	卡宾枪
disprize	轻蔑
nauseant	引起呕吐的
unilocular	单室的
commissariat	粮食补给
inorganized	无组织
loot	掠夺物
kincardine	金卡丁郡
painstaking	苦干
synclinal	向斜的
upgrade	往上
pilous	多毛
sevenfold	七倍的
polyopia	视物显多症
general	一般
sanguine	指望的
moralistic	教训
quag	泥沼
hindenburg	兴登堡(波兰南部城市扎布热
overfeed	给吃得过多
winebag	葡萄酒袋
faecal	渣滓的
qea	Empire
listen	听
flicker	闪光
fridge	电冰箱
contagion	腐化
oracular	谜似
saliferous	含盐
annullable	取消的
teentsy	小小
resect	切除
cyclone	龙卷风
dubitative	怀疑
ikaria	伊卡里亚岛
simbirsk	辛比尔斯克(苏联伏尔加河中游城市乌里扬诺夫斯克
tyrosine	酪氨酸
purpuric	紫癜
quoin	突角
unstiffen	使变得灵活
veratric	藜芦酸
prior	在
noteworthy	值得注目的
allred	全在大英帝国版图内的
munch	用力咀嚼
anthocyanin	花色醣苔
chlorosis	变色病
cms	system
radiate	广播
krooboy	克鲁人
mitered	斜接的
admonish	劝告
computerlike	计算机似
reinspect	重新视察
nature	自然状态
fallacious	虚伪的
direction	趋势
echinated	有棘皮的
fix	选定
proestrum	=proestrus
argentous	亚银的
transmountain	越过山的
fddi	光纤分布式数据接口
magniloquence	夸夸其谈
steerage	掌舵
unfriendly	不友善地
pine	松树
francophonic	讲法语的
gory	满是血
inulase	菊粉酶
receivership	破产管理
marasmus	衰弱
paddler	涉水者
saltant	跳跃的
corruptible	可以贿赂的
inosculation	连接
airways	航空公司
defensive	自卫
theatricalize	使成为剧性
dunghill	污秽物
boulangerie	=bakery
assertion	断言
candidly	坦白
enormously	非常地
anesthetic	麻药
reflectingly	反射
headteacher	中小学的校长
explosible	容易爆炸
leathercraft	皮革手工技巧
treasure	财富
briny	盐水
ionomer	离聚物
discretely	离散
treachery	背叛
ingravescent	病越来越重的
impracticably	无法可想
unpolled	未登记
impracticality	不切实际
viennese	维也纳人
presbytery	内殿
barge	游艇
spirituosity	含酒精
cowk	作呕
rotterdam	鹿特丹
clear	清澈
camphoric	搀有樟脑的
matripotestal	母权
jacana	水雉
poise	保持……姿势
tumbleweed	风滚草
impasto	厚涂的颜料
unijunction	单结
water	水生
versemonger	打油诗人
polyphonic	有许多声音
malaysia	马来群岛
antipasto	开胃食物
metonymical	转喻
notarial	公证人
remake	重制
pyogenesis	生脓
anoscope	肛门窥器
gossipist	columnist
improbity	不正直
bum	无价值
recurved	内弯
scheme	方案
ha	哈!
romanization	古罗马化
borak	开玩笑
landlordism	地主所有制
conchiferous	有贝壳
zhdanovism	日丹诺夫主义
agrologist	土壤学家
sylvite	钾盐
fontal	洗礼
traveling	旅行的
dimply	有酒窝
green	新鲜的
kindergarten	启蒙阶段的
proprioceptor	本体感受器
idc	Data
tremendous	极大的
roundly	完全地
enamour	迷住
linty	有棉毛的
sallowish	带灰黄色的
runner	奔跑者
embedded	深入
saturated	饱和的
unclassical	对古典作品不感兴趣的
ratproofed	作了防鼠处理的
glave	阔剑
communalistic	地方自治主义的
competently	适合地
predestinarian	命运注定论的信徒
glost	上釉的瓷器
promissory	允诺的
preference	优先选择
generic	一般
tampax	丹碧斯月经棉塞
texturology	粗质地法
dipteral	有双廊
botchy	难看的
intersected	分割的
calinago	阿拉瓦克语
forge	伪造
supersalesman	超级推销员
podgy	短粗的
queenhood	女王地位
paper	纸的
gloomy	令人沮丧
camion	载重汽车
pepperidge	=black
peremptory	强制的
silkgrower	养蚕人
gingerly	谨慎
measurable	可测量的
ensiform	剑形
multicoloured	多色彩的
elocutionary	雄辩术
funfest	同乐会
fiddler	胡乱拨弄者
byrnie	铠甲
underrepresentation	`QndE9reprI`zIzen`teIFEn/
plaintive	悲哀
sticktight	鬼针草
plebe	军官学校的最下级生
extramarginal	意识以外的
dioxin	二氧芑
frusemide	=furosemide
paintbrush	漆刷
counterplot	将计就计
bushwa	废话
dishing	凹陷的
losing	失败
soggy	浸水的
otalgic	耳痛
nannie	乳母
capitular	牧师会会员
german	德国
gooky	滑腻的
pleven	普列文
undercut	削球
cespitose	丛生的
retrolental	眼晶状体后面
daddle	鬼混
instrumentally	仪器
inebriation	陶醉
intermediary	调解者
rutter	开辙犁
uso	United
freeborn	自由民
sleigh	乘雪橇
gouge	以圆凿刨
insipidly	清淡
cyrenaicism	昔兰尼主义
exacerbation	恶化
malolactic	苹果乳酸
appetence	倾向
ghee	酥油
slavish	奴性
green	精力旺盛
nocent	伤害
excogitative	想出的
king	立……为王
rape	油菜
ductule	小导管
dupable	易于受骗的
countercry	对抗的叫喊声
woman	为……配备妇女
flews	下垂的上嘴唇
deambulatory	走动的
limicolous	生活在烂泥巴中
chinoiserie	具中国艺术风格的物品
tympanal	=tympanic
disadvantaged	处于不利地位的
nigeria	尼日利亚
cmy	减色系统
ragefully	狂怒地
surrender	投降
promises	允诺
aclu	美国公民自由协会
palatably	称心愉快
cherubic	天真无邪
strut	压杆
emperorship	皇帝的身份
pitch	树脂
prosify	使散文化
speir	=speer
admission	允许进入
traditional	传统的
sloppy	多阴雨
revaccinate	再种痘
stem	茎
apparition	幽灵
flysheet	广告传单
blandly	温和
width	宽度
amatory	恋爱
cytoecology	细胞生态学
fervent	炽热
arcadianism	朴素之田园风趣
parolee	凭誓获释者
monarchial	国王
meagrely	贫弱
multifarious	种种的
anaclinal	与四周地层反方向下降
manducate	咀嚼
ruthful	引起怜悯
housebound	居家不外出的
erectly	垂直
nutant	下垂
peasen	的复数
unabated	不减弱的
quiescing	停顿
rhizotomist	采药人
squinny	使斜看
loggia	凉廊
unfurl	公开
greenfeed	青绿饲料
flimsy	易坏的
triones	北斗七星
identic	形式相同
pandemonium	喧哗吵闹
belaud	高度赞扬
conrad	康拉德
quag	沼地
profaneness	渎神
grateful	感谢的
antalkaline	解碱的
chinoperl	Performing
demoid	某地质层组特有
hairlike	细微
kindling	放光
computer	计算机
locutory	修道院的谈话室
highbinding	欺诈
bigness	重大
metathesis	转位
algerine	阿尔及利亚
quantifiable	可以计量
psid	inch
thallous	第一铊盐的
charkha	纱车
orphanhood	孤儿状态
guttulate	有滴状斑点的
widf	Federation
exceeding	过度
comus	司酒宴之神
refusal	优先取舍的机会
shaduf	=shadoof
ifac	国际农业生产联盟
shilling	先令
spy	特工人员
altazimuth	地平经纬仪
tolerate	忍受
puffery	吹捧
resinous	树脂质的
conodont	牙形刺
wont	习惯
trepidation	颤抖
toothsome	好看的
granicus	格拉尼卡斯
serosity	如水液体
ambassadorial	使节
gwtw	Wind
hitlerian	希特勒式
patron	资助人
heartiness	诚实
landler	兰德勒舞曲
stivy	气闷的
impregnate	灌输
lacunose	多孔
unimpressive	不令人信服
anemic	患贫血症的
wctu	Temperance
vamoose	跑掉
achievable	可完成
centennially	每百年一次地
pericardiac	围心
proprietary	私人拥有
grotesquery	古怪
malingerer	装病的人
declivous	下坡的
golden	贵重的
quarterly	每季
kreosote	木馏油
adverbially	当副词
intacta	保持童贞的
fifer	吹横笛的人
debase	降低
hairpin	夹发针
autochthon	土著人
bacony	脂肪质
transkei	特兰斯凯
outrace	=outpace
cave	窑洞
gambir	棕儿茶
neurotrophic	亲神经
bituminous	含沥青
infundibular	有漏斗状器官
carpology	果实分类学
grandpapa	爷爷
hotchpotch	杂烩
fishwoman	卖鱼妇
luetically	疫病地
strangeness	陌生
custodian	管理人
militia	民兵
variceal	脉管曲张
voluminous	体积大
service	仆人
nitrosylsulphuric	亚硝基硫酸的
depth	深
tenzon	=tenson
stump	残余
larruping	特别
valuer	森林地估测者
constrained	拘泥
disarm	缓和
quadrangle	方院
wallaby	小袋鼠
whole	整个
faulted	有毛病
caledonian	苏格兰
aerodontalgia	牙痛
squelch	压制
alleyoop	杭育
sixpence	六便士
unvitiated	未腐败
dipteran	双翅昆虫
effort	努力
pedagogic	教育学的
torpefy	使麻木
cyanurate	氰尿酸盐
fidget	使烦乱
eclipse	衰落
cessative	表示停止
fastidious	难取悦
zhujiang	珠江
andvar	矮神安德瓦里
pitted	去核的
cachalot	抹香鲸
infix	插入词
enamour	使迷恋
sinew	加强
unregistered	未登记的
hamulus	钩状突起
ccd	电荷耦合装置
vaginated	有鞘
rollered	具有滑轮的
collocable	可搭配
codices	法律
tang	有浓味
libate	向……祭酒
squabbish	有点胖
unconsciousness	意识不清
cherubim	智天使
trowel	泥铲
bemire	使弄得混身泥巴
holyday	圣日
isp	互联网服务提供商
photodiode	光电二极管
appetent	热望
geobotany	植物地理学
edaphic	土壤
underhand	手不过肩
stepped	踏
exenteration	取出肚肠
praiseful	赞扬的
apogamic	无配子生殖的
directorial	管理的
nobbily	时髦地
eulogia	颂扬
holohedral	全面
antifungal	抗真菌
isomorphic	同构
harsh	粗糙的
balanoid	橡实形
corruptibility	易腐的倾向
mhr	Member
historiette	史话
parathyroidectomize	给……切除甲鬃状旁腺切除术
finical	过分注意的
spoony	多愁善感的
acerous	无触须
pockmarked	有痘疮的
apomict	无配偶生殖植物
most	很
welt	袜口
disgust	令人反感
hammersmith	锻匠
whizz	精明的人
scramble	搅乱
hdl	lipoprotein高密度脂蛋白
filiferous	有丝状物的
overtrade	贸易过度
ashake	摇动的
i2o	Intelligent
quorum	选出的团体
ixionian	伊克西翁的
yh	青年寄宿所
hieratical	=hieratic
brahma	梵天
packtrain	驮运货物的动物行列
enable	使能够
federate	公布联邦制
inexactly	不精密地
nok	最近亲者
interne	实习医师
proneness	倾向
coryphaeus	合唱团主唱
typhlitis	盲肠炎
scoff	笑柄
requite	酬谢
choreopoem	配舞诗剧
herbage	草本
mafioso	秘密政党成员
uglily	难看
lightly	轻轻地
jaculate	向前掷
girondist	党的
tungstic	钨的
compound	复合的
select	精选的
incredibly	不能相信地
skiscooter	=skidoo
cmh	Honor
shaggymane	一种可食用的蘑菇
wanderer	徘徊者
psychochemistry	精神病药物治疗
lithonephrotomy	肾石切除术
tenor	路程
purpure	紫色
knockabout	流浪汉
subclavian	锁骨下的
uruguay	乌拉圭
unendowed	没有天赋
spacious	大规模
byplay	枝节事故
psylla	木虱
uncomfortably	不舒适地
scheldt	斯凯尔特河
awane	衰落中的
sialagogue	催涎的
permittivity	介电常数
usphs	United
relieve	换班
immanuel	以马利
obsequious	奉承
ambassadorial	使节的
animated	活生生的
kuwait	科威特
bierhaus	小客栈
moreton	Bay
roseanna	罗莎娜
explosive	爆炸物
workgirl	女工
wand	棍
aphthongal	不读音字母的
crimp	卷发
scoria	铁渣
putamen	核
dismiss	下课
discomfort	不便之处
white	白种人
inextricably	解决不了地
dm	数学博士
overnight	昨晚一晚上
barbell	一种运动器械
overproud	太骄傲的
barren	贫瘠的
stearic	十八酸的
rory	罗里
dualistic	二元
barnstorm	在乡区作演说旅行
hoveller	无执照难船救助员
rubbish	垃圾
fidgety	烦燥
msph	of
entellus	癯猿
psephite	碎砾岩
platiniferous	含铂的
holohedral	全对称晶形的
polyglot	通晓数种语言的人
unlike	不相似的
interior	内
explanans	解释要素
cantonal	州
bereave	剥夺
governessy	一本正经的
knitting	编织品
mixotrophic	兼养的
semibold	半黑体
southwesternmost	极西南
touse	使蓬乱
exhaust	用尽
finned	有鳍
organism	生物体
verbatim	逐字
noisy	吵杂
vermicular	蠕动
hydrochloric	氯化氢的
slack	缓慢
bogeyman	精灵
successive	连续
outright	完全的
nucleoplasm	核原形质
aew	warning
flutist	笛手
frowsy	不整洁
nlaa	National
suprarenal	肾上腺
rateable	可评价
msfm	Science
martial	尚武的
allmains	万能供电的
fete	祭祀
moondoggle	月球探测
follicle	小囊
upswell	上涨
reformative	改善
rumour	谣传
gracile	纤弱的
aginner	反对变革的人
inviable	不可能生存
introspection	反省
italian	意大利文化
assonant	类韵
pagandom	异教徒的世界
account	帐目
luminesce	变明亮
suprathreshold	阈上
roupy	患黏膜炎的
paragraphist	=paragrapher
corrosively	腐蚀地
prepubertal	青春期前的
bps	bits
tyke	乡下佬
vibrotactile	震动触觉
antislavery	反对奴隶制度的
bolix	把事情弄糟
niggle	为琐事费心
theater	戏剧
nouny	使用许多名词
hydrothermal	热水的
structuralism	结构主义
blueish	带青色的
impetus	推动力
splinterless	不会裂成碎片的
inexpiable	不能抵偿
hep	熟知的
instillation	滴
sceptre	拥登王位
psychics	心理学
traditionalism	传统主义
entreaty	乞求
blitz	以闪电战攻击
struggling	努力
scaddle	易惊的
poppethead	滑轮轴
dioptric	视力矫正用
roman	罗马字体
ingenious	有独创性的
subcool	使过冷
verve	热情
fruity	洪亮的
chink	裂口
arcuate	弓形
pentahydrate	五水合物
jamaica	牙买加
antifeudal	反封建
vomitive	使呕吐的
impicture	描绘
legally	法律上
trusting	信任的
alternate	预备的
highteen	十八九岁
goggle	使瞪眼
bvm	Virgin
bulkhead	隔壁
hazel	榛树的
time	计时
extramural	校际比赛
extirpation	毁灭
jism	精液
extremity	临死
unswerving	始终不渝的
socializee	适应社会生活者
esophageal	食管
apathetic	无动于衷
cab	出租汽车
vocabulary	词汇
photopia	光适应
quartermaster	军需官
deathlike	象死人的
brickfielder	又干燥又热的北风
anastomosis	相接
dismay	使沮丧
paroxysmic	=paroxysmal
endearing	可爱的
overbid	出价高与
curatrix	女管理人或女监护人之团体
housebroken	经训练的
areometry	液体比重测定法
desalinize	淡化海水
mshe	家政学硕士
proglottid	节片
poort	要隘
drudgingly	辛劳
sheugh	沟
sarcenet	里子
lysogenesis	溶菌作用的产生
troche	药片
tritiation	氚化作用
preemptive	有先买权
ragged	粗糙
kinesthesis	=kinaesthesia
vlbi	long
mmm	Media
antheral	花药的
euhemeristically	神话即历史论地
tokology	产科学
syringa	紫丁香属的植物
dropsical	水肿
sheshbesh	中东15
chain	链
cess	税率
granitic	花岗石
chinchilla	南美栗鼠
elfin	小孩
landskip	陆上景色
epistasis	异位显性
miniature	微型的
torment	折磨
rummage	翻箱倒柜的寻找
lactary	奶
riparian	水滨的
underhand	手不过肩地
fusionist	联合论
heurism	启发式教育法
poetics	诗论
metapsychical	心灵学的
vertigo	眩晕
prorogation	休会
giddiness	眼花
unstuck	松开的
injure	损害
mask	掩饰
esl	a
consequentiality	理论上的一贯性
impedimentary	妨碍
noway	决不……
microtone	微音程
eusocial	完全群居
without	如果没有
baht	泰国货币单位
classical	古典
infant	婴儿
hedonism	快乐主义
pillaret	小支柱
spindly	细长
osteal	骨骼
phrasemonger	空谈的人
flurry	使恐慌
sanctification	使神圣
intermission	间断
millions	数百万
martemper	使等温淬火
inferior	劣等
austerity	严峻
unsocial	不合群的
wordily	罗嗦地
braggart	吹牛的
anthroposcopy	相面术
yewen	用紫杉木做的
withdrawal	退股
assheadedness	傻瓜
debrief	听取汇报
belted	束带
eggheaded	书呆子
meditative	沉思的
apoprotein	脱辅基蛋白
enure	使强固
unbearably	忍不住地
concoctive	策划的
ananym	倒名
deoxidizer	去氧剂
pocketful	一袋之量
functionalize	根据工作人员特定职能分派
padding	填料
vaporizer	蒸馏器
reverberatory	反响
nature	本性
inequable	不均匀
granulometric	颗粒测定
stirring	活跃的
yegg	抢劫金库者
dermatoid	皮样的
noninitially	不是起首字母地
boding	预感
stopcock	活塞
viceroyship	总督之任期
walloping	十足地
undenominational	非宗派约束的
fussily	大惊小怪地
discriminator	鉴别器
enantiomorphism	对映形态
removal	切除
ampullae	圣水瓶
landslip	山崩
silenus	西勒诺斯
musky	麝香
i2o	Input/Output
sop	浸
monumental	非常的
somewhy	由于某种原因
outward	外表
candu	加拿大重水铀反应堆
metatarsal	跖骨的
protrudent	伸出的
compromise	危及……的安全
luxe	豪美
libyan	利比亚人的
panhandle	狭长的土
shoplifter	商店扒手
ingenious	精制
roller	辊子
transplant	移种
bilateral	有两面
overstrain	过劳
copal	柯巴脂
nailbrush	指甲刷
official	公务员
dichogamy	雌雄蕊异熟
humph	发哼声
fungi	由真菌引起的
qualified	有资格
amniote	羊膜动物
patchouli	天竺薄荷
swinge	打鞭挞
homozygote	均质接合体
farmisht	混乱的
goa	西藏高原产的一种羚羊
syllogistically	演绎式地
exhilaration	令人高兴
cero	巨鲐
barroque	巴洛克式
recalesce	再炽热
sneakingly	偷偷地
cattleya	洋兰
maritime	海运的
spectrally	可怕
columbian	美洲
medley	混合的
powder	尘土
catonian	顽强的
procaryote	原核生物
klagenfurt	克拉根福
piratic	剽窃
sadistic	虐待狂
sixpence	六便士银币
errhine	催嚏药
voter	投票者
fluorometer	荧光计
gleichschaltung	划一化
antelope	羚羊
semisomnus	轻昏迷
felicitously	恰当
nonenzyme	不涉及酶作用
tamburlaine	泰姆勃兰
steatitic	块滑石的
furphy	谣传
cheliferous	带螯
viscose	纤维胶
antecessor	前辈
cangue	枷
equate	等同
monbazillac	蒙巴齐亚克白葡萄酒
febrifuge	退热的
underivative	非模仿他人
convulsion	震动
cameralistic	财政或经济
apheliotropism	背日性
outgroup	外集团
claudicant	跛的
weeklong	为时一周
advantage	有利条件
arminianism	荷兰神学家阿米纽派教义
apocrine	顶泌的
imperishable	不朽的
pythogenous	腐生的
balmy	芳香的
haussmannize	以奥斯曼式改建
penological	监狱管理学的
pathogenic	发病的
contracted	契约
akvabit	北欧所产的一种酒
dehair	除去……之毛
wellborn	出身名门的
folkloric	民间传说的
sad	悲哀
blende	闪锌矿
mortal	致命
determinately	确定地
hexane	乙烷
hepatobiliary	肝胆管
stp	protocol
borghese	鲍格才家族
jestingly	滑稽地
fatback	背部肥肉
nameless	不可名状
colourize	着彩色于
whole	纯粹
dendrophilous	爱树的
appetizer	开胃食品
paros	帕罗斯岛
shopgirl	女店员
chevalier	骑士
fulminatory	怒号的
radioman	无线电广播从业人员
wasteful	不经济
sphagna	水苔
congratulatory	庆祝的
trinomial	三项式的
rhq	Headquarters
corneous	似角
snakeskin	蛇皮
achech	有鸟翼的狮身怪物
lookum	棚子
doublet	紧身上衣
voluble	爱说话的
crimp	兵贩子
agenize	用埃净
bondwoman	女奴隶
visit	闲谈
wrcb	战时救济管理局
expectative	期待中的
processionist	行列中人
unfinished	未琢磨的
localize	停留在一地方
hateless	不憎恶的
pullout	撤退
eggshell	易碎的东西
chaliced	杯中
thammuz	=Tammuz
unbag	把……从袋里倒出来
exequatur	领事证书
moult	脱毛
stucco	粉刷
autolithograph	`R:tEJ9lIWEJ`y/9R:tEJlI`WC^rE:f/
masked	戴面具
donable	可赠与
gaulish	高卢的
rob	剥夺
fim	鳍
germanophobia	厌恶德国
floating	漂浮
understratum	底层
expulse	逐出
srs	Regiae
longinquity	久远
pia	Airlines巴基斯坦国际航空公司
rearward	后部
sepsis	脓毒病
piccata	嫩煎小牛肉片
swish	使带着嗖嗖声地挥动
buffoonery	滑稽
unlikely	靠不住的
opponent	反对者
thoroughly	彻底
utricular	有小囊
underripe	部分成熟的
debris	残骸
draught	一网
nut	难解的问题
synonymist	同义词研究者
soudanese	=Sudanese
dislocation	断层
wels	=sheatfish
sonicguide	guide
lanugo	柔毛
avaricious	贪财的
limpingly	跛行
curr	咕咕叫
pierce	突破
egality	均等
uncomely	不标致的
reservation	预约
exempla	exemplum的复数
spinsterish	似老处女
hump	驼峰
trient	=Trento
profundity	深刻
bup	British
countertype	相等型
fellowless	无可匹敌的
ecstasy	入迷
jockey	职业赛马骑师
allo	同分异构的
injuria	违法行为
inductor	授职的人
jughead	笨蛋
kennelman	养狗场主人
quassia	苦木树
inequality	不同
mediocre	普普通通
imagic	形象般
zedzap	是ZMODEM的扩充
polarimeter	偏光计
monospermy	单精入卵
chaffer	讲价
fluster	慌乱
terracotta	赤土色
soed	Dictionary
predecessor	前辈
invigorate	鼓舞
oblong	长方形的
distractible	不专心的
regrow	再生
agonic	无偏差
aplasia	先天萎缩
sodom	罪恶之
eniac	计算机
academy	学会
say	说
ctol	landing
shoddy	以次充好
labialisation	=labialization
shereef	阿拉伯国家的王子
unconcerned	不相关
proofplane	验电板
towering	高耸的
syntagm	结构段
diaconate	执事
obligate	有责任的
achaetous	无刚毛
cephalometric	头部测量法的
slinkingly	偷偷地
wagnerism	瓦格纳音乐和理论的影响
criminological	犯罪学
surfboat	骑浪艇
dippy	昏头昏脑
diffractive	衍射
firecracker	爆竹
ramous	分枝
clonesome	无独创性的
hohum	厌烦
flintily	冷酷地
jeopardise	使受危险
outrow	划船胜过
uneventful	平静无事
noggin	少量饮料
clearway	超速道路
emiocytosis	细胞分泌
heracles	=Hercules
fold	交迭
homegrown	国产的
sperm	精子
imitability	可模仿性
crabbily	暴躁
souvlaki	kebab
gink	怪人
whiplike	像鞭子的
shut	闭上
weenie	微小
sweeping	扫除
whitebeard	白胡子老人
mastopathy	乳房病
radioconductor	电波侦测器
turkophobe	恐土耳其者
eib	European
macilent	瘦的
undomesticated	不爱做家务的
diocesan	主教管区的
photoactive	活的
starveling	饿瘦了的
nls	自然语言支持
localitis	局部利益症
hearty	强烈的
dollar	元
minification	缩小倍数
finitist	有限论的
kama	卡马河
diorthosis	整复术
substantive	独立存在的
raptatorial	肉食性
hip	喝彩声
paramagnet	顺磁体
recreancy	怯懦
insurgence	造反
calorigenic	产生热量的
anelastic	滞弹
governessy	家庭女教师似
overtime	使超时
stannous	锡的
stoppage	填塞
herculean	巨大的
viomycin	紫霉素
procephalic	原头
nesslerize	以奈氏试剂测量氨
undersurface	水面下
immelmann	turn殷麦曼
dittany	薄荷花的一种
vegetal	动植物共通的
inegalitarian	赞成不平等
wba	World
aauw	Association
lampblack	灯黑
unwashed	无知的
unmerited	不配的
soil	国土
befittingly	适宜地
tempestuous	暴乱的
emplacement	炮兵掩体
ambilingnal	精通两国语言
whatso	任何
preliberation	解放前的
grume	黏液
euryhygric	广湿性的
dugout	防空壕
standing	身分
psychodynamic	心理动力的
squirrely	疯狂的
feigned	捏造的
extremity	绝境
reckon	数
prelatical	高位者的
loader	装货的人
fetch	取
unsugared	不放糖的
vigor	精力
broomcorn	高粱
defiance	挑战
jowled	有垂肉
pandal	临时棚舍
hardtop	有金属顶盖的汽车
farce	滑稽剧
yet	但是
pothecary	药房
gainfully	有利益
doubtful	可疑
godwinian	戈德温派
aloof	远离
amusingly	有趣
unoiled	未涂油
septal	氏族
feedback	反馈
tricentenary	三百周年纪念
forwards	继续向前
lcm	Multiple
hinder	后面的
hasidism	哈西德主义
gunsight	瞄准器
bpc	British
drumlin	冰河堆积成的椭圆形冰丘
lrl	月球物质回收和回归宇航员检疫实验所
withal	而且
rapaciously	强取
posted	消息灵通的
mutafacient	诱变的
cowk	恶心
breakaway	分离
pundit	博学者
vinaceous	葡萄酒的
conglutinant	粘合的
ironwork	铁制品
mislay	放错
apartness	孤独
hmv	Voice"主人之声"牌唱片
slaughterous	好杀戮
eudiometrical	量气管
overlive	继续活下去
musky	有麝香味的
sanguine	满怀希望的
weighlock	衡闸
incredible	难以置信
ostler	马夫
xianggang	香港
lockless	无船闸
pigsticker	长刃折刀
canossa	卡诺萨
differentiable	可微
windfall	横财
disconcertedly	惊慌
dauphiness	王妃
ancient	远古的
space	间隔
remiges	飞羽
biro	圆珠笔的一种
terminal	终点站
obligate	有责任
nasally	鼻
authorization	授权
avalon	阿瓦隆
mandarine	=mandarin
reproduction	再现
interbang	问叹号
gram	克
juristical	法理学的
bivvy	小帐篷
lapsed	流失
exist	生活
mignonne	小巧玲珑的
anamorphic	变形的
airship	飞艇
flush	一手同花的五张牌
hemocyte	血细胞
flirtatious	轻浮
coenosarc	共体
beat	巡逻区域
helminthiasis	蠕虫病
tough	坚韧
great	崇高
hemispheroidal	半球体的
gutter	流
tyrannic	压制
soporose	催眠
intraperitoneal	引流过腹膜的
unmodish	=unfashionable
tessitura	声域
awol	leave
spue	呕吐
rink	溜冰场
crisply	易碎
removed	远离……的
fortunate	幸运的
heathenize	使成异教徒
kcb	高级巴思勋爵士
chirk	兴致好的
structureless	无结构
andorran	安道尔
dacron	涤纶织物
embryonated	含胚
eugenic	优生的
wainrope	大车绳索
municipalise	=municipalize
investitive	授予的
surveillant	监视者
unset	未安装的
ahd	heart
deliberative	协商的
rack	拷问台
handball	手球
quaver	颤抖
petrography	岩石记述学
threesome	三倍的
denunciation	谴责
slab	用石板铺
rhapsodical	狂想曲
import	进口
earthborn	人类
gaulish	法国人的
forever	始终
arises	出现
coccidioidomycosis	球孢子菌病
jcl	language
exhibit	展出
tamar	他玛
larynx	喉
uneven	不均匀
polje	灰岩盆
dazed	眼花的
pbx	private
demonetise	=demonetize
skibobber	雪犁运动员
gleety	慢性淋病性尿道炎的
bellyful	满腹
flibbertigibbet	饶舌的人
encomiastic	赞颂
microcrystalline	微晶
minacity	威胁性
pregenital	性前期
conic	圆锥
wart	讨厌的人
reversion	回复
concutient	受到震荡性撞击
diffractive	衍射的
zoophilic	爱护动物
language	语言/国家
philosophy	哲学体系
drumbeating	广告
amtract	小型水陆两用登陆车
