traveling	滑动
done	合乎礼仪的
decanal	南侧唱诗班的
rattleheaded	愚蠢多嘴的
facility	容易
bnoc	Corporation
espial	间谍活动
intellectualize	使理智化
loral	眼端
equally	公平地
melinite	炸药之一种
register	提示
coiner	造币人
manganiferous	含锰的
staphylinid	隐翅虫
sinistral	左旋
fluidity	变移性
emiocytosis	细胞物质
roughly	粗糙地
acoustical	声学的
copier	制作拷贝者
caenozoic	新生代
novillada	斗牛
pluralist	兼职者
traumatic	创伤
salute	行礼致敬
bondmaid	女奴隶
accentuate	强调
tramontana	屈拉蒙塔那风
patavinity	方言的使用
pigmentize	给……着色
manikin	侏儒
krone	德国旧金币
semibold	半黑体的
preterhuman	超人
dainty	讲究
glairy	蛋白质的
klieg	=klieg
gymkana	运动会
wallow	堕落
irritably	性急
nitrotoluene	硝基甲苯
fossilate	成化石
gemmule	无性芽
dichromatism	二色性
extern	走读医学研究生
phe	公共卫生工程师
endoglobular	在血球内发生的
co	Order
antirust	不锈
toscana	托斯卡纳区
oxo	氧络的
multivocal	多义的
looseleaf	活叶式的
dentirostral	喙边有齿状突起的
rate	费用
headpiece	头盔
sessional	会议
basanite	碧玄岩
penology	监狱管理学
usefully	有用
motion	运动
satchel	书包
intellectualize	赋与理智
astringently	收敛性
abiogenetic	偶发
catecholaminergic	含有儿茶酚胺的
swimmy	眩晕的
rotator	转动体
kitbag	行囊
instead	更换
beamingly	发光
term	期间
monobuoy	单浮筒
field	使上场
oomingmack	=musk
lithic	膀胱结石
kent	ken
geomedical	风土医学
command	命令
dissipated	消散
diphycercal	圆尾鳍的
esthesiometry	触觉测量法
prelibation	预尝
crannog	沼泽地内之人工岛
dodecastyle	十二柱式的
assumption	假定
mildew	霉菌
undercut	牛腰部下侧嫩肉
fudge	梦话
afield	在田野
hurdle	篱笆
aero	航空的
calceolate	拖鞋状
mwa	Woodmen
atonalistic	无调性的
obscurity	阴暗
alternate	预备
coedit	共同编辑
bta	英国旅游管理局
bottom	底部的
crustily	有硬皮
dumbbell	蠢人
wealthy	丰裕的
coldhearted	冷淡无情
circean	喀尔刻的
ladderlike	梯式前进
gravific	产生重量的
nymphish	少女
miniature	微型
undigested	未经消化的
inbreaking	闯入
iaupe	University
approver	自首并告发同伙的人
coppery	含铜
bozzetto	制雏形
flummery	麦片制的粥
aftereffect	余波
startle	震惊
operation	运转
mortice	榫眼
laciniate	有穗边的
redistribute	再区分
drivel	淌口水
ymha	Young
don	穿上
nagged	被压制的
spoken	口头的
ceuca	中非关税经济同盟
magnific	崇高的
kaydet	西点军官学校学生
cephaloid	像头
gamogenesis	雌雄生殖
curvilinear	曲线的
retroflexed	向后弯曲的
introspectionism	腻
carucage	犁头税
seeing	观看
krater	双耳喷口杯
sciagraph	X射线照片
seize	夺取
indisposed	不合适的
aptness	倾向
unproposed	未提出的
drosophila	果蝇
asthenopia	弱视的
vacuous	空虚的
fagot	捆
manchette	靠手垫
collagenous	成胶的
palpably	易觉察
tontine	唐提式养老金法
dihydrochloride	二氢氯化物
chloralose	氯醛糖
sumpter	驮兽
tax	税
scree	碎石
scuzz	脏东西
compounder	中止起诉者
mesmerise	施以催眠术
intraocular	眼内
extensible	可展开
hmcs	Canadian
awshucks	谦卑的
baudelairean	波德莱尔
encephalograph	光照片/I/
foretype	前例
lamppost	街灯柱
emphysema	气肿
isoplastic	graft同基因移植物
performing	表演
unwound	未卷绕
reductivism	最简单派艺术
resplendent	辉煌的
nonlicet	不准许
fraternity	互助会
lapsible	易变的
depasturage	放牧权
nephridium	肾管
mpls	多协议标记交换
electret	驻极体
entreprenant	有上进心
trichotomize	三分
zoetic	有生气的
sf	science
teak	柚木
deathly	象死一样地
pedantry	卖弄学问
fox	使生黄斑
love	情人
nefandous	邪恶的
triassic	三叠系
uncontroverted	无争论
openhearted	不客气的
sniff	用力吸
swingeing	巨大的
quirk	急转
osb	Order
dravidian	德拉威语
fontal	原始的
pinwale	一种有凸纹的灯心绒
multilateral	多边
idc	Center
epicyclic	本轮
nofretete	娜弗雷提蒂
fusible	可熔
cater	满足
exclusively	专有
coat	涂层
bootes	牧夫座
prolonge	钩索
loaiasis	罗阿丝虫病
sifter	负责筛选的人
anaesthetization	麻醉
cordotomy	脊髓前侧柱切断术
sleazy	质量差
urochrome	尿色素
craniometrical	头盖测量
tangleweed	=tangle
hysterics	发疯
antisickling	抗镰形细胞形成的
godless	无神论者的
fallup	放射性尘埃对海洋地区的污染
new	新近
atremble	发抖的
rifacimento	改编
tortoiseshell	龟甲色的
tif	File
cephalochordate	头索动物的
nonscience	非科学
unsuspicious	不怀疑
plus	加
csce	Security
slithery	滑溜
subcrustal	路面底层的
ache	觉得疼痛
semicentenary	半世纪
dead	死的
bluff	vi诈骗
disestablishmentarian	主张政教分离
iontophoresis	电离子透入疗法
undecane	十一烷
wealthy	富有
dislike	不喜欢
nondirective	非指示性的
thin	空洞的
osculatory	接触的
handtailor	手工缝制
allostery	变构效应
micellization	胶束形成
hinder	阻碍
upcoming	即将来临
oxycarpous	有尖刺果
antibiotics	抗生学
recultivate	再培养
eyeable	赏心悦目
unmediated	无中介
memoirist	追思录
water	喷淋
scientist	科学家
lateral	支线
straggling	落后的
damoiselle	少女
indianist	印度通
autogravure	照相版雕刻法
ironclad	装甲
eruciform	毛虫状的
telocentric	具端着丝粒的
uncomplex	非组合
uropygial	尾臀的
document	证明
herbartianism	赫尔巴特的学说
porkling	小猪
sundown	阔缘的女帽
utp	非屏蔽双绞线
hallah	白面包
parietal	学院生活
neoplasticism	新造型主义
ranchette	小农场
inquiring	咨询的
tea	茶点
silkscreen	用丝网印刷术印制的
norsteroid	去甲甾类
pusillanimous	懦弱的
manner	方式
avventurina	avventura
forel	作书皮用的羊皮纸
gold	黄金
rudderless	无舵
antiquate	废弃
reoffer	再供应
generate	产生
qarnns	Queen
msj	Science
squeezable	可逼迫的
monticulate	有小丘
carbanion	负碳离子
lean	使倾斜
forewarn	预先警告
buttock	屁股的一半
dendrology	树木学
magniloquent	夸张
microcrack	微裂纹
preemptive	有强制收购权
morphogeny	=morphogenesis
alkalosis	碱毒症
circumplanetary	环行星旋转的
capsizal	倾覆
motor	电动机
rudesheimer	吕德斯海姆酒
genbakusho	sickness
tasty	好吃的东西
gossamer	薄纱
transferable	可转换的
cysteine	半胱氨酸
pronounced	明确
episcopize	担任为主教
multicoloured	多色彩
vigintennial	每20年一次的
chaliced	有杯状花
orbit	沿轨道飞行
prevalency	=prevalence
beauteously	美丽
punch	冲压机
transfixion	贯通
bacchius	抑扬扬格
formalistic	形式主义
unheroic	不英勇
painless	无痛
teosinte	墨西哥类蜀黍
secondary	第二
albeit	虽然
convincible	可说服的
mastoiditis	乳般突起炎
maximal	最高
udag	Action
redware	掌状昆布
veronese	维罗纳人
pitier	怜悯者
visitatorial	巡视
unbacked	无助的
circularize	通知
wizzled	干枯
magyar	马扎尔人的
handmaid	侍女
kinkled	有小纽结的
agreement	协议
staphylotomy	葡萄肿切除术
semasiology	语义学
preemptive	抢先
lipographic	字母或词之脱漏的
pie	爱说话的人
wert	be第2人称的过去式
servomechanism	伺服机构
linkup	联系
mandamus	命令书
hottest	热烈
tranquilly	安静
gladly	乐意
reactively	反动
ruridecanal	乡村教区司铎
whither	什么目的
housemasterly	像男舍监
wordy	唠叨
excogitative	想出
legitimation	认为嫡出
frumpy	不见世面的
woof	织物
carlish	卑下
filter	过滤器
graphitoid	石墨状的
winnow	扬谷器
gamophyllous	叶子相连的
dinosauric	庞大的
sweepstake	赌金的独
pyrimethamine	息疟定
interspinal	椎间
inept	不适当
redislocation	复脱骱
diamantiferous	产钻石的
dasher	搅拌装置
cnaa	for
defiant	目中无人
streptomyces	链霉菌
resplendent	光辉的
sketch	素描
rudie	=rude
unornamented	朴素
cafard	厌烦
puncher	打印机
disk	圆板
documentarily	在记录上
grandee	显贵者
lacunose	凹陷的
somnambulant	患梦游症
scene	布景
cisrhenane	莱茵河西岸
cloak	用外衣遮蔽
custody	保官
sunfish	淡水产小鱼
lumisterol	光甾醇
redwood	红木树的木材
symphonette	小型交响曲
limburger	林堡干酪
fiddle	拉小提琴
god	神
sychnocarpous	结多次果
diapsid	双窝型的
telegraph	电报
cubeb	荜澄茄
transonic	接近音速的
ribband	用肋骨牵条固定
lacerative	有伤害或撕裂力的
greedily	贪婪
uniplanar	同平面
macrophotography	超近摄影
woman	女人
leftish	左倾
whistle	口哨声
sardegna	=Sardinia
collect	由收件人付款地
salle	室
very	绝对
palestra	体育学校
champion	拥护者
opaque	不传热的
sparing	保守
medaled	接受奖章
touch	格调
adularescent	乳白色
abstinent	饮食有度的
easygoing	放荡
unfurl	打开
prosy	单调
quip	妙语
orrice	=orris
unheroical	不英勇的
parallel	相同
integrable	可积
ribotide	核糖酸
screwball	曲线球
rubydazzler	顶刮刮的东西
ichthyography	鱼类学
retold	retell的过去式及过去分词
inconsonant	不协和的
bimonthly	两月一次
manucode	辉风鸟
changeable	可改变
exocrine	外分泌
parsley	欧芹
cmos	Oxide
plebeianize	使普通化
like	喜欢
hydridic	带一个负电荷
female	柔弱
disposal	处理
cbu	unit
mucic	黏液
stegosaurus	剑龙
spicula	骨针
about	附近
somniloquist	呓语者
metalworking	金属加工术
tryout	尝试
waxy	光滑
irreciprocal	非交互的
barebones	皮包骨的人
thetford	塞特福特陶器
executant	实行者
fetich	物神
unequalable	无双
featureless	平凡的
germless	无菌的
overestimate	评价的过高
kibosh	胡说
thrust	力推
geoeconomics	地缘经济学
unfirm	不稳固
transpositive	变换的
ostentatious	装饰表面
saltatory	跳跃的
scattershot	漫无目标
ironist	讽刺家
sunniness	阳光照射
unstuffed	未填塞的
imo	Opinions
discriminative	有判别力
showground	展览场
unpolluted	未受污染的
avaricious	贪财
miogeosyncline	冒地槽
royalties	版税
piercing	刺骨的
scutate	盾状
cool	淡漠
rodriguan	罗得里格斯岛人
chromosphere	色球
intercharacter	字符间
crust	盖以硬皮
defy	挑战
rhamnaceous	鼠李科的
rhizocarpous	宿根
fortune	大量财产
interword	字间的
juneau	朱诺
forward	向前
antiaircraft	防空
spruce	整洁
toxigenesis	毒素产生
sanious	排出脓液的
coinstitutional	的中学的
peelite	皮尔派保守党员
grenadier	手榴弹兵
papaya	番木瓜树
surfboard	冲浪板
cathar	清洁派教徒
drainpipe	排水管
lavendery	有熏衣草香味
cyanopathy	绀色
thankful	感谢的
traffic	交通
gallop	迅速运输
unprevailing	不流行
annonaceous	番荔枝科
nte	Examination
reposal	信用
compulsorily	强迫地
frizette	=frisette
jukebox	自动唱片点唱机
rookery	破旧而拥挤的住房群
crassly	粗鲁地
hypothalamus	视丘下部
journeywork	散工
ranchero	牧场工人
maulstick	腕木
pleasurably	快乐地
iced	冰冻
catalina	=Santa
rct	Corps
sablefish	裸盖鱼
rightful	公正
forethoughtful	深谋远虑
staple	大宗生产的
deface	丑化
sargasso	马尾藻类海草
iconographic	图像材料的
jackass	公驴
snowmobile	雪上汽车
worthwhile	值得做的
hatty	Harriet
crimpy	卷缩了的
cablet	细缆
quarrier	采石工人
hopeless	没有希望
benzedrine	苯丙胺的商标
radioprotective	避免受辐射影响的
shredder	切菜器
aerobiology	高空生物学
quirky	离奇的
millionnairess	=millionairess
pageantry	壮观
rrb	Board
log	把……记入航行日志
carbonous	含碳的
zymosis	发酵作用
log	航行日志
trigonal	断面呈三角的
receptor	感受器
ante	赌注
digraph	连字
cavalier	有礼貌的绅士
bosun	商船甲板长
gyniatrics	妇科治疗
zincous	含锌的
upstair	楼上的
exorbitancy	过度
chipper	喋喋而言
deuteranopia	绿色盲
subtle	狡猾
jobbernowl	蠢蛋
pottery	陶器
nonenforceable	不可实施
array	部署
hymenoptera	膜翅目昆虫
tallness	高
micah	希伯来的先知
bandoeng	=Bandung
kettering	凯特灵
strac	Strategic
relucent	光辉
lowermost	最底下的
tortoiseshell	龟甲色
ulotrichan	有鬈发的
coalsack	装煤麻袋
disrupt	使中断
chiaroscuro	明暗法
diabolic	残忍的
reversible	可逆的
ardeid	属于鹭科
locomote	行动
icu	重点护理组
parched	炎热
green	新鲜
peachful	宁静
trouper	演员
rebarbative	令人讨厌
hypocorism	爱称
complaining	抱怨
endangered	有灭绝危险
brangus	布兰格斯菜牛
faithlessly	靠不住地
racquet	拍球戏
dalliance	调情
peckish	饥饿
daven	作祈祷
kituba	吉士巴语
lifelong	终身
unctuously	油腻
filicoid	如羊齿植物的
philter	春药
ammunition	军火
polydirectional	多向性
sidetrack	侧线
unessential	非本质
upmost	最高的
printout	打印输出
siliceous	硅土
smudgily	污点
perfect	正确的
signorina	小姐
saturnalia	农神节
centurion	百人队长
thrust	猛推
cacoepy	发音不准
stony	多石的
coagulen	凝血剂
albumen	蛋白
windfall	被风吹落的果子
wolfbane	=wolfsbane
remonstrance	抗议
lettercard	封缄明信片
ban	禁令
shippen	牛舍
mythopoeic	创作神话的
current	流通
backwoodsy	蛮荒的
dictatorially	独裁地
ber	Basic
scatter	分散
rss	Regiae
tardigrade	缓慢
justification	认为正当
fatherfucker	畜生
whop	重击
recollectedness	冷静
workhorse	做粗工者
splenial	夹肌
cleanness	清洁
intermarriage	近亲结婚
lexeme	词位
sparmate	=sparring
headland	岬
polyp	珊瑚虫
diemaker	开模工
ambitiousness	不凡的抱负
millirem	毫雷姆
palaeanthropic	古人的
virginia	维吉尼亚
papillate	乳突
vitrifiable	可玻璃化的
flagship	旗舰
magnification	扩大
desperately	失望地
overprescribe	处方过量
efficacious	有效的
sketch	概略
taboret	小凳子
denominator	命名者
druggie	吸毒者
imu	浅炊坑
phagolysis	吞噬溶解
centrifugate	使离心
enzootic	方性动物病
street	街
styli	日晷指针
telerecord	给……作电视屏幕录像
classical	正统派
lichenize	使……长满青苔
units	/
tricorne	三角
symbolisation	=symbolization
spiniform	似脊柱
sketchily	写生风格
distance	远方
explanative	=explanatory
recitativo	=recitative
millimeter	毫米
reproduce	复制
unerring	无过失
podite	肢节
negotiating	谈判
eely	似鳗
mean	平均
playbus	游戏公共汽车
homolysis	均裂
inspirit	激励
extra	特别
whence	pro
db	dB
fifteenth	第十五的
escuage	免役税
nonchromosomal	不以染色体遗传特质的
rural	乡下的
guidepost	路牌
barbe	白麻巾
cotoneaster	枸子属植物
complemental	补足
horniness	硬质
shimmery	微微发亮
launder	清洗
term	条件
ampliation	扩张
psychotropic	作用于精神
pleonastic	重复的
equanimously	安静
draff	废物
fosterage	养子身份
totemistic	图腾的
ideographic	表意字构成
merge	并入
expire	届满
billhead	付款通知单
redemand	再要求
hyalography	玻璃书写术
easier	更舒松的
callus	胼胝
iodinate	=iodate
subliterate	粗通文墨
baronetage	从男爵爵位
reactionism	极端保守主义
trying	难受
vortumnus	=Vertumnus
cockle	折皱
beefeater	英王的卫士
fico	无价值的东西
carpometacarpus	腕掌骨
forestry	森林地
symmetric	均衡
intestinal	肠内
disuse	不被使用
verge	边缘
beflag	以旗子装饰
dogginess	爱狗
ruffianize	使变得残暴
visigoth	西哥特人
histopathologic	`hIstEJ9pAWEst//
fslic	联邦储蓄与贷款保险公司
lugubrious	可怜
nonoccurrence	不发生
editorially	以编辑身份
unbaptized	未受洗礼的
operand	操作数
probenecid	丙磺舒
shammer	伪君子
symmetrical	均匀
under	在……领导下
evangelical	新教会的
concertino	大协奏曲中的独奏群或独唱群
clothesline	晒衣绳
dickie	=dickey
sicklebill	弯嘴鸟
jefe	军事首脑
norward	北方
preservationist	保护主义者
illusory	不牢靠的
majorcan	马略卡岛的
doubly	双重
pyramidal	锥体
carpospore	果孢子
freely	直率
sene	分
matey	伙伴
takamatsu	高松
abridge	删节
silly	失去知觉的
systemless	无系统的
grown	长满某物
felice	菲利斯
maiden	处女的
grovy	树丛的
cinnamonic	肉桂的
classical	古典文学
butylate	把丁基引进
deliria	极度的兴奋
trustily	诚实地
thriftily	繁茂地
savage	凶猛
substantia	塞梅林氏神经节
socket	给……配插座
afterschool	供课外活动用的
regensburg	雷根斯堡
thoro	完全
accustomed	按照风俗习惯的
exploitative	开发资源的
cerecloth	裹尸布
inconsonant	不协和
russety	红褐色的
irc	Internet
dogface	小兵
imagic	形象
parietal	腔壁的
crypt	地下室
coatroom	寄物处
exemplum	例证
horatius	贺雷修斯
msgm	Master
road	路
refragable	可证明为妄想的
demographic	人口统计学
image	典型
unequalable	无比的
unbridgeable	不能架桥
electrogalvanize	用锌电镀
superabundance	剩余
wostteth	=wost
unconventional	非常规
interpretable	能说明
castellated	有城
wheelman	骑脚踏车的人
doubled	快步走
indebt	使负债
planer	刨机
collusion	共谋
rejigger	更改
antirheumatic	治疗风湿病的
phenomenal	现象
helotry	奴隶
funky	胆战心惊的
cilium	cilia的单数
instant	立即的
losing	输
earwitness	亲听证人
harmonical	音乐般的
quid	一镑
gardenesque	花园般的
alchemistically	炼金术士
tympana	中耳
cumbersome	笨重的
johannes	九世纪的金币
ariot	骚乱
healthwise	由健康的观点来说
uneducable	不可教育的
extinctive	使消灭
squawk	故障
vitrify	变成玻璃物体
calefaction	发暖作用
bombazine	用丝绸、棉纱、毛等织成的斜纹布
towel	毛巾
honest	正直的
proportionment	调和
fusionist	联合主义论者
uselessly	无益地
raspy	刺耳的
state	陈述
souteneur	靠妓女养活的人
twain	一对
sociogroup	社会群体
humiliatory	蒙羞的
wash	漂浮
scalar	数量的
wheeziness	气喘状
sized	有……大小的
tristimulus	三刺激
hyperthermal	极高热的
cobelligerency	战时盟国
zincous	锌
cytophotometry	细胞分光光度法
unsightly	难看
unmerciful	残酷
counterpoise	秤锤
carriageway	车道
exoteric	开放
exactness	正确
ruffian	无赖
reliance	信任
aruspex	古罗马肠卜祭司
amontillado	白葡萄酒
them	pro
create	创造
bombardon	低音铜管乐器的一种
dicrotism	重搏脉
vile	恶劣的
midriff	中腹部
ruthless	无情
hyperbolize	夸张
edge	刀口
cameral	有关立法或司法机构之一院的
hominine	人
anaclastic	屈折的
cementum	水门汀
rooty	根似
suzerain	宗主
reinforcement	加固
preface	作序
wittgensteinian	维特根斯坦思想的信徒
informative	情报
epulary	宴会
tellurium	碲
reticent	沉默寡言的
semele	塞默勒
blent	blend的过去式及过去分词
dop	酸二辛酯
sixfold	六倍
lemnian	利姆诺斯岛上的土人
blurry	模糊
exultantly	狂欢
unartificial	自然的
elementary	基本的
toast	烤暖
whirl	旋转
tenderometer	成熟测度计
standing	停滞
flop	扑拍
squalidness	穷困
unsolicitous	不关怀的
shutter	装以遮门
flattering	谄媚的
knapper	打碎的物体
fugacity	易逃逸
qarnns	Nursing
defrag	整理磁盘文件碎片的工具
famous	著名
scarbroite	羟碳酸铝矿
discerption	分开
notable	显著
equator	圆
spellbound	着迷
prolapsus	脱垂
innutrient	缺乏营养的
sapient	有见识
rasp	粗锉
book	书籍
disabuse	解惑
gym	体育
doubler	加倍装置
selvage	镶边
microbial	微生物的
blast	使枯萎
pule	低声哭泣
charge	掌管
trigynous	具三花柱的
lathing	板条
blarney	谄媚
towing	bracket牵引支架
watering	流泪的
monogamist	一夫一妻论者
redisplay	重新显示
pepperbox	胡椒粉盒
dabchick	鸟的一种
unwalkable	不适宜散步的
housebody	=homebody
feijoa	费约果属植物
creepage	蠕动
migration	移往
spheroidal	类似球体的
motorcycle	机车
thine	你的东西
solitaire	单人纸牌戏
bait	中途休息
separately	个别
collutory	漱口剂
astrictive	收敛剂
carriageway	马路
sclerotitis	巩膜炎
divine	超人的
abnormal	反常
corrade	侵蚀
resistante	从事地下组织之女性
madding	发狂的
overcareful	过分用心
burrhead	黑人
photorealism	超级现实主义
turbidimeter	浊度计
hallucinatory	幻觉的
flunk	使不及格
setdown	辱骂
scud	风吹起的浪或水花
gyrate	旋转
interspinal	椎间的
fauvist	野兽派
premature	未成熟的
dirigibility	操纵可能
decarboxylation	去碳酸基
extraartistic	艺术范围以外的
like	同样的
enisle	使成岛
cartoonist	漫画家
chicane	诈骗
goggle	眼珠转动
toothed	有……齿
playa	海边休养地
unexaminable	无法测定
unemployed	失业的
retiform	网状
fancydan	爱卖弄的人
exequies	葬礼
square	正方形
regreet	再问候
jenghiz	Jenghis
anthropic	有关人类
licensed	到许可
valuta	可使用的外汇总值
untuneful	不和谐的
human	人性的
choir	唱诗班的席位
boiling	沸腾
dismayful	令人丧胆的
graniferous	结粒状之实的
masked	戴面具的
toddler	初学走路的孩子
fenestral	小孔
ladleful	满杓
peace	安静下来
multiplexer	多路器
mitigatory	减轻
sab	科学咨询委员会
cryptical	秘密的
unpliant	不易弯折的
drive	飞跑
uncoil	展开
disembark	登陆
pronouncement	声明
spill	涌流
done	做好了的
gravitational	重力
thorough	彻底
show	引导
samos	antimissile
salep	一种食用淀粉
undevout	不真诚的
peach	告发
fail	使失望
reduce	缩小
psychodynamic	精神动力
tympanoplasty	中耳整复术
bespectacled	带眼镜
scurril	恶语毁谤的
scientificity	科学性
bronze	铜像
blandiloquence	甜言蜜语
adsorptive	吸附
oxo	含氧的
anticarious	抗龋
snugly	舒适温暖
disoperative	阻碍
ambroid	=amberoid
prosector	解剖员
thickening	增厚过程
exaggerated	夸大的
onomatopoetic	拟声的
shelly	由壳而成的
lachrymal	泪的
hoik	急剧上升
immixture	混合
coordinate	同等的
qaranc	Nursing
bioelectronics	生理功能电子控制学
serein	晴空雨
streakily	容易生气
seedy	褴褛
yourself	你自己
stalwart	坚定的
astrophysics	天体物理学
cipolin	有白绿纹
claudicant	跛脚
microfiche	单片缩影胶片
informidable	不足畏惧
abuliding	兴建中的
guru	头头
proteoglycan	蛋白多糖
crabbily	暴躁地
anselm	安塞姆
apra	秘鲁革新政党名
muck	施肥
predominate	掌握
bloomer	失败
corroboree	狂欢会
nonresidential	非居住的
scowl	板着脸表示
watchword	格言
mdcccxcix	1899
commiserate	怜悯
quiveringly	震动
lapwing	田凫
secondary	二级
cataphonics	回音学
lavaliere	垂饰的一种
cainozoic	新生界
antiskid	防滑装置
uncharitably	无慈悲心
aphemic	失语症的
malm	白垩土
snooty	自大
calcific	钙化的
chink	裂缝
defer	服从
choreographic	舞蹈术的
restraining	抑制
usha	States
defervescence	退热
gruesome	可怕
feeling	有同情心
sternly	坚决
pullulate	发展
pshaw	啐声
stridulatory	尖声鸣叫
ajut	突出
motherfucking	讨厌的
legislatorship	立法者
polemical	挑起争端
wherefore	因此
epistome	口上突
manageable	易处理
dripstone	滤石
marriage	合并
infinitesimal	极小量
contrastimulant	有镇静作用的
reinless	放纵
nas	Storage
hypsography	测高学
medially	中间
clement	宽大的
dodgy	善于骗人
thermoremanent	热剩磁
virtuosity	艺术鉴别力
obey	服从
roset	=resin
grammatical	合乎文法的
easygoing	放荡的
ucky	黏乎乎
inseparate	相连
proteinoid	类蛋白
escapist	逃避现实
optokinetic	视动的
varley	loop华莱回路
help	救命
reasonless	无推理能力的
fulmar	管鼻藿
bluestone	胆矾
conciliationism	kEn9sIlI`eIFEnIzEm/
graupel	软雹
servient	从属的
qemm	一种计算机内存管理软件
discouraging	令人气馁的
quercine	栎树
joinery	细木匠业
palladize	涂钯于
epigene	外成
regenerator	收革者
adriatic	亚得里亚海的
headland	向水中突出的陆地
fluxionary	微分的
strix	柱身凹槽
cocaine	可卡因
asean	Asian
morasthite	摩利沙人
assiduously	恳切
ipsu	IP地址配置工具
subtense	对边
venter	母
octan	每隔八日发一次
voyeurism	窥阴癖者
unhidden	不隐瞒
burning	极严重的
greatly	很
northlander	北方人
tailcoat	燕尾服
aok	源出美国宇航员向发射指挥中心的报告语
helpfully	有益
chansonette	小歌
regather	再收集
haemorrhage	出血
faker	骗子
cucumiform	黄瓜状
pentoxid	五氧化物
firry	杉树
oui	是
gomeral	傻瓜
invocatory	祈愿的
dispread	向各方展开
wold	无树木的山地
xanthian	赞西亚
fill	充满
husky	嘶哑的
fine	精美的
accusatival	宾格
infected	被感染
navigator	航海家
irrefutable	不能驳倒的
conservatize	成为保守
peddling	忙于琐事
weather	露天
peritonealize	用腹膜覆盖
klompen	荷兰人穿的木鞋
ondometer	波长计
entremets	附加菜
marshy	沼泽般
luster	发亮
japonic	日本特有的
humongous	其大无比
month	月
monsoon	季候风
wheeze	很困难地呼吸
amblygonite	锂磷铝石
scanty	不充足的
tactic	排列的
pinup	受欢迎的
ruth	悲哀
overboard	在船外
vasodilation	血管舒张
hydroski	水橇
errhine	催嚏的
chromatophil	嗜染性的
leatherhead	傻瓜
target	靶子
flowerless	无花的
contorniate	边缘内有槽
level	变平
ahead	提前
seismographic	震仪
condensability	可压缩性
successor	继承者
untaa	联合国技术援助管理处
if	条件
reprehension	非难
pithecanthropus	猿人属
sacramento	萨克拉曼多
associative	联合的
hatshepset	哈特谢普塞特
borne	bear的过去分词
lucullan	富裕
contabescence	憔悴
interpose	提出
entropy	平均信息量
spruce	整洁的
dermoid	皮样的
scalogram	量图
ground	把……放在地上
pendent	悬而未决
jagatai	杰格塔语
neutralisation	平衡
gospodin	先生
damagingly	非常地
yosemite	Valley
who	谁
jutty	防波堤
yeggman	抢劫金库者
spectroscopy	光谱学
auspice	赞助
voyage	航空
unexhausted	未尽的
cinder	煤渣
univac	通用自动计算机
pukkah	纯良的
flyaway	不合身的
lobulate	由小叶片组成的
baseborn	庶生的
leukocytotic	白血球增多
concertante	适于发挥高度技巧
staple	主要的
passivation	钝化
viscountess	女子爵
dogberry	山茱萸
julienne	切成丝的
luxurious	奢侈的
fixedness	固定
atheromatous	粉瘤的
elevator	电梯
astute	狡猾
battleship	战舰
foeman	敌人
corrugate	起皱
vibropack	振动子整流器
iranair	Iran
instreaming	涌进
efficient	生效
counterpose	使对立
rendition	演唱
develop	显影
claribel	克拉丽贝尔
increasingly	愈加
pansexual	泛性的
lickerish	贪婪的
fete	给予……巨大的荣誉
efficacious	灵验
expense	开支
carmen	卡门
tokugawa	德川
catalepsis	强直性昏厥
pinworm	蛲虫
endolithic	石内
framing	取景
transmission	发射
exasperater	惹人生气者
towmond	12个月
green	青春
dumbstruck	吓得发懵的
armoric	阿莫里凯人的
makefast	浮标等物
erotological	色情文学
lcvp	and
impalement	刺穿
facer	铣刀盘
punk	年轻无知得人
attribute	特征
fuck	毫不在乎
uninclosed	=unenclosed
matted	缠结
series	连续
rimous	有裂缝
ganoblast	成釉细胞
firedamp	沼气
agitato	激动
unapproachable	不能接近
approvingly	赞许
oppugn	反驳
sloppy	肥大
floorer	难题
vesical	椭圆形
unprevailing	不起作用的
jayhawking	掠夺
cookroom	厨房
disentitle	剥夺……的权利
sunglow	晚霞
haemochrome	血色素
follow	理解
wroth	愤怒的
rosace	蔷薇花饰
rebaptize	为……再命名
excisable	可抽税
raftsman	撑筏者
postclitic	重读词后词
absolutory	给予赦免的
jurassic	侏罗纪
lgm	man
coonskin	浣熊皮
buret	玻璃量管
infrequent	稀少
syriacism	古代叙利亚语风格
scanner	扫描仪
corrective	矫正的
unthinking	未加思虑的
smaragdite	绿闪石
dogfight	空战
uncorrupted	未腐败的
skitter	沿水面拉动鱼钩钓鱼
edgeways	从旁边
nonobjectivism	艺术的抽象主义
spearman	枪兵
eacm	东非共同市场
beagle	打听某事始末
mechanical	机械似
lynx	山猫
defatted	脱脂的
ease	安逸
unaverage	出众的
prolifically	丰富
supersensible	超知觉
thereinto	其中
ceremonialism	恪守礼节
warranty	授权
purpuric	紫癜的
usmcr	Reserve
uneventful	无重大事件的
rondino	简单的轮旋曲
delphian	神谕的
piercingly	感动地
featherpate	=featherbrain
hygeian	健康的
statehood	州的状态或地位
soldiery	军人
copulation	交尾
righteousness	正直
linograph	莱诺整行铸排机
iridous	亚铱的
phthisic	肺痨
hemogenia	假性血友症
jumper	海员的上衣
bluejeans	蓝布牛仔裤
snowball	迅速增长
diamante	镶人造钻石装饰的
freyr	=Frey
service	服现役的
retrospective	回顾
overrespond	反应过火
airproof	密封
crooner	低声唱歌的人或歌手
arrival	到来
chromascope	表示色器
derivational	来
ledge	架状突出物
dab	少量
lucullian	奢侈的
acpi	Configuration
gibus	折叠礼帽
beneficial	有使用权
dizzyingly	灿烂地
anabasis	侵入
arpeggio	琶音
theca	膜
ethnic	异教徒的
discreteness	组件
bulkily	庞大地
divers	种种
aglossal	无舌的
unionize	统一
morgan	摩根马
swiz	欺骗
subhuman	低于人类
wmo	Meteorological
annum	岁
upcast	向上抛的
decongestive	可降低充血
flitter	一掠而过的东西
bursarial	会计员
aching	心痛的
wearproof	防磨损的
biotite	黑云母
image	图象
outdoor	户外的
once	曾经
stabbed	刺
magnesuim	镁
craziness	热中
molecularity	分子性
woad	靛蓝
prelingual	有语言能力前
bargee	粗鲁无礼之人
ambiance	=ambience
flump	砰的摔下
tacitean	简洁且多警句
assyrian	亚述
effectually	有效地
tricentennial	三百年的
ard	respiratory
brd	Deutschland
veritably	真正地
clatter	使卡搭卡搭的响
calendric	历法的
soldier	军人
sittable	自始至终不必离座的
odious	可憎的
insinuative	暗示
multivocal	暧昧
lemongrass	柠檬香草
useless	无益的
annunciatory	可预告作用的
euchromatin	常染色质
decennary	十年间
unscramble	使回复原状
fattener	养肥禽畜者
fluorite	氟石
obtrude	冲出
garran	矮小结实的载重马
neoarsphenamine	新胛凡纳明
empanel	选任
judaize	使成犹太式
volute	螺旋形的
unef	联合国紧急部队
microcrystalline	微晶的
antienzymic	抗酵素
bloom	青春
monocotyledon	单子叶植物
hydrotherapeutic	水疗法的
betacism	音和
successive	继承的
interphase	相间的
cahier	会议记录
lethal	致死因子
stomachic	健胃
assentient	同意的
exheredate	剥夺……的继承权
juncaceous	灯心草科的
resonatory	激起回响的
unbranded	未打上烙印的
grouchy	不满
irenical	和平主义的
applique	嵌花
unjelled	未定形的
delightedly	欣喜
fibber	撒小谎者
livelily	生气勃勃地
acheulian	欧洲旧石器时代早期文化
epixylous	木上生
subjugation	镇压
unweave	解开
outsoar	比……飞得高
edge	镶边
enterozoan	内寄生虫
habacuc	=Habakkuk
fact	事实
synthetically	综合地
knowledgeble	知识丰富
octahedron	八面体
concentrical	共中心
emptying	倒空
corsetry	紧身衣
north	北
discussion	讨论
ramshackle	摇摇欲坠的
spacer	取间隔的装置
soutar	=souter
westwardly	自西
symbolic	象征
enterprise	企业
unreasoningly	不合理
autobiographic	自传作家的//fIkl/
zpg	人口零增长
zorana	佐拉娜
krasnovodsk	克拉斯诺伏斯克
limpwort	=brooklime
quitclaim	放弃权利
ingredient	成分
indistinguishable	/
overawe	威震
co2	dioxide
favorite	中意
zoar	避难所
polyandrous	一妻多夫
associative	联合
spermatozoa	精子
disulfuram	二硫龙
iupap	Applied
creosote	用木馏油处理
emotive	感情
malay	马来人
rawness	生
unreprieved	未缓解的
carpogenic	结果实的
catalytic	接触反应
sirup	糖浆
ductility	展延性
cold	寒冷的
mudbank	泥滩
laryngotracheitis	喉气管炎
kwangchow	见Guangzhou
fallen	落下来
atlantean	Atlas
jouk	闪避
jambe	旁柱
present	给
stump	掘去树桩
crashproof	耐撞的
rdram	Rambus
osfcw	for
footle	说呆话
raucously	粗声地
variocoupler	可变结合器
twinkling	闪动
wtp	Transaction
sententious	警句的
forenotice	预告
kilchu	吉州
surgeoncy	外科医师的职位职位
meander	蜿蜒而流
steamroll	压倒
paralyse	使麻痹
set	Transations
arboreal	乔木
elodea	伊乐藻属植物
latterly	最近
rosabel	罗莎贝尔
candler	烛台
genoese	热那亚人的
absorber	减震器
fashionably	时髦地
yield	收益
anteater	食蚁动物
southeasternmost	极东南
unduly	不正当
reins	感情
lustihood	强壮
playday	非正式比赛
stormy	激烈的
feracious	丰富的
cornelian	红玉髓
colophony	树脂
diarthrosis	动关节
involute	复杂的
tumble	弄乱
eto	Operations欧洲战区
unialgal	单种藻的
beauish	花花公子的
molder	铸工
yielding	易受影响的
photomechanical	照相工艺的
silex	石英玻璃
nematic	向列
acmesthesia	尖锐感觉
reissue	重新发行
orthomorphic	正形的
zymosthenic	促进酵素作用
sixth	第六
advertizing	广告
superconduct	体作用
landon	兰德勒
ovenbird	灶巢鸟
humidifier	湿度调节器
antiparallel	反平行
filibuster	阻碍议案通过
epndb	perceived
obtuse	圆头的
fortyfold	四十倍
piggin	长柄杓
faulted	有缺点
astonishing	可惊异的
typhoidal	伤寒的
antidotal	解毒
airy	空想的
heptode	七极真空管
kilohertz	千赫
haram	女眷
convolvulaceous	旋花科植物
tritural	用于研磨的
edificatory	启迪的
wow	发出叫声
olfactometer	嗅觉计
grille	铁格子
damning	毁灭
reprehension	指责
neuropathist	神经病专家
eec	Community
holocrine	全泌
hypobranchial	鳃下
forfeiter	受没收处分者
toot	嘟嘟声
sceptre	节杖
resuscitable	能恢复
heaviest	重的
vexillology	旗帜学
principial	原始的
nubian	努比亚人
unmeant	偶尔
acronymous	关于首字母缩略字
isoantigen	同族抗原
allmains	适应各种电压
canterer	慢跑者
mastopathy	乳脉病
rightfulness	公正
homebuilt	家里做
kanagawa	神奈川
tubal	输卵管
ither	pro
incubative	孵蛋
annihilationism	灵魂毁胻ical//
breadbasket	胃
hysteric	歇斯底里
sleazy	质地薄的
peculiarly	特别地
caraway	香菜
fuzz	起毛
angled	成角
poll	选举之投票
incongruity	不调和
brazilwood	苏木
mignonne	娇小可爱的
inquisitorial	询问人
unacquainted	不熟悉
cinefilm	电影胶片
madder	人造西草染料
laddie	老弟
housebreaking	行窃
execrative	憎恶的
trunkmaker	制皮箱的人
director	董事
scalloping	海扇贝采集业
muchly	几乎地
risc	Reduced
judicature	司法
intimidatory	威胁的
bubalis	狷羚
dreadful	讨厌的
pretty	机灵
nls	support
aic	美国化学家联合会
aplomb	垂直
slipway	滑台
fogbank	雾堤
touching	动人
osteomalacic	骨软化
strikeless	无罢工
nonprotein	不含蛋白质之物质
inblowing	向内部吹
striated	有条纹的
rototill	用旋耕机耕
emetic	引起呕吐
sebaceous	脂肪过多的
rifampin	=rifampicin
aboveground	未被埋葬地
chloette	克洛埃特
numbered	有限
vacuolate	有液泡的
agricultural	农艺的
tinhorn	华而不实
lethal	致命的
provirus	前病毒
hypergeusesthesia	味觉过敏
outstride	大踏步地走在……的前面
lethargic	瞌睡
towfish	拖鱼
hoatching	挤满
trailing	泥浆彩饰
gap	间隙
reckon	猜想
napoleonist	拿破仑的拥护者
ihram	穿朝圣服时的神圣状态
sharpener	磨具
slopehead	亚洲人
lha	Admiral
evocative	唤起
cymbate	船形的
hypothecate	抵押
infrequence	很少发生
giddily	头晕地
whorled	有涡漩的
catalonia	加泰罗尼亚
simpleminded	头脑简单
bulwark	壁垒
dentition	生齿
radc	Dental
caboodle	堆
osteopathist	正骨医生
baronet	从男爵
retroflex	翻转的
realize	实现
injectant	注入物
soberminded	头脑清醒的
oriflamme	军旗
rebelled	造反
sophomorical	=sophomoric
grid	栅格
asshur	=Ashur
cryptoanalysis	密码分析学
indelicacy	粗俗
wire	金属丝制
gangrenopsis	走马疳
remit	缓和
claimer	申请者
eel	蛇形鱼类
riskiness	富有冒险性的事
barker	杂耍、戏院前叫喊招揽观众的人
copyreader	校订人
accessary	同谋的
ruffly	起波纹的
fluky	侥幸的
shoreless	没有陆地的
swift	快
locator	表示位置之物
anticatalyst	抗化剂
transpositive	移调
hahnemannian	哈内曼疗法
discrepancy	相差
latigo	马鞍上的皮带
vicariance	地理分隔
owi	Office
aventall	=ventail
impendency	迫切
stentorian	声音洪亮的
hexanitrate	六硝酸盐化合物
gradient	坡度
uncondemned	未被判罪的
hexabasic	六碱的
dyke	女子同性恋者
broadside	全面
acacia	阿拉伯树胶
fumaric	反丁烯二酸的
trichloromethane	=chloroform
dissector	解剖学家
arrect	倾耳注意的
gem	被喜爱的人
freethinking	自由思想
occultism	神秘主义
friend	助手
cretinoid	矮呆子样的
wheeled	用轮子行走
wins	Internet名称服务
pled	plead的过去式及过去分词
cellulase	纤维素酶
tease	取笑
sanhedrin	古犹太最高评议会兼最高法院
epistoler	举行圣餐时朗读使徒书之人
warmly	热烈
scalding	尖刻的
dissolution	解散
rhodesoid	罗得西亚化石人的
parnassian	希腊帕纳塞斯山的
windup	结尾
postvaccinal	种牛痘后的
endearment	钟爱
unforgettable	令人难忘的
unpublicized	未公布
idea	念头
ring	环
counterorder	逆命令
viny	象葡萄树的
erzgebirge	Erz(即克鲁什涅山脉
skillful	制作精巧
iskenderon	伊斯肯德仑
coz	表兄弟姊妹
exegetical	评释的
melodia	笛管音栓
indebted	感恩
witchetty	木蠹蛾幼虫
unbalanced	收支不平衡
chimp	黑猩猩
exotic	外来的
druidic	督伊德教的
aureate	镀金
fringlish	法国式英语
idly	空闲地
successive	继承
stealing	偷垒
acerb	酸涩
assign	将驱动器符重定向至第二个驱动器符
protest	断言抗议
daywork	日工
wistaria	紫藤
aberrant	异常的
crumble	面包屑
labber	濡湿之人
griddle	煎饼用浅锅
dia	Agency国防情报局
rosarian	玫瑰花鉴赏家
unequally	不公平地
trellis	格子
erstwhile	往昔的
sab	Advisory
toddle	东倒西歪的走路
polska	=Poland
discerning	有辨识能力
best	最好
bank	浅滩
federally	在联邦政府一级
solon	议员
nonbank	非银行
likely	有希望
marrowbone	动物髓骨
bountiful	宽大的
agedly	老态龙钟
dexiotropic	右旋的
mind	介意
guanin	鸟嘌呤
amerasian	美亚混血
pstn	network
involucrate	有总苞的
subpolar	近极的
vagueness	暧昧
irresistible	不可抵抗的
milimetre	千米
unfoiled	未受阻
healthy	健壮
vehicle	媒介物
clank	叮当声
puling	哀诉的
everyday	每天的
cognation	同族
exhortative	劝告的
irrespective	无关的
trump	喇叭
cowhearted	怯懦的
genitival	属格形
trend	通向
hammer	铁锤
character	性格
ciliary	毛状
embolic	栓子
enlighten	照耀
handmade	手工
nondescript	无特征
touchback	持球触
audacious	大胆的
pied	杂色
totally	整全地
mihrab	米哈拉布
effulgence	光辉
board	木板
apophyge	蜗牛形柱墩
cher	谢尔河
dravidian	德拉威人
restriction	限制
fortnightly	每两周的
roachback	弓背
heap	许多
msp	Protocol
sparsely	稀疏地
crested	有冠毛
regnum	统治期间
through	穿过
gleichschaltung	一体化
wetback	"湿背人"
sea	大量
bvds	内衣
riazan	=Ryazan
filtrability	过滤性
satyr	好色之徒
covered	有屋顶
mbfr	and
landship	陆地上供训练用的船
bifurcate	分叉
dependency	依靠
shipwreck	遇难
perch	栖木
depletory	放血的
enmity	憎恨
formulization	用公式表示
convolvulaceous	旋花科植物的
lydian	吕底亚的
superpersonal	超个人
lurch	惨败
kayak	爱斯基摩人用的皮船
enregiment	把……编成联队
yank	拔
corbie	乌鸦
aeruginous	绿青色的
helot	古斯巴达奴隶
gastric	胃的
telefacsimile	电话传真
alehouse	酒馆
frugally	节约地
vespine	大胡蜂
itn	News独立电视新闻公司
netkeeper	=goalkeeper
meclozine	敏克静
eolian	风
impugnable	可责难的
pyronine	焦宁
cavate	形成山洞的
cep	Probablity
translatory	平动的
trimetrical	有三音步
pretend	伪称
adventuresome	冒险性
hamulate	弯曲的
trieteric	一次的
querulously	易怒
monoacidic	一元的
cyclohexylamine	环己胺
distemperedness	紊乱
inferior	下等
mattamore	地下仓库
horsemint	香蜂草属植物
seminiferous	输送精子的
rhabdomyosarcoma	横纹肌肉瘤
expellee	被逐出国外者
moschatel	五福花
prickly	多刺的
crown	王冠
noxious	有害
patina	古色
neuroleptic	安定药
fos	steamer
average	平均为
kindly	和善的
dress	衣服
scenic	风景影片
coindication	征兆之一
distant	疏远
electro	电版
dipteral	双翅类的
relique	纪念品
chatty	爱讲闲话的
pouch	成袋状
tease	强求
kuching	古晋
trichroic	三色
antler	茸角
broil	烤
ravenous	渴望
aramaic	亚拉姆语
irrevocable	不能取消
biramose	具二枝的
cockaigne	伦敦及其近郊
staphylococcal	葡萄球菌的
nonnasally	非鼻
affinitive	关系紧密
wolfish	豺狼般
run	开动
fluid	可另派用场
declaratory	公布
reeducate	重新教育
supralittoral	岸上的
bum	流浪
resister	抵抗者
exotic	异国情调的
helpfully	有用
croquignole	化学烫发法
opengl	开放式三维图形库
kench	腌渍箱
leal	忠实
ochlocratic	暴民政治
abet	支持
baudelairean	波德莱尔式
jar	不一致
gray	老的
gradient	倾斜度
miracle	奇迹
force	影响力
appeasable	平息得了
sprint	美国著名的通讯公司
sanguine	指望
vinaigrette	香料嗅瓶
swellhead	自大者
fossorial	适于掘
altisonant	冠冕堂皇的
unreversed	不相反的
whaling	捕鲸
suave	温和
interknot	把……结在一起
stand	经受
maternity	母性
natively	天然
erection	竖起
hope	期待
afflict	折磨
pesach	=Pesah
dropsy	水肿
lumpfish	圆鳍鱼料
autogamy	自体受精
autofining	精制
castle	城堡
miee	电机工程师协会会员
attainments	造诣
lacteous	乳状
answer	响应
nlrb	国家劳资关系委员会
ardent	激烈
lop	下垂
macrostylous	具长花柱
lain	lie的过去分词
larghettos	稍慢乐节
iridocyclitis	虹膜睫状体炎
xeroform	塞罗仿
fat	油腻
backing	援助
egg	鸡蛋
risc	精简指令集计算机
tyrolean	提洛尔人
ingurgitate	狼吞虎咽
septicaemic	败血病的
wake	尾迹
higgle	讨价还价
deathtrap	危险的地方
tangent	相切
hagiarchy	圣人政治
staphyloma	葡萄肿
boxroom	收藏室
aberdevine	金翅雀
foolproof	十分简单的
nomistic	以经典中之法则为基础的
grisly	恐怖的
incessant	不断的
knurly	多节的
respect	敬重
icebound	冰封的
unsharp	钝的
naeb	全国教育播音员协会
sacrosciatic	骶骨坐骨
coshery	免费招待
runtish	发育不良的
feodal	封建的
cardioverter	心律转变器
indexed	与生活指数挂钩
crablike	似蟹
rife	普遍
chuckwalla	大型蜥蜴
mowing	牧草地
winter	过冬
predate	居先
incretory	内分泌
bismuthic	含五价铋
dazzling	耀眼的
eurocapital	欧洲资本
bpi	per
underpopulation	人口不足
roadhead	路端
impotence	虚弱
naggish	劣等
regard	当作
racemiform	总状花序形的
renunciative	脱离关系的
zoophysics	动物物理学
remarkable	非凡的
underserved	服务不周到
iaea	International
lagger	懒散的人
mohammedan	穆罕默德的
multifarious	各式各样
conversationist	有口才的人
wpc	Constable
kedron	=Kidron
fractional	分数
ultimate	最后的
deweyite	杜威哲学思想研究者
pull	拖
incomplete	不完全
sinhala	僧伽罗语
uar	Arab
australorp	澳洲黑
fucose	海藻糖
wash	被冲蚀
trailside	沿山路的
collet	宝石座
ringing	铃声
porkpie	猪肉饼
merosymmetrical	=merohedral
magnification	放大倍率
allocution	训示
missileman	发射者
grading	坡度缓和
hatching	阴影
diplomatic	老练
sassy	失礼
incurably	治不好地
inlier	内窗层
make	获得
cussed	该诅咒的
unbuttoned	解开钮扣的
sheeny	光亮的
plumpy	丰满的
cauterant	腐蚀的
exceeding	过度的
bice	灰蓝色
endoderm	内胚叶
gigman	有二轮自用马车的人
loosen	解开
peg	桩
absolute	完全的
bronze	青铜色的
vern	弗恩
dissentious	争吵的
warring	敌对的
secam	Couleur
scissile	易切断的
domicile	定居
compendiary	简明
lixivial	碱汁
nanette	纳内特
cottonwood	棉白杨
ululant	哀鸣
reppo	depple
rascal	下贱的
relaxative	有缓和作用的
chemiluminescnet	化合光
pontifical	罗马教皇的
tepid	不太热烈
paraparesis	下肢轻瘫
availably	有效地
frisco	=San
pdsa	for
cnn	美国有线新闻网络
suggested	暗示的
gazette	报纸
guisard	化装的人
classically	古典主义地
put	迫使
initiate	开始
iaf	Astronautical
unwarily	不注意的
flq	du
bronchogenic	产生于支气管的
fallol	矫饰的
aiff	Format
eutectoid	类低共熔体的
lcp	Craft
emphatic	断然的
deterrable	可威慑住的
unaccounted	未解释
urgently	急切地
kaki	亚洲柿树
cosmopolitism	世界主义
unmatched	无匹敌
refurnish	重新装备
grubstreet	文丐作品式的
pob	邮局信箱
quarrelsome	喜欢吵架
iberian	古代伊比利亚人
ampholyte	两性电解质
clinique	诊所
accounts	帐号
iconographic	肖像学
deniable	可否认
stalactiform	钟乳石状
dropout	退学学生
hurdle	障碍
housemaster	舍监
crispy	易碎
crofting	日光漂白
giddy	头晕
embalm	铭记于心
congealer	冷藏器
diligently	勤勉地
brigadier	陆军准将
relative	亲缘植物
machair	沿岸沙质低地
malleolar	踝
reaphook	弯月刀
phylactic	防护的
linn	绝壁
laryngoscopic	喉镜检查
uneven	不平坦
trapezius	斜方肌
annoyingly	恼人
finery	装饰
logical	合理
housemaid	女仆
shroud	遮蔽
direct	直接地
rebop	早期之爵士乐
forested	被森林所覆盖
lurch	举步蹒跚
con	精读
nocent	伤害的
preceding	前述
loosen	松开
hayes	贺氏公司
escort	护卫队
giver	送礼者
inseparability	不可分离性
unworthy	不值
nosogenetic	发病原理
excusatory	辩解
mlf	多边核力量
nicotine	烟碱
adjuratory	恳求
coonskin	浣熊皮的
demoded	不合时宜
kgps	kilograms
tumorous	浮华的
manual	手册的
computistical	经统计计算
precis	摘要
parliamentarian	国会议员
after	模仿
ammoniate	氨化合物
realizable	可实现
yike	争论
pandanaceous	露兜树科的
charpoy	印度轻便床
paricutin	帕里库廷火山
pignut	花生米
penicillinase	青霉素酶
acetification	醋化
unearned	自然得到的
enroll	成为成员
basketry	篮筐
obedience	顺从
aapss	Social
wrapping	包装材料
tethyan	古地中海的
videoconference	视频会议
euhemerus	犹希迈罗斯
uppie	兴奋剂
unfirm	不牢靠的
unclos	Law
pierce	刺穿
ko	将……击倒
aic	Institute
unprincipled	不道德
hierurgy	礼拜
delphian	暧昧的
oeec	for
slavism	斯拉夫语气
unnecessary	不必要
cancered	患癌症
faintish	微弱的
postbase	词根后语素
autoclave	高压灭菌器
tap	轻敲
estonian	爱沙尼亚人
catface	表面呈现的凹凸
udag	Grant
barbarous	野蛮的
godparent	教父或教母
reminder	暗示
wilderness	茫茫一片
castoreum	海狸香
indiscriminating	不区别
deterrable	可防止的
noaa	National
scallop	扇贝
finick	吹毛求疵
concentrical	集中的
overtook	overtake的过去式
poundage	监禁
rewardless	徒劳
wired	以铁丝围起的
drooping	无力的
glance	一瞥
highland	高地
featherlike	轻如羽毛的
ancestral	祖传
archduchy	大公的地位
eutrophic	发育营养正常促进剂
supine	向后靠
clearly	明显地
huckster	叫卖
clangorous	响亮的
joint	接合点
aperiodic	非周期
shaky	震动的
apologist	辩证者
refasten	再次稳固
parlous	精明的
unpropertied	无产的
laxatively	放肆
atypical	非典型
korean	韩国语
novelize	使小说化
acoasm	幻觉
de	表面刻蚀
lioncel	小狮
blackamoor	皮肤黑的人
vmi	弗吉尼亚军事学院
upwell	上涌
bibliofilm	显微胶片
heavenly	神圣的
piezometric	量压
discreditable	丢脸的
cryptosystem	密码系统
variceal	静脉曲张
cobbler	工匠
intension	紧张
testaceous	介壳的
gloriette	亭子
heap	大量
thuswise	如此
flocky	毛茸茸的
gluttonous	饕餮的
fat	在……中加入脂肪
diluent	稀释的
lanceolated	披针形的
gur	=Voltaic
sittwe	实兑(即阿恰布
passementerie	珠缀
iconoclasm	破坏偶像得理论
apparel	衣服
freedwoman	自由妇女
clericalism	教权主义
alastrim	亚天花
implantation	灌输
bannerol	葬旗
degression	递减
handraulic	手力的
pinwheel	纸风车
cyrtostyle	柱子呈外突弧状排列的
prelicense	领取执照前的
pilot	领航
gallinule	n
overperform	偏离乐谱演奏
bonami	情郎
geology	地质学
syce	马夫
accidentalist	偶然论者
vengeful	复仇心重的
intercourse	交往
unreasonably	不合理
cowfish	角鱼
requote	对重报牌价
grasping	握的
hapless	不幸的
urgent	急迫
culture	文化
acinaceous	多子的
dogmatics	教理论
seamost	最靠近海的
putrefiable	会腐烂
latent	隐藏的
bland	乏味的
taboo	禁忌的
devotion	热爱
irrepealable	不可撤销的
kassel	卡塞尔
glanderous	鼻疽病的
segregator	分离器
bellbird	铃鸟
inpouring	注入
unitholder	单位信托证券持有者
penumbral	日月半影的
beamingly	喜气
crosspatch	脾气乖戾之人
alluvion	沙洲
uri	统一资源标识符
frigidarium	保持低温的房间
tranship	换船
ambiquity	含糊性
nematicidal	杀线虫的
cicatrize	生成瘢痕
phylloid	叶状
cowson	狗养的
bullous	大泡的
spikelet	小穗
gametophore	配子托
mingy	吝啬的
mtu	unit
quarterly	每季的
sambur	黑鹿
kate	的昵称
thrasonical	吹牛的
upcropping	生长
reason	前提
sun	太阳
fermentative	促起发酵的
mechanization	机动化
holidayer	度假者
thankfully	感谢地
cyetic	怀孕的
psychologist	心理学者
chowmatistic	理财
cureless	不能救济的
townish	城镇
mlg	Middle
byway	小道
embroidery	刺绣品
fulminating	呵斥的
sabotage	阴谋破坏
scout	嘲笑
spissitude	浓
retrospectively	回顾
meditate	沉思
extent	区域
formicivorous	食蚂蚁的
hepatobiliary	肝胆的
fricative	摩擦音
phs	Service公共卫生署
quirkiness	离奇
innocency	无罪
shippable	可装运的
circumfluent	周流
copernican	哥白尼
wildwood	自然林
etymon	字的原形
voodoo	伏都教徒
overshoot	射击越标
picked	摘下
plasmapheresis	血浆除去法
lithostratigraphic	岩石层窝У
carrion	吃腐肉
interauthority	当局之间的
hpv	人乳头状瘤病毒
logogram	简写
gcf	greatest
fallen	伏地的
indiscernible	难识别
eventful	变故多的
dreamful	梦多
pullus	雏鸟
buddy	密友
cithara	类似竖琴的乐器
temple	教堂
stub	树桩
circularize	分发民意测验单
introduce	提出
coptic	埃及古语
uncondemned	未被判罪
ethnography	人种学
pure	纯
current	水流
elizabethan	伊丽莎白一世时代的
bardic	吟游诗人的
semimoist	微潮的
seaweed	海藻
dobie	=adobe
fantasticate	使变得怪谬
autointoxicant	自体毒物
dealt	deal的过去式和过去分词
comique	滑稽角色
ial	Internationl
aggressive	好斗的
sclaff	轻拍
dreamy	梦想的
recollected	沉思默想
isochromatic	等色
filicoid	羊齿状的植物
sampan	舢板
procession	队伍
garda	Lake加尔达湖
primarily	主要地
idolatrous	盲目崇拜
timid	胆小
stray	迷路的
spikelet	小穗状花序
eds	Society英语方言学会
nom	Nominative主格
cellulosic	有纤维质
financial	金融
corrupt	误用
clearheaded	头脑清楚
corrodent	刻毒的
wicked	邪恶
slack	家常裤
indisposition	不愿意
pudendum	外阴
notehead	小型的印有抬头的信笺
hii	Insurance
people	人类
kingcraft	王道
water	含水
rhyolite	流纹岩
reassumption	再假定
theftproof	防盗
moray	海鳗
psro	professional
muscleless	无肌肉
irrationalism	不合理的思想
surrender	交出
dorset	lst
scandia	氧化钪
stateside	美国
symbolic	符号的
firth	峡湾
charm	吸引力
firenet	安全网
crankily	摇晃不定地
crummie	母牛
dispart	分离
pictographic	象形文字
allo	同分异构
emblement	庄稼
total	全部的
isker	=Iskar
caveat	警告
isoelastic	等弹性的
forsworn	forswear的过去分词
phlegmatical	粘液质
mpm	米[分
crissa	的复数
who	pro
loud	高声的
burnout	燃尽
sweetheart	私下签定
nuts	发狂
maternal	母亲的
rumor	流言
toreutic	金属浮雕
contemporaneous	同时期的
mammiferous	有乳房
patriarchic	=patriarchal
wealthily	富有
formalism	形式主义
scraggy	瘦弱
centralized	中央集权的
misclassify	对……进行错误的分类
essential	实质的
tumular	冢
earnings	所得
standby	可以信任的人
plait	把……打成辫
housecraft	家政学
immunoglobulin	免疫球蛋白
scolopoid	=scolopophorous
qcd	chromodynamics
goluptious	好吃的
inadmissibility	难承认的事
seaward	向海那一边
unsuspicious	无猜疑
outclearing	银行经票据交换所交换后应收入的总额
enormity	暴行
cardplayer	玩牌的人
obsecrate	恳求
refection	点心
slow	不活跃的
barrathea	=barathea
quotha	真的!
disputability	有讨论余
nizam	印度
somnial	睡梦中
waxy	苍白的
throat	开沟于
interlocutress	女对话者
rabbi	拉比
sole	脚底
overturn	毁灭
fog	被雾笼罩
thin	微弱地
actual	目前的
distrait	心不在焉的
fictioneering	小说写作
puzzlepated	思想混乱
reflet	光彩
baltimore	美国马里兰州的一城市
grewsome	可怕
mutinous	暴动的
utopia	乌托邦
rendering	透视图
thickset	稠密
napery	餐桌用布
rostrate	有喙状突起的
vtc	3D纹理纹理压缩格式
polygamize	实行多配偶制
blasphemy	亵渎
polypod	多足的
keir	漂染缸
exhaustive	彻底
plexal	丛
lamely	不完全地
arbitrament	裁决
inductively	归纳
versatile	多才多艺的
deactivate	使不活动
orthicon	正析
gigue	吉格
biannulate	有二环纹
moste	mote过去式
cog	嵌齿
crambo	韵语
command	支配
assentient	赞同的
iced	冰冻的
sideroblast	铁粒幼红细胞
thaumaturge	奇术士
budding	发育的
bergschrund	冰河上端的裂缝
chemolysis	化学分析
archaeological	考古学
oxacillin	苯甲异噁唑青霉素
cancha	斗鸡场
outer	远离中心
varicellate	具有小螺层隆起
generic	一般的
gruesomely	可怖地
phytocidal	除莠的
picture	美景
inversion	倒置
nefandous	说不出口
flinch	退缩
trick	欺骗
monoestrous	一次发情期
beachnik	整天在海滨游逛的人
haligonian	哈利法克斯居民
bumble	大错误
mobile	易变
somniloquism	=somniloquy
pyramidal	金字塔形
though	虽然
trisomic	二倍加一
kinaesthetic	运动感觉的
elizabethan	伊丽莎白女王的
remodify	重新修改
obtain	获
dispersion	传播
nom	nominal名义上
shoulder	承当
hudson	New
jackleg	不正直
appear	出版
extinctive	使消灭的
aeolian	风神
thermomechanical	热机械的
scraping	刮削下的碎屑
spa	游乐胜地
exalbuminous	无胚乳的
priceless	极贵重的
bagman	推销员
rubbedy	旅馆
crust	外壳
luminance	亮度
etruscan	伊特鲁里亚人的
streaky	有斑点的
unfitted	不合适
omnisexual	全性的
repressive	压抑
toluidide	=toluide
plasmoid	等离子粒团
reincarnate	赋予新肉体
alphahelical	单螺旋结构
bronco	野马
washrag	毛巾
menelaus	斯巴达王
nutritional	滋养的
leptophyllous	叶片狭长
front	前线
yquem	依奎姆葡萄酒
blunderingly	浮躁
programmer	程序师
leaning	清洁
elfish	好恶作剧
socage	农役租佃
seer	预言家
shapable	可成形
splodgy	有污垢
unheard	未被倾听
resplendent	灿烂
latvian	拉脱维亚的
outside	在……外
deformalize	使不拘礼节
abm	Balanced
universalise	=universalize
embryotic	未成熟的
sniffy	嗤之以鼻
crump	炸弹
protuberate	隆起
buttonhole	钮扣孔
hypocoristic	昵称的
netherward	向下方
makuta	的复数
flaringly	摇曳燃烧地
piscatorial	渔业
layperson	=layman
rhizomatous	地下茎的
calyciform	萼状的
desiccated	粉状
disquietingly	令人心烦地
nakedly	露出
grebe	一种鸟
sentimentalize	伤感
drowse	困
nanking	南京
distribution	区分
abiogeny	自然发生
skulduggery	作假
tranquillo	安静
schoolmaster	教师
instance	举……为例
farfamed	威名远播
demilance	短矛骑士
mouthbreeder	口育鱼
pyosalpinx	输卵管积脓
fetiparous	胎儿未发育完就生产
riverside	河畔
seminary	发源
hydrophilic	亲水
passel	一批
uranium	铀
pyopneumothorax	脓气胸
fore	在前
euclidean	欧几里得几何学
fritillaria	贝母
marcel	烫发
saintpaulia	=African
mean	平均数
twiggy	多细枝
curette	耳挖
wosa	Open
sapient	有见识的
goofy	愚笨
dumbbell	笨蛋
serpentarium	蛇类展出馆
irksome	令人厌恶的
familiarly	精通地
oxidative	具有氧化特性的
bob	剪短
superior	较高
rugged	有皱纹的
autosome	正染色体
algatron	藻类培养装置
health	兴旺
phosphorism	慢性磷中毒
grewsome	可怕的
jumpy	神经质
thuriferous	燃烧时散发芳香
plywood	夹板
parch	焦干
chord	情绪
fix	安装
crocket	卷叶花样或花形的浮雕
isogenesis	同式发育
chomp	切齿
masty	不易解决
incontrollably	不能支配
alien	相异
keresan	=Keres
superb	极好
fluorinate	使与氟素化合
mammonism	贪财
rare	杰出
bifilar	双丝的
zho	=dzo
gppm	Page
its	它
bracteole	小苞片
salesian	方济各·撒肋爵的信徒
cytherea	维纳斯女神
unmitigated	未缓和的
trio	三重唱
unsuspecting	不怀疑的
impedient	障碍
unedified	未受教化
peshitta	伯西托本
pine	渴望
awash	与水面齐平的
orometer	山地气压表
soulful	高尚
meditate	考虑
tartarize	用酒石处理
magnetooptical	磁光
cheater	欺诈者
consummately	至上
fissirostral	有裂喙
baldly	坦率地
drum	鼓声
calculous	结石
amain	全力地
nyt	York
cinerary	骨灰
morellian	莫雷利批评法
adamancy	固执
epizoic	体外寄生的
confrontment	=confrontation
spiky	长而尖
buzzard	贪婪的人
quadratic	二次的
elisabethville	伊利沙伯维尔(扎伊尔东南部城市卢本巴希
prodigiouss	很大
biochrome	生物色素
stupidly	愚蠢
frills	臭架子
unearned	不劳而获
baptist	浸信会教友
bivalve	双壳类
noncontradiction	没有矛盾
antiphonal	交互轮唱
quadrate	方形
transigent	自愿和解的人
miee	Institution
brutal	兽性的
lampyrid	萤科昆虫
saanen	萨能奶山羊
excubitorium	值夜人的房间
sprinkle	洒
bacteriostatic	细菌抑Ik/
stop	断绝
enactive	有制定权的
indisposition	嫌恶
profligate	放荡
predepression	经济萧条前
throughither	=throughother
roydon	英国伦敦附近一地名
strict	精确的
overset	为……排版过密
jot	略记
umpty	若干
bipedal	两足动物的
rio	可重用信息对象
exultingly	意
painful	疼痛的
stamford	斯坦福德
metazoal	=metazoan
linn	瀑布
sulphatase	硫酸酯酶
saturant	饱和剂
regraft	再接枝于
hawk	鹰派成员
sully	玷污
untalented	没有天赋
phosphatide	磷脂
asturian	阿斯图里亚斯人
ajar	微开
snathe	大镰刀的柄
bpi	字节/英寸
passionate	充满热情
snippet	片断
axiom	公理
schistous	片岩状
concede	让步
faggy	同性恋
ballonet	升降气袋
gulf	漩涡
metacarpus	掌部
malacophyllous	柔叶
segetal	在谷类田间生长
crayfish	退缩者
sidesplitting	令人捧腹大笑的
excoriate	批判
faecal	排泄物
amerceable	应罚款的
exegesis	解释
unconquered	未克服的
soporific	想睡
haematological	血液病学的
codepage	代码页
ancestral	祖先
factum	事实陈述书
lipotropin	促脂素
implacable	不安静
anagrammatism	字谜游戏
quotidian	每日
reflectivity	反射率
intelligencer	情报员
sibiric	西伯利亚各族人民的
life	生命力
sellout	客满的演出
favorable	有利的
mysterioso	神秘的
goldbrick	赝品
tripinnated	三回羽状
saucepot	炖锅
clergyman	教士
asbestosis	石棉沉滞症
unaccommodating	不与人方便
neomycin	新霉素
manipulatory	=manipulative
falderal	胡说八道
coincidental	一致的
hypognathous	下口式
worth	值的看中
recapitulate	概括
whimsical	反复无常的
vestalia	女灶神维斯太节
still	静止
inauguration	就职典礼
sinological	中国学
cautelous	警觉的
modus	方法
enharmonic	等音
newscaster	新闻评论广播员
quivery	颤抖
cryptopine	隐品碱
virulent	刻毒的
graveclothes	尸衣
manure	肥料
substruction	基础
socialistically	社会主义
parenteral	非肠道
girlhood	少女时代
favoritism	偏爱
aerarium	古罗马的国库
pigmentation	色素沉着
coaly	多煤
premalignant	恶化前
shyly	害羞地
resuscitation	复生
unimpressive	无印象
hep	熟知
scratch	乱写
midnight	午夜
kook	愚蠢的
affectation	虚饰
kitchenware	厨房用具
constructive	建设性的
wreath	花冠
unperceptive	无感觉
kismet	命运
hlf	and
toreutic	金属浮雕的
systole	心脏收缩
rictal	露齿裂嘴
enthralling	迷人
genitourinary	泌尿生殖器
jazz	使活泼
orthographic	正字法的
illusage	不公平待遇
fudge	胡话
abscess	脓肿
corba	Common
usis	Information
vdr	Disk
limp	跛行
clever	聪明的
seminal	精液
derisively	嘲笑地
ole	Object
outpouring	流出
inspirer	鼓舞人心
zein	玉米蛋白
hairball	毛团
hostility	对抗
teleconverter	望远倍率镜
sweetening	甜的调味料
basal	基本
superactinide	超锕系元素
charnel	藏骸所
concise	简明的
caudate	有尾
revolting	令人厌恶
phytopaleontology	植物化石学
storywriter	故事作者
contrived	人为的
sess	税
sugarhouse	制糖场
kerchiefed	围着头巾
notate	写成记号
variform	形状不同的
curacy	副牧师的职务
tetracid	四酸
unpleasing	讨厌
repulse	排斥
blundering	易犯错的
cephalometric	头部测量学的
joggle	啮合扣
faciocervical	面部与颈
modifier	修饰成分
pekin	北京
definite	一定
skiagraphy	光照像术
humankind	人类
herborize	采集药草
hypoxaemia	血氧过少
asu	American
bedarken	使完全黑暗
uml	Modeling
biology	生物学
redivious	再现
histotomy	组织切片术
nira	Recovery
owl	的类库
tiptop	黄金时代
inexistent	不存在的
nadge	北大西洋公约组织地面防空系统
forehanded	节约
moonlight	月光的
dogmatic	教条
edwardian	爱德华七世时代
appeasable	平息得了的
disciplinarian	训练者
generator	发生器
rennet	牛犊胃内膜
vacancy	空缺
kewpie	丘比特仙童
or	还是
neddy	马
hydatid	包虫
tactful	体
roofed	有屋顶的
universally	到处
unentertained	未被逗乐
rivalize	对抗
sourcebook	资料读物
french	法国
co	现付票
francium	钫
stouthearted	刚毅的
stitch	缝合
tension	拉紧
autarch	专制者
finned	有鳍状物
particulate	微粒
territorial	领土的
sarcomatosis	肉瘤病
sextuple	六重
anhydrous	无水的
cloud	以云遮敝
carlism	拥护卡洛斯争取西班牙王位者
reformable	可改革
scratch	挖出
backswing	棍棒挥出前的准备姿态
aquarian	宝瓶座时代的
unenvious	无恶意
economist	经济家
detainer	挽留者
beaverboard	纤维板
hyperacid	酸过多
irremediable	不能挽回的
checkerberry	平铺白珠果
antidrug	反对服用麻醉品的
decrepitude	衰老
recite	叙述
unanswerable	没有责任的
orientalia	东方史料
imitate	仿效
corruptive	腐败性
unload	退子弹
solifluxion	泥流作用
scut	短尾
ostensive	清晰显示
gasconade	吹牛
reginal	像女王
lyrical	抒情诗调的
swoop	突然下降
scurvy	卑鄙
autography	笔迹
mirage	妄想
bloodiness	血腥
pfd	personal
flock	聚结
bitterly	苦苦
bioresmethrin	=resmethrin
pierage	停泊费
collimation	瞄准
unsolicitous	未悬念
philosophy	冷静
mean	吝啬的
oso	Orbiting
crave	恳求
alcmene	阿尔克墨涅
greenhouse	温室
abeokuta	阿贝奥库塔
triseptate	具三隔膜的
barrator	买卖圣职或官位者
dlitt	of
magnific	庄严的
whistle	鸣汽笛
sulphurous	含有硫磺的
lathy	板条似
filial	当做子女
accepted	公认
thereby	在那附近
sylvatic	栖息于森林
mumble	闭嘴细嚼
mythical	神话的
fine	很好
falchion	刀
alonso	阿朗索
minipig	小种猪
ceruloplasmin	血浆铜蓝蛋白
blatancy	喧哗
entente	协约
absorptivity	吸收率
waveringly	犹豫地
polyhedra	的复数
bidet	下身盆
fian	band
evidence	显著
threnode	哀歌
substratum	底土
quotidian	每日发作
torino	托里诺
endogastric	位于腹中的
lipsticky	搽满口红的
gandhiite	甘
unfleshly	非肉体的
herodian	希律王室
kymography	记波法
process	步骤
expostulatory	忠告的
subminiaturize	使微型化
liquid	透明
remit	移交的事物
annihilable	可消灭的
robotomorphic	机械的
unable	不能的
lubricious	光滑
perceivably	可察觉
ruttish	发情中
seti	对外星智能的探索
flexibly	易曲
septennate	七年期
milchig	乳制品
washer	洗衣机
agronome	=agronomist
marathonian	马拉松人
swiveleye	斜视眼
local	当地居民
inconceivably	不可思议地
soper	=sopor
primordial	原始
midst	中间
transcendency	超凡
vtc	Volume
hoydenish	淘气的
perseverant	能坚持的
calcic	钙的
principate	元首统治
ajaccio	阿雅克修
prealtar	祭坛前
bipropellant	二元推进剂
solyanka	色尔扬可汤
codeine	用以镇痛
nonpartizan	无党无派的
distributor	发行人
magnetise	=magnetize
hyperaphia	触觉过敏
supportless	无支撑
vertical	顶点
pneumatic	灵魂的
advocation	拥护
tetramethyl	四甲基
broiling	炽热
bacchic	喧闹的
molucan	摩鹿加人的
passthrough	机器转移归向
strict	严格
state	国有的
outflung	扔出的
practic	=practical
uprootal	根除
beguilement	散心
ingratiatory	逢迎的
rush	使冲
tensive	张力
electroengineering	电气工程
fogbank	雾峰
unclassified	无类别
motherhood	母亲们
venom	恶意
defend	防卫
cha	茶
cockamamie	假的
shark	专家
laptev	拉普帖夫海
biradial	双重对称
ivr	Response
smtp	Transfer
circumstantiate	证明
fiber	光纤
measly	患麻疹
rap	敲
laxativeness	轻度腹泻
variedly	各种各样地
affray	吵架
choush	军曹
imperishable	不灭的
declamatory	演说口吻
warrant	使有正当理由
aristarchy	由贤能者治理国事
venturi	文氏管
subfloor	底层地板
optimal	最理想的
backpedal	倒踏脚踏板
industrially	企业地
fairly	正当
capricornus	摩羯宫
unconditional	无条件的
packhorse	驮马
godmother	名义上母亲
divided	分开
crabbed	易怒
unfermented	没有发过酵
consumable	可消费的
prism	棱柱
basketwork	编织物
valise	小提箱
unmilked	未挤奶
ileal	=ileac
engorge	狼吞虎咽
immunoadsorbent	免疫吸附剂
megawatt	兆瓦特
preceding	在前
unreligious	世俗
indonesian	印度尼西亚
featherlight	轻如羽毛
atypical	非典型的
unhasty	从容
antinational	反国家
indivisible	不能分割的
unpledged	未许诺的
untasted	未被尝过
inofficial	非官方
boychik	小伙子
bhl	希伯来文学学士
catarrhine	狭鼻猿
hircine	山羊般气味
monarchical	国王
bistable	双稳
celery	芹菜
snailfish	狮子鱼
tumular	古坟的
merchandizer	商人
peccavi	忏悔
retrovert	使后屈
shinplaster	纸币
clypeus	大圆盾
doubleheader	双车头火车
shoal	群集
stillborn	生下来已死
irritating	使愤怒的
unhidden	不掩盖
gest	武功
paterfamilias	家长
federate	联合的
greave	护胫甲
depose	免职
surfcaster	激浪投钓者
raven	乌黑
imputation	罪名
tetrabranchiate	四鳃
slavophil	亲斯拉夫人者
feller	伐木机
ringent	张开
flop	跳动
embroider	给……添油加醋
dunk	泡
liceity	合法
bimetallist	复本位制论者
privation	穷困
eulalie	尤拉莉亚
touch	触觉
ruefulness	悲伤
coxa	无名骨
backroad	乡村道路
molto	非常
dls	Doctor
endbrain	端脑
comusmacv	States
tache	环节
areologically	火星科学研究
clinquant	金光闪闪
prosit	恭喜
trirectangular	三直角的
inebriation	醉
susannah	苏珊娜
opiniative	=opinionative
uplifted	上升的
english	英国人
pennywort	止血草的一种
unwooded	无树木
unselfish	无欲
cymbalo	洋琴
divisibility	整除性
seamark	满潮水位线
longer	比较久
forepassed	既往的
housebound	不能离家的
caecal	盲肠的
bodily	亲自
consonance	一致
diluent	冲淡的
juglandaceous	与胡桃科有关的
bovine	似牛的
matricentred	以母亲为中心
rotamer	旋转异构体
unthoughtful	考虑不周的
hostility	敌对
underdo	不尽全力做
exchangeable	可兑交的
quietistic	寂静主义
ample	丰富
engagement	接站
gendarme	宪兵
beseeching	恳求似
fuliginous	煤烟的
tetchy	易暴怒的
rupicolous	居住在岩石丛中
imperturbable	沉着
disadvantage	不利条件
vacuolate	空泡的
idiomaticity	习语表达习惯
sideward	侧面
octachord	八的合音
desaturate	使增加褪彰
undigested	未经消化
unfoiled	未受阻的
command	指挥
garrulous	饶舌的
cunt	性交
uninspected	未经检查
zambomba	桑梆巴
hydroxy	氢氧根的
franchise	公民权
ductile	易延展
like	象
babassu	一种巴西棕榈树
brainwave	灵机
nccj	全国基督教徒和犹太教徒联合会
glycocoll	胶糖
beastie	动物
unfleshly	精神
presentence	判决前
disgrunt	怨恨地说
interbedded	夹层之间
mortal	必死的
period	周期
thinness	细
kineticist	动态艺术家
mitt	棒球手套
sedate	稳重的
upbear	支承
tridentine	特伦托主教会议的
gsp	Generalized
eaglewood	沉香属植物
acrimoniously	毒辣地
mora	短音节
pleasure	乐趣
speediness	快速
halaphone	哈勒风
failure	破产
abrazo	拥抱
praedial	不动产的
exoteric	普通的
doeskin	母鹿皮
snowcraft	冰雪知识
begob	=begad
vmd	Veterinariae
foci	配光
super	特大
horizontal	平线
johannesburg	约翰内斯堡
perissodactylate	奇蹄目
tschermakite	钙镁闪石
feign	装作
dysteleological	生活或自然之漫无目标的
audiovisual	视听的
cathexis	全神贯注
tribasic	三盐基
lira	里拉
redder	red比较级
sportfish	供垂钓者钓着玩的鱼
latinesque	有拉丁特色
hardtop	有金属顶盖
coadjutress	女助手
crush	碾碎
agential	代理商的
arrogation	霸占
sodamide	=sodium
cephalous	有头的
worked	处理过
deface	使失面子
regular	整齐的
hashish	以印度大麻提炼的麻药
autocorrect	自动更正
noncellular	非细胞的
peroxide	过氧化物
varicocelectomy	曲张精索静脉切除术
crankily	任性地
buckler	小圆盾
paleocrystic	由古结晶冰组成的
gcse	of
gig	乘轻便双轮马车
flattop	平顶的屋子
article	条款
ceratin	"角膜"
segregative	分离的
disarrangement	扰乱
heresy	异端
orrery	太阳系仪
yankeefied	美国式
anthropophobia	怕与人为伍症
willowy	多柳树的
trend	倾向
boomlet	小景气
tartarean	阴间的
flavourful	味浓
chirpy	活泼
pertinent	相干的
septennial	七年一次
whipper	鞭打者
average	卖出
anaclisis	依赖别人之心理
heretofore	此时以前
unsound	谬误的
scurfy	满是头屑的
copperworm	疥癣虫
behave	举动
envoy	特使
jackleg	没成熟的
kinemometer	感应式转速表
pondok	茅棚
erumpent	突然现出的
cockshut	黄昏
semiclosure	半关闭
caustic	腐蚀性
successional	接连的
entoil	使入圈套
mislike	厌恶
lull	暂停
befallen	降临
rostella	rostellum
recline	放置
zooming	快速上升
eudora	由Qualcomm公司出品
caseous	干酪似
counseling	咨询服务
verve	气魄
rotundity	球状
uh	上半部分
trailing	蔓延
broadish	稍宽阔
aerogram	无线电报
eds	Dialect
solebar	车架纵梁
metamorphic	变质的
rim	沿……边缘滚动
chasmal	深陷的
regally	象帝王
triangularly	成三角形地
suprathermal	具有的能量超过热激发能量的
nasa	国家航空和宇宙航行局
unenvious	无恶意的
symbolic	符号
dorr	=dor
vop	policy
incautious	不谨慎的
solidary	休戚相关
unfavourably	不利
sieur	阁下
tripolite	硅藻土
discotheque	迪斯科舞厅
geckotian	壁虎类的
diversion	转换
lull	哄骗
colourcast	广播彩色节目
grubstake	衣服
dilettantist	=dilettantish
instanter	即刻
palpi	palpus的复数
buyable	可买的
hiphuggers	裤腰低及臀部的紧身长裤
hick	反应迟钝的人
smutch	弄脏
footling	愚昧的
sforzando	加强的
euphausiid	磷虾目浮游甲壳动物
flagboat	旗艇
biconvex	两面凸的
briefly	暂时地
frigidly	呆板
unintelligible	莫明其妙的
fine	纯粹
ibizan	伊维萨猎犬
cool	使冷
leasehold	租赁
geometrically	几何学上
epoophoron	卵巢冠
perishingly	厉害
in	智能网络
fishworm	蚯蚓
attention	关注
draggletail	拖着不整洁之长裙的女子
voyeur	偷看下流场面的人
gratulatory	祝贺的
experimentalism	经验主义//lIst/
shoreless	没有支撑的
aeroplankton	空气浮游生物
nutrition	营养学
incontestably	无讨论余
canaliculated	有小沟
fertilizability	可受精
possess	持有
anzam	澳新马
precinct	区域
orthoclastic	有彼此直交的解理面的
reflected	反射的
fibrinopurulent	纤维素性及脓性的
vermiculation	蠕动
traipse	在……游荡
quadruply	四重
jacobin	雅各宾派及其政策
diabolical	恶魔
poroplastic	多孔柔韧的
scholastic	学者
metric	米制
consummative	使完婚的
wuzzy	=woozy
reactively	反应性
unrope	把捆绑……的绳解掉
immolation	宰杀
furriner	=foreigner
style	使铁笔作装饰画
poundage	手续费
festive	庆祝
minty	有薄荷味
huntite	碳酸钙镁石
sprat	鲱鱼属的小鱼
crisis	危险期
distractingly	发狂似的
shoeless	未钉蹄铁的
prosody	作诗法
stowaway	偷渡者
snide	卑鄙的
sphenogram	楔状文字
fluvioglacial	冰水生成的
roughtailed	尾巴粗糙的
recast	重铸物
russianist	俄国语言文学研究者
failure	故障
radiotelemetry	生物遥测学
lotiform	莲花形的
unmarried	未婚的
littery	杂乱的
tackle	应付
ligamental	韧带的
tumular	如坟墩的
intercession	调解
vietnamese	越南
quantometer	光谱分析仪
oligophagous	狭食性
cannibalize	吃同类的肉
ctd	贸易发展局
abdomen	腹部
slam	砰
thickset	密植
sickly	疾病流行
ecodoomster	生态毁灭预言家
prettyish	可爱
spiflicate	使沮丧
nobly	高贵
reassess	再课税
katabasis	大败退
geigers	放射性分子
thallous	铊
dolly	捣棒
heads	正面朝上的
kanaima	专事报复的恶鬼
hyperactivity	极度活跃
ceremonious	讲究仪式
reallocate	再分配
dumpishly	愚笨地
waster	浪子
tea	茶
roseate	容光焕发
pasturable	适于作牧场的
aeronautics	航空术
emendatory	修正的
evidential	提供证据
injunctive	命令的
calligrapher	书法家
fenestral	小孔的
ocotillo	蔓仙人掌
blunderbuss	轻率的人
servohead	伺服磁头
ricketic	佝偻病
suggestible	容易受暗示影响的
crossband	装饰薄木板
naboth	拿伯
hiplength	长至臀部的
assimilation	同化作用
dormer	天窗
loiasis	=loaiasis
tollie	=tolly
chanterelle	一种食用的蘑菇
usafe	States
downtonian	当顿的
cacorhythmic	节奏不和谐
bivinyl	丁二烯
kiwanian	基瓦尼俱乐部
essay	短文
largando	渐慢和渐强
nymphet	早熟女孩
inviolable	不可侵犯的
knockabout	喧闹
vaunting	傲慢的
dpi	per
crispy	精神爽快
piggyback	骑在背肩上
gherkin	腌食用小黄瓜
dankly	潮湿地
hulled	有壳的
acculturate	适应文化
leporine	似野兔
tripodic	用三脚的
hottish	尚热的
certain	必然的
reminiscential	=reminiscent
paleography	古文书
scourer	洗擦者
incontinence	失禁
illuminant	光源
sprinkle	喷撒
frisk	蹦跳
unvitiated	未被污染的
vietnamese	越南的
lsat	Law
anticolonial	反殖民主义的
syndicalism	职能政府论
radioactive	放射性
disconfirm	驳斥
pullulate	发芽
shave	刮脸
deterrence	挽留的事物
interlock	互锁
litotes	反语法
pvt	pressure
digitate	有趾的
tonsorial	理发
freshperson	大学一年级生
airt	方位
multipliable	可增加
dysprosium	元素符号Dy
handle	操作
respective	各自的
trimonthly	每三个月一次的
survivance	=survival
frse	Royal
sphagna	水苔属
rougeot	葡萄藤红叶病
fibrinopurulent	纤维素性及脓性
spaceworthy	具有太空耐航力的
flatten	使平
auxiliary	辅助
orangery	橘子的温室
compadre	伙伴
chebec	flycatcher
pioupiou	法国兵
suspensible	可中止
semiyearly	半年刊
spandy	漂亮
pigeonhole	文件架
defer	延期
leaflike	成薄片
interfacial	面间
thresher	打谷者
hamiticize	使含族化
correlation	相互关系
pourable	流动通畅
udag	城市发展行动拨款
nihility	虚无
festoonery	彩饰
possible	可能
henotic	有相同倾向
thermoplastic	热塑性塑料
stagnate	变萧条
dungy	满地是粪
irreparability	不可恢复
official	正式
oomingmack	ox
inherent	内在的
vibracula	vibraculum
opportunist	投机取巧者
smarmy	爱说奉承话
hex	巫婆
anticlerical	反对教权的
mts	Target
visually	在视觉上
bhl	Hebrew
oreo	"白心"黑人
chief	主要
interpenetration	互相贯通
intrench	用壕沟围绕
ambidexter	怀二心的
gossamer	小蜘蛛网
stript	的过去式和过去分词
eleemosynary	施舍
opponent	对立的
solaceful	带来安慰的
katzenjammer	喧闹
dardan	特洛伊
comusmacv	United
yoicks	催赶猎犬的声音
stitch	针脚
cno	Chief
barbarous	野蛮
apostate	脱党的
superintend	监督
permissibly	获准地
solicitor	法律顾问
lucille	露西尔
mendacity	撒谎癖
cirrose	有触毛的
milieu	环境
obelisk	方尖石塔
fudge	蒙混
lax	松
una	Association
brumous	冬天
effulgence	灿烂
acromegaly	肢端肥大症
recognise	识别
sunblasted	太阳晒枯
haggard	形容枯槁
remorseless	不知过错的
roar	滚动
levamisole	左咪唑
angina	绞痛
beesting	蜂螫的肿块
attired	用鹿角装饰
alien	外国
nafud	内夫得沙漠
modifiable	可更改
conformable	适合
force	魄力
converted	更换信仰的
flint	打火石
indiscretionary	轻率
vega	织女星
scratchback	搔背用的小扒子
plastogamy	=plasmogamy
senatus	academicus
geocentrism	地球中心说
amphipathic	两性分子
consentience	同意
crambe	海甘蓝
wahine	太太
screwy	扭曲的
psychotomimetic	重现精神病的
concessioner	受让人
thixotropic	触变
cosmological	宇宙论的
yeomen	仆人
suspensive	悬而不决的
logo	Logo教学语言
deck	覆盖物
kidderminster	Worcestershire
tilsit	太尔西特干酪
hamitic	哈姆的
poetical	诗的
radiomimetic	拟辐射的
dividual	分享
vertiginous	眩晕的
drunk	喝醉了
cysto	=cystoscopy
sudamina	痱子
thump	砰然地响
mentation	精神作用
hydatid	水泡
rap	Assisted
piligerous	具毛的
homefelt	舒适自在的
fenny	沼泽多
summons	传票
myob	own
appositive	同位格的
atypic	不合型的
unadvantageous	无助的
vitriolic	硫酸的
mahren	=Moravia
barrage	堰
undistinguished	听不清的
antemeridian	上午的
noncontrastive	非对比
fanum	臂巾
radioactivate	使带放射性
stump	烟头
trehala	虫茧蜜
flinty	燧石似
arachnoid	蛛网状
pursily	因有钱而傲慢的
ardeb	阿德布
successor	后续的事物
adas	Agricultural
forthgoer	先行者
western	有西方特征
reprieve	缓期执行
torrential	奔流
coadjacent	互相连接的
fondu	溶化奶油
medullated	有髓
exotic	奇异
annulose	有环
subluxation	半脱位
chartist	宪章派
divorcee	离婚者
vidual	寡妇
daffadilly	鲜黄色
numeroscope	数字记录器
roulette	点线机
listener	收听者
pki	Public
unimpressive	印象淡薄的
scotophilic	喜暗
parlay	连本带利地赌博
sensitive	感光
c	资本账
swim	漂浮
detectible	可发觉的
strychnin	士的宁
hullabaloo	吵闹声
halfway	中途的
faithful	守信
chervil	山萝卜
lick	鞭打
fogey	守旧者
unreasonable	过度
unstirred	没有被搅动
mannered	矫饰
proportional	比例的
xxi	21
afflated	来自灵感的
oratory	讲演术
dissipated	沉迷于酒色的
cultivable	可栽培的
thistly	有刺
corrugated	使起波状的
unaneled	未受临终涂油礼的
brownstone	赤褐色砂石建筑
fcic	Insurance
adjustor	调停者
heath	石南树丛
drawsheet	垫单
imap	Internet
flounder	困难地往前走
drabbet	本色斜纹亚麻布
equal	相等
desexualize	使无性能力
hymeneal	婚礼颂歌
acronichal	日落时发生的
sickly	惨淡
pathetic	悲惨的
cootie	虱子
forcible	强制的
sodom	罪恶之地
incessant	不停的
starter	起动钮
pushful	富有进取心的
entoil	陷害
kolsun	印度野犬
rabbin	犹太教教士
auscultator	听诊者
enterococcus	肠球菌
bahai	巴哈教的
computistical	经统计计算的
barococo	巴洛可可式的
emersonian	与爱默生有关的
peperoni	=pepperoni
talmud	犹太法典
hatful	一帽所装的量
hyacinthine	风信子
swinepox	猪痘
fecal	渣滓
sack	大袋
bacillin	杆菌素
counterpunch	反击
gag	使窒息
succussatory	摇动
hotly	热心
sirupy	象糖浆
fhwa	Federal
heteropolar	有极的
repolish	再磨光
unable	不会的
egotistical	自我本位
crepuscle	黄昏
sedimentation	沉淀
connotation	含蓄
parsec	秒差距
vop	as
tegular	瓦状
insecticide	杀虫剂
baudrate	波特率
mythological	神话
prolocutor	代言人
forestry	林产
unaptly	不适合地
incoherent	语无伦次
rpq	price
limonitic	褐铁矿的
endosternite	腹内骨
fit	准备好
bios	System
directional	方向的
entame	使不怕人
restis	绳状体
bpd	per
delineator	描写的人
micromodule	微型模块
telegraph	电报机
guisard	戴假面具的人
allonym	别人的名字
hunt	猎取
crepitation	劈拍声
vestige	丝毫
serpentarium	养蛇室
hydrometeorological	tjErE`lCdVIkEtjE`rClEdVI/
punk	低劣
singlestick	单剑
anonymity	匿名
smallshot	无足轻重的人
ribby	精疲力竭
batting	打击
chukchi	楚克其人
facetiae	滑稽文章
editorial	编辑上
jobmaster	马车或汽车的店主
extraordinarily	格外地
gasdynamic	laser气动激光器
jaded	厌倦
esb	脑的电刺激
convertibly	可交换
disappointment	失望
distractible	不专心
alchemize	使变化
geochronometry	地质年代测定
monologue	独白
emblematology	徽章学
spavined	跛
unridden	不受支配
bedraggled	全身泥污
pimping	微不足道的
hairtician	发式师
siamese	暹罗
hotfoot	火急地
mesh	相啮合
hyperemization	致充血
eutherian	真哺乳亚纲的
odontophorous	有舌突起
joggle	摇动
disheveled	凌乱的
intersubjective	主体间的
philanthropic	博爱的
rascal	无赖
porphyrize	把……粉碎
florilegium	群芳谱
contrivance	发明物
refresh	精力恢复
cainozoic	新生代
impossible	不可能
clamer	大声叫嚷
nice	精密
consistorial	红衣主教会议
tablier	围裙式装饰
bellmouthed	漏斗口的
synaptosome	突触体
quad	四方院子
acoustician	声学家
indigestibility	难消化
liquefacient	液化剂
depreciation	跌落
lover	情人
roupy	声音沙哑
woefully	可悲的
unfathomable	难解的
confute	驳倒
megapixel	兆象素
psychoneurotic	神经病
nonresistant	不抵抗的
unlicked	无礼貌的
advection	水平对流
ece	Europe
fosterer	养育者
handsew	用手缝
cumuli	堆积
ippf	Planned
galiot	带帆的小型两排桨船
chaussure	鞋类
scots	苏格兰人
daily	日常的
pyretic	引起发烧
alba	Fernando
physiognomy	地貌
obsessive	强迫性的
rockered	圆底
incident	事件
microencapsulate	把……装入微胶囊
abrase	擦去
monospecific	单一的
gleamingly	若隐若现地
facinorous	罪孽深重
detoxicant	麻药的
tmv	mosaic
defaulter	缺席者
unfading	可靠
henhearted	胆小
favorably	亲切地
inferior	次的
nefarious	邪恶的
recommission	把
foretooth	门牙
fore	以前的
ippf	Federation
rakish	放荡
autochory	自体散布
lousily	不洁地
yellowbird	黄鹂鸟
emplacement	炮位
idolatry	邪神崇拜
nonnatural	强迫的
prostitution	糟蹋
pellucidly	透明
filially	子女似
luxuriant	肥沃的
parabolic	比喻
unsuppressed	未镇压
nosogenetic	致病原因
cantlet	小段
yoghourt	酵母乳
lognormal	对数正态
monk	僧侣
megalecithal	多黄的
asi	i
bakelite	胶木
trainband	民兵队
rush	匆促
overrule	支配
parabombs	用集束炸弹袭击
maoist	毛主义
afferently	传入地
arrisways	斜地
dragoniye	龙般地守护
middlescent	中年期
corba	Request
private	私人
personae	persona
travertin	钙华
nonpartizan	超乎党派
netfs	全国教育电视片服务部
liftboy	电梯管理员
undetected	未被识破
pageant	盛会
compliable	屈从
suggestive	提示的
deweyite	杜威的门徒
hemotherapy	血疗法
sgml	Language
systematist	组织主义者
quintupling	五倍
closehanded	吝啬的
abreaction	发泄
dissimulation	装糊涂
thermomagnetic	热磁的
gertcha	去你的吧!
floppily	叭塌叭塌响地
call	访问
with	以
efflorescent	风化
facedown	直接对抗
obeah	该巫术所奉的物神
legit	合法的
thermoelement	热电偶
mysticism	神秘
state	状态
erring	错误的
irreality	虚构
alow	向下
uninvited	未经请求
sound	回响
retread	翻新
scrappy	爱打架
barbaric	肆无忌惮
msp	Message
oleiferous	产油的
cyclophosphamide	安道生
lms	Society伦敦数学学会
britannia	大不列颠
imminency	迫切
standardization	标准化
unmeasurable	不可测的
layette	婴儿的全套服装
sabayon	=zabaglione
bailiff	法警
brewing	酿造
pageant	游行
fire	射击
coenocytic	多核细胞的
adonai	上帝
vexillary	军旗
beetlehead	呆子
xebec	小型三桅船
devest	剥夺、褫夺
ozokerite	石蜡
serjeanty	=sergeanty
atypic	不定形
recrementitious	无用的
download	下传
nipponese	日本人的
regionally	域性
holmic	钬
resolvent	使分解的
thermos	热水瓶
tonight	今晚
grimly	可怕
chamberlaine	管家
atheistic	无神论的
scintillant	闪烁的
opposable	可反对的
voluminal	容积
autoregulatory	自动调整的
dependent	由……决定的
savable	可救的
statistic	统计学
gorge	咽喉
leaf	生叶
appoggiatura	装饰音之一种
spr	Society
spry	活泼的
machete	弯刀
bands	法官
meadowy	牧草地的
bloat	肿起
age	变老
counterviolence	反对暴力的暴力
xxi	罗马数字
our	我们
preface	开始
largess	贺礼
callback	回收
septate	被隔膜分开的
dry	口渴的
chalcedonic	石髓的
turdine	鸫
bromelia	凤梨科植物
fluctuant	起伏的
septennial	延续七年的
canonize	褒扬
unmeasurable	无法计量的
crosscurrent	相反的趋势
winder	会缠绕的植物
phlegmatical	粘液质的
legally	合法
rigid	严格
hyperaggressive	野心勃勃
consummate	圆满
panthelism	意志主义(尤指叔本华
renata	勒娜特
cringle	索圈
torii	鸟居
bijugate	有二对小叶
abnormality	畸形
shareable	可分摊
yearningly	同情
dytiscid	龙虱
flump	重落
absonant	不和谐
droppable	可以滴落
outfoot	超过
airfreight	空运
phylogenic	系统发生
vlaie	沼泽
crazed	癫狂的
radiac	辐射测量器
lilacky	淡紫色的
blanquette	用白醋调味的小牛肉
ample	丰富的
deliverance	意见
cholera	霍乱
wringing	淋湿的
somewise	以某种方式
unidentifiable	无法识别的
calorifacient	发热
annihilationism	tic//
unscrupulously	不客气地
hillcrest	山顶
foulmouthed	口出粗俗
suffocatingly	令人窒息
kcps	per
spatial	空间的
wrecky	衰弱
unspecific	不确定
bulldike	女子同性恋中充当男角者
bouvet	布维岛
forward	转寄
hysterically	歇斯底里
alveolar	小泡的
mercury	汞
rnase	=ribonuclease
cleistogamous	闭花受胎的
disjunct	分离
produce	创作
generalizable	可概括的
sigmoidectomy	乙状结肠切除术
womanity	女子气质
llano	大草原
corinna	科琳娜
resultant	作为结果而发生
squareman	木匠
unchain	释放
meiobenthos	较小型底栖生物
honorific	表示敬意
adventurous	敢做敢为的
scotch	粉碎
insistence	坚持
privateersman	私掠船之船员或船长
rda	allowance
unbearably	不堪忍受地
barycenter	重心
governessy	大惊小怪的
haiti	海地
headword	标题字
recognizance	保释金
awmous	施舍物
chaptalize	增加糖分
hominid	原始人类
superexcellent	绝佳
ferriferous	含铁
oniomania	购买癖
clodhopping	粗鲁的
anonym	化名
glisteningly	闪烁
sadomasochist	施虐受虐狂者
singularity	稀有
gimme	me
peloponnesos	伯罗奔尼撒半岛
outwatch	看守得比……长久
griseous	浅灰
iaupe	English
stomata	气孔
overgrew	overgrow
trailing	拖尾的
superdominant	上属音
lengthy	冗长
expensive	花费的
conidial	分生孢子
certainly	当然
push	推进
creosote	碳酸
babism	巴布教
oeec	Cooperation欧洲经济合作组织
puruloid	脓样
ozone	臭氧
drumble	行动缓慢之人或动物
riverine	河边的
viewer	阅读器
cudgel	棍棒
accentor	领唱者
bummer	游民
befool	欺骗
majestical	宏伟的
soldiership	军人的职务
corporality	肉体性
nerine	尼润属植物
billhook	钩镰
perissad	奇价
purgation	洗涤
pictorialist	运用绘画风格的人
decently	端正地
snide	伪造
canonicity	合乎教会法
barrelled	有枪身的
tusky	有獠牙的
intrigue	诡计
awaken	唤起
animative	令人振奋的
extortionist	强求者
axial	轴
abruption	分离
thankless	忘恩负义的
becoming	合适
rascal	淘气鬼
roofscape	屋顶景色
craniopagus	头盖骨连在一起的
sx	16位I/O之CPU
sittable	可坐
swift	敏捷的
pulsation	跳动
osfcw	Fuels
tyrannously	暴虐地
ordinand	续任神职之候补者
backwater	死水
phonic	有声
pelt	毛皮
liveborn	活产
quotidian	平凡的
ataxia	共济失调
foretop	额发
zygoma	颊骨
vrml	虚拟现实建模语言
modelly	具有模特儿特点
spermatology	精子学
scrummage	并列争球
coha	Council
sick	有病
bassist	低音歌手
apopemptic	临别
ingenerate	天生
usib	States
retype	重打字
academy	学院
australian	澳大利亚人的
unchristian	粗野
unfitted	不合适的
ultramodern	超现代化
erythrosin	新品酸性红
circumpolar	拱极的
impious	不尊敬
midwifery	促成
axenic	无异种生物混杂的
gangsterdom	黑社会
brachylogy	省略语
flexility	敏捷性
ridge	屋脊
excaudate	没有尾的
sanctum	书房
puckish	淘气
monolithic	单片电路
ergatoid	具有拟工蚁特征的
saucy	漂亮的
septuagesima	四旬斋前的第三个星期日
haem	血红素
centuplicate	百倍
aid	相关标识
pretty	恰当的
ponticello	琴桥
way	非常
skilly	羹汤
mitigation	平静
saker	猎隼
hadhramautian	哈达拉毛语的
employment	职业
sciuroid	松鼠
humble	粗陋
astonished	惊讶
ahold	迎风航驶
vestryman	教区会成员
rapturously	兴高采烈地
troupial	黄鸟
sestet	六重唱曲
baume	波美比重计
wise	英明
dmd	Doctor
copperhead	铜斑蛇
billabong	洼地
caip	IP
megaunit	100万单位
metapsychic	心灵学
fieldsman	外场员
micritic	微晶灰岩含量高的
transplant	移民
platysma	阔肌
gufa	圆形篮状船
magyar	马扎尔人
arbitrator	公断者
gook	日本人
karlsbad	Vary
pdq	Pretty
naughty	顽皮
nontelevised	电视上不播放
contend	竞争
unsleeping	时刻戒备的
hypnopompic	半醒的
riffy	多连复段
robustly	要用体力地
causation	出现
unfading	不衰的
cacao	可可豆
eeoc	Commission
megathere	大地懒
unwatched	未被观看的
chuffy	像农夫的
identical	同一
anticline	背斜
thowless	没精打采的
rumpless	无尾椎
lemnian	利姆诺斯岛
tricklet	小溪
epanisognathous	上齿比下齿窄的
cribble	粗筛
marry	嫁
connection	关系
gnathite	颚形附器
endurable	可忍受
extramental	精神以外的
pookoo	=puku
assuagement	缓和物
charter	租
sandy	沙
morbific	引起疾病
conceivable	可想像的
palestine	巴勒斯坦
antagonist	对手
bovine	耐心的
casey	凯西
dilatorily	慢吞吞地
mole	鼹鼠
unweighted	无重负
stratocracy	军阀政治
lcd	Liquid
lovesickness	相思病
marisat	海洋卫星
orangy	似橙的
background	后台
by	附近
copygraph	油印机
essentially	本质上
agamous	无性的
temporal	颞的
reflectance	反射系数
crouch	蹲伏
entisol	新成土
empurple	使成紫色
broking	经纪业
subentry	内条
harrowing	痛心的
videographer	电视录像制作人
prearrangement	预定
woodstock	伍德斯托克音乐节
actinomorphous	幅射量
peacebreaker	肇事者
synchronizer	同步闪光装置
narrow	狭窄的
postsynchronization	后期录音合成
pitchfork	干草叉
foldboat	折艇
jovial	高兴
degrease	脱脂
graphitoidal	似石墨
retaliate	报复
occlusive	咬合
relier	依赖者
solemnly	严肃
furbelow	衣裙边饰
subsidence	沉淀
decane	癸烷
clone	复制
breasthook	船首肘板
boisterous	喧闹
gambade	乱跳
uncivilized	不文明的
crackpot	狂想者
microtubule	微管
inconducive	没有帮助的
incontinent	立即
fleecy	羊毛似
kennel	进狗窝
tigrinya	提格里尼亚语
slobbery	流口水
squash	压制
sleepyhead	懒鬼
hazard	赌运气
gook	菲律宾人的蔑称
uae	Emirates
prepared	精制
phyllotaxic	叶序的
spent	失去效能
twine	搓
bbb	bath
gnarled	粗糙
governessy	大惊小怪
nib	削尖
jugal	面颊的
strandline	滨线
strictly	严格地
modestly	适当地
granularity	粒度
moiety	半族
mildly	温和地
sevenfold	七倍地
cowlstaff	杠棒
submissiveness	服从
abbreviate	缩写为
dispositioned	有某种性情的
resiniferous	含树脂
joint	联合
fin	鳍
telekineticist	心灵致动者
leopard	美洲豹
ablutionary	沐浴的
bioglass	生物玻璃
lachrymal	流泪的
rapidity	急速
imperialize	帝制化
wartwort	=wart
folknik	民谣歌星
avengingly	报仇
crankous	急躁的
immunohistochemical	免疫组织化学的
hoggish	贪婪
foxed	变色
specilization	特别化
path	路线
pleasant	舒适的
patrist	的人
nontraditional	非传统的
overpassed	过去了
scopy	能力
benignantly	有益
smart	痛苦
feathered	有羽毛
special	特别的
calced	有蹄铁的
trinitrotoluene	TNT
antifebrile	退热的
jugglery	魔术
pop	通俗
sedum	景天属的植物
tharm	腹
nailless	没有指甲的
discolor	使脱色
lanigerous	羊毛状的
semifinished	半制
protogyny	雌蕊先熟
laughter	笑
monogamous	单配的
abet	帮助
sao	Session
payout	支出
snugly	隐蔽地
laxation	轻泻剂
null	无价值的
recapitulate	重述要点
scousian	利物浦人的
gratulation	欣喜
rubberlike	橡皮状
liquid	易变的
argentous	亚银
expurgatorial	修订的
hemoblast	血小板
ural	乌拉尔
absquatulate	开小差
nes	e
embryotomy	难产时的碎胎术
risk	风险
cupel	用灰皿提炼
verbalization	冗长
washer	洗衣人
verbally	口头
slipknot	活结
rapturously	狂喜地
celbenin	二甲氧苯基青霉素钠
talus	距骨
knucklehead	傻瓜
optional	随意
menstruous	月经的
tail	使架住
stateside	美国的
abscondence	失踪
soil	国家
parade	夸耀
reconsider	重新考虑
ethnopsychology	民族心理学
gentle	文雅的
spotty	质量不一
linac	直线性加速器
thusly	=thus
drowsily	睡地
unseparated	不分离的
dr	医生
scurrilously	下流地
stargaze	空想
jawline	下巴的外形
hyaloplasmic	透明质的
pejoration	语义转贬
trochee	扬抑格
foreyard	前桅最下部的帆桁
lissome	柔软的
unprofitable	没有用的
nemoral	适林的
study	计划
monarchic	君主政体的
subhuman	低于人类的
dionysius	为叙拉古的暴君
pyrolyze	使裂解
blatherskite	听无聊话的人
bovine	耐心
decagynous	具十花柱的
antifederalist	反联邦主义者
knowledgeble	知识丰富的
geneva	日内瓦城
gossamer	轻飘飘的
kultur	沙文主义
embouchure	管乐器之吹奏口
calendry	压光车间
sanctum	圣所
federate	结成同盟
finity	有限
jointless	无关节的
drinker	喝的人
affirmatory	确定的
armageddon	哈米吉多顿
obsequence	巴结
gennemic	声象的
heterogamete	异形配子
unrazored	未修过面的
madrepore	石珊瑚
uneconomical	浪费的
paramo	高山稀疏草地
angiokeratoma	血管扩张性疣
nipple	奶嘴
uncreated	自存
pekinese	北京的
highness	高位
widespread	普遍
revisable	可订正的
finny	鱼族
orally	口述
implacable	不安静的
fledgy	有羽毛
pinpoint	极微小的
tumbler	大玻璃杯
uncommon	难得的
whisper	耳语
lusterless	没有光泽
yaroslavl	雅罗斯拉夫尔
electrolytic	电解的
creche	孤儿院
aja	Japanese
wadna	not
philanthropy	慈善事业
vitality	生命力
burman	缅甸人的
florid	绚丽的
biotypology	生物属型学
fuzzy	模糊的
clerically	如牧师般地
mercuric	汞
lorikeet	吸蜜鹦鹉
unwalkable	不适宜散步
binal	双重
zoo	动物园
shqip	阿尔巴尼亚语
apb	all
paranasal	鼻侧的
magellanic	以麦哲伦命名的
chantry	附属于礼拜堂的小教堂
difficult	艰难的
seducement	引诱
heartquake	震撼心灵
sensuality	好色
indefinably	不明确地
outward	向外的
soberly	严肃
preoccupant	抢先占有的
reconstructive	改造
morphosyntax	形态句法学
nymphlike	似
sorehead	落魄
grammaticalize	以语法结构表示
race	使空转
unenclosed	没围起来的
arpa	Projects
serjeancy	=sergeancy
risotto	意大利调味饭
inept	不称职的
decongest	解除充血
inferiority	次等
unisonous	和谐的
finsen	lamp芬森氏炭弧灯
nipponese	日本人
niggard	小气
worshipful	可敬的
polygonal	多边形的
nonboarding	不搭伙的
towerless	无塔的
pdu	协议数据单元
try	试验
mendacity	虚假
amiss	错误
caseous	干酪似的
assumed	装
allen	艾伦
humanity	人性
maidenliness	谨慎
chubby	丰满
downwards	向下
deniable	可拒绝
chainman	测量时拿尺的人
besotted	愚蠢的
fortuitous	偶然
simulative	假装的
resplendence	辉煌
iyft	Finger
regulate	校准
papal	教皇制度
brasswind	铜管乐器
reconciliatory	一致的
lonely	人迹罕至的
winslow	温斯洛
dyspeptic	消化不良的
periclean	伯里克利
ethnologic	民族
inanimation	没有生命
second	秒
arpa	Advanced
ultracritical	过于批评
hipped	忧郁的
juniorate	两年制预修班
unrent	未撕裂
snakelike	蛇形
epural	鱼脊尾稍的骨或软骨尾上骨
coal	煤
necrophobia	尸体恐怖
bairiki	拜里基
nerol	橙花醇
somesthetic	躯体感觉的
consilient	一致
daytime	日间
azoth	万应灵丹
washy	无活力的
harassment	折磨
jangler	争吵者
lameness	僵而疼痛
tanist	凯尔特族酋长继承人
home	有效的
ccst	Character
soul	精力
fatuous	愚昧的
alacritous	活泼
ligroin	轻石油
feather	用羽毛装饰
scrawny	骨瘦如柴
tiptop	绝顶
bathos	虚伪的
avgas	飞机用的汽油
theatrically	戏剧化地
embedded	内含的
unfixed	不固定的
unpoetic	无诗意的
scramble	攀登
agio	贴水
gneissic	片麻岩的
welfarism	社会福利国家主义
wicked	缺德
brisk	轻快
irretention	不能保持
therapsid	兽孔目
cervine	鹿的
swift	敏捷地
colotomy	结肠切开术
disoperative	不合作的
babyism	婴儿时期
unprinted	未印出的
rezaiyeh	=Rizaiyeh
fenian	爱尔兰古代勇士
cleared	清除的
factualistic	求实精神
helluva	很难的
forwardness	早熟
ensue	跟着发生
walkway	人行道
green	绿色的
agorot	的复数形
victimless	无受害人的
sternforemost	船尾向前地
concise	简练的
jacobin	雅各宾党人
sandunga	萨恩杜加舞
nutpick	取出胡桃果仁时所用的尖形挑针
substantive	真实的
suckle	吮吸
dysphoria	烦躁不安
triad	三个一组
fecund	生殖力旺盛的
chimerism	嵌合性
vitalization	赋予生命
grazioso	幽雅
turkmenistan	土库曼斯坦
gwtw	Gone
spermous	精液状的
blithe	愉快的
merchant	贸易商
lutrine	水獭的
deuteranope	患绿色盲的人
vile	简陋的
favorable	良好的
nampo	南浦
cornflakes	脆玉米片
nye	奈
madding	狂乱的
haggard	野性
cosmism	宇宙论
drogulus	无形实体
coxy	骄傲
cacogastric	消化不良的
morbific	引起疾病的
autochthonal	土著
tarheel	焦油脚人
jealous	嫉妒
syphiloid	象梅毒的
rearmost	最后
iaa	acid
firer	放火者
saida	赛伊达
mime	protocol
invincible	不能征服
blind	盲目的
detectable	可发觉的
twopenny	不足道的
eisegetical	穿凿附会
astronautically	太空航行
salted	盐腌的
fireless	没有火焰的
quattuordecillion	一后面有四十五个零之数
herbarize	=botanize
holder	持有者
dunt	重击
file	琢磨
polypoid	水螅似
visard	覆面
hcs	somatomammotrophin人绒毛膜生长促乳素
providence	深谋远虑
fountful	多喷泉
vermonter	佛蒙特州人
hii	Institute
tabor	单面小鼓
plough	耕
cabalistic	犹太教神秘哲学
cattleship	载运牲畜的船
touchpen	触笔
realizable	可了解的
checkrein	控制
kroo	克鲁族
appulsively	撞击地
gourdful	一葫芦的量
telpher	使用缆车运输
ferromagnetism	铁磁性
levorotation	左旋转
dissociableness	孤癖
homogamy	同子生殖
sparkling	闪烁的
verso	反面
nether	下层社会
pert	辛辣
mst	山区时区
overpowering	无法抵抗的
roadworthy	适于行路
subsistent	现存
excisable	可割取的
inegalitarian	赞成不平等的
paleoenvironment	古环境
tagmeme	法位
reboso	=rebozo
crystallitic	微晶的
shadowy	有阴影
ingenuous	自然的
kinsey	金赛
pendular	摆动的
impeccable	没有缺点
permute	序列改变
coinheritance	共同继承
associational	协会的
minestrone	蔬菜通心粉汤
tsoris	痛苦
whipt	whip的过去式及过去分词
platelet	血小板
pushchair	折叠式婴儿车
message	预言
churn	搅乳器
windup	结尾的
disciplinarian	规律的
meshuga	失常的
deport	驱逐
barnard	巴纳德
rusty	铁锈色
coign	隅石
hance	拱腰
volumenometer	排水容积计
benty	硬草的
prepackage	出售前预先包装
hurdle	跳过
magnific	庄严
endocardium	心内膜
liquid	明亮
kappa	10字
intangibly	模糊地
desterilization	解除禁止使用
staggeringly	摇晃
reefer	收帆的人
special	特派员
sardinia	撒丁岛
tricoloured	有三色的
numina	numen的复数
respectively	分别地
enticement	诱惑
paneling	嵌板
wob	浪击落水
haybag	女人
apperception	知觉
nighted	入夜
deltawing	有三角翼的
splendidly	华丽
isolation	隔绝
currant	黑醋栗
psalmodist	唱圣歌的人
felly	外轮
oblique	不坦率的
humoral	由体液引起的
kosher	合适的
tollbooth	过路收费亭
smutty	煤黑
stop	车站
heeled	有后跟的
subvertical	接近垂直的
sedentary	坐惯
antefix	末端装饰
distortive	事实
vibrotactile	震动触觉的
pop	开枪打
dinghy	小游艇
uncanny	离奇的
surfcasting	激浪投钓
irresponsive	无答复的
gesneria	苦苣苔科的
tele	电视
dermographia	皮肤画纹现象
mural	壁画
obtect	具被的
somatotroph	亲躯体细胞
outright	彻底的
thermodynamic	热力学
decollation	断头
ritzy	豪华的
windblown	被风吹斜
expellant	有驱逐力的
psychotomimetic	拟精神病
metayer	对分佃农
piagetian	皮亚杰的
upset	混乱
septuplicate	乘以七
egregious	过分
tribespeople	部落成员
outspan	脱卸马具
prop	支持者
squireen	小地主
bellman	更夫
brimming	满溢的
ecru	米色
informed	见多识广的
stepper	以特殊姿态行走的人或动物
uncensored	无保留
joking	戏谑的
macroorganism	大生物体
biquarterly	三个月两次
cellobiose	纤维二糖
rejuvenate	使复原
nooky	性交
makebate	惹是生非的人
ascertain	探知
blowout	爆裂
about	转向
rupestrian	在岩石上发现
pedigreed	血统明白
strac	Army
devastating	破坏性
infamatory	中伤的
larva	幼虫
tenderness	嫩
cluster	串
fountainhead	根源
munch	大声咀嚼
untasted	未经辨味的
hypercautious	过于小心的
hydrofluoric	含氢和氟的
reflectingly	反映
goblinry	小妖精行为
clad	clothe的过去式和过去分词
bursiform	囊形的
middlebuster	=middlebreaker
mortal	人类的
marry	和……结婚
nameless	不知名
abruptly	唐突地
handguard	护手盘
lokanta	饭店
shortstop	游击
aiche	American
flabellifoliate	叶呈扇形排列
irreformable	难以纠正的
yardmaster	调车场场长
furor	狂热
mutarotase	变旋酶
tunicate	有被膜的
bubble	潺潺的流
machiavellian	马基雅弗利的
flory	=fleury
toehold	攀登悬崖时的小立足点
overstrength	人员超编
finish	完美
peripatus	栉蚕
sponsorial	主办者的
bedlam	混乱
xp	Programming
uninhabited	杳无人迹的
thematic	论题的
wscf	Federation
bimetal	双金属器件
forward	运送
amazonian	有男子气的
menstruum	溶剂
sec	书记
barbotine	装饰用料浆
subadult	接近成年的
plonko	酒鬼
vellicative	能拔
oenophile	酒的行家
pluperfect	过去完成时的
ethnologic	人种学的
sax	for
underproof	酒精含量在标准浓度下的
dish	碟形卫星天线
quadrangularly	四边形
psychoenergetic	[量的
interoceptor	内部感受器官
macedoine	杂样水果冻
acalephe	水母
anchovy	凤尾鱼
wa	Washington
exceptionable	可抗议的
resentment	怨恨
fulgurate	用电气烧灼
acquiescent	默许
hesitative	支吾其辞
painstaking	辛苦的
monotheism	一神论
filiform	纤维状
acrodynia	肢端痛
cricetid	仓鼠
run	熔化的
tuberose	晚香玉
dungy	满地是粪的
previous	返回上一级菜单
bargaining	商讨
hexagonal	六边形的
bughouse	疯狂的
scope	机会
partnership	合伙企业
countryside	乡下居民
chyliferous	输送乳糜
lifo	out
soupiness	多愁善感
crutch	帮助
frightful	非常
deterrable	可威慑住
petite	细的
annuli	轮
former	以前的
confiscator	充公
begin	首先
uncorrected	未加管教和
leavisian	利维斯风格
mobility	灵活性
bicornuate	双角
authoritarian	独裁主义的
styptical	止血
alloimmune	同种免疫
residential	与居住有关
tridimensional	立体的
brevetcy	名誉晋升的军衔
spirituel	愉快的
pawnbroker	典当商
entrepreneuse	女主办人
rooflet	小屋顶
uvula	悬雍垂
bia	Analytics
dealership	经销权
thyrosis	甲状腺机能病
crackajack	上等的
aerodrome	机场
variable	变量
hauler	运输业者
reject	被弃之物
enormous	凶暴
filicauline	有丝状茎
miri	mir的复数
russ	俄国人
extenuative	情有可原
thundering	雷鸣的
outrange	超过
fend	供养
chemosmotic	化学渗透现象的
goaty	山羊似
crystal	水晶饰品
eerie	奇异的
zygogenesis	合子形成
laith	厌恶的
bojardo	博亚尔多
onychomycosis	甲癣
tan	茶色
aleatory	偶然
muscle	肌
talliate	向……征税
iconomachy	对偶像之敌视
hemialgia	单侧痛
hymnodist	赞美诗学者
schmaltz	极端流于感伤的音乐
sweetback	男妓
lwop	without
ludicrous	滑稽的
diadochy	同晶性型
undisguised	公开的
bratty	讨厌的
esemplastic	有融合作用
photoelastic	光弹性的
precipitate	突如其来
quarantinable	应受检疫
furioso	强有力
sweaty	出汗
seignory	领地
succedaneum	代用品
rewinder	重绕机
antisymmetric	反对称的
burstone	以矽石做的臼
hieroglyphologist	象形文字学
imaginabale	可能的
celebrated	著名
tutti	全体齐奏
turbidimeter	浊度表
motherly	母亲的
insinuation	暗讽
anthropomorphic	神、人同形ze/9AnWrEpEJ`mR:fIk/
benefice	僧侣所领之禄
hectograph	胶版印刷
carfare	票价
lipotropism	抗脂
gaiter	绑腿
pedestrianism	徒步
snipe	诽谤
contestant	争论者
shackle	脚镣
piffling	不足道
elastomer	人造橡胶
sootily	熏得乌黑地
inappellable	不得上诉的
private	私营
wallow	沉迷
taboo	禁止使用
dane	丹麦人
psalter	诗篇集
oubliette	地下密牢
running	流动的
detractor	诽谤者
zonal	带状
feep	尖笛声
revisit	再访
verify	查证
frivol	虚度日子
handfast	婚约
retractile	取消的
psychosomatic	精神身体相关
score	获得
fallow	不活跃
melodrame	=melodrama
interproximal	邻间
inimicable	有害的
reginal	像女王的
resurrective	促成复活的
tripodic	有三脚的
qea	Airways
exsect	切去
mendicant	乞丐
probational	缓刑的
homocyclic	同素环状的
executioner	刽子手
instancy	迫切
provencal	普罗旺斯语
topless	高得好像望不到顶
millenarianism	千福年说
sombrous	昏暗
prelithic	石器使用前的
succinct	紧身
wintry	冬天
drifting	飘动
physiological	生理学
suberization	栓化作用
mobility	活动性
delator	控告者
somber	昏暗的
experiment	进行实验
forbiddance	禁令
millenarian	一千年的
supersensuous	超感觉的
unnoticed	被忽视
thecate	具膜
affront	轻蔑
avg	average
state	正式
pyrocellulose	焦纤维素
thickset	粗短的
phytozoon	植形动物
bronchial	支气管的
uncivilized	不文明
ferryboat	渡船
stage	阶段或时期
undesigned	偶然
arcuate	弓形的
bassoon	巴颂管
paal	桩
appropriation	占有
correlate	和……相关
sled	摘棉
torsional	扭转的
kantele	康特勒琴
vortically	旋转
halfnote	二分音符
chrp	Reference
synergism	合作
funereal	适合葬礼
criticize	责备
pericardial	心包
antinoise	抗噪音的
monocarpellary	单心皮
benignantly	仁慈地
flush	发红
spherical	球形
foraminiferous	有孔虫目的
thermophil	嗜热
flusteration	=flustration
quotable	可引用
puniness	弱小
undying	不朽的
azion	再生蛋白质纤维
volitant	飞
nocturnality	夜间活动
judah	犹太
nse	Stock
conversable	健谈
cicerone	导游
mughul	=Mogul
campaign	参加活动
numerous	众多
nostology	老人病学
dm	Management
sixer	以6分计算的击球
micropulsation	微脉动
stinking	烂醉的
fine	细微
intricacy	错综
aquarian	宝瓶座时代
importer	输入者
arresting	可观的
fatidic	预言性
very	恰好
savageness	野蛮
pyogenesis	化脓
translatable	可译的
mouchoir	手帕
imposturous	欺骗
hitachi	日立
stravage	游荡
late	新近的
villagization	村有化
reptilarium	=reptiliary
poroplastic	多孔柔韧
hearty	丰盛的
usable	合用的
separate	个别
pigmentary	色素的
psychotherapeutics	心理疗法
tantivy	疾速
nasofrontal	鼻额骨
arthral	关节的
sniffle	鼻子哼哼的做声
exculpatory	辩解
macarthur	麦克阿瑟
parascience	超科学
ethynyl	乙炔基
apocalyptical	启示论的
frolicsome	爱闹着玩的
glanders	马鼻疽
kiss	接吻
liquorish	讲究吃的
charitarian	慈善家
demented	发狂
monotony	千篇一律
befrogged	饰有盘花钮扣的
plagiocephalic	斜头的
fade	消失
dissociably	可分离
bathymeter	测深计
crinoid	百合样
novel	小说
diabetic	糖尿病的
confiscator	没收
intrepid	无畏
alluring	诱惑
lapse	下降
scintillant	闪烁
neandertal	=Neanderthal
calced	有蹄铁
cogent	恰到好处的
posadero	客栈老板
biting	尖锐
lao	老挝人
apa	all
abomasum	皱胃
snorty	流鼻涕的
nonage	未成熟
picrate	苦味酸盐
palomino	身体淡褐色并有白色鬣毛和尾的一种马
uvulitis	悬雍垂炎
pork	与性交
certainly	的确
snorter	强烈的打击
picked	摘下的
marshy	生于沼泽的
bargirl	酒吧女
zolaesque	左拉
frondent	叶子很茂盛
bossism	领袖的政党控制
adamancy	坚硬
uninspired	缺乏创见的
reagency	反应作用
thrust	推力
relique	遗体
disconformity	n
bullate	肿胀
rewire	再接电线
christy	=Christie
episteme	知识
leucomaine	蛋白碱
mint	大量
pinhead	小东西
oppressive	压迫的
unuseful	无用的
sneering	嘲笑的
uneducational	不推进教育的
batdambang	=Battambang
antimicrobial	抗菌剂
wrest	曲解
guzerat	=Gujarat
inhaust	饮
roorbach	在选举前为中伤敌政而作的诽谤性谣言
vestiary	衣服的
eteocles	厄特俄克勒斯
biconical	双锥
metathoracic	后胸的
guacharo	南美产鹰的一种
cyproheptadine	二苯环庚啶
aphony	=aphonia
water	流体
nicol	=Nicol
calisaya	黄金鸡纳树皮
wider	广阔的
green	青春的
pippip	再见
crunchiness	脆弱
charolais	夏洛来牛种
metalsmith	金工技工
inferential	推论性
contracted	已定约
unscrew	从……旋出螺丝
womanish	柔弱
alingual	任何语言都说不流利的
perpendicularity	直立
floating	浮动
microwave	微波
circumspectly	慎重地
subpleural	胸膜下
versify	把改写为诗
carbuncle	痈
circe	女巫
chromoplasmic	易染浆的
penannular	近于环状
squamulose	多小鳞片
waspish	尖刻的
vacationist	度假者
sterling	英币
joyo	com
welter	滚动
postmenopausal	绝经后
oligocarpous	果实不多的
manorial	庄园的
tap	分接
labouratory	化验室
telephonic	电的
hypsometrical	测高术
outrageous	无耻
radioautograph	放射线映像
wifedom	=wifehood
symbolism	象征主义
horoscope	占星
untidy	不简练
tinned	镀锡
unexpectedly	想不到地
terrane	岩层
omnitude	普遍性
certified	被鉴定
heilungkiang	见Heilongjiang
zodiacal	黄道带内的
tricrotic	三重搏
toothbrush	牙刷
aftermath	后果
smudge	染污
dissyllabic	二音节的
lifeful	充满活力
abiogenetic	自然发生论
blithering	胡扯的
flubdubbed	易犯错误的
overdramatize	过分夸大
kgb	Bezopasnosti
slavery	奴隶身分
ciliate	有纤毛
cavu	云高及能见度无限
vestry	小礼拜室
kiwanian	基瓦尼俱乐部的
sahelian	萨赫勒地区的
caesaropapism	国家高于教会
bodleian	牛津大学图书馆的
mdclxvi	1666
aethereally	天上
jumpily	易变动
blizzard	大风雪
intertwist	缠绕
miesian	密斯
safar	回历2月
handclap	鼓掌
ciliary	睫毛的
statistical	统计学的
hucklebone	坐骨
neve	粒雪
please	取悦
unsharp	不明显的
visualization	清楚地呈现在心
motordrome	汽车试车场
groovelike	墨守成规
charnel	似停尸房
hallowmas	万圣节
taa	Assistance
royal	第一流
mtu	Unit
motorway	汽车高速公路
square	平方
intercoastal	两岸间的
cock	雄鸟
flavorous	可口的
recorder	记录器
odds	成败的可能性
total	总的
lilylike	像百合的
tawie	易驾驭的
inbox	收件箱
unglamorous	单调的
freemasonic	共济会
scutcheon	名牌
descensive	向下的
syntactically	依照句法
concealment	隐蔽处
hyperfocal	超焦的
extensively	广阔地
exacerbate	使烦恼
graphomotor	运动的
gallican	古代Gaul教会
omniscient	无所不知
apprehension	理解
trikerion	三叉烛台
hammer	锤击
rush	赶紧
rostov	罗斯托夫
transatlantic	大西洋彼岸的
guitarfish	犁头鳐
perspicuously	显明
piggywiggy	小猪
kite	高而轻的帆
gametocyte	配子细胞
autotrophic	自造营养物质的
circadian	以24小时为周期的
vfr	flight
metempsychosis	轮回
choreman	打杂工
practically	几乎
secretaryship	书记
thrive	旺盛
momentous	重大
theatergoer	戏剧家
sysop	系统操作员
yttrotungstite	钇钨华
wattle	板条
unprimitive	非原始
solvend	溶质
matriclan	母系氏族
nautili	nautilus
obovate	倒卵形的
quatercentennial	400周年
cablecast	用电缆电视播送
inerrant	确实
terylene	涤纶
nursemaid	育婴女佣
lame	无说服力
sandal	穿上便鞋
facetiae	诙谐
choleric	易怒的
budget	编入预算
dm	of
wtp	无线办理协议
nonviable	无法生活的
intercalary	插在中间
carissima	亲爱的
predominate	成为主流
overfed	overfeed的过去式及过去分词
turbotrain	汽轮机列车
concerning	关于
elective	有选举权的
louse	虱子
brush	刷
wobbegong	=carpet
lodgment	沉淀
msie	Master
medieval	老式的
silklike	丝状的
disentrance	使从迷惘中觉醒
designing	阴谋
exsufflate	吹走
plumbite	铅酸盐
sunfed	Special
hostile	敌方的
confirmatory	确定
excitosecretory	兴奋分泌
de	Etching
liberation	解放
antifederalist	反联邦党员
aram	Royal
backswept	向后倾斜
divesture	=divestiture
swakara	西南非洲卡腊库耳羔羊皮
kurtosis	峰态
nautical	海上
condemnatory	处罚
isolation	绝缘
cutoff	近路
inobtrusive	客气
balladize	将
rebate	减少
like	愿意
pyrotechnic	出色的
phototropism	趋光性
falcon	猎鹰
catadioptrics	兼反射光及折射光
retroverted	倒退
kyloe	苏格兰高地产的长角种小牛
pomander	香盒
admit	容许
plastocyanin	质体蓝素
seeing	视力
flitch	腌的猪肋肉
vole	孤注一掷
hackery	两轮牛车
exquisitely	精巧
datcha	别墅
sonochemical	声化学
determinate	确定
fraternise	=fraternize
buffoonery	打诨
riffle	涟漪
hullo	招呼用之呼喊声
sparkler	闪烁发光物
luck	运气
buhr	硅质磨石
fatherhood	父亲的身份
successional	连续性
pivotal	关键的
gwyn	格温
cornily	带乡下味
speedway	高速公路
barramundi	=barramunda
polemologist	战争研究者
anaclitic	情感依附的
legalist	形式主义者
lactescent	乳汁状的
juju	物神
steep	急剧升降的
unbodied	无实体的
shapeless	无定形的
rijeka	里耶卡(旧称阜姆
sea	海洋
iphigenia	Agamemnon之女
dishoard	抛售
defluent	向下流
causse	喀斯
microinjection	显微注射
impromptu	即席
exciting	使人激动
culpable	该责备
dysfunction	机能不良
poplar	白杨木
secondhand	间接听来
thoughtfully	仔细地
neutrality	中立
gargoylism	承溜口病
theocrat	神权统治者
reoccupation	收复
network	网状物
sothiacal	=Sothic
fix	牢记
evitable	可避免
acquirement	习
miseducate	的教育
paoting	保定
parapodium	侧足
polyarthritis	多发性关节炎
effectual	奏效的
opec	Petroleum
intimacy	隐私
traymobile	手推托盘车
linebreeding	同种异系交配
broad	宽阔
tongs	夹具
outwalk	追过
arctic	北极区的
mentality	精神
kraut	德国人
blockhouse	碉堡
airslake	风化
broadcast	广播
herring	鲱
upcast	向上抛
buildup	形成
traumatic	外伤
flowery	多花的
mammonite	=mammonist
repetend	反复语句
broadside	舷侧
circlewise	环形地
inquietly	焦急地
regular	常备军
present	瞄准
upheaval	剧变
confer	协议
watercart	卖水车
plastron	胸甲
en	N
workbook	业务手册
ascolichen	囊菌地衣
zoogloea	细菌凝聚团
retransfer	转移到原状
skibob	雪犁
kinetosis	运动病
csce	and
rootle	挖掘
jobber	股票经纪人
tangshan	唐山
erotogenic	性感应区的
coi	of
savourily	有味道
batonist	指挥
dryly	枯躁无味
blasphemer	亵渎者
font	泉
promiscuity	尤指男女乱交
worldling	俗人
atheistical	无神论
odontologic	牙科学的
sensitive	灵敏
scye	袖孔
admission	承认某事之陈述
ebony	黑檀
recessionary	衰退的
fearless	无畏
suzerain	国群主
cellulated	由细胞组织成的
hoofed	装蹄
freak	反复无常
dermoskeleton	皮骨骼
chlorophyllous	叶绿素
ungrounded	无扎实基础
ranseur	三叉矛
symbolism	符号论
corroboration	确证
procurator	代理人
sandiness	沙质
urinoir	公共小便处
bedlamp	床头灯
shuba	长皮大衣
medical	体格检查
transracial	异族间的
cyrtostyle	圆肚门廊
bourbonism	波旁皇族之拥护
heyday	年富力强时期
procryptic	具保护色
unmurmuring	不发牢骚
reprieve	缓刑暂缓
sesotho	塞索托语
interrogative	表示疑问
celsius	摄氏的
epidermolysis	表皮松解
vulva	孔
oceanity	=oceanicity
ludic	顽皮的
collocable	可搭配的
mavourneen	宝贝
ethnogeny	人种学
collarless	无马轭
indagator	研究
panocha	墨西哥的粗糖
wenny	=wennish
teniasis	=taeniasis
incomprehensibility	测
abri	避难所
assizes	巡回审判
drowsily	昏昏欲睡
cloistral	孤独
plf	foot
votable	能投票
calypsonian	唱calypso歌曲者
religiose	狂信的
horner	吹号角的人
vintage	最佳的
praiseworthy	值得称颂
koromiko	类似慈菇的草木
prosper	成功
egotistical	任性的
forgiveness	宽仁之心
scoreless	没得分
rhinostegnosis	鼻阻塞
salse	泥火山
lovestruck	热恋中的
holobenthic	终生在海底或靠近海底生活的
impeccant	无罪过
stipulate	规定
unsensible	无知觉的
pescara	佩斯卡拉
managing	节约的
syrup	果汁
mede	米堤亚人
ream	大量的纸
unoiled	未涂油的
lapm	Access
drossy	铁渣的
mony	=many
cytosol	胞液
immanent	无所不在
yippie	雅皮士
dastard	畏缩
junk	垃圾
orca	兽人
hid	Display
necklet	皮围巾
mitigant	减轻的
ensue	继起
slavonize	使斯拉夫化
transfusional	输血引起
xvii	17
radiolucency	射线透射性
outrun	逃脱
gasping	喘气
voluminal	容量
obligingly	亲切
cobbra	头盖
prophylactic	预防疾病的
prefect	各类官员
beefalo	s)
semicivilized	半开化
sillar	未固结火山凝灰岩
haslet	内脏
counterdrug	解瘾药
scalar	分等级
lusterless	没有光彩
striking	惊人的
champignon	食用香草
rotfl	Laughing
defray	支出
isd	Subscriber
southpaw	用左手的运动员
gutturalize	使颚音化
rediscount	重贴现后的票据
diffuser	散布者
overclothes	罩衣
keltic	凯尔特人
perennate	多年生长
ugric	=Ugrian
byplot	旁节
cytophysiology	细胞生理学
epuration	肃清
overcapitalization	投资过多
unfixed	放松了的
tephigram	温熵图
ultraclean	超净
irrationally	不合理
