disunionist	分离主义者
limicolous	生活在烂泥巴中的
posted	消息灵通
criminatory	控告的
diagrammatic	概略
revery	幻想
exponential	倡导者
transfluence	越流
dishevel	使头发凌乱
declensional	词形变化
chunky	矮矮胖胖
operation	操作
salpingotomy	输卵管的切除
indiscreet	轻率的
asean	South
count	计算
analogically	类推
huffish	发怒
forgeability	可锻性
streaky	容易变
teetertotter	上下晃动
landtied	陆连的
coordinative	同等的
rubbly	碎石状的
postage	邮资
orthopaedist	整形外科医师
kickboard	踢水板
dsn	Data
caressant	爱抚
wonted	习惯
advised	考虑过
autotomize	自行分裂
revisable	可订正
mechanization	机械化
speculate	思索
superb	极好的
endotrophic	体内营养
gpd	gallons
skiascopy	视网膜镜检查
beady	象珠一样
sacrificially	牺牲地
misprise	贬低
deportable	可流放的
mamillated	乳头状的
unformed	未充分发展的
inconsequently	不合适地
foresighted	深谋远虑的
necessary	必需的
geist	感性
fatheaded	愚笨
intolerable	无法忍受
director	主管
answer	符合
epaxially	轴上地
faint	昏晕
carbohydrate	醣类
sulfureous	硫磺质
kooky	怪人
sectionalism	地方偏见
fucking	烦恼等的语气
wash	洗澡
brooklime	婆婆纳之一种
sarmentaceous	=sarmentose
clonesome	机器人般
teal	水鸭
prop	维持
multihull	多船体船的
spirit	灵魂
endocrinology	内分泌学
astrologer	占星家
cytosol	细胞溶质
rachis	叶轴
bellipotent	战力强大的
windless	平稳的
lasable	可受激光照射
euphotic	透光层
workingman	劳动者
molucan	摩鹿加语
deltoid	delta
disquiet	忧虑
subapostolic	十二门徒后的时期
codlin	尖头苹果
isoglucose	糖类代用品
sprowsie	6便士
bedouin	贝多因人
civet	麝猫香
chromatism	变色
foredeck	前甲板
fasciated	成束的
hempy	似麻
montevideo	蒙得维的亚
mitred	斜拼接
restitute	归还
beachcomber	流浪汉
pert	Program
gnarl	节
favorite	亲信
druffen	酒醉
rcvs	College
rehearsal	预演
sabulite	强烈炸药
kenning	比喻的复合辞
petalite	透锂长石
snuggery	舒适的位置
terpolymer	三元共聚物
scummy	下流的
preexilian	放逐前
backboned	有脊椎
spuddy	短而粗
soprano	女高音
expressible	可表现
superb	华丽
agrochemical	农用化学品
amah	保姆
citing	举例
from	今后
pontifical	主教祭服及徽章
supportable	可忍耐
postimpressionism	后期印象派
tetrasyllable	四音节字
excelsior	精益求精的
shiftless	想不出办法的
ectotropic	体外营养的
larghetto	稍缓慢的
dlp	Digital
pericycle	中柱鞘
ductility	柔软性
unweeded	未除草
spotter	着弹点观察员
tromp	践踏
base	低级
hunkey	=hunky
toot	痛饮
manzanita	石兰科常绿灌木
iconology	肖像
bracket	支架
absolvent	赦免的
leaping	跳跃的
qwerty	与英文打字机键盘一样
scarabaeus	金龟子科
wctu	Christian
shudder	发抖
aeneid	埃涅伊德
successful	成功
ptolemaic	埃及的托勒密五朝
delicate	精密
simulfix	同存词缀
commensuration	同量
instant	立即
aiglet	带端的金属尖头
condition	社会地位
yarmouth	Yarmouth
nohow	绝不
fleeceable	易受欺诈的
wellingtonian	威灵顿的
bridewell	监牢
augmented	扩张的
fixing	调料
ornamental	装饰用的
musingly	冥想
noncandidate	非实际候选人
feudalistic	封建性的
gonimoblast	产孢丝
wicked	坏
staig	小马
wrinkly	中年人
minor	未成年
clean	清洁的
geoisotherm	=isogeotherm
uncalled	未经邀请
hyetal	雨的
vibration	颤动
electoral	选举
larine	鸥亚目
detail	细说
bewray	暴露
chalkstone	痛风石
linum	亚麻属植物
salvor	打捞人员
carryall	单马马车
cometary	彗星似
pretreatment	预处理
octavo	八开本
visa	签证
confidentiality	机密性
outspread	延伸的
mass	大规模的
achaean	亚该亚人
explanation	说明
rhizocarpous	多年生草本植物
uptown	在住宅区
truer	真
ingenerate	天生的
unwanted	有害的
unbelonging	不属于……的
murmur	咕哝
rampart	壁垒
redistrict	重新区分
secretarial	书记的
aphtha	口疮
acoustic	声学的
chemotherapeutant	`kemEJ9WerE`pics/`kemEJ9WerE`pjU:tEnt/
ametropia	屈光异常
contingently	偶发地
accelerated	加速的
aliquant	不能整除的
aauw	Women
megrim	沮丧
gun	加大油门快速前进
pectase	果胶酶
powwow	医师
cary	卡里
prankish	戏弄
nonfarm	与农场无关
exhaustible	被竭尽
barker	发出似狗吠的人
labialized	唇音化
gleety	后淋
proprietress	女所有人
autobahn	高速公路
fitfully	断断续续地
morat	桑椹酒
daily	日常
homicidal	杀人的
macbeth	麦克白
iamap	Association
effeminacy	娇气
knobbly	棘手
blindfold	盲目
gadgetize	以机械处理
strapper	彪形大汉
afire	燃烧着
gravity	地心引力
iodometry	碘定量法
disseisee	=disseizee
butcher	屠夫
herbescent	似草
bystander	旁观者
work	渐渐移动
fairyland	乐园
respectfully	尊敬
checkerwork	彩格花样
psychoactive	影响心理状态
lamblike	小羊似
isotactic	全规
supervisory	管理的
nondefense	非国防军用
supermassive	特大质量的
mana	威望
benzaldehyde	苯甲醛
goaltender	守门员
diazoamino	重氮氨基
underscrub	下木
solderable	可软焊
tutti	全体齐奏地
distillage	蒸馏而得之物
bicornuous	=bicorn
crownwork	人造齿冠
blusterous	狂吹的
forelady	女工头
looseleaf	活叶式
familiarity	亲密
kashmirian	克什米尔
innumeracy	科学盲
levogyrate	左旋的
unstrained	未过滤
antehall	前厅
short	不够的
electric	导电的
bearably	忍得住
intercurrent	中间发生的
rate	认为
multocular	多眼
fifteen	十五
illustrative	说明性的
cacodemon	恶魔
oceanarium	海洋水族馆
illusively	幻影
appulsively	趋向地
replenishment	补充
tilak	小红点
symantec	Cafe
dogfight	混战
goddaughter	名义上的女儿
automatous	自动的
canniness	机警
eupneic	呼吸正常的
pacifical	=pacific
facing	饰面
impuissance	无力
equivocally	可疑地
equal	合适
haloperidol	氟哌丁苯
illiquid	非现金的
overstrength	超额的
blivit	不必要的东西
amicron	次微粒
simuland	模拟对象
lumbricoid	蚯蚓状
make	被制造
hurley	爱尔兰棒球的球棒
physical	物理
flavobacterium	黄质菌属
escort	陪同
bream	打扫
restyle	改变……的风格
domical	圆屋顶的
dialectic	辩证的
nation	民族
pointy	非常尖的
vamp	拼凑
bestial	野兽的
eleaticism	埃里亚派
rigolette	羊毛头巾
ivr	Voice
swami	学者
aob	Business
throughly	彻底地
disemploy	解雇
apical	顶点的
universally	全体
overwhelm	淹没
approximatively	接近地
occasionalism	偶因论
acutance	锐度
aapss	and
hydrobromide	氢溴酸盐
voluminous	长篇
measuring	测量
ethnomusicological	/
inconscient	无意识
pinspotter	保龄球自动服务机
histrionic	戏剧
evanishment	消散
aacs	Air
bullate	起水泡的
miscount	计算错误
pietism	虔信派
laptop	膝上型电脑
spy	发现
currie	=curry
mdram	DRAM
alchemically	炼金术地
lingeringly	延迟
camenae	克米尼
fogy	守旧者
immitigable	不能缓和的
licensed	得到许可的
maquillage	化妆品
diplomatese	外交辞令
habituate	使熟习于
galago	丛猴
metaplasia	化生
ubangi	乌班吉
topline	背线
brokedealer	股票经纪人
exospheric	外大气层
pastorly	牧师的
tyke	小淘气
quadridentate	四齿
maidenish	处女的
quartziferous	石英质的
conjecturable	可推测
twitch	阵痛
meagerly	瘦地
disject	使裂开
fluid	流度
gen	情报
serotype	把……按血清型分类
originate	创办
revolutionology	革命研究
scamp	草率地做
contumacious	不听令
tho	可是
fated	命中注定的
himyaritic	希米亚里特人
portcrayon	蜡笔夹
nonbook	无真实价值的书
childproof	不会被孩童弄坏的
dosimeter	放射量测定器
homogamous	同子生殖
dominoes	多米诺
dishearten	使……气馁
yank	拽
suprathreshold	阈上的
remissible	可赦免
seine	拖拉大围网
bulk	大小
labouring	劳动
haematocyte	血细胞
week	周
papule	长疮
zpg	Growth
steelworks	钢厂
multicylinder	多汽缸
inductee	就任者
print	用印刷体写
somnambulant	梦游
sinological	汉学的
unorganized	无组织
mushily	糊状地
nagged	被激怒的
valuer	评价者
phentolamine	芬妥胺
legibility	易读性
scalder	汤洗工
epizootic	流行于家畜
bocce	=boccie
gamopetalous	花瓣相连的
alcyonarian	珊瑚类
apropos	恰好
crossbearer	十字杖捧持者
intrados	穹隆之内面
subalpine	亚高山带的
zinciferous	含锌的
corruptly	腐败地
knavishly	不正地
remote	遥远的
gassy	气体
secretively	隐匿地
atomy	尘埃
paper	象纸
recross	再越过
impressively	令人难忘
nodular	小结的
dragon	凶暴的人
sennight	七昼夜
eclecticism	折衷主义的运动
witch	迷人的女子
hapteron	附著器
hairweaving	假发编入
deck	打扮
piratic	剽窃的
ethnic	异教徒
lattermost	最后的
plaintful	哀诉
uniovular	单卵
nautical	海上的
leachable	可滤取的
moustachio	髭
rubdown	磨光
whistleable	可用口哨吹
muntz	蒙知合金
flesh	使肥
calyciform	萼状
inflectional	抑扬的
basilary	=basilar
funeral	出殡
egg	卵
excitonics	激子学
unworldly	对钱财不感兴趣的
aftertaste	回味
catechol	儿茶酚
martialize	使变得勇敢
ourn	pro
accretion	增长
subcrustal	路面底层
relative	比较而言
amyotonia	肌弛缓
toilet	盥洗室
tractive	牵引的
associability	可联想性
sulfurous	含有硫磺的
phenethicillin	苯氧乙基青霉素
antonym	反义词
rongalite	保险粉
songbird	鸣鸟
arrogantly	傲慢地
vertical	头顶的
domelike	穹顶状的
trowelman	使用镘刀的工人
scenic	舞台
incontinence	不能自制
secession	脱离
unformed	无定型
crushmark	汽车车窗玻璃上的裂痕
annihilationism	灵魂毁灭说
centreless	无中心的
unskillful	不灵巧
yarke	狐尾猴
effect	效果
coaming	边材
araeosystyle	对柱式
fade	乏味
indiscutable	=indiscussible
dottle	残烟丝
nara	奈良
tinnery	锡矿山
anecdote	奇闻
congenial	适意的
mongoose	猫鼬
handlebar	八字胡
vsam	Access
adapt	改编
sprightly	轻快的
pert	Technic
linen	亚麻
en	半方
field	暴晒于场上
unable	不能
minimap	小地图
pseudopod	伪足
saturated	渗透的
run	竞选
axletree	轴承
ellsworth	Land
anorthite	钙长石
antithetic	正相反
aero	航空
multiplex	多元
wardress	女典狱官
circumcolumnar	绕着圆柱
suitability	适当
subhepatic	肝下的
pietistic	虔诚
featured	有……的面貌特征
fleshy	肉体
rebaptism	再洗礼
concoction	混合
pawk	诡计
advantage	优势
jocosely	说玩笑
interknit	互相联系
urgent	急迫的
dominus	上帝
transtage	变轨级
cuprous	一价铜的
cry	流泪
hitherto	至今
seajack	海轮的劫持
illicitly	不正地
weighty	重
deoxidize	除氧
att	美国电话电报公司
mischoose	误择
duchy	公国
quintic	五次的
kilimanjaro	乞力马扎罗山
solemnness	认真
enlightenment	启迪
rebate	回扣
resolvent	使分解
phillips	=Phillips
intercut	作镜头交切
slovenry	邋遢
richly	富饶地
zairese	=Zairean
fulgurous	闪光
argumental	好争辩
youngling	年轻的
yellowthroat	黄喉地莺
isotropic	等方性
easygoing	逍遥自在
longtime	为时甚久
expurgate	删除
diffractometer	衍射计
bovine	似牛
tubercula	tuberculum
raven	大乌鸦
slump	跌落
wally	好的
screwhead	螺钉头
anthropomorphosis	人形化
puny	小
triliteral	三字母的
spicy	辛辣
unaccounted	未说明
louisiana	路易斯安那
chivalrous	侠义的
unforensic	非法庭
phthisic	肺结核
subclavian	锁骨下神经
cotyle	髋臼
semen	精子
noxious	有害的
spy	秘密侦察他人行动者
nonassessable	除缴投资额外免除任何费用或责任
symbolistic	象征主义的
flyby	飞机或太空飞船的越过定点
excite	使兴奋
adopt	采用
veblenian	信奉维布伦学说的人
penal	刑事的
triphibian	空三军指挥作战官
zoologic	关于动物
balzacian	巴尔扎克风格的
manna	天赐
brickie	砖瓦匠
areole	=areola
thirstily	如饥似渴地
usmcr	Marine
tidily	整洁
intersex	兼具两性特征者
prefab	活动房屋
luxuriate	沉溺
bulbiform	球状
draft	起草
kaffeeklatsch	咖啡会
embayment	港湾形成的
isogeneic	同系的
enisle	置于岛上
environal	=environmental
glume	颖苞
mmx	Extensions
cacodylic	四甲二砷
enisle	使孤立
mortify	克服
topcoat	夹大衣
calypso	特立尼达岛上土人所演唱之歌曲
zoochore	由动物做传粉媒介的植物
mount	爬上
ulterior	较远
tabnab	小圆面包
doomwatcher	末日论者
defend	辩护
casteless	没有社会阶级
criminal	犯法
ukaea	Atomic
princox	纨袴子弟
surprised	感到惊讶
external	外部的
tunisian	突尼斯人
taphole	塞孔
snapshot	快照
snuggle	偎依
bloomy	多花
crank	易怒的
inventroy	存货清单
for	对于
esthete	美学家
meretricious	娼妓的
vfat	File
tzaritza	=czaritza
helpmate	配偶
average	使平衡
merchandize	=merchandise
canulate	中空
installation	安装
dentulous	齿状
rupee	一卢比银币
clactonian	旧石器时代文化的
astrictive	使收缩
crenulate	细圆齿状
planetarium	天文馆
moxibustion	灸术
brisk	使活泼
zener	breakdown齐纳击穿
astutely	伶俐
stationer	文具商
cosmological	宇宙哲学的
lamprophony	声音的响亮和清晰
ptah	卜塔
skyrocket	流星焰火
difference	差动的
bioautography	生物自显影法
alt	高音
upside	上部
widest	宽的
tache	色彩
waggish	滑稽
pelagic	浮游
scratch	擦伤
trilemma	三难选择的窘境
somatotype	按体型分类
thenar	手掌的
generic	非特殊的
tractably	驯良地
facp	of
romanaccio	罗马话
lally	拉莱柱
downstage	向舞台前方
biquadratic	四乘幂
gruesomely	可怖
liveried	穿规定服装的
stearic	似硬脂
loessial	黄土
consequence	重要的地位
yttrium	钇
endogamy	同系配合
divider	园规
extrasystolic	期外收缩
scoundrel	卑鄙
sunflower	向日葵
communique	官报
workmanlike	技巧精湛
gyrostabilizer	回转稳定器
affected	受侵袭的
neutercane	中性热带气旋
crookneck	一种颈长而弯曲的南瓜
tightwire	钢索
digestion	领悟
gozitan	戈佐岛的
rougeetnoir	纸牌赌博之一种
transplanter	移植机
glomeration	球状化
penicillium	青霉菌
americanize	使美国化
tacitean	似塔西佗文风
unshapely	丑怪的
cymar	女便袍
anchoress	女隐士
assuredness	自信
hypersexual	纵欲的
jollily	愉快地
compellent	令人信服
mage	博学者
diphthongia	=diplophonia
stateside	美国本土的
gamesman	以诈术取胜的人
psychotoxic	能引起精神病的
solvent	溶剂
pulverous	粉状的
broadside	较宽的一面
flexitime	弹性上班制
constabulary	警察的
bullbat	夜鹰
komiteh	伊朗革命委员会
tertial	第三列
blackdamp	窒息瓦斯
messianism	救主即将降临之信仰
quirkish	含糊其辞
barbarity	残暴的行为
unguarded	没有防备的
etherialize	=etherealize
subovate	近似卵圆形的
unpresented	未呈递
demount	卸下
accepter	承诺人
arabia	阿拉伯半岛
coincidental	一致
unlawfully	非法地
spheric	球状的
pulut	糯米
oxygenate	以氧处理
taking	吸引人
webwheel	板轮
suppose	料想
aerobiologic	大气生物学的
hairsbreadth	极狭
roam	漫步
chartula	包药粉的纸
call	称呼
quantometer	红外光电栅摄谱仪
woosh	=whoosh
transcutaneous	由皮
demipique	低鞍头战鞍
lobulate	分成小裂片
ordinant	指示
raucously	粗声
culminating	到绝顶
chapfallen	沮丧的
cauterant	灼烧的
ambilingnal	精通两国语言的
subaltern	副的
contrastimulant	亢奋剂
algophobia	疼痛恐怖
hearty	精神饱满的
orthodox	习惯
undress	脱衣服
noctambulism	梦游病
blatantly	喧闹地
inbred	天生的
viviparous	母体发芽的
floral	植物群的
temerarious	不顾一切
inconsolably	无法安慰
irreciprocal	非交互
minitype	小型
coowner	共同所有者
jonah	带来不幸
stp	屏蔽双绞线
extrovertish	如外向者的
submarine	海底的
achromatic	消色差
nomenclaturist	学名命名人
ferdinand	男子名
parricide	杀长辈
ever	不断地
liner	衬垫
painstaking	辛勤的
ex	不包括
adenocarcinoma	腺癌
sprout	萌芽
extracanonical	经典以外
univalent	单价染色体
activise	使活动
epical	叙事诗的
birdfarm	航空母舰
priss	娇气的人
keister	手提皮箱
photochronograph	照相录秒器
fog	使困惑
freshness	精神饱满地
undersexed	性能力弱的
steno	速记法
ethyl	乙荃
dsn	Souce
rage	愤怒
explicans	术语或陈述的意义
diabolo	响铃
shampoo	洗发
plane	平的
uncalled	未经请求
quencher	骤冷
frequenter	常常来访者
goldberg	犹太老板
dynamoelectric	发电
redescribe	重新描述
tapestried	饰挂绣帷
mucedinous	霉
letup	松懈
inconsiderable	不足取
profoundly	衷心
intercity	城市间
layoff	活动停止期间
spizzerinctum	劲头
virulent	剧毒的
millicurie	毫居里
psalm	圣歌
orthotropism	直生性
frank	老实
furtively	偷偷地
pyrolyse	=pyrolyze
psilocybin	采自墨西哥蘑菇的一种迷幻药
gumwood	产胶树之木材
cloze	填充测验法
set	放
ultrashort	极短的
willing	心甘情愿的
vigesimal	第二十的
unitive	统一
reexplore	重新勘查
complexometry	配位滴定法
oscinine	鸣禽类
bengali	孟加拉人的
disembargo	解除禁运
disrepair	荒废
lavish	滥用
overbrilliant	过于华丽
synchronise	=synchronize
justly	应得
entertaining	招待
sialic	富硅铝的
harvest	收获
napalm	用凝固汽油炸
lankly	瘦
embalm	施以防腐剂
ulf	Frequency
timidly	羞怯
fold	调入
moiety	二分之一
unfixed	不固定
astrometry	天体测定
ancestry	血统
moro	摩洛语
usom	Operations
pinbone	髋骨
machicoulis	堞眼
javari	查瓦利河
endosteal	骨内膜
pigboat	潜水艇
dayfly	蜉蝣
enormity	极恶
hallucinosis	幻觉性精神病
dynamic	动力的
cleansing	清洁
depressor	压板
autoist	开汽车的人
introvert	格性内向的人
landslip	崩塌
thumbkins	拇指夹
adapter	改编者
ravc	Army
duodecimal	十二进制
deprecatory	反对的
walker	常散步的人
carbonylic	碳酰基的
erogenous	唤起情欲
tiptop	极好
swagger	漂亮
metempsychosis	灵魂转世
lebanese	黎巴嫩的
previous	在前的
still	寂静
roc	巨鸟
carefree	不负责的
torso	残缺不全的东西
pediment	三角墙
necrotic	骨疽
sikkim	锡金
intramarginal	页边内
libration	振动
iterate	重申
outdare	较……更大胆
babyhouse	儿童游戏室
feverish	热病的
salivant	催涎
cryosorption	冷凝吸附
favose	形似蜂巢的
fibrous	纤维性的
correct	纠正
substitution	代替
jolliness	愉快
apparition	幻影
diagonal	斜纹织物
prosecute	从事
orchidaceous	兰科的
heedless	不注意的
skylit	skylight的过去式和过去分词
select	精选
sextette	六重奏曲
prix	奖金
carsey	=carzey
wacke	玄武土
stellated	星形
offhandedly	立即
amphimictic	杂交繁育的
engagement	婚约
bugbear	怪物
belgic	荷兰或比利时的
pod	扁豆层
suppliance	哀求
redactor	校订者
kuznetsk	库兹涅茨煤田
elastivity	倒介电常数
ultrabasic	超碱的
latter	近来
recommission	重新委任
surrender	自首
skoal	祝您健康!
flatette	小公寓
word	消息
hushpuppy	南部乡下的
peepul	=pipal
yate	各种桉树
unexaggerated	不言过其实的
worthily	正当地
hypophloeodal	生成长在树皮下
wardship	保护
listenability	值得一听
past	pass的过去分词
iroquois	易洛魁族人
distinct	明显的
develop	发扬
philippi	腓力比
hunks	性情乖僻之人
crassamentum	半凝之血
tenseless	没有时
wort	植物
cameralism	重商主义的经济或财政
runt	发育不全的矮小动物
inflexible	不屈
highflying	高飞
amatory	恋爱的
loner	不合群的动物
nitriding	渗氮
colleague	同僚
extortive	勒索
alsoran	落选者
piratic	盗版
enormity	巨大
splice	接合
antechamber	接待室
strain	紧张
booby	傻瓜
reassociate	再聚集
solecistic	失礼
gimpy	跛
gerent	统治者
nice	拘泥的
olingo	尖吻浣熊
vbscript	Basic
hateable	可憎
triboelectric	摩擦电
flatways	平面朝上
mount	上演
cover	铺
unwatered	已排水的
kansan	堪萨斯州的
rollicksome	嬉戏耍闹作乐的
friskful	活泼
thermophil	适温
interferometric	干涉测量
refractory	难熔的
surgical	外科
reconstituted	再生
araliaceous	五加科的
elfin	小妖精
kingship	君主的身份和尊严
aru	美国铁路工会
manual	指南
underabundant	不够富裕
deprecatory	恳求的
telemetry	遥感勘测
clabber	凝结的酸牛奶
banteringly	戏谑地
falcial	镍
typhogenic	引起伤寒
cytotaxonomy	细胞分类学
methodic	有组织的
umbilic	中心
sultrily	闷热
dihybrid	双因子杂种
verbatim	逐字的
coelom	体腔
bla	文学士
vibratiuncle	小抖动
insphere	=ensphere
eldo	Organization
preventive	预防性
whop	打
philobiblic	爱书
papillose	有小乳头突起
unlikeness	不相等
bedabble	泼脏
colander	滤器
slogger	乱打者
boatable	小船可通行
norse	挪威人
understand	推定
vaccinal	疫苗的
univac	Computer
cubicle	小卧室
porky	猪肉的
macronucleus	大核
artefact	人工品
shrunken	shrink的过去分词
economic	经济学
salmo	斑鳟属
secund	偏向一方
swabber	卑鄙的人
kindle	发亮
arrect	倾耳注意
unversed	无经验的
alveoloplasty	牙槽成形术
monocracy	独裁政治
peg	栓
someways	以某种方法
proof	防……的
phonemicize	用音位符号表示
depressed	沮丧的
smacker	一块钱
hiddenite	希登石
cereal	谷类
touchable	可食用
stimulus	刺激物
countershock	对抗电震
sondage	试掘深沟
personalism	人格主义
clearer	更清楚的
dirigible	可驾驶的
radiophysics	放射物理学
woodhouse	木料间
divider	分割者
fatuous	愚昧
increscence	盈
oversea	外国
lecherous	淫荡的
gerrymander	欺骗
aggression	侵略
ivb	benefit
shrubbery	灌木林
waterline	吃水线
carnarvon	=Caernarvon
summable	可和
convincingly	信服地
vehement	激烈
haematopoietic	生血的
digenetic	复殖的
alluvion	冲积地
frizzle	卷曲
cymbalom	=cimbalom
cunt	女性之阴部
palish	稍微苍白
decastyle	十柱式的
restorative	滋补剂
anxiety	热望
framboesia	印度痘
rid	使摆脱
point	指
domesticity	对家庭的挚爱
byronic	拜伦
stayer	滞留者
jeepload	吉普车所能装的数量
clear	清晰的
yenangyaung	仁安羌
exudate	分泌液
slobbery	过于伤感的
arrestive	引人注意的
equilibratory	产生平衡的
pyrostat	自动报警装置
workmanlike	技巧熟练
foundation	根本
rehabilitative	使复原的
hopbind	忽布的缠绕茎
infinite	无穷的
unacquirable	不可取得的
broad	宽的
reboot	重新启动
softly	柔软地
animosity	仇恨
usurp	侵占
skybridge	=skywalk
inextricable	解不开的
saturated	深颜色
fluidonics	射流学
mythoi	的复数
nychthemeral	随昼夜差异而变化的
houseroom	放东西的地方
caustic	刻薄的
eon	永世
thundering	非常的极大
documentarily	在文书上
incurability	不能医治
seminomata	seminoma的复数
gynaecologist	妇科学家
nupe	Employees全国公务员联合会
kineticism	动态艺术
coquina	软质石灰石的一种
momentous	重要
sapful	多液汁
carpaccio	白汁红肉
forgery	伪造
garcon	男雇员
accentual	有抑扬
kolinsky	西伯利亚貂
levanter	躲债人
wholesale	大规模的
mideast	East
plinth	柱基
corny	乡下味的
heliogram	反光信号
afdc	with
orchectomy	=orchiectomy
pa	Paname
unwarned	未被告诫的
tar	一种压缩文件的扩展名
eyeshot	视界
jurassic	侏罗系
supranational	超国家
crossly	故意为难地
whine	发呜呜声
jdisplay	型显示
starchy	含淀粉的
decalogue	摩西的十诫
lory	一种羽毛美丽的鹦鹉
conversant	熟悉的
unifilar	单线组成的
buckingham	=Buckinghamshire
eldest	最年长
bms	超黑矩阵屏幕
suprapersonal	超个人的
demist	为……除雾
borscht	=borsch
early	早的
foolproof	十分安全的
elocutionist	朗诵者
pyrheliometer	太阳热量计
naturopathic	自然疗法
narcoma	麻醉性昏睡
alt	高音的
cactaceous	仙人掌科的
permissible	可容许程度
outguard	警戒哨
carneous	似肉的
codex	药典
jay	傻瓜
doughty	刚强
unright	不公
landtrost	=landdrost
marriageable	达到结婚年龄
effervesce	泡腾
heeled	带手枪
druther	宁愿
hindustani	印度斯坦人
unexploded	未发射
factorial	因子
firethorn	火棘
volant	迅速
leachable	可滤去
nephron	肾单位
mhc	complex
facta	呈文
oesophageal	食管
unpaying	不付款
microhabitat	=microenvironment
tweedy	爱穿粗花呢服装的
arbitrage	仲裁
irreformable	难以纠正
planter	种植园主
dulcin	甘素
truncheon	权杖
moil	作苦工
knobstick	在罢工期间上工的工人
refreshant	提神物
repellent	排斥
morigeration	卑从
microweld	微型焊接
venoconstriction	静脉缩窄
prelude	前奏
unshed	未流出的
bbb	附早餐与浴室之旅馆
shirttail	衬衣下摆
largo	宽广
armrest	靠手
acrylic	丙烯酸
firefang	受热变质
mediaperson	记者
macular	有污点
hotspur	卑鄙的人
sanguine	乐天的
biohazard	生物危害
rooster	雄禽
nga	Graphical
tempt	吸引
catalytic	接触反应的
exeat	缺席许可
scurfy	皮屑的
channels	通路
oneiric	梦
sandron	桑德伦
drinking	喝酒
facemaking	扮鬼脸
cutdown	删减的
northwesternmost	极西北
fortunehunting	靠婚姻发财的人
novennial	每九年的
neuropteran	脉翅目的
hoarfrost	白霜
scape	花茎
naissance	诞生
jo	情人
provoking	激怒的
smoothness	平滑
undistributed	未分配的
vraisemblance	似真实
sneak	帆布胶底运动鞋
outcaste	被剥夺种姓者
bardling	青年吟游诗人
syllogistically	三段论法式
settecento	18世纪
predomination	卓越
nurture	教养
magma	稀糊
tapestry	挂毯
hartree	哈特里
enterprise	事业心
ochreous	含赭石的
goofy	傻瓜
debilitated	疲惫不堪的
tiddled	微醉的
schoolgirl	女生
hyposulphurous	连二亚硫酸的
apterygial	无翼的
eikon	圣像
pulsant	脉动
glaswegian	Glasgow
companionably	适合做朋友
methodic	有条理的
synjet	合成喷气燃料
sameness	千篇一律
machiavellian	权谋术
challenger	挑战者
psychodynamic	心理动力
wftu	世界劳工组织
famous	令人满意
velveret	印花棉绒
minicom	小型计算机
disenroll	开除
gardenly	如花园
squirrely	疯狂
peak	缩小
delphian	意义不明确
tavr	Army
altigraph	有自动记录仪的高度测量器
cantala	肯太拉麻
downy	绒毛的
cyborg	电子人
dicty	富裕的
archicerebrum	原脑
burp	打饱嗝
imbed	埋入
cockily	自高自大地
rack	放在架上
infuscate	略带褐色的
snitch	告密者
unnecessarily	不必要地
dobsonfly	蛇蜻蜓
invite	引起
ghastfulness	可怕
division	分配
loverboy	美男子
lathering	怒骂
unventilated	空气不流畅
cloyless	不会使人感到腻烦的
stuff	素材资料
loadstar	指示方向之星
cadetcy	军校学员的地位
matrilateral	母亲一方
centroplast	中心质体
subjacent	在底下
aberration	失常
papyraceous	纸状
chard	可供食用之甜菜
iridous	三价铱
rough	粗糙的
short	松脆
design	企图
phalanx	指骨
cycle	使循环
marginalize	忽视
sas	Air
icj	of
bucketeer	欺骗主顾的股票经纪人
chibcha	奇布查族
galliard	活泼愉快
razon	拉松式制导炸弹
steward	干事
spiroplasma	螺原体
practically	在实践上
livid	青紫色的
dare	敢冒
uncatchable	无法捉住的
ratify	认可
curtness	简略
reaction	反作用
furcation	分叉
feod	封
amerce	罚款
trinket	密谋
bluing	靛青漂白粉
subsidize	资助
ponderance	重量
worcestershire	伍斯特郡
antics	古怪的姿态
scua	Users''
poise	使悬着
atelic	未完成
audiometric	测听术
holohedral	全面的
ascertain	确定
ungodly	不虔诚的
cogently	中肯地
available	有空的
carnify	变成肉质
hyperkeratosis	角化过度
mask	面具
confectionery	糖果
ichthyologist	鱼类研究者
syringa	山梅花属的植物
omnitude	无所不包
oxtail	牛尾
udometric	雨量计的
barbellate	表皮有钩形短刺的
filer	文件编档员
inkblot	墨水斑点
distinguish	辨别
delint	将纤维从棉花籽除去
gotham	纽约市的别名
joyful	令人欢欣的
liquidly	清脆地
join	连接
ticket	票
articulator	接骨的人
bayrut	=Beirut
isaias	=Isaiah
overroof	给……装顶盖
reglet	木嵌条
physiognomonic	/
involuntarily	不知不觉
leadenhearted	铁石心肠的
pasture	牧等
extern	外
unparallel	不平行
shaman	僧人或巫师
flashily	灿烂
oxytocic	阵痛促进
legendary	传说中的
overdare	使灰心
piquant	兴奋
savvy	机智
vitality	生动性
unguardedly	不留神
hansom	一马二轮之有盖双座小马车
xhosa	科萨人
coenocytic	多核体的
geoeconomics	地理经济学
powder	使成粉末
grano	人造石铺面
chamomile	黄春菊
panavision	宽银幕电影
outgeneral	用优越的战术打仗
transpire	得知
kept	受人资助控制
lenticulated	小扁豆状
oriole	白头翁科的小鸟
potbellied	大肚子
smart	严厉
flummery	冻状食品
impavid	无畏
issuer	发行者
remissive	减轻的
posh	优雅的
mort	大量
trivial	琐细的
spumous	起泡沫
buddhist	佛教的
chieftain	酋长
accomplishable	可达成的
girdle	束
ungifted	无才华的
hopping	忙碌
liberalistic	自由主义
sizzle	咝咝的响
pupillary	学生
unsuccess	徒劳
bouilli	红烧肉
mum	沉默的
refractive	折射的
superbike	超级摩托车
rehumanize	再教化
warbler	鸣鸟
legit	正统剧
physiognomic	相术的
pumiceous	象轻石
innavigable	不能航行
coliform	象大肠菌的
relaid	relay的过去式及过去分词
chiack	讥笑
basely	下贱
seismographic	测震学的
merrymaker	寻欢作乐的人
guiltiness	有罪
tereus	蒂留斯
discontinuance	停指
hemianopia	一侧视力缺失
security	安全
caprylic	辛酸
empennage	尾翼
tallyho	追捕的叫声
roast	烘
stirrup	镫形物
orthorhombic	斜方晶系
recidivist	惯犯
riverward	向河的
rime	使蒙霜
uneducable	不堪造就
communally	社区地
wilding	野生
wean	使断念
phloroglucinol	藤黄酚
monotheist	一神论者
feelinglessly	无感情地
cccs	CS
wadna	=would
bathless	不洗澡的
underact	不充分地表演
percipient	理解
zincky	似锌
reproachful	责备的
insurgent	起义
fulvous	黄褐色的
hardy	勇敢的
flush	直接的
reversedly	颠倒
wellborn	出身名门
airman	空军
gelatinise	=gelatinize
potecary	药房
barely	刚刚
industrialise	=industrialize
dyne	中国达因电脑集团
unenlivened	不快活的
curt	简略的
semiotic	症状
worthless	无价值的
dishoard	减少储存
slaister	一团糟
diminishing	逐渐缩小
lexicalize	编入词汇
sucre	苏克雷
standing	常备的
aquifer	含水土层
monad	单孢体
corporatist	社团主义者
rubasse	上等砂金石
iconographic	肖像
ochratoxin	赭曲霉素
usherette	女引座员
soli	独唱
dastard	畏缩的
twicer	兼做两件事者
lapsable	易变的
latter	后者
belat	强烈西北风
narrater	讲故事者
furzy	像荆豆属植物的
rumpy	无尾猫
superinfection	双重感染
illiteracy	文盲
filmmaking	电影摄制
algoid	水藻般
scrag	绞死
whorled	有螺纹
paupiette	鱼卷
accouter	供以军用品
glitzy	闪光的
remember	记得
febricide	退热
dubitable	可疑的
adipose	动物脂肪
yokel	乡下人
shirttail	远房
screaming	引人捧腹大笑
cruel	残酷
embrown	着褐色
weeping	下雨的
spiff	把……打扮整齐
negritude	黑人的品质素养
triptych	三张相联
walty	易倾侧
lanugo	胎毛
pinda	花生
cowbane	毒芹
flexural	曲折
flexor	屈肌
incendiary	纵火的
dickensian	狄更斯
scant	欠缺
laf	路易斯安那州人讲的法语
spa	游乐胜
makefast	系船的柱
injudicial	浅薄
overpassed	已废除
unstressed	不着重的
unpleasantness	煞风景的事
tubulate	管状的
liking	嗜好
splash	溅湿
basket	一篮
untamed	难控驭的
academize	使……成为刻板传统的
dinkum	公平的
sanyasi	=sannyasi
face	威信
vesicular	小泡
semiclassic	准古典式
toupet	=toupee
bombardier	炮兵下士
plantigrade	跎行类的
chatelaine	腰带
dst	驱动器自我测试
saditty	摆出优越神气
witty	富于机智
titrator	滴定器
busulphan	二甲磺酸丁酯
dayside	的光面
ministrable	适合的
forefather	祖先
caliche	硝酸钠
currently	现在
phyle	种族
proponent	支持者
mamba	树眼睛蛇
please	满足的
playbroker	=play
unsavory	令人讨厌的
sourkrout	=sourcrout
impersonate	模仿
ah	Helicopter
originator	发明人
run	运转
nonmonetary	非货币
lease	租期
bulgy	凸出
endgame	最后阶段
rpq	报价申请书
adipic	来自脂肪的
commiserate	同情
determination	决心
scathe	危害
baize	厚羊毛毯
waterfowl	水鸟
twister	缠绕者
gypsy	象吉普赛人的
blaze	光辉
implacability	无情
fellowman	人
truculence	致命性
bastinado	杖
overaggressive	过于积极进取
clisthenes	克莱塞尼兹
forklike	像叉一样的
information	资料
creta	漂白土
cilia	睫
corroboree	歌舞会
ventilation	流通空气
phyletic	种族
array	军队
cynocephalous	似犬面
savagely	野蛮
eurybathic	广深性
habited	穿着衣服的
chicory	菊苣
eda	Automatic
inaugurate	举行开幕典礼
huntaway	经训练可牧羊
gerald	男人名
negotiability	可转让性
glossarial	字辞注解
pestle	用槌磨
heathy	石南
facp	the
admittible	=admittable
conchiolin	贝壳硬蛋白
affection	友爱
emotive	感情的
bedazzle	使眩惑
wane	亏缺
adjudicator	判决者
poop	使精疲力尽
project	射出
aught	零
predication	论断
mutagenesis	突变形成
dread	畏惧
syllabary	字音表
resting	静止
massawa	马萨瓦
asiatic	亚洲人
elevated	欢欣
niobic	铌
sweeting	苹果的一种
impasto	厚涂颜料的绘画法
hemerocallis	=day
megaloblast	巨成红细胞
vapour	蒸汽
coadapted	相互适应
lettic	列托族的
condolatory	吊唁
phonic	声音的
battlefield	沙场
bedlamite	疯子
acierate	增碳
intuitional	直觉
uninvoked	未被祈求的
childish	幼稚的
kleptomaniac	有盗窃癖的人
aerarian	关于国库
financing	资金
deuteronomic	劝人行善的
flimflam	荒唐的
eventual	终于的
countryseat	郡政府所在地
denominational	宗派諩nElaIz/
loch	海湾
bulky	体积大
pompon	绒球
telerecording	电视影片
toga	参议员的职位
emporium	大百货商店
hardhearted	冷酷
shopfront	店堂
ergastoplasm	酿造质
olein	甘油之油酸脂
cany	藤制的
scene	场面
interferometric	干涉测量的
abandonee	被委付者
comedienne	喜剧女演员
olivaceous	橄榄色的
habile	熟练的
clocklike	有规律的
defeature	损伤外貌
lierne	枝肋
terminative	结尾
vane	翼
substantify	=substantivize
flimflam	骗
marrowy	多髓
hyperplastic	增生的
dodecaphonic	十二音体系的
adventurously	爱冒险地
intrados	内弧面
unconfessed	未承认
distraite	心不在焉
radiation	放射线
run	跑步
woopie	富有的退休人士
surpassing	超过
inconsequentia	不合逻辑鏊榈氖
carnivore	食虫植物
xpvm	and
conference	讨论会
congener	同属的动、植物
pensionable	有资格领退休金的
succinctness	简明
blockbusting	街区房地产跌涨牟利
penologist	刑罚学者
cystamine	乌洛托品
heterophony	衬腔式奏法
humiliatory	丢脸
coatdress	女式紧身外衣
coaly	煤状的
angry	生气
culmiferous	生成空心茎的
antennary	触角
lachrymal	泪腺的
schmutz	废物
inglenook	炉边
vegetarianism	素食主义
other	其他的
beseeching	恳求似的
unilocular	单房的
raucity	粗哑
grainy	木纹状的
jesuitical	阴险
neckwear	领带
nonjuror	不肯宣誓效忠者
sidestroke	侧泳
magniloquent	夸张的
closemouthed	嘴紧
shift	替换
tricksy	欺骗的
numerary	数目
accommodationist	妥协的
spa	矿泉疗养地
erotogenesis	性冲动发生
aftermentioned	后述
savoury	味香
sisterly	象姐妹
ultraviolet	紫外的
chance	碰巧
shunpiker	驾车走支路的人
nightwalker	夜间上街找客的妓女
foucquet	Jehan
scintillant	产生火花的
antler	鹿角
painty	着色过度的
bullionism	重金主义
saleswoman	女店员
trigamist	结过三次婚者
sheepwalk	牧羊场
fillet	带子
fogle	丝绸手帕
addressor	发言人
screech	发出恐惧或痛苦的叫喊声
ssid	Service
syriac	叙利亚的
derivation	出处
extradural	硬膜外
enjail	囚禁
depreciate	轻视
ccsa	arrangement
gyral	旋转
sordamente	柔和地
bedspread	床罩
commentate	解说
afflated	来自灵感
dutiful	恭敬的
reagin	梅毒反应素
greasy	油污
squadron	骑兵中队
lush	豪华
underdiagnosis	未能作出全面性诊断
tuitionary	讲授
snuggies	女式保暖长内衣
comprehension	理解
verein	协会
pallid	苍白
scutate	有鳞甲的
seminarian	神学校学生
erect	勃起
sacker	掠夺者
towable	可牵引
crackjaw	发音困难
habergeon	中世纪的高领无袖短铠甲
umbrous	被遮荫的
accelerated	加速
scratch	搔
metallurgical	冶金学的
tepee	美国印第安人的圆锥形帐篷
fray	使磨损
strigillose	被硬毛的
presenter	推荐者
lambskin	小羊皮
loathing	嫌恶
notornis	南秧鸟
scytheman	使用长柄大镰刀者
heterogonous	=heterogonic
hottest	热烈的
grouchy	不高兴
semicirque	半圆形
avigator	领航员
striate	有条纹
hyperpnea	呼吸过度
midsemester	期中考试
gunnery	射击学
anaphoric	首语重复法
choleraic	霍乱的
candlenut	桐树
bndd	Narcotics
friskful	有生气
ringent	开口
gom	傻子
filiferous	产丝状物的
saltier	=saltire
hilum	核
league	同盟
vexation	苦恼的原因
gilt	小母猪
fusional	熔解
ordure	粪
enarthroses'	NULL)
headachy	令人头痛
hum	吵杂声
flutter	摆动
picturesque	独特
recidivation	再犯
dumbbell	傻瓜
undebatable	无可争辩
hilch	跛行
riser	叛乱者
gunther	巩特尔
asclepiad	马利筋
constituency	支持者
efficiency	效率
hamah	=Hama
spent	精疲力尽的
key	键
ecuadorian	厄瓜多尔的
adjure	恳请
unwanted	不必要
scholarly	学者风度
cleaver	切割者
patrico	游方教士
latvian	拉脱维亚人
disimprison	释放
matriculability	符合入学资格
jackknife	折叠刀
preparative	预备
deflagrate	爆燃
pollinic	花粉的
rival	相匹敌
homeward	向家的
annihilation	歼灭
lincolniana	林肯文物
remarkable	显著的
courageous	勇敢
charlady	打杂女佣
marrism	马尔语言学说
crumby	低等的
hub	木片
aslant	倾斜地
budless	无蕾的
actual	真实的
fissionable	可分裂
sill	岩床
hematopoietic	造血
mow	收割庄稼
rawhide	生牛皮的
mcmxc	1990
terminable	有期限
uncontradicted	未遭否认的
veritably	真地
quadriphony	四声道立体声
injurious	有害
vocabular	词汇
famulus	私人秘书
chiseled	轮廓分明的
cheekily	厚脸皮地
leave	剩下
table	台子
snoop	探听
underfinanced	财力不足的
caecilian	蚓螈
ucky	令人厌恶
chairwarmer	懒虫
mammiferous	有乳房的
weighman	司磅
bootlast	=boottree
ferro	为西班牙耶劳岛的旧称
yielding	柔顺
technology	技术
boldfaced	冒失
thicket	灌木丛
church	礼拜堂
unbelievable	难以置信
semiannular	半圆形
disabuse	使省悟
swathe	裹
embryulcus	牵胎器
voiced	有声的
xenophile	亲外者
cultus	祭仪
jumpy	神经质的
obsecration	恳求祈祷句
iyft	Tip
tavr	Territorial
dedicatory	献呈的
photoproduct	光生产物
estrepement	滥垦
darshan	沾光
intragroup	社会团体成员之间
aerial	天线
hesiodic	赫西奥德风格
dogmatic	独断的
relocate	重新部署
catcall	嘘声
sked	程序表
avalanche	雪崩
discrepantly	矛盾地
bearnaise	蛋黄酱
patriarch	家长
logbook	航海日志
vorlaufer	先驱滑雪运动员
nidge	以凿子修削
systematization	分类
maxim	座右铭
literalize	拘泥于字句
slightly	苗条地
hiccough	打嗝
vincible	易于克服的
blinding	碎石子
aerocraft	飞行器
quarterly	一年四次
artefact	赝象
aural	听觉的
rattoon	=ratoon
unemployment	失业人数
led	Lead的过去式和过去分词
doughy	半熟的
motion	动作
ripeness	老练
poikilothermic	冷血的
gat	手枪
fanfare	吹牛
salivation	分泌唾液
dyeability	可着色性
thorax	胸膛
unneutral	偏袒
barefaced	不隐瞒的
lettering	刻出的字母
febriferous	产热的
intensivism	饲养
gothland	哥特兰岛
lemonish	似柠檬的
prejudice	成见
cribriform	有小孔的
exasperating	激怒人的
flackery	广告
governmentese	官腔
narrow	使变狭窄
caulicolous	附生在他种植物茎部的
blah	瞎说
hyposensitize	使敏感度减弱
icker	谷穗
laboring	劳动
inappreciative	不正确评价的
unprincipled	不合人道的
accompanying	陪伴
chocolaty	加巧克力的
buic	后援截击机控制系统
fall	来临
surety	担保
inflictive	加以打击的
cryocable	低温电缆
intermix	混杂
cap	carrierless
mephitis	毒气
fivescore	一百
barred	有木栅
try	努力
exemplary	可做模范
geriatric	老年医学
goethean	歌德派的
sharpshooter	奸商
blankbook	空白账簿
edacious	狼吞虎咽的
tugboatman	拖船工人
fishable	适合钓鱼的
deray	素紊
otherworldly	专注于精神方面
dirty	暴风雨的
proudly	骄傲
conventionalise	=coEm/
afric	非洲的的
jejunostomy	空肠造口术
elegiac	哀歌体的
deviously	绕道
bacchae	酒神之女伴
swither	犹豫
hitlerian	希特勒式的
leukosis	=leucosis
vigorous	精力旺盛的
administerial	管理上
profound	渊博的
discolor	退色
octachord	八度音阶
designee	被指派者
denudate	使裸露
teen	烦躁
lambdoidal	人字形的
tajiki	塔吉克语
depose	作证
revery	空想
utopia	空想的社会改良计划
ozoniferous	生臭氧
unroyal	不配为王的
undisposed	未分配
guest	客人
zucchetto	无边帽
tachisme	抽象绘画法
vagary	反复无常的行为
advisor	顾问
persevering	不屈不挠的
today	今天
categorial	范畴的
unmeaning	呆板
executant	演奏者
fictile	陶土制的
bacteriostatic	阻止细菌繁殖法的撤ǖ
vision	景象
copious	丰富
neologist	新语创造者
exsertile	可伸出的
antifertilizin	反受精素
mystificatory	使人大为惊奇的
mycelia	mycelium
pepla	peplum的复数
motherfucking	混帐的
versatile	通用
turfski	滑草板
hogger	火车司机
slack	马虎地
nuclide	核素
montbretia	鸢尾科植物的一种
cephalocide	智力虐杀
consanguinity	血缘
potassic	钾的
meningioma	脑膜瘤
inequilaterally	不等侧
lumphead	傻瓜
overhappy	过于幸福的
mutt	蠢人
playground	操场
pinko	左倾的
irrepressible	镇压不住
clinamen	偏见
indolent	不痛的
ase	Stock
rifeness	流行
simba	狮子
xylograph	木版印画
saith	的第三人称
pittypat	噗噗跳的
flexible	可通融的
belitung	勿里洞岛
fixation	定置
cruellie	挖苦人的笑话
axisymmetrical	轴对称的
mercilessly	无慈悲地
agriculture	农学
procreate	产生
pucka	真正
drowse	打瞌睡
joltheaded	笨人的
mongrelise	=mongrelize
apartment	公寓住宅
canthus	眼角
rubbery	橡胶似的
peitaiho	Beidaihe
wordy	多言
premeditated	预想的
frondesce	长叶子
gorp	高能量小吃食品
latish	稍迟的
oneself	pro
debouchure	山谷的出口
upbind	捆
pulsant	搏动的
pavilion	笼罩
fitter	胜任
cutaneous	皮肤
rattler	嘎声
wastery	=wastry
likability	可爱
eurytopicity	广适性
jarring	辗轧
abuse	弊端
mall	商业街
iphigenia	险被其父供神而牺牲
delay	延迟
akin	类似的
widgie	女无赖
mightily	非常地
regulable	可控制
refusal	推却
effectual	有效的
landaulet	轿式汽车
traffic	贸易
overseer	监督
daphnia	水蚤
torpify	=torpefy
eerie	怪诞的
recriminative	反控诉
galactopoietic	催乳的
comprehensible	易于了解
idol	偶像
paper	报纸
relique	遗物
dialectician	辩论的能手
nutlet	果仁
assyriologist	亚述研究者
photofit	照片拼凑人像法
defocus	使散焦
prosit	祝健康
yield	屈从
stigma	柱头
biff	打
depreciatory	蔑视
polite	客气的
oxbow	牛轭U字形部分
wrcb	Control
help	帮助
enclisis	附读
neologize	创造或使用新语
rooted	根深蒂固的
sashless	无窗框
charge	负荷
waldo	沃尔多
antiscriptural	违反圣经的
evangelistically	福音传教士地
suxamethonium	丁二酰胆碱
shade	荫
madly	发狂
complete	全部的
presentative	表象的
rantipoled	行为放纵
cladogenesis	系枝发生
depreciatory	贬值
slim	无价值的
consort	配偶君王或女王的配偶
polychromasia	变色性
he	氦
hainan	海南
beautility	美观实用性
quadrangularly	正方形或矩形地
tubbing	盆浴
catchpenny	不值钱的
ost	科学技术局
zmodem	是YMODEM的扩充
strawy	稻草的
fission	裂变
martin	马丁
subapical	位于顶点下
avaricious	贪婪的
unquestionably	无疑
hangfire	延时爆炸
leadwork	铅制品
short	浅薄
seagirt	四面环海的
stockbreeder	畜产业者
lynchet	=lynch
lay	形势
shippen	牛棚
agriculture	农业
misdirect	误导
theroid	野兽般
presumable	可假定的
jimberjawed	下颌突出的
designing	设计
somal	神经元体细胞
grizzle	变成灰色
versant	熟悉的
worthwhile	值得做
plodder	沉重行走的人
pitiably	卑劣
mfn	Nation
intrapsychic	心灵内部
troophorse	骑兵马
informidable	不足畏惧的
immixture	卷入
gatefold	大张折页插图
ingathering	收获
fraternity	兄弟关系
invulnerable	不会受伤害
accommodable	可适应的
stake	树桩
megimide	美解眠
telltale	告密的人
cyclist	骑脚踏车的人
sassenach	撒克逊人
sheave	滑车轮
aphthoid	似小溃疡
quavery	颤声的
seminivorous	食种子的
relique	遗迹
mustardy	芥末的
crosstie	枕木
indistinctly	不明了地
po	波河
aerial	生活在空气中的
parallel	平行的
superuser'	NULL)
poughite	碲铁矾
spermatophyte	种子植物
gourbi	帐篷
puzzler	使困惑的人
eutrophic	富营养
wormwood	苦恼
gelable	能变成胶状的
hoochie	=hootch
termer	服刑者
cymiferous	生长聚伞花序
collusion	勾结
glassy	象玻璃
unpremeditated	非预谋
druzhinnik	义勇队员
roomer	寄宿者
feudist	封建法学家
saturated	深颜色的
square	广场
dicker	做小生意
immure	监禁
set	安全电子商务协议
reginal	威严的
insectivora	食虫类
shipentine	四桅帆船
betray	出卖
ghast	死人般
piffle	做无聊事
sociogenic	社会因素影响的
dodgasted	被咒的
determine	使终止
puny	微不足道
disaffect	使疏远
opalesque	似蛋白石的
didakai	=didicoi
agp	Graphics
filigree	饰有金银丝细工的
egomaniac	极端自我主义者
veldt	草原
ebullient	热情
gramercy	不得了!
soporific	催眠剂
atrocious	凶恶
rescissible	可取消
lps	Seal
permanently	不变地
unbelieving	多疑的
eclipse	日蚀
wake	痕迹
pds	简便式诊断系统
vantage	有利情况
diadochic	同晶性型
messianic	弥赛亚
underproof	酒精含量在标准浓度下
airconditioned	备有空气调节装置
assumption	作态
palatogram	口盖图
qse	qualified
conjugal	夫妇间的
snooty	傲慢的
anomie	混乱
recuperation	恢复
stub	短而秃的
hijack	劫机
pregnant	孕育的
vfat	虚拟文件分配表
podgorica	波德戈里察(南斯拉夫南部城市铁托格勒
manway	人行巷道
relieve	减轻
mismanagement	办错
daddy	爸爸
hostile	敌对
agley	弯曲
kanji	日本汉字
ornate	华丽
cordiality	郑重
leipsic	莱比锡
canonize	使加入圣徒之列
exhortatory	告诫
monastical	僧院的
savagism	=savagery
hypoglycemic	血糖过低
trailside	沿山路
waddy	棍棒
kilograin	千英厘
bobsled	长橇
saucerian	飞碟
siesta	午睡
pothecary	药剂师
permeate	弥漫
cortex	皮层
constabular	保安队
vicarate	=vicariate
filmset	电影布景
nigerianize	把……置于尼日利亚政府之下
artificial	非原产
authoritarian	独裁
goat	山羊
faker	冒牌货
datable	可确定时代
belly	腹部
eponym	名字被用于命名地方的人
antituberculous	抗结核
awake	醒
bughouse	疯狂
unturned	未翻转
exultantly	欢欣鼓舞
nightstool	卧室用便器
sensitometer	感光计
haunt	神鬼出没
damascene	大马士革人
cholecalciferol	维生素D3
jitteriness	神经过敏
ruttish	发情中的
commissionaire	门警
offal	废弃物
ozoniferous	含臭氧的
frothily	起泡
silurid	鲶
chicquer	chic的比较级
buff	软皮
minor	小音阶
recital	独奏会
suppressible	可隐藏的
occultist	神秘学者
calliope	气笛风琴
glycollate	=glycolate
tranquilly	平静
injuriously	有害
indemnification	补偿
asperifoliate	有粗糙叶子
evolutionary	进化
wireworm	切根虫
ranter	豪言壮语的人
sportfishing	垂钓
peacemonger	和事佬
ozoniferous	含臭氧
ballottement	触诊子宫检胎法
vasopressin	后叶加压素
tome	大本书
welsh	逃避履行义务
underlaid	下有衬物的
stably	坚固
fruitive	能产果实
impiously	不信神地
wolfish	豺狼般的
childish	孩子气
skimeister	滑雪教练
ascosporic	囊孢子的
icing	结冰
disseat	夺席位
nomarchy	省长管区
extramitochondrial	细胞中的线粒体之外
plating	被覆金属
laevoglucose	左旋葡萄糖
righthearted	诚实
electrokinetic	I9lektrEJkaI`ntIk/
roentgen	伦琴
catchy	易记住
geelong	季隆
encurtain	用帘子围住
cyclometry	测圆法
impeccance	无罪
ahold	握
brainteaser	难题
swim	游
oversimplification	过度单纯化
swbs	south
puncturable	可穿孔的
expostulatory	训诫的
naysaid	拒绝
aucuba	桃叶珊瑚
matrilateral	母亲一方的
langue	语言
confusable	易被混淆
nonsignificant	无意义的
mlg	German
sinai	西奈山
vizir	元老
bobbysocks	短袜
orthodox	习惯的
spck	Promoting
spiculate	尖锐
believing	有信仰的
cismontane	山脉的这边的
precipitate	沉淀物
orient	适应形势
buffer	缓冲器
realizing	清晰生动
nameless	匿名的
balky	停止不前
unfading	不衰
winterkill	受冬寒枯萎
manuscript	手稿
predefine	预先确定
hypotensive	低血压
bromatium	饲蚁菌丝
loving	亲爱的
pilus	纤毛
uncongeal	融解
zwinglian	茨温利的
adipic	油质的
ruleless	无规律的
ventriloquous	似腹语的
volumetry	容量分析
nonreward	有意不给预期的奖励
unprincipled	无原则的
chemopsychiatry	精神病化学疗法
escapeproof	防逃脱的
obbligato	不可缺少的
institute	创立
footfault	脚步犯规
leyden	荷兰都市名
motley	五颜六色的
trust	赊卖
wearisome	使厌倦
shift	轮班
galactosamine	半乳糖胺
visibility	能见度
phlebolite	静脉石
glanderous	鼻疽病
permissive	许可
chipper	爽快的
catechetical	问答式教学法的
technologic	技术的
gfr	Republic德意志联邦共和国
loutish	无礼
sideboard	餐具柜
viaduct	高架铁路
social	社会
tee	T形物
waxen	蜡制
disoperative	侵害
apparat	地下活动组织
inelegantly	不优美地
spindleshanks	细长腿的人
ditto	同上符号
validity	合法性
therm	小卡
myrrh	没药
short	矮的
prawn	大虾
univalent	单价的
capacitor	电容器
humdrum	单调
hyraces	的复数
homological	=homologous
constitutional	/宪法
unmatched	不相配
monarchial	国王的
clectroscope'	NULL)
magnesia	镁氧
gsm	Global
lanuginose	=lanuginous
isotonic	等压
echinoid	海胆属
superduty	超耐用的
scrubwoman	打杂女工
chirographer	书法家
inquilinous	寄食的
trigonous	三棱
longer	比较久的
corporatism	社团主义
hyperphysically	超自然
quadrangularly	四边形地
preindustrial	工业化前
liker	爱好者
bluet	矢车菊
nattily	帅地
arbitrage	套利交易
worker	工人
druffen	醉的
xylographer	刻版师
dependency	信赖
lestobiotic	靠偷取异种动物为生
undistracted	注意力集中
bank	银行
elevatory	升高
escot	维持
membranate	有膜的
weak	不耐用的
siallite	硅铝土
charm	行魔法
homage	敬意
reconcentrate	集中于某一点
promin	普罗明
damnify	损伤
impotable	不适合饮用
sacramentalism	圣事主义
suboceanic	洋底的
provinciality	粗鄙
statutory	法令
fishable	适合钓鱼
hijaz	=Hejaz
subordinating	连接主句和从句
sclerosing	硬化性的
spirit	勇气
keynes	凯恩斯
wroth	愤怒
chaperone	伴护
landskip	山水
fiard	低峡湾
sitting	易击中
substantive	大量的
repeatedly	再三
effuse	涌出
subthreshold	阈下
downtrodden	被蹂躏的
disbelieving	不相信的
creaser	各种压摺之器具
gerenuk	非洲瞪羚
envier	妒忌者
luster	有光泽
eryngium	刺芹属植物
cordillera	山脉
infinitesimal	无限小的
runabout	流浪者
fiddler	弄虚作假
unhcr	United
bullate	起水泡
nogaku	=No
counterchange	变换
financial	金融的
syria	叙利亚共和国
sterile	消过毒的
scabbed	生疥癣的
sustentacular	支持的
superserviceable	过分殷勤的
exceptional	例外
cmd	电荷调制器件
allochthonous	外来
stinking	讨厌的
chronically	慢性地
carburettor	汽化器
fluf	波音737客机
neutralise	使中立
unfailingly	不倦
escaut	埃斯考河(即斯凯尔特河
dissidence	异议
jazzily	愉快地
jsd	Scientiae
narcotic	麻醉的
zone	地区
shoaly	多浅滩的
discoid	平圆形
uncustomed	未付关税的
oklahoman	俄克拉荷马州的
polynomial	多项式
afrikaans	南非荷兰语的
guianese	圭亚那语言的
arbalest	劲弩
impresario	舞台监督
barleycorn	大麦粒
mesquit	牧豆树
gsp	System
hip	蔷薇果
caliper	卡钳
poseuse	故作姿态的女人
theroid	野兽般的
fright	吃惊
cloudward	朝着云地
distributing	分发
tetramorph	四联像
fetichist	拜物教徒
galati	加拉茨
sphenographic	楔形文字
replicative	重复的
clement	宽厚
sarpedon	萨耳珀冬
busiest	最忙
exarch	主教
behoove	适宜
eartab	=earflap
lengthy	冗长的
subnuclear	亚核粒子研究的
nobody	谁也不
ptyalectasis	涎管扩张
roman	罗马
jesuitical	虚伪
flavourless	无趣味的
phalarope	矶鹞之类
hognut	=pignut
transiency	无常
perpetrate	犯
cold	感冒
earl	伯爵
begrudge	嫉妒
general	普通的
noneffective	无效的
bannerette	爵位
anonymously	不具名
lexicographic	词典编辑
tahiti	塔希提岛
monetary	金钱
curability	治愈可能性
mahlstick	腕杖
cordiality	诚恳
orology	山理学
mealworm	面粉中的甲虫之幼虫
rainstorm	暴风雨
backformation	倒反构词
burry	芒刺多
cupful	满杯
papoose	婴儿
unpromising	无前途的
kneed	有膝一般的关节
sweetish	有点甜
roupy	患黏膜炎
derwent	德文特河
bower	凉亭
rumpty	极好
smithite	斜硫砷银矿
allocution	面谕
victor	胜利者的
disharmonious	不和谐
alveolate	有肺泡的
unaccountably	无责任
keelage	入港税
assamese	阿萨姆的
feebleminded	无决断力
gnaw	消耗
syllable	分成音节
corona	王冠
vagarious	奇特的
photocoagulator	激光凝固器
helpfully	有益地
hawk	掠夺他人的人
corps	特殊兵种
israelitish	古以色列
vocalization	发声法
norwards	向北方地
misspelt	拼写错误
translator	翻译者
dekagram	十克
lacet	靴带
mafioso	黑手党成员
culminating	最后的
raiser	饲养者
languidly	无力
computational	计算的
crowhop	短距离
escapeproof	防逃脱
outlook	景色
hazardous	碰运气
fascismo	法西斯主义
housemasterly	男舍监式的
bawdily	淫秽
boffo	非常流行的
larruping	特别的
tmesis	插词法
fourierism	傅立叶主义
superzealot	极端狂热分子
heterogenous	异种的
stratal	层
trirectangular	三重正交
efface	抹掉
cholelithiasis	胆石病
oppugn	责难
keyed	键入
declination	偏差
physiographical	形学
playback	录音重放装置
farcetta	短闹剧
devotement	专心
orbiter	人造卫星
lovesick	为爱情而生病或忧愁的
taymyr	Peninsula
pandemonium	大吵大闹
boswell	为名人详细记述言行的人
vein	翅脉
cybernetic	控制论的
adverbial	副词的
logman	伐木工人
limpidity	清澈
maternity	产妇
tack	以大头针钉住
huanghe	黄河
gauze	薄纱
palankeen	担在肩上的轿子
decide	决定
postnasal	鼻后
combinatory	=combinative
gorget	饰领
praetorian	禁卫队
curage	刮除术
papilloedema	视神经乳头水肿
crusade	加入十字军
destructible	可破坏
geigers	辐射
cyclostomate	有圆口的
modesty	谦逊
pivot	枢轴
twirl	旋转
dichlamydeous	两被
hemistich	半行
tomahawk	印第安战斧
generalcy	将军的军阶、地位、任期、或权力
voluntarily	自动
betrothed	订婚了的
fair	美人
chrp	共用硬件平台
odt	Transportation
demimonde	品德有问题的女人
enow	充分
fake	假货
fluoresce	发荧光
cordite	无烟火药
somerset	=Somersetshire
faddist	好新奇的人
spoony	愚蠢
excitory	易刺激
persuader	强制的工具
excrescency	赘生物
whittret	=weasel
boding	凶兆的
leftwinger	左翼队员
baptistry	洗礼池
moot	未决议
clastic	碎屑状的
subcontrary	小反对关系
trachea	导管
airfare	飞机票价
unequable	不稳定
atlantean	岛的
agonize	使极度痛苦
boatel	汽艇游客旅馆
chin	下巴
colubrine	蛇似
kite	使用空头支票
brayer	用手复印的滚筒
spck	基督教知识普及协会
erythroleukemia	红白血病
rebato	披肩领子
lax	不严格的
tungstic	六价钨的
andante	行板
pyxides	药箱
semidomesticated	半驯养
birchen	桦木制
eluviation	淋溶作用
notoungulate	南美有蹄动物
inbound	内地的
traveled	旅客常到的
lathi	警棍
aristate	有芒
moonshiner	烈酒走私者
dodad	=doodad
sputteringly	气急败坏地
konzern	康采恩
missel	獬鸫
especially	特别
departmentalize	把……分为各部
thermoelement	热电元件
intimity	隐私
apagogic	反证法
hokkaido	北海道
quizzical	探询的
slavonian	斯拉夫尼亚人
progestin	黄体酮
charger	军马
incertitude	无把握
qarnns	亚历山德拉王后皇家海军护理队
stuff	塞满
lpg	液化石油气体
laguey	极端
malefactress	作恶的女人
flueric	=fluidic
vaticinal	预言的
argent	银色的
borrowed	借来
citizen	市民
pentagonian	五角大楼工作人员
reintroduce	再引入
dep	Productivity
aether	以太
puky	令人厌恶的
weatherly	能抢风航行的
carbonous	含碳
sulfhydryl	=sulphydryl
down	向下的
rurban	靠近都市之农村的
nga	全国印刷协会
undershot	下射的
vile	不足道的
fullmouthed	口牙长齐
soberize	使清醒
regionally	地方的
soapolallie	无患子果制成的饮料
theftproof	防盗的
superable	可以胜过的
uninjured	未蒙损失的
larmor	拉莫尔进动
opulence	富裕
gmat	astronomical
duchenne	dystrophy
lathy	细长的
passe	凋谢的
tangent	相切的
findable	可找到的
microcapsule	微胶囊
croupy	格鲁布性
sovran	君主
polacolor	宝丽来一次成像彩色胶片
serrulate	细锯齿状的
reformative	改善的
toothed	锯齿状
crapshoot	有风险的事业
scurvy	下流的
decapacitate	除去使卵受精的能力
pedosphere	土壤圈
airborne	空运的
flattery	巴结
thalamus	室
unusual	与众不同的
thymine	胸腺嘧啶
vauntingly	傲慢
pool	撞球
parapsychology	超心理学
phytocide	除莠剂
battlements	碉堡上的城垛
thridace	莴苣膏
retinene	视网醛
touch	使接触
installation	装置
endways	在末端
dionysian	狂饮
fleckered	有斑点
maidenly	适合于少女
misuse	错用
carvel	轻快帆船
hymenium	子实层
deceiver	欺诈者
neutral	中立国
aestival	夏季的
philtre	催情药
katharevousa	道地希腊语
unmined	未开采的
chickweed	繁缕
snowdrift	被风刮在一起的雪堆
kurtosis	峭度
evolution	进展
remover	去除剂
memorialist	回忆录作者
justiciary	司法官
indirect	迂回的
shipwreck	船只失事
fountful	多泉水
farriery	马掌铺
elucubrate	精心表达出
hesternal	昔日的
recoverable	可重获
obsessive	分神
judaeophile	对犹太人亲善的
polylysine	多熔素
litterbag	废物袋
agreement	协定
brocade	织有金银丝浮花的
sexagesimal	六十进位的
caliche	生硝
acquiescently	顺从地
disseise	=disseize
fastidiously	非常讲究地
eulachon	太平洋细齿鲑
bonesetting	接骨术
vineyardist	葡萄栽培人
poleaxe	屠斧
chlorotic	萎黄病
gsp	of
plaint	抱怨
custom	风俗
convertibly	可改变
scalper	剥头皮的人
malnourished	营养失调
skyward	向上
netfs	Educational
unboastful	不自夸
centiare	平方米
ripe	时机成熟的
massify	使
b2b	商务对商务
hit	伤……的感情
nectarine	油桃
sempervirent	常绿的
chartreuse	黄绿色
marginalize	排斥
pathetical	可怜的
snuffling	假装虔诚
desiderative	愿望动词
grinder	尤指磨刀具的工人
caterwaul	吵架
circularize	传阅
viscus	腑脏
misanthropic	厌恶人类的
conscript	征募
apospory	无孢子状态
denominational	宗派
harmonious	悦耳的
quickie	简短
sartorial	裁缝
beaufort	Sea
underclay	底黏土层
introductive	序文的
homologous	同源
darling	亲爱
mention	提及
musk	麝香鹿
viatic	道路
parlance	谈话
immersible	可没入的
telescopically	伸缩地
compartmental	分割为若干部分
plumbous	铅的
cheerily	兴高采烈
biparental	双亲
airy	空气的
brassart	臂铠
ballproof	子弹打不穿的
cummin	枯茗
speel	爬
numbness	麻痹
maddening	发狂的
platform	讲坛
noumena	的复数
lcd	Display
betaine	甜菜碱
auriferous	含金
scca	America美国赛车俱乐部
spitz	波美拉尼亚丝毛狗
unstudied	不懂
hydroclone	=hydrocyclone
bks	Barracks
city	都市
ornate	装饰的
grave	严重
monophonematic	单音位的
biceps	强健的筋肉
jesuitically	耶稣会
sleigh	雪橇
impetuous	猛烈
aromatic	芬芳
dendrite	树枝状结晶
exhaust	抽完
encephaloid	类脑
piped	滚边
cascalho	砂石沉积物
slip	事故
autoantibody	自身抗体
contractual	契约
glenoid	关节窝
oppugnant	反对
pained	痛苦的
bluejeans	蓝"紧士"裤
waspish	如黄蜂
fulgurate	闪亮
caique	土耳其狭长划艇
impersonate	人格化
assembly	集合
taihang	太行山
suction	吸力
undetermined	未解决的
annulate	有环纹
tackle	处理
extortive	逼取的
suspensive	暧昧
capillary	毛细作用的
romanization	皈依天主教
tussor	野蚕
inculpate	使……有罪
luminarist	光色画家
flyaway	翅状的
domiciliate	决定住处
upland	高地的
metrorrhagia	子宫出血
mousey	像老鼠的
mitannite	=Mitannian
rap	Rocket
unpruned	未修剪
spur	踢马剌
pedunculate	有花梗
fragmentized	破片
subviral	亚病毒的
abridge	精简
pore	因凝视过度使……疲劳
cep	圆概率误差
gypsite	土石膏
jackfield	ware
crouch	蜷缩
utricle	小囊
santolina	神圣亚麻
diversely	不同地
tvp	textured
gorgonian	如蛇发女怪的
quiveringly	颤抖地
soapie	肥皂剧
sep	九月
message	带信息
distill	滴下
rescale	重新攀登
recognizant	认识的
fire	点燃
unworn	没有磨损的
quadplex	有四部分
ptfe	fluoro
kousso	苦苏
rhinopharyngeal	鼻咽的
achillean	阿基里斯的
emphatic	显著的
succedent	随后
lapper	舐食流体食物的人或动物
sphere	方面
mounting	乘骑
nundinal	市集的
sure	确信某事
depressor	抑压物
tar	柏油
fluidounce	液量盎斯
incredibly	不能相信
sexualia	有关性的书籍
dun	催债
bored	烦人
conchiferous	含贝壳
solecist	违反语法者
bumptious	傲慢
classify	分类
dipterist	双翅昆虫学家
catch	捕获物
kindless	薄情
echopraxia	模仿倾向
schistosomicide	杀血吸虫药
interrogative	质问的
regal	帝王
supplely	易弯地
giglot	荡妇
howl	号叫
sandy	沙质
collagenous	产生成胶的
vow	宣誓
mycenaean	迈锡尼文明
unrip	撕开
visionally	虚幻地
artotype	珂罗版
leafage	叶状装饰
ambulant	走动的
through	直通的
teachable	可教的
stubbed	株状的
tetra	脂鲤
trichrome	三色的
wolfish	残忍的
west	向西方
ohmic	欧姆
kantist	康德学派的人
beta	贝它
ertebolle	新石器时代文化
vega	织女
reject	呕出
registered	记名
gamodeme	隔育群落
mabe	Business
vomitive	使呕吐
uigur	维吾尔人的
japanize	日本化
semifinished	半完成
discretional	自由决定
indigestible	不吸收
flowery	花的
bmoc	big
wedeling	双板平行摆动转弯滑
morbid	由病引起的
teletype	电传打字机
throve	thrive的过去式
neonatal	新生的
thieves	小偷
circassian	切尔克斯
sheepish	羞怯
diatribe	恶骂
hyperosteogeny	骨发育过度
abyssalbenthic	深海海底
gaston	加斯顿
semievergreen	半常绿的
paramedian	正中旁
snakeskin	蛇的熟皮
kickup	骚乱
canaliculate	有细管
clodhopper	庄稼汉
episcopalian	主教制的
devolution	落下
cleanup	获利
incident	易于发生
recur	复发
splodgy	有污点的
earthen	土制
sholapur	肖拉普尔
reprivatize	取消国有化
aggradational	沉积的
koumiss	乳酒
aacs	航路与航空通讯联络处
monuron	灭草隆
qualmish	受良心责备的
icj	Justice
unimposing	不动人的
extensible	可扩张
abaft	在……后
hagborn	巫婆生的
roofer	客人对主人道谢的函
rann	国民需求研究计划
voicespond	口声通信
rudderpost	舵轴
flecker	斑点
sutton	萨顿
opposeless	无可反驳的
biologically	生物学上
necrophily	=necrophilia
invective	恶言
aves	鸟类
overly	过度
ecp	Capabilities
mature	到期
iamap	of
unpretending	不骄傲的
outright	全部
ulcerously	溃疡性
unlovely	丑
opposable	可反对
supersedure	撤换
beneath	在……之下
lyrate	竖琴似
climatization	机器设计而使其能在任何气候下作业
ignitron	放电管
scanty	缺乏
infaust	不利的
dari	达里语
purebred	纯种的动物
ue	of
mythographer	神话收集者
articulator	音节分明之人
tumorous	浮夸
refraction	折光
tarras	=trass
ripe	成熟
dockhand	码头工人
fledgeling	刚长毛的鸟
excitably	易兴奋地
lockable	可封闭
grassiness	象草
hila	门
bariatrics	肥胖病学
prepose	把……放在前面
hecatonchires	百手三巨人
gluttonous	暴食的
sanguicolous	栖血的
ample	充足的
springtime	春季
gudrun	古德龙
nummular	圆形的
perspective	前途
perivisceral	内脏周的
instantial	实例
vive	有生气的
brightly	明亮地
inseminate	向……受精
sialic	富硅铝
accusation	指控
acierate	掺碳
multimeter	万用表
nounal	=noun
tictac	=ticktack
argental	银
emperor	君主
ips	英寸[秒
ghostlike	恐怖的
declarative	宣言
convergent	会聚性
whisht	静
blatantly	喧闹
timeworn	陈旧的
flog	严厉批评
bluntly	坦率
wilma	威尔玛
dildo	假阴茎
andorra	安道尔市
microcontinent	小陆块
erectormuscle	竖立肌
foresighted	深谋远虑
fingerbreadth	指幅
rattled	恼火的
impayable	极好的
falcongentle	雌游隼
chlorinous	氯
ammino	氨络
osteocranium	骨颅
congregational	会众的
unmanly	怯懦
nicker	嘶
german	德国人
ccst	Chinese
decrepit	衰老的
victorianism	风尚
disengaged	自由
ducat	硬币
gadroon	圆模雕刻装饰
haggis	将羊的心
smogbound	烟雾笼罩
collenchyma	厚角组织
sybase	主要生产数据库产品
caudate	有尾状附属物的
oxenstjerna	Axel
genial	亲切的
tufty	簇生
fungoid	真菌样
quicksand	敏捷
dissimilarity	相异
endobiotic	生物内生的
haneda	羽田
multiplicable	可增加
apart	分成零件
sierran	锯齿山脊区居民的
manstopping	大威力的
impersonalization	非人格化
nodosity	节
metabolism	变形
whirlabout	盘旋的
zincous	含锌
question	怀疑
xiphias	旗鱼属
gallophobia	恐法症
aragon	西班牙北部地方
downtrod	=downtrodden
cohere	紧凑
spindly	纺锤形
fluffhead	傻丫头
esmtp	Extended
lemures	勒穆瑞斯
freaky	捉摸不定
vallation	壁垒
aarnet	Network
project	事业
bemazed	恍惚的
endoerythrocytic	红血球内
offset	形成分支
tibiofibula	胫腓骨
oblique	无诚意的
choreic	舞蹈病
dall	Dall''s
insurrectional	起义的
woundwort	治伤草
epithetical	形容语句的
thoroughly	彻底地
sunderance	拆开
unrwa	and
iris	彩虹之女神
witch	巫婆
noninstallment	非分期付款的
tufthunter	势利者
inturned	内弯的
impoliteness	无礼
turkmenian	土库曼
arriviste	暴发户
calciphobous	不适于石灰质土壤之植物
bessarabian	比萨拉比亚的
dusky	忧郁的
sublimate	理想化的
aristocracy	贵族统治
upright	竖式的
overreach	以后蹄踢前蹄
invocatory	祈求的
tropaeolin	金莲橙
wallow	泥坑
transuranic	超铀元素
dichromate	重铬酸盐
unreflecting	浅薄
explanation	解释
explosive	爆炸的
wallaceism	华莱士主义
mesomorphic	体育型体质
mcat	Test
formal	形式
pocketknife	随身小折刀
tubbing	划浆练习
nonconform	不信奉国教
endoarteritis	=endarteritis
nonrefundable	不可归还的
lactobacillus	乳酸菌
sunnily	照着阳光
discohere	失去连贯性
polyhedric	多面体
cissy	柔弱胆小
slot	足迹
usurp	篡位
dirham	迪拉姆
sandwort	蚤缀
stepwise	楼梯式
woodlander	居住在森林中的人
hypermetropia	远视
frere	兄弟
autocade	汽车队伍
calk	摹描复制
unswerving	不歪的
lick	少许
disputative	爱争辩
shagginess	毛茸茸
exciseman	收税官
piquant	淘气的
ureteritis	输尿管炎
sialoid	唾液状的
skullfish	老鲸
perform	演出
illegality	非法行为
unbearded	无胡须
edc	Defence
inceptive	表始动词
paediatric	儿科的
milk	牛奶
unaccustomed	不平常的
puky	令人厌恶
rosario	罗萨里奥
onlooker	旁观者
choreal	=choreic
afford	给予
axminster	一种以黄麻为底之羊毛织花地毯
pectinate	栉齿状
escheatage	归属产业获得权
argonautic	号远征
stalactical	生有钟乳石
molluscoidal	拟软体动物
fit	痉挛
vasa	vas的复数
chinchona	=cinchona
riverward	向河
waddy	用棍棒打
screwman	棉花装船工
inculcation	教授
coremium	孢梗束
hugely	非常地
underhand	欺瞒的
frosted	被霜覆盖的
brierroot	石南科植物之根
tabby	斑猫
epidemical	流行的
laboured	谨慎的
shite	=shit
bwr	reactor沸水堆
inexpressive	无表现力的
pusillanimity	胆怯
rainbow	彩虹
proclaim	显示
coachwhip	鞭蛇
pleasurably	欢愉地
zygote	接合体
tricentennial	三百年
rascaldom	流氓
wosa	Windows
gapemouthed	目瞪口呆的
acaudal	无尾
traditionary	惯例的
meshuga	失常
discredit	疑惑
icy	冰冷
architect	建筑师
mycophilic	喜欢蘑菇的
berimbau	拨铃波琴
garfield	加菲尔德
disrespectable	不体面的
squall	嚎啕
lawless	非法
ferryhouse	渡船船夫的屋
ardor	情欲
gachupin	西班牙人
sensorimotor	感觉运动
cursillo	短期培信班
melodeon	簧风琴之一种
agp	Accelcrated
morphoneme	=morphophoneme
vincaleukoblastine	=vinblastine
wangan	=wanigan
empiric	江湖医生
scousian	利物浦方言的
monument	纪念碑
immovable	固定
locution	说话风格
fraternity	友爱
realist	现实主义者
regulon	调节子
prepsychotic	精神变态前的
aymaran	艾马拉语的
uncloak	除去……覆盖物
demark	区分
joseph	连帽大氅
jerkin	男用无袖短上衣
cocktail	鸡尾酒
scant	欠缺的
squat	蹲着
cantabrigian	模仿剑桥大学的
hazard	危险
reassumption	再接受
mischievous	淘气
cursive	草书的
scot	估定的款项
sceptic	怀疑论者
impactful	有效
personal	个人的
lioness	雌狮
undelighting	令人不愉快的
constancy	坚定不移
intermetallic	金属间
colonial	殖民的
refluent	倒流的
spill	小塞子
working	工作的
grizzle	灰色
treachery	叛逆行为
peloponnesian	伯罗奔尼撒半岛的
flatten	使失去光泽
resultant	作为结果而发生的
vegetal	植物性的
rightward	在右边
enslave	沉溺
trichomonal	毛滴虫引起
piddle	游荡
stroke	一次努力
actionless	静止不动
worm	使蠕行
fishlike	似鱼的
mucker	无赖
cuspidated	尖
quizzical	探询
physiognomy	人相学
dissimilate	变得不同
preaching	讲道法
sural	小腿肚
bailable	可保释
hardly	艰辛的
villainous	腐化堕落
pronounce	断言
phlegethon	地狱火河
stargaze	眺望星星
statics	静力学
mastocytoma	肥大细胞瘤
hidrotic	发汗的
blotchy	到处有污点
hermeneutic	解释的
mitriform	主教冠形状的
hepburnian	Hepburn式的
nhg	German
infundibulate	漏斗管
eater	吃的人
dews	warning
statement	陈述
unbent	未弯曲
simulacra	simulacrum的复数
saboteur	怠工者
unstrained	未拉紧的
jugate	具翅轭
punishable	可罚
quickness	尖锐化
floodwall	防洪岸壁
campaign	战役
semidarkness	半暗
ungainly	不象样
belligerent	好战的
monopteral	圆形外柱廊式
snapper	甲鱼
bmta	Motor
luminosity	发光度
intimist	描写个人情感的
advantage	利益
crowtoe	百脉根
funiculate	有细索
slink	潜逃
surjection	满射
practised	老练
color	改变……的颜色
sea	大浪
scale	刻度
curlicue	形成花体
unitr	联合国调查训练研究所
economizer	经济家
buildup	累积
tetradynamous	四强雄蕊
cuspidated	有尖端的
futurologist	未来学家
clumber	矮脚体壮毛厚的西班牙猎犬
esplanade	平坦的空
didymous	双胎
clerk	店员
contradictorily	逆
knout	笞
sententiously	简洁地
preplacement	雇用前
lettered	精通文学的
rebellious	造反的
colonnade	柱廊
delegitimation	合法性丧失
salmagundi	杂录
neurohypophysis	垂体神经部
pcav	Velocity
chargeable	可以控诉
majesty	最高权威
apprehensively	担心地
incontinent	失禁的
enunciative	表明的
barrette	条状发夹
slouch	懒散
gamme	=gamut
versicolor	斑驳
countermove	对抗手段
ingrown	向内生长的
loud	大声地
coupler	配合者
fillipeen	=philopena
smooth	无毛的
issueless	无结果
aeronaval	海空联合的
freeloader	不速之客
nonproficient	不熟练
lover	爱好者
tangent	切线
litho	石版画
renew	续借
bardian	个性
asyndeton	连接词省略
mesic	栖于湿地的
scurvily	无礼地
inspiratory	吸气的
dogie	失去母牛的小牛
collegiate	学院的
sutherland	萨瑟兰郡
equilibria	均势
linenfold	布轴式的
lepidosiren	南美肺鱼
uranic	星学
brickkiln	砖窑
flagging	衰弱
pasteurize	用巴氏法灭菌
worthwhile	值得出力
shrug	耸肩
spunk	引火木柴
jape	开玩笑
rotiferous	=rotiferal
derby	英国的大赛马会
amylene	戊烯
ectogenic	外生
shemite	闪米特人
lovingness	忠诚
uredospore	夏孢子
aether	能媒
renardite	黄磷铅铀矿
autonetics	自动控制学
headstand	头手倒立
metric	公制的
undo	松开
rhotic	发r音的
holothurian	海参的
refulgent	灿烂的
logodaedaly	玩弄词语
unmitre	解除……的主教职务
antagonistical	敌对
persuadable	可以说服
cutesy	矫揉造作
carom	碰击弹回
rigorous	严酷
fossilize	变成化石
heterozygosis	杂合现象
magnetist	磁学家
wicked	淘气的
fire	烧火
flaccidity	没气力
gingkgo	银杏
amitosis	无丝分裂
elliptic	椭圆形
charge	电荷
palaearctic	古北区
interproximal	邻间的
quarrelsome	好争论的
scribe	担任抄写员
dumb	无声音的
tumultuary	骚动
xanthosis	黄变病
omniscient	无所不知者
keystroke	按键
electrovalent	电价
hipped	忧郁
aristotelean	实验主义者
regular	定期
rookery	白嘴鸦的群居
general	大体的
pronumeral	变项
fabulosity	传说性质
eudiometric	量气管
thews	肌肉
suffer	遭受
uncommonly	罕见地
prepackage	事先做好的包装
untuneful	不和谐
protestant	新教徒
realization	实现
remembrance	问候
contrastive	对比
glittery	闪光
sulfinpyrazone	=sulphinpyrazone
insufflation	吹入法
embed	深留
ebonite	硬橡胶
unacquaintance	不熟悉
david	大卫
varlamoffite	水锡石
gayly	快乐
underwing	后翅色彩瑰丽的蛾
unilocular	单房
loose	自由的
afterword	编后记
exceed	胜过
castoff	废弃物
glaucous	蓝绿色
attenuation	衰减
coalman	送煤工人
ergonomic	人类环境改造学的
epidemical	传染病
fourdrinier	长网造纸机
unstained	没有沾污的
amazonian	刚勇好战的
nonnegotiable	不可谈判
yakut	雅库特
foeticide	残杀胎儿
londonese	伦敦话
fine	罚金
flavescent	逐渐变黄的
ophidian	蛇样
eff	滚开
mcat	Admissions
futility	无用
grade	等级
vibrational	摇摆的
posadero	旅店主
entrenous	不得外传
cabane	顶架
adzuki	小豆
sleazy	廉价的
fluorescent	荧光
urd	黑绿豆
sustentacular	支柱
dower	嫁妆
hypodermis	真皮
westward	向西
phenician	=Phoenician
hastiness	轻率
cruciate	十字状的
nattierblue	柔和的蓝色
geanticlinal	具地背斜的
icky	令人作呕的人
weathering	风化
imperforated	闭锁
wobbly	歪斜的
stitch	一针
spray	喷溅
compliment	褒扬
ramification	支流
stigmatic	污辱的
crosswise	交叉
shagreen	绿皮鲨革
semiellipse	半椭圆
perpendicular	正交的
unreachable	不能得到
circularly	循环地
intactness	完整无缺
loathly	勉强地
horseboy	马夫
sulfurous	硫磺
quits	对等
apology	辩解
carload	货车的最低载重量
limpopo	林波波河
supervene	被附加
shoreward	朝向陆
guiltily	罪地
abranchial	无鳃类
tocodynamometer	分娩力计
lino	亚麻油地毡
arm	提供
gentleman	先生
youthfully	无经验
gaffsail	斜桁帆
mnemonical	=mnemonic
roose	趾高气扬
xylographer	木刻师
unbearable	承受不住
tuck	活力
calabash	葫芦
elf	小精灵
learning	学问
paunchy	大肚子
meningitic	脑膜炎
slantwise	倾斜地
childrenese	儿语
isolated	隔离
topaz	南美蜂鸟
lvov	利沃夫
tasty	吸引人的东西
pram	parameter
mocambique	=Mozambique
rouser	激励者
sprightliness	愉快
imperfect	未完成时的
proportionately	成比例
sophisticate	掺合
comitia	议会或国民会议
whip	突然移动
cumbric	坎布里亚王国使用的凯尔特语
blowout	井中喷水或油等
derma	皮肤
hijack	劫持
ultrascsi	传输速率为40Mbps的快速接口
vfr	rules
translatability	可译
schismatic	分裂
accountant	会计
sororicide	杀亲姊妹的人
odourless	没有气味
rasp	发刺耳声
debridement	清创术
unsaid	不说的
indigene	土生的动植物
omuda	大牟田
schistous	片岩的
taphouse	酒吧
spendthriftiness	挥霍
acerate	针状
gimmick	暗机关
plug	插栓
breakdown	衰弱
limekiln	石灰窑
decry	谴责
pyramid	上涨
glove	手套
contaminative	弄脏了的
catamnesis	诊后病历
glyceric	甘油的
bilateral	有两面的
unpledged	未经保证
workmanlike	技巧熟练的
imroz	印布洛斯岛
fascinator	魅惑者
ovariotomy	卵巢切开
kitchenmaid	在厨房工作的女佣
vidual	守寡的
antedate	居先
hypsography	地势图
temporal	时间
centrally	在中心
mordida	贿赂
harmonically	和声地
activex	网络化多媒体对象技术
leprous	麻疯病的
dopy	呆笨
quarter	刻
bother	操心
paddleboard	桨叶式冲浪板
breathless	无声息的
vichy	维希
gloomy	黑暗的
mechanoreception	9mekEnEJrI`sepFLn/
adult	成熟
pinfish	钉头鱼
cankerous	溃疡的
masterman	丈夫
scramble	争夺
comix	连环漫画
disject	使散开
shrinkproof	防缩的
depolarize	去极化
domesticate	教化
haptical	由触觉引起的
concession	让步
hydrocracker	氢化裂解器
hz	赫兹
helpmate	助手
liberticide	破坏自由的
coontie	全绿叶择米
unpin	拔去别针
squeezer	剥削者
cellularity	细胞结构
irised	彩虹色的
plodder	辛勤工作的人
theatromania	观剧狂
ordure	污物
spck	Christian
fco	Foreign
unequal	不平衡
romany	吉普赛人之风俗习惯
storefront	店面
vigor	活力
generous	大方
balsamic	有镇静作用
competent	有能力的
gley	潜育土
northlander	北部居民
punctulated	有凹陷的
datamation	自动化资料处理
thematic	词干的
mortgagee	承受抵押人
wpm	per
mutably	性情不定地
middy	妇女或儿童穿的水手领罩衫
hurried	匆忙的
splanchnic	内脏
headpiece	帽子
sjaa	John
rear	屁股
schematiye	将……列入计划
choosy	慎重选择
monoglot	使用单一语言的
dependent	依靠的
grumbler	爱抱怨的人
iliamna	伊里亚姆纳山
harmonic	融洽的
bairn	小孩
cervine	鹿一样的
indecency	猥亵
kibitz	多管闲事
jis	日本工业标准
feverish	兴奋
bonny	健美的
laf	Louisiana
failing	失败的
tussock	草丛
iata	国际航空运输协会
gunrunning	军火走私
rattled	慌乱
votable	有投票权的
abysmal	无底
derris	一种杀虫剂
seriously	认真地
worsen	损害
water	加水
survey	俯瞰
evident	显然
fatbrained	愚钝的
aneuria	脑力衰退
precordial	心前
gentleness	温顺
panglossian	过分乐观的
gladly	高兴地
leporine	似野兔的
boondoggle	手工品
templar	法学生
mosque	清真寺
fay	小仙子
jow	打铃
circumglobal	环
abradant	摩擦着
irdome	红外整流罩
syndactyl	并趾
minitype	微型
montagnard	山地居民
bacchus	巴克斯
derivable	可推论
pairage	以双计算的鞋子数量
tennessee	田纳西州
sulk	愠怒
strepitous	嘈杂的
technicist	=technician
competent	胜任的
baldish	秃头
hookey	多钩
apart	分离着
might	权力
roric	露水的
dropt	放下
contractive	收缩的
pimiento	辣椒
tabby	平纹织物
drover	把家畜赶到市集的人
sulfurize	使含有硫磺
generous	大方的
uncontainable	无法控制
runtishness	发育不良
drivel	糊涂话
cella	内堂
ingoing	深入的
kil	千米
slavish	卑屈的
irreplaceable	不能调换的
retiary	结网
bylaw	规章制度
mat	垫子
monophyletic	单源的
outdistance	凌驾
rotc	Training
outsoar	高飞超出
documentarian	记录影片导演
premature	未成熟
probationary	试用的
volley	群射
fog	变模糊
volvox	团藻
momentous	重大的
unsigned	无正负之分的
marsupialize	给……造袋
reedy	细长的
body	赋以形体
reinforce	得到增援
revolver	旋转式装置
radioprotective	辐射防护
plagiarize	抄袭
jingoism	武力外交政策
carbo	碳水化合物食品
industrious	刻苦的
transcutaneous	由皮的
inject	注射
protohistory	史前人类学
hairpiece	假眉毛
clofibrate	降固醇酸
universalize	使普遍化
playbus	es)
hypnotic	催眠的
education	培养
nincompoopery	愚蠢
brominate	使溴化
lax	腹泻的
dagan	巴比伦的土地神
hyperoxemia	血酸过多
dainty	适口的食物
enabled	激活的
jambalaya	什锦菜肴
otic	耳
menes	美尼斯
hyperthermal	过高热的
amply	充足
invariable	永恒的
thud	砰的一声掉下
doubly	二倍
monofunctional	单功能
shiv	开门闸刀
haematocryal	冷血的
tjirebon	井里汶
prolicide	杀害胎儿
oysterwoman	采牡蛎的妇女
spittoon	痰盂
furl	收拢
photoautotroph	`fEJtEJ9R:
unprimitive	发达的
laniferous	有羊毛
busman	售票员
industrialist	工业家
strum	乱弹
glace	糖渍的
laboursome	费力
promulgate	公布
unsmart	不机智的
respiration	呼吸
reemployment	重新使用
advice	忠告
prophetess	女先知
swerve	转向
imagist	意象派诗人
fountful	多喷泉的
autotransformer	自耦变压器
pinnatifid	羽状半裂
negligee	妇女长睡衣
insectivorous	食虫的
moralistic	道学
shopman	店主
illustrious	杰出的
cragged	崎岖
petulancy	闹气
modificative	=modificatory
phlox	草夹竹桃属植物
lexicographical	词典编纂的
mbabane	姆巴巴纳
sibling	同胞
voyage	航海记
weather	风化
reversing	回动的
quinsy	咽门炎
lumberjack	短茄克衫
furred	穿毛皮的
globulous	球状
insomnia	失眠症
taxis	排序
cynical	愤世嫉俗的
cistus	水犀科的一属
rube	乡巴佬的
snowdon	斯诺登峰
mediatress	女仲裁者
fieldworker	实地考察工作者
giddyhead	草率从事的人
unselected	随意选定
forthcoming	来临
tapestried	织在绣帷上的
luebke	Heinrich
flocculent	柔毛状
vise	签准
ferocity	凶猛
beloved	所爱的人
amorously	好色地
unquelled	未被镇压
bleomycin	争光霉素
emulsive	乳剂质
bruxism	夜间磨牙
lionize	把……奉为名人
miniscule	小字
snuff	用鼻子使劲地吸
identic	恒等
mesothorax	中胸
judges	士师记
polybasic	多碱
equanimousness	安静
sitotoxin	食物毒素
tabouret	绣框
velaria	拟缘膜
entozoic	内寄生
laxatively	有轻度腹泻的
life	寿命
furl	卷起
silica	硅土
nightlong	彻夜
libeler	损害名誉者
version	译文
joyo	www
armourial	徽章的
optician	光学仪器制造者
plump	坦白地
supplemental	追加的
reassembly	重新组装
unbent	不屈服的
undercooked	火候不足
unfortunate	不幸的人
galabia	宽大的白色长袍
uniform	相同的
umbilical	脐带的
curvature	弯曲
volcanological	火山学的
triserial	排成三列的
finalize	定案
microcurie	微居里
druffen	醉
blowzy	蓬乱
meandrine	多纡曲的
whitesmith	锡铁匠
replicable	可复制
lichee	荔枝果
lobation	叶状
unurged	未被催促的
kyongsong	=Seoul
biotic	关于生命的
deviser	想出者
fearful	恐怕
displeasure	不愉快
dissolve	解散
poacher	侵入者
tracheoesophageal	气管食管的
collect	聚集
unexaggerated	未夸大
vellum	上等犊皮纸
kinsman	男性亲戚
vermis	蚓体
ultrafashionable	极端时髦的
globoid	球状
amnionic	羊膜
fruitlessly	无益
mycoplasma	支原体
nudity	赤裸
jacobin	毛领鸽
exocrinology	外分泌学
villainous	缺德的
interpolate	添写进去
contributory	贡献的
mort	许多
newmown	新割
hummocky	多圆丘的
overuse	使用过度
bugloss	牛舌草之一种
querulously	抱怨地
palaeethnology	古人种学
filter	过滤
monroeism	门罗主义
crytic	隐含
tokharian	=Tocharian
untoward	不幸的
enculturative	使适应某种文化的
oxbow	呈U字形弯曲的
mendable	可修理的
acquirement	取得
trepang	海参
theirself	=themself
tarbrush	焦油毛刷
selvage	布的织边
rare	稀罕的
duchy	直辖领地
ravage	掠夺
diazoamino	重氮氨基的
embryotrophic	胚胎营养素
fastidious	需要复杂营养
hydrophily	水生
ralliform	似秧鸡的
fateful	预言性
fun	供娱乐用
mangosteen	莽吉柿
unobservant	不注意的
provisionally	临时
renowned	有声誉
flagitate	苦苦哀求
rafferty	无组织的
pizazz	精力
foundry	铸造厂
forcipressure	钳压术
antidiphtheritic	抗白喉血清注射剂
periodic	周期
rippling	潺潺流水般声音的
embracery	笼络陪审员的行为
muzzleloading	前装式
cording	棱纹织物
devilishly	过分
resolutely	坚决地
pantie	短裤
lively	活泼
diorama	透视画
southwardly	向南的
dolosse	扭工字块体
rv	Vehicle
nombril	盾脐
uncondescending	不屈尊
backen	阻碍……的发展
nondefense	与军事防御无关的
unfitted	宽
fatigue	疲劳
unlovely	不可爱
fork	叉
reddle	红赭石
comitiva	一群有组织的盗匪或不法分子
uptake	举起
overhung	从上悬垂
ohmmeter	电阻表
automaker	汽车制造商
locusta	草之小穗
littleness	少量
caries	龋
flap	副翼
andorra	安道尔共和国
overcare	自寻烦恼
inscient	不知道
sum	算术题
pyelogram	肾盂X线片
cssr	Czechoslovak
trustless	不可靠
boldness	勇敢
dichotomise	=dichotomize
ilka	各自的
realistic	现实
reductionism	简化论
skerry	碎礁
lie	平放
singularize	成单数
feebleminded	意志薄弱的
characterize	刻画的……性格
malthusian	Malthus
brevirostrate	短喙
informative	提供情报的
syrup	糖浆
been	去过
insentient	无知觉的
noncontentious	非争论性
satyric	性好酒色
reprographic	复印的
praelector	=prelector
dithyramb	狂热的诗
grim	严酷
chipboard	纸板
diarist	记日记者
scholasticism	循规蹈矩
intuitionalism	直觉说
posterior	较晚
screaming	引人捧腹大笑的
polytene	多线性
thrave	廿四捆谷物
haggis	肺
iridectome	虹膜刀
irreparability	不可挽回
mumble	咕哝
blazon	装饰
unaccommodating	不随和的
impercipience	无感觉
sententious	很多说教式的
usrc	Reserve
tue	星期二
crenel	枪眼
do	算出
victorious	胜利的
nematicide	杀线虫剂
thio	含硫
lowery	阴霾的
systematically	系统地
macrocephalic	巨头的
lienable	可留置的
anthelmintic	打虫药
hyphenise	=hyphenize
ahd	动脉硬化性心脏病
ease	使安心
until	直到……才
relics	崩溃
whish	呼呼作声
discursive	不得要领的
helpmate	伴侣
marry	娶
remembrance	回想
lean	倚靠
inductive	诱导
carbuncled	有粉刺的
tuberose	块茎状
bugs	疯狂的
kidvid	儿童电视节目
pharaoh	法老王
excitant	刺激性的
biodegradable	生物所能分解
nepotism	偏袒
done	做
rashly	轻率
druse	鼻疽
pedicure	修脚
gayly	快乐地
strophulus	小儿丘疹性荨麻疹
bichloride	二氯化物
cockish	自负
deliria	发狂
azury	青色
card	卡片
anuclear	无核
engagement	交战
mudskipper	泥猴
zacharias	殉道者撒迦利亚
apoplectic	易患中风的
piaster	比索
moneygrubbing	蓄积钱财
transcendency	超越
bangup	把……关押起来
hydrargyrism	汞中毒
transmission	播送
miscarriage	失败
naughtily	顽皮地
fictile	塑造
medallion	大奖章
sarcasm	讽刺
borneo	婆罗洲
artificialize	使人工化
cockeyed	傻的
wringing	湿透
minimize	将……减到最少
moniliasis	念珠菌病
pinken	变成粉红色
sheba	Queen
microstomous	小口
sulfureous	硫磺
beaconage	信号系统
septal	氏族的
nannyish	象保姆
coeternal	永远共存
resplendency	灿烂
birch	白桦
nene	夏威夷雁
topically	时事问题
quintessential	精髓的
anchoret	隐者
to	在……之前
hypothalami	的复数
tinplate	马口铁
surpass	超越
bearberry	结红果实的桃类
guildhall	市府
chairperson	主席
mannered	守规矩
scotch	使受伤
unpriestly	不像教士的
chaw	一口
sponsor	发起
macadam	碎石
conferrer	授予者
cheep	吱吱的叫声
nepotism	裙带关系
unpretending	谦逊的
magician	术士
cpsu	of
donald	男子名
ruritanian	想像中之王国的
dexter	吉利
expressive	表现的
nice	细微
amphibology	暧昧的词句
anastatic	锌版术
rsd	Dublin
cautioner	担保人
capataz	监督
aliped	有翼肢
newsflash	简短的新闻报道
spelldown	拼字比赛
gibing	讥刺
rattler	绝顶典型
auditorial	查帐官的
hydrostatical	流体静力学的
unplagued	未染瘟疫的
overcareful	过分谨慎的
bva	英国兽医协会
volos	沃洛斯
rattailed	鼠尾状的
unprofessional	外行的
flako	喝醉的
laughing	带笑
highjacker	劫盗
destitute	困穷的
megaton	兆吨
exophthalmic	眼球突出症
anchormanese	新闻节目主持人的语言风格
chop	排骨
accordant	一致的
creedal	信经的
nonrepresentational	非写实
malic	由苹果取
gerent	管理者
cozy	舒适
screen	掩蔽
summarise	=summarize
slaky	泥泞的
sorbol	=sorbitol
reiver	掠夺者
disconsolate	郁郁不乐的
unwashed	不清洁的
obstacle	障碍
unzippered	=unzipped
dollop	团
unapparent	不清楚
movable	活动
angelic	似天使
lotusland	安逸
schlemiel	笨手笨脚的人
rushes	毛片
pastorate	牧师的任期
authority	著作权威
tartarian	鞑靼人
subsequent	后来的
baric	气压
laomedon	拉俄墨冬
handle	句柄
cathartic	通便
septate	具隔膜的
growler	咆哮的人
rack	破坏
unofficially	非公认地
subterfuge	托词
electrooptics	电光学
iambus	抑扬格
oscule	=osculum
rhamnus	鼠李
reimpression	重印
bevy	一堆东西
taskwork	计件工作
glauberite	钙芒硝
progamete	原配子
phalanx	密集队
reformatory	妓女教养所
sundowner	流浪汉
toxigenic	产生毒素
penult	尾倒数第二音节
rabbanist	=rabbinist
halid	卤化物的
arum	海芋植物
desquamative	脱屑
alveolar	齿槽
xingu	兴谷河
baddy	坏人
company	公司
appulse	趋向
exposed	暴露于风雨中
greyly	带灰地
moravian	摩拉维亚人
spandy	极好的
amphitryon	东道主
dispersal	消散
alamode	上面加冰淇淋的
unit	部队单位
enemy	大敌
fire	解雇
lenitive	缓解疼痛的
spectropolarimeter	分光偏振计
transcortin	结合皮质甾类球蛋白
improver	提高的人
restaurant	饭店
glomerulus	小球
shade	遮光物
metronomic	节拍器
costive	便秘
cod	on
apostrophize	加省略符号
coffee	咖啡色
esculent	可食用的
lauraldehyde	十二醛
bluish	带蓝色的
coercively	强制地
retrocardiac	在心脏后
crafty	诡计多端的
evangelization	福音传道
kale	羽衣甘蓝
conciliate	赢得
daf	空军部
ipse	集成化工程项目支持系统
puppet	木偶
relocation	再布置
dinoceratan	恐角兽的
clinoscope	旋斜视计
inquiry	质询
nauseate	作呕
judicable	应受审判
frolicly	嬉戏地
stopgap	暂时
augustly	威严
vri	Victoria
vinery	葡萄温室
lather	汗沫
parmesan	用脱脂乳制成的坚硬的意大利干酪
farfamed	威名远播的
nilgai	蓝牛
abborrent	嫌恶
beztine	antler
acetarious	凉拌用
liposome	脂质体
fusiform	纺锭状
duodenary	十二进位的
wmo	Organization
cystocarp	藻果
precarious	不稳定
liquidly	清脆
timbered	木造的
whirlicote	豪华型大马车
nds	Directory
hemishere	半球
mavourneen	亲爱
deradicalize	使非激进化
decriminalization	合法化
aeolian	风
miaow	猫叫
heathery	石南丛生的
natsopa	Society
accurately	正确
blackfoot	居住于落矶山脉以东
monocarpellary	一心皮的
copperah	干椰子肉
aminopterin	氨喋呤
rhenish	莱茵河的
unconsummated	未实现
reincite	再鼓励
softy	多愁善感的人
norethindrone	炔诺酮
haut	上流社会
tailpiece	补白用的图片
forensics	辩论练习
unscrupulously	无道德原则地
trifoliolate	有三小叶
strain	拉紧
narrow	精密
erosive	腐蚀性
firehorse	拉救火车的马
suitably	合适地
reemphasis	再度强调
unblushing	不脸红
stressable	可用重音读
brownstone	褐色砂石
incunabulist	精通初期刊本知识的专家
aberrant	异常
seminal	生殖的
wadmal	瓦德麦尔呢
heath	石南
squamaceous	鳞状的
radiolucency	射线可透性
munitions	军需品
supraoptic	视束上方
puzzlehead	思想混乱的人
heroicomical	英雄喜剧的
monobloc	单块的
inquisitorial	严格审问
photonasty	感光性
neurotrophic	向神经
mackinawite	四方硫铁矿
libidinous	好色
steeliness	冷酷
caprylic	辛酸的
factotum	特大型花体大写字母
introspectionism	内省主襆nIst/
alu	Arithmetic
aborative	仔细
symbol	象征
scrutiny	详细审查
testamentary	遗嘱中有的
pig	猪肉
dinkum	诚实的
frugally	节约
vomiturition	连续呕吐
siphonage	虹吸
cauda	尾
worthy	值得的
rpg	角色扮演游戏
tyrolean	提洛尔区居民的
seventeenth	十七分之一
silverless	无银
titanic	钛
hoverbed	气垫床
openhanded	豪爽的
lawless	违法的
promissory	有约束力的
zombie	蛇神
swiss	瑞士人
pointy	非常尖
flute	长笛
peopleware'	NULL)
atabrine	疟疾平
unbed	起床
psychataxia	精神失调
forwardness	卤莽
accountancy	会计学
rough	大致
seriously	认真
radiance	闪烁
deglutinate	中提取麸质
dollar	美元
juvenescent	到达青年期
unwoven	unweave的过去分词
bestrew	撒布
ameban	=amoeban
visitatorial	巡察
nectared	有花蜜的
rics	Institution
podite	附器
mind	留意
aiguille	钻孔器
wrcb	Relief
inciting	煽动
kedjeree	烩饭的一种
velveteen	棉绒
nurser	奶妈
tissular	组织的
iht	Tribune
triphibian	善于陆海空战
sonochemical	由声化学现象产生
flinty	坚硬的
audiovisual	视听设备
corking	非常地
hero	男主人公
terminus	界标
combustible	易燃的
ouster	夺取
breather	呼吸者
signature	署名
gazette	在公报上刊载
mend	改善
foremost	首要地
gdmo	of
riblike	像肋骨的
hemiplegy	偏瘫
demerara	红糖的一种
vendition	销售
exsert	使突出
petrarchan	彼特拉克体十四行诗
entrepreneuse	女创业家
waste	多余的
undying	不死
unaccountable	无法解释的
haggard	憔悴
roadhead	路的尽头
tablet	药片
grum	阴郁
irredeemable	不能赎回的
lame	瘸行
ground	grind的过去式
judas	叛徒
emotion	情感
unbridgeable	不能逾越的
intermediator	中间人
budless	无芽的
alecithal	少蛋黄
eggheaded	书生气十足的
flickeringly	摇曳地
batholithic	岩基
overdose	配药量过多
limitary	限制
vilely	讨厌
cornish	康沃尔郡的
inofficial	非正式
interethnic	不同种族间的
amortization	摊销
grossly	很
rear	用后腿站起
multicentric	影响多中心的
drainage	排出物
physicky	由药物引起
pingpong	乒乓球
premises	立前提
suppressible	可以禁止的
gerundive	动词状形容词
barrator	诉讼教唆犯
chastening	矫正性的
fluorescein	荧光素
razorstrop	磨剃刀皮带
diaspora	犹太人的离散
prattle	天真地说
conferrence	赐给
ammonoid	菊石
floating	浮动的
licorice	欧亚甘草
usher	引座员
overfree	过分自由
hindermost	最靠近后方的
station	岗位
general	概括的
senatorial	参议员的
umbelliferous	有伞状花的
nectar	神酒
allotropy	同素异形
lobeline	山梗烷醇酮
lignify	木质化
apparition	鬼怪
plew	一张海狸皮
eda	Design
obscurant	愚民政策
limosis	饥饿
owler	走私船
abnormity	异形
italianise	成意大利式
multipurpose	多种用途
logical	合理的
homoscedasticity	方差齐性
sav	=saveloy
cytopathogenic	致细胞病变
embark	装于船上
owlwise	像猫头鹰一样聪慧
cpsu	苏联共产党
spirochetosis	=spirochaetosis
alkalescent	碱性
coleopterous	鞘翅类的
galvanograph	电铸版
gassy	吹牛的
penologist	监狱管理学者
maternity	产科的
fixative	固定的
towering	激烈的
mental	智力的
introduction	传入
dilettantish	业余爱好的
remains	遗迹
catheterize	插入导管
lithology	岩石学
wired	极其兴奋
barracks	许多人居住的简陋房舍
ketene	烯酮
wriggle	宛蜒行进
gooseherd	饲鹅者
funambulist	走绳索的人
neologist	新语使用者
dudish	花花公子般的
tennist	网球运动员
hela	cell
incised	有锯齿状边缘的
berberine	黄连素
grouch	闹脾气
swab	拖把
upswell	肿起
inkpad	打印台
floatage	浮力
unpopular	不流行
tupamaro	图帕马罗城市游击队队员
statutable	法规
consultative	咨询
tennessean	美国田纳西州的
ditchdigging	挖沟渠
telephone	打电话
zincy	似锌的
saxicolous	生于岩石上的
tilth	耕地
farinose	被粉的
chastening	惩戒性的
inductively	诱导地
bested	在……境遇
bergamasque	贝加莫舞
regionalization	按地区安排
overweening	自负的
feed	一餐
plant	植物
pourable	流动通畅的
stereotype	套用老套
wysbygi	It
wetter	湿润工
cobra	眼镜蛇
exhibitionism	裸露癖
rakish	潇洒
rattleheaded	愚蠢多嘴
engorgement	暴饮暴食
lampion	装饰用灯
prospect	期望
phantasm	幻觉
bauneen	=bawneen
whorish	妓女般的
proletaire	无产者
bistro	小酒馆
jain	耆那教的
xml	extensible
shako	有檐平顶筒状军帽
camp	露营
outgo	优于
spermous	精子
shanachy	吟游说书人
beautification	美化
ammoniated	与氨化合了的
outsoar	飞在……之上
saxophonist	萨克斯管吹奏者
abnormal	变态的
unlicked	没舔干
mec	机修工
slashing	乱砍
overdaring	过于大胆
quayside	码头周围
unfirm	松散
getter	获得者
housekeeping	家务管理
congest	充血
demandable	可要求的
clannish	团结心很强的
bowman	弓箭手
fade	平淡的
taxless	无税
balzacian	巴尔扎克小说的
enunciator	宣言者
inducibility	可诱导性
headquarters	指挥部
portly	肥胖
ovine	绵羊的
lord	统治者
eventful	重要的
reperusal	再读
transformism	进化论
fascicle	丛
minor	小调
susurrous	=susurrant
laboured	吃力
splayfoot	八字脚的
fabian	拖延时间的
stomata	口
layelder	平信徒长老
nettle	荨麻
chic	别致的款式
sumless	无数
needfire	去邪之火
bald	光秃
ailurophile	极其喜爱猫的人
hesse	=Hessen
diametric	正相反
narrow	气量小的
melodic	调子美妙的
vagabond	到处流浪
baldly	坦率
crewel	刺绣用毛线
suspensible	可悬吊
ploy	策略
kiln	窑
southeastern	东南方的
xanthopathia	黄肤症
joycean	乔伊斯专家
stead	用处
thrasonical	吹牛
nice	正派
geohydrology	水文学
trashiness	没用
declaratory	公布的
coxalgy	=coxalgia
nimblewit	机灵的人
premature	早熟的
shading	留下阴影
seminole	米诺尔人
soothsaying	预言
biscotto	意大利式脆饼
endolithic	石内的
schistocytosis	裂细胞症
receptor	接受器
awing	飞翔
oxidative	氧化
motivic	动机的
catercornered	对角线的斜放
sensuousness	知觉
yawnful	无聊的使人打哈欠
condottiere	佣兵队长
overtly	公然
dcm	Distinguished
crested	有顶饰的
footlights	舞台
zahle	扎赫勒
dps	衰变
brood	一伙
mux	使混乱
reversely	相对
sig	有共同特殊观点或要求的群体
printcloth	印花布料
barefaced	厚颜无耻的
languishing	日趋衰弱的
alkalescence	碱性
sncc	Committee
illumine	启发
pedagogic	教授法
flap	扔
enwrap	包裹
herpangina	疱疹性咽峡炎
muck	垃圾
revealed	显示
semimilitary	半军事
screwball	略带神经病的人
lose	失败
reattempt	重新尝试
workalike	软件通用型的
intuitivism	洞察力
disputability	真假可疑
alors	那末
copious	很多的
folly	傻话
ephebos	的男青年
current	最近
psalmodic	赞美诗篇
improvvisatrice	女即兴演奏者
mia	战斗中失踪的
hydrosulfuric	含氢及硫的
bibliolater	圣经崇拜者
foresaid	上述的
unconditional	无限制
cryopump	低温泵
shalt	shall的第二人称单数现在式
consult	请教
anapest	短短长格
flammable	易燃
resolution	决定
thalamus	花托
inflatable	通货膨胀
randomly	随便地
iiium	伊利昂(小亚细亚西北部的古城特洛伊
set	一批
gemmiparous	发芽的
antrum	房
imploring	恳求的
urological	泌尿科学的
corticated	有外皮
passel	一群
sinitic	中国文化的
smooth	安祥的
hangchow	见Hangzhou
pipsqueak	小人物
asleep	睡着的
horrific	恐怖的
nipple	乳头
disengaged	闲散
fluvioglacial	河冰
camelback	骑在骆驼背上地
drastic	猛烈
isometric	等容积
meningococcus	脑膜炎球菌
xylonite	赛璐珞
bungarotoxin	金环蛇毒素
abuzz	嘁嘁喳喳的
entire	全部的
worthful	可贵的
florescence	全盛期
cebuan	宿务的
referenced	参考的
unexpired	未到期的
febricide	止热的
unresponsive	感受性迟钝
caseworm	在身体周围筑巢的幼虫
grenade	手榴弹
formal	整齐匀称的
antimicrobial	杀菌剂
evocatory	=evocative
desolate	无人烟
indigest	不能消化
involucra	外膜
jezail	阿富汗长滑膛枪
extern	走读生
barrelled	桶装
unperson	没落人物
disappear	消失
geomantic	风水的
tepid	微温
upstand	竖立构件
bonded	以债券作保证的
fallacy	谬误
adonis	阿多尼斯
barrater	诉讼教唆犯
airmanship	飞行术
summerwood	夏材
beady	象珠一样的
serotype	血清型
extraliterary	文学之外
cobdenism	科布登主义
scaffolding	脚手架
regress	逆行
brawling	争吵
hepatopexia	肝固定术
caravaneer	乘敞篷车旅行者
caulocaline	成茎素
baseline	基线
jubilant	喜洋洋
geosphere	岩石圈
snoopy	爱探听
carnation	粉红色
electrotype	制成电版
dynastic	朝代的
sitrep	军情报告
northbound	北行
depredate	毁坏
basting	疏缝
retroverted	后倾的
nickelize	镀镍于
wpc	Police
crepitant	劈劈拍拍响
owlery	鸮栖息
cycloalkane	=cycloparaffin
rummager	翻译者
insipidity	清淡
parasitize	寄生感染
hymnbook	赞美诗集
snifty	卑视的
nexus	关系
goluptious	好吃
togated	着官服的
flattery	谄媚的举动
insistent	坚持不懈
vertiginous	眼花
penitentiary	忏悔的
incitant	兴奋
paginal	每页
meetinghouse	教会
infinitude	无穷数
plangorous	哀号
otiose	多余的
exactitude	精确
zmodem	支持重传
frangipani	鸡蛋花
ariose	如歌
myocardia	的复数
glareproof	防眩
blastema	芽基
scholastic	学校教育
dipterous	双廊堂
chlordiazepoxide	利眠宁
deific	神圣
grandiose	宏伟
tricorne	船形帽
herdman	牧人
touch	接近
gingeli	芝麻油
dustup	争吵
block	街区
mortify	制欲
identic	措词相同的
insectile	似昆虫的
pentanol	戊醇
synecthry	强迫共栖
angiogram	血管造影片
floristic	植物
landslip	塌方
jods	马裤
reappraisal	重新评价
thrapple	气管
catachrestic	修辞生硬且自相矛盾的误用
glow	发光
prove	考验
voivodina	=Vojvodina
beckoning	引诱人
guessingly	凭猜测
intro	的引子
shift	转变
stopped	停止
skycoach	空中大客车
evacuation	撤退
impracticality	办不到
spoony	笨
transvest	使穿异性衣服
destruction	破坏
submissive	顺从的
decimal	以十为基础的
bonbonniere	糖果店
condescend	谦逊
ours	我们的
education	教育
gumshoe	侦察
troop	把编成骑兵连
dormice	睡鼠
phonetic	语音
wand	嫩枝
peptic	消化器官
lilied	百合花覆盖
embargo	禁止出入港口
nauseating	作呕的
coptic	科普特人
sax	石板斧
slimming	减轻体重
embarrassingly	使人尴尬
televisionwise	在电视方面
zilch	零
please	请
horsewhip	惩罚
start	开始
corkboard	软木板
sternum	胸板
poon	胡桐
cryogenic	低温学的
iaea	国际原子能组织
congregation	圣会
ametropia	非正视眼
obsequious	谄媚
arhythmical	无韵律
ebullition	爆发
blitzkrieg	奇袭战法
declamatory	雄辩家式的
coloury	品质优良
sciolous	知识浅薄
unvexed	安详
pvc	Circuit
become	成为
unionides	unio
posh	豪华
bonnily	快活
amphitropous	植物横生
argentine	阿根廷人
rive	裂开
constatation	证实
menticide	心理上的伤害
lapidation	投石
donkeyish	顽固
gastronomy	享乐主义
upright	竖式
kbe	Knight
indeliberate	无心的
reimpose	再强加
dawt	=daut
employer	雇主
illinoisan	伊利诺斯州
plump	鼓起
metabolism	新陈代谢
cran	鲱斗
shaddock	柚子
cannabic	大麻的
nutate	下垂
whizzo	极好的
magnetotactic	具趋磁性的
unsympathizing	不表示同情的
polyonymosity	一人多名
endopsychic	灵魂中
overcharge	使过量装填过度充电
headmaster	男舍监
rbs	British
mudskipper	弹涂鱼
toddy	棕榈酒
excommunicate	被逐出教会的
thecodont	有槽齿的
multipliable	可乘的
affrontedly	被侮辱地
expellent	排毒剂
unaccompanied	无伴奏
pronto	急速
fmi	Fonds
lister	制表人
mesalliance	和低身份者结婚
limbless	无大枝的
cosmopolite	属于世界的
brushwork	画家的风格
calory	大卡路里
letterman	优秀运动员
sarcosine	肌氨酸
atheistic	无神论者的
mythomania	渲染狂
orthography	正确拼字
cytospectrophotometry	细胞分光光度测定法
uml	统一语言模式
cornfed	看来营养健康而带土气
untrammeled	自由自在的
antagonistical	敌对的
philosophism	哲学的思索
adduction	引用
observingly	注意
electroacoustic	电声的
erode	腐蚀
pasture	牧地
contentment	满意
reversional	倒退的
madbrain	鲁莽的人
inguinal	腹股沟
hellhole	非常令人不舒服的场所
pancreatectomize	对……施胰切除术
bear	熊
friended	有朋友
unprophetic	非预言的
triturate	捣碎
telepuppet	遥控机器人
daybreak	拂晓
smithcraft	锻工
cumin	孜然芹
paralysis	麻痹
griddle	烘
thermoset	热固
kashmiri	克什米尔人
thaumaturgist	奇术师
mophead	乱糟糟的头
depasture	吃草
tabs	跳格设定
defoliation	落叶
convincing	有力的
cc	抄送
clepe	名叫
maiden	少女
steely	似钢
comically	滑稽地
retiree	退休者
streetwalking	拉客卖淫
cab	驾驶室
agoraphobe	广场恐惧症
fainthearted	懦弱的
yieldingness	柔顺
angolan	安哥拉的
guileless	正直的
energetic	积极的
guidable	可引导的
cove	小峡谷
prc	中华人民共和国
trammel	束缚
henna	指甲花
jazzist	爵士音乐爱好者
subungulate	次有蹄类的
enneastyle	有九柱的
rodent	侵蚀性
retinol	松香油
lax	松元音
rightness	公正
whopping	巨大
boorish	农民
mortally	致命地
prewar	在战前
sheep	信徒
saint	神圣
occupational	占领
aerobiological	大莆镅У
sturdiness	坚固
homotransplant	=homograft
aggregative	集合
aspidistra	蜘蛛抱蛋属植物
counterplan	预备方案
insensibility	不在乎
mauve	紫红色的
stepstone	楼梯石级
crises	危险期
liberticide	破坏自由
besom	扫把
passable	可通过
concenter	集合
manacle	手铐
enslave	束缚
rare	珍贵
witherite	碳酸钡矿
septipartite	七个部分组成的
superscript	写在上边
restock	再储存
magnifico	显要人物
hypochondriacal	忧郁症
hygrophyte	=hydrophyte
dipsophobia	惧酒症
terebinthinate	松脂
uplifted	举起的
dm	Doctor
sockdolager	突出的人
komi	科米人
broad	显著的
zengakuren	极端左翼学生运动
landward	向陆
wahine	玻利尼西亚妇女
geoanticline	地背斜
lending	出借物
dryopithecine	森林古猿
liquory	烈酒所引起
proclinate	前倾的
broadwise	横
sika	挂绳
tantivy	int
gastral	消化道
vaticanology	梵蒂冈学
cockle	起皱
flattering	奉承的
fawny	近鹿毛色的
ppt	1兆分之……
humiliating	羞辱性的
minimi	的复数
outdare	胆量胜过
xpvm	PVM图形控制台
hydrothermal	热水
actually	居然
tricoloured	三色的
bndd	Dangerous
humdinger	极出色的人
psf	foot
assumed	假定的
scarp	使成陡坡
point	分数
suberate	辛二酸盐
hurricane	狂风
felony	重罪
intracardiac	心脏内的
nettlegrasper	大胆抓棘手问题的人
feticidal	打胎的
sunstruck	患中暑
sememe	义位
pampa	南美大草原
saxicolous	岩生
carrel	单独研究室
polyglottic	=polyglot
furtively	暗中地
biotype	同型小种
modifier	修正的人
patroclinal	=patriclinous
wily	老谋深算
directness	率直
unharmful	不致伤的
suffice	有能力
unladen	的过去分词
unwedded	未婚的
extoll	=extol
adventurous	充满危险
betting	打赌
caudillo	领袖
fatidic	预言
xxxi	31
phanerogamic	开花
unite	团结
fallen	伐倒
sumptuosity	奢侈
scratchcat	凶狠的女人或小孩
revascularize	换……血管以增加心脏的血液供应
azonic	非地方性的
value	确切涵义
sustainer	支持者
pretend	装扮
sub	潜水艇
womanlike	像女人的
unweighted	不被认为重要
hyperbatically	倒装法地
institute	学会
savourless	不风趣的
synecdoche	提喻法
aquiferous	含水
voiced	浊音
screeve	地状
brokenhearted	极度悲伤
waspish	腰细
rummager	检查者
tweedy	粗花呢制的
gastroenteritis	肠胃炎
khurramshahr	=Khorramshahr
sustentive	支持的
crises	危险
puli	匈牙利长毛牧羊狗
mesenchymatous	由间叶细胞组成
katathermometer	冷却温度表
boatable	可行船
capsulary	蒴状的
hypocoristic	表示亲爱的
suspensibility	悬而不决
lenitive	轻泻剂
solemnify	使隆重
prothetelic	先成现象的
pothole	壶穴
olympic	奥林匹亚的
footnote	脚注
trochaic	扬抑格
barbacue	野外宴会
sparaxis	水仙菖蒲
nystatin	制真菌素
drew	draw的过去式
lucern	苜蓿
putrefactive	易腐败的
squashy	易压碎
sensibly	明显地
trigamous	有雄
nullcheck'	NULL)
pronumeral	变元
tripodal	三脚架的
awl	尖钻
flackery	宣传
libertyman	上岸休假船员
poikilitic	嵌晶状
grotesquerie	奇怪
unacquirable	不能获
remarkably	显著地
tarragon	龙嵩
rounding	制圆
towel	用毛巾擦
exacting	吃力的
ubi	无论何时
inadvertence	怠慢
comity	礼让
mistress	女能人
ken	知识领域
mcluhanite	麦克卢恩
malthouse	麦芽制造厂
euglenoid	眼虫
aural	听觉
scabby	结痂的
moreover	而且
last	最后
dilaceration	撕毁
pokey	破旧
ribbing	肋状组织翅
beauish	轻浮
probatory	=probative
arenose	多沙
cppcc	Consultative
careworn	受忧虑折磨
incommunicative	沉默寡言
urge	促进
tough	坚韧的
kiswahili	斯瓦希里语
keerect	正确
underfinanced	资金短缺
amphipath	两性分子的
uncovery	暴露
centra	的复数
naprapath	推拿治疗患者
paratactic	并列的
disclaimatory	表示否认
moray	欧洲海鳗
mixotrophic	混合营养
madwoman	狂女
redispose	再处置
jenghiz	成吉思汗
bland	刺激性少的
sphygmic	脉搏
biodynamics	生物动力学
asturian	阿斯图里亚斯的
vociferous	喊叫
unsocial	不善交际的
nice	细微的
atticism	高雅的言辞
depot	新兵训练营
streaky	有条纹的
manavelins	船具
oarage	划桨
aeromedical	航空医学的
pearly	用珍珠装饰
organum	工具论
sociogenic	社会引起的
brainwash	对人洗脑
telebit	科学信息贮存和发送装置
stuffless	单薄的
initiate	传授
record	创纪录
arroyo	小河
deafness	听不清
zoophytic	似植物之动物的
haemorrhoid	痔
cultivatable	可栽培的
project	计划
pelt	急降
plenty	丰富
distichous	二分的
cryptococcus	隐球菌
sunny	阳光充足的
ush	作招待员
hemipterous	半翅类
mim	假文静
electrotype	电版印刷物
magnetic	有吸引力的
deject	使沮丧
anthema	皮疹
unprofessional	非职业性
blithely	快乐
fenny	住在沼泽
discusser	论述者
tradeoff	交易
upholster	装潢
retrad	向后地
distill	蒸馏
jay	碎嘴唠叨的人
tepid	微温的
cockamamie	假
mainly	主要
ue	United
eminent	有名
tivy	向前奔
receptionist	招待员
argenteous	银灰色
polysaccharide	多醣
gnaw	折磨
frustrated	失败的
tapu	=taboo
affliction	苦恼
tripleheaded	有三个头的
pityingly	可怜地
exultingly	兴高采烈地
wash	耐洗的
frankhearted	坦白
zora	卓拉
sunfed	联合国经济发展特别基金
abherent	拥护者
unloved	未被喜爱的
oxo	氧络
marantic	=marasmic
extrascientific	科学范围外的
rescale	重新调节
leary	空
entente	协定
crossbreed	培育杂种
presentment	陈述
ineptly	无能地
puzzlepated	思想混乱的
gablet	小山墙
mux	多路复用器
sublimate	气质高贵的
speechwriter	演讲稿撰写人
uncombed	蓬乱
semiofficially	半官方地
scuzz	邋遢的人
afterlife	晚年
maharanee	女君主
poikilothermic	变温
nondiscrimination	不歧视
smelt	冶炼
cosine	余弦
suprafacial	同面
sycophancy	谄媚
eff	字母f
gerontocracy	老人统治
everlasting	持久的
righty	保守派
favose	形似蜂巢
subcontrary	小反对命题
copremic	毒毒血症
staple	主要成分
gait	步态
retrospection	回想
absorbability	吸收
statedly	庄重的
sudetic	苏台德山脉
diethyltoluamide	避蚊胺
tiddled	喝醉
mullion	竖框
cowichan	印第安人厚毛衣
dropper	点滴器
torture	痛苦
recommendation	建议
icae	智能计算机辅助工程
rusa	黑鹿
plant	培养
mormon	一夫多妻主义者
bertha	贝莎
annihilator	消灭者
bingy	肚子
agio	折扣
scout	觅得
utopian	乌托邦的
uninformative	不提供信息的
owen	欧文
deoxygenize	除氧
delphinium	飞燕草子
ginny	杜松子酒的
evaginate	外翻
nosepipe	放汽管口
magnetohydrodynamic	[用作刀的
numberless	无数的
tremellose	胶状
derry	歌谣
inconstantly	易变
brokenhearted	极度悲伤的
phocomelus	海豹肢症的畸形儿
haemophiloid	类血友病的
bloodless	苍白
aerophyte	附生植物
socket	窝
esmtp	扩展SMTP
honeymouthed	甜言蜜语
yieldly	支付地
proliferation	分芽繁殖
tubal	管
nonstandard	不规范
candid	坦白的
spiderwort	紫露草属
formerly	从前
gymp	花边
mantilla	连披肩之头纱
draughtsman	起草人
prevailing	流行的
gagger	笑料的作者
marmolite	淡绿蛇纹石
shaven	刮过脸的
hest	命令
dismutation	歧化
microangiopathy	微血管病
elopement	私奔
reinstallment	重新装配
charnel	恐怖
voluminous	庞大的
invaluable	无价
semplice	单纯
jehu	马车夫
herb	药草
picture	描述
subgiant	亚巨星
algorithm	运算法则
loyalize	使效忠
dominancy	优势
punctuate	使用标点
hypersonic	极超音速
bombsite	被炸区域
prosodical	作诗法的
photoinduced	光感生的
argent	象银
destitution	贫穷
brambly	有刺的
melodramatist	戏剧似地行动的人
asseveration	断言
bimillennium	两千周年
nine	九
contribution	捐献
conversancy	精通
telemachus	忒勒马科斯
hydrothoracic	水胸
shallot	葱
intertranslatable	可互译
scuzzy	肮脏
ontogenesis	个体发生
loosely	松散地
bestride	骑
embossment	浮雕
ozonizer	臭氧管
tension	牵力
lithophytic	石生植物的
welsh	威尔士
phat	容易排字的
agrin	微笑的
wats	Area
expressive	富于表情
cabas	提篮
phallical	阴茎
green	未成熟
atmospherium	云象厅
molestation	干扰
psyche	心智
clemency	和蔼
orangery	橘园
godless	不敬神的
declamation	雄辨
featherlike	像羽毛的
surrealism	超现实主义
petal	花瓣
crimped	起皱褶
dint	打
waiting	服侍
shindy	奢华舞会
taligrade	拐脚
chemically	用化学
comfort	使缓和
swinishly	下流
teary	哭泣
southeasternmost	最东南
pony	每日摘要的
replenishment	补给
ineradicable	不能根除
grolier	格罗里埃式装订的
gyroscopic	回转仪
radular	齿舌的
amass	收集
katalysis	催化作用
homy	家庭般的
rummager	搜查者
gracious	高尚的
ability	能力
glm	method
lyricize	用抒情手法书写
ecdysone	蜕化素
misdeal	发错牌
suggest	暗示
segmentalize	分割
condolence	哀悼
augmentative	有增加力的
comtian	孔德
fibrous	纤维性
gymnocarpous	裸果
upgrade	改良品种
quint	五度音
routineer	墨守成规者
decumbent	横卧的
exopathic	病因在体外的
great	顺利地
morphiomaniac	吗啡中毒者
sabotage	从事破坏活动
counterview	反对意见
labdanum	岩茨脂
dictum	格言
counterfactual	反事实的
xylographic	木刻
hook	上瘾
crossbelt	斜挂在肩上的皮带
savage	未开化
endsville	最好
scent	嗅
ssa	Administration
recreant	怯懦
viennese	维也纳文化
syllabi	判决理由书的要旨
overnight	头天晚上
disharmonic	奇形怪状
unprinted	未印出
azygos	单一器官
corymb	伞状花序
swahili	斯瓦希里人
fixt	fix的过去式及过去分词
plump	坦白
unfelt	无感情
figurehead	有名无实的领袖
pomposo	华丽
bros	兄弟
fumy	多蒸汽
adgb	Air
deplorably	可叹地
flow	川流不息
unimproved	未耕种
hindward	往后
investigative	好研究的
promotional	奖励的
fulminatory	雷鸣
hepburnian	Hepburn式
fourpenny	四便士
clistogamy	=cleistogamy
blameful	该受谴责
whence	拒此
downhearted	闷闷不乐
pastiche	混成曲
hebrewwise	从右向左
catechetical	问答式
snowslide	雪崩
explosive	炸药
impress	印
correct	正确的
hydrostatic	流体静力学的
atelier	画室
residuary	剩余
ultramarine	海外
waterworn	被水冲蚀的
forehold	前舱
begrudgingly	吝啬地
photoscope	透视镜
exoculation	挖眼
metempirical	超经验论
elfin	象小妖精的
affectionate	挚爱的
brominate	用溴处理
uncanny	离奇
setter	安装员
mentality	智力
bay	使走投无路
ashikaga	足利
overskirt	罩裙
anesthetic	麻醉剂
tome	本
unshackle	释放
infinitesimal	无穷小的
graininess	粒状的
cirriped	蔓足类动物
priory	小修道院
amesace	=ambsace
duchy	公爵领地
connoisseurship	鉴赏家力
flap	掷
repository	仓库
historic	历史上著名
accredited	可接受
zigzag	Z字形
pug	哈巴狗
actinism	光化作用
costmary	艾菊
mill	磨细
flopper	雏水鸭
supposal	推测
festally	如节日地
parliamentarian	议会的
picaresque	歹徒
hindermost	最后面
faithful	可靠的
inexpectant	不期待的
installant	任命者
membranate	膜的
local	局部的
inversely	相反
uigur	具有维吾尔人的特点
chicklet	少妇
upswell	鼓起
blatant	炫耀的
asiatic	亚洲的
wud	发疯
biosynthesize	用生物学方法合成
repellancy	=repellence
miserable	悲惨
pantechnicon	家具搬运车
gargle	漱口药
dizygous	两受精卵
wettable	可霑的
isohel	等日照线
multipartite	分成多部份
bridle	上笼头
jostle	挤
ascosporic	囊孢子
squiggly	弯弯曲曲的
methoxyflurane	甲氧氟烷
consortia	银行团
chasmal	深陷
euripus	急流海峡
hellward	向地狱
shrewish	泼妇一样
haymaker	制作干草的
ease	使悠闲
gemel	双生
carelessly	粗心
fairly	公平地
sheeplike	温顺的
sloot	=sluit
australian	澳洲
fulmination	爆发
natural	简单自然
viole	viola
exactitude	规规矩矩
ngoma	恩戈麦鼓
state	国家
fibrilla	小纤维
fly	敏捷的
insupportably	不能忍受
trochometer	车程计
dianetic	排除有害印象精神治疗法的
allan	艾伦
threatening	危险
catching	迷人
tailpiece	附属物
fiberglass	玻璃丝
circuit	一圈
listeriosis	利斯特氏菌病
landrace	长白猪
blinding	使眩目的
mortification	动物体组织局部的坏死
wordy	冗长的
abroad	到处
pat	轻拍
gallicism	法语特有的语法
paper	象纸的
marketable	适于销售
impayable	无价的
straitness	狭窄
exhume	掘出
szeged	塞格德
mrcp	the
axillary	腋窝的
capri	卡普里酒
waxen	苍白的
picocurie	微微居里
psychochemistry	精神化学
celticist	凯尔特语言专家
currant	葡萄干
under	在下
boiling	激昂的
unfeeling	无情
fail	辜负
knitting	针织
devise	作出
bundobust	细节的落实
inosculation	接合
usng	美国国民警卫队
hypercautious	过于小心
aesthetic	美学
felspathic	长石
enrich	浓缩
twinkling	转瞬
kushitic	古西地克语
consanguineous	血亲的
fanged	有尖牙
intraperitoneal	引流过腹膜
colourably	似是而非
thwack	强打
playmobile	玩具车
break	违犯
peppy	精神充沛的
terror	恐怖行动
beery	啤酒
parturient	临产的
fennec	一种非洲产的大耳小狐
mirky	黑暗地的
cowpoke	牧牛工
isdn	综合业务数字网
gigametre	千兆米
jcl	job
hitchy	蹒跚
fogbound	因浓雾而进退不得的
humify	使潮湿
puberulent	被微柔毛的
