francophil	亲法
upriver	向上游
ardeid	属于鹭科的
swashbuckler	恃强凌弱者霸道小说
nok	next
disjunctive	分离性
sheol	阴间
afloat	飘浮的
intercalary	被夹于中间
padouk	=padauk
managing	管理
deluxe	豪华地
ileum	回肠
deception	欺骗
objectively	客观
secrecy	秘密
exhaustible	被取尽
thatcher	茅屋匠
thin	细小部分
preprofessional	职前
gawk	呆呆地看着
twill	把……织成斜纹
ecclesiae	教会
blah	乏味的
wrongly	错误地
boaz	波阿斯
prelicense	领取执照前
soulful	深情
society	交际
pulvillus	爪垫
boggle	不知是否应
gentlefolk	名门世家
brumous	冬天的
ascap	Authors
ulexite	硼钠钙石
dickensian	崇拜狄更斯者
polyhedral	多面体的
medieval	中世纪
antares	心大星
interior	内的
microvolt	微伏
unassimilable	不能消化
dialectologist	研究方言者
nondairy	不含奶的
deeply	深深地
formicate	蠢动
misplay	违反规则的玩法
grungy	低劣的
creepered	蔓草丛生的
willemstad	威廉斯塔德
feminality	妇女喜爱的物
frigate	三帆快速战舰
louvered	像百叶窗板一般安排
choose	选择
outright	痛快
emanative	流出的
bladdernut	省沽油
exoteric	公开的教义
stencil	用蜡纸印刷
drop	滴剂
infatuated	入迷的
changeably	易变地
birdy	多鸟的
baor	of
abrasive	研磨
radiotechnology	辐射能
fastidious	挑剔的
afflicting	痛苦的
nauseated	厌恶的
pullulation	成长
australia	澳洲
neaped	搁浅
plumb	垂直的
audio	声频的
slashing	尖锐的
triquetral	三棱的
cankerous	使溃疡的
adapter	扩充卡或特殊设计的电路
metrist	诗人
hemicyclium	半日晷
dantonesque	似丹东
staylace	女人的束腹的带子
cancerous	癌的
battu	打脚
chromatology	色彩论
poleax	以斧砍倒或攻打
hoppingly	忙碌
inflect	使屈曲
physiocracy	重农论
brassily	低廉而华丽
rustily	声音沙哑地
reddish	略带红色的
solunar	日月共同作用引起的
blockage	封锁
associational	联想的
jake	乡下佬
perfect	修改
afebrile	无热
shorts	短裤
blimp	肥胖的人
schemozzle	=shemozzle
faultiness	不完善
cesarian	专制政体的拥护者
uprate	提高……的等级的价值
cape	海角
verifiable	能作证
supraspinal	棘上的
elegant	雅致的
surround	环境
mollescent	变软的
imperialization	帝国主义专横
peachful	爱好和平的
bosom	胸
apprehensibility	能理解
avignon	阿维尼翁
lampad	烛台
thrustful	有强大推进力的
domain	范围
christly	如基督
carney	哄骗的话
targe	圆盾
ssafa	Association
ascensive	强调
quadrilateral	四边形
exhaustible	被汲尽的
grab	攫取
rearward	在后面
imperscriptible	非正式
word	词
photoelectric	光电子照相装置
domical	圆屋顶
ssr	Soviet
diminutive	指小的
uncontradictable	无法否认的
wattle	板条的
trochaic	扬抑格诗句
sulfur	用硫磺处理
stiletto	一种小剑
carnelian	玛瑙
geopolitic	理政治学
nitrous	含氮的
dicom	in
crazed	癫狂
floricultural	种花的
keester	屁股
easel	画架
cochineal	胭脂虫洋红
quarrel	挑剔
indistinction	模糊
appreciable	可评估
reoccupy	收复
canonic	轮唱
quakerism	贵格会
aerobics	增氧健身法
bailey	城堡外庭
petit	没价值
freon	氟利昂
genocidal	种族灭绝的
coon	无可救药者
eurytherm	广温性生物
internuclear	核间
hypotensive	降血压药
cockcrowing	破晓
fuzzy	模糊
devotional	虔诚
adhere	胶着
attaboy	好啊!
pinnatiped	蹼足的
countermine	对抗
pocketbook	笔记本
inobtrusive	谦虚
sedately	安详
continue	延伸
gibeon	吉比恩
performance	性能
basidia	的复数
netop	朋友
calculational	计算
buttermilk	酪乳
arcticologist	研究南北极的科学家
aram	the
atomic	微粒子的
packsack	=knapsack
acrimonious	辛辣
wizened	消瘦的
stemmed	有茎
marabou	鹳
might	可能
epitomist	写摘要者
gracile	细长的
russet	黄褐色的
krete	=Crete
tba	to
vengeance	复仇
philtrum	人中
disinterested	无私的
epochal	划时代的
ousel	乌鸫
costive	便秘的
explanation	互相讲明
vulcanic	硫化的
spignel	=spicknel
bogor	茂物
undelete	恢复被删除的文件
loose	解放
undamped	不潮湿
interjectional	叫声的
feather	长羽毛
bireme	古代船
selective	选择
polygamous	一妻多夫
barky	似树皮的
belong	住
slavery	苦役
thersitical	破口大骂
unshed	未流出
ballooning	乘气球
getparms	获取参数的
zygosperm	接合子
mime	多用途的网际邮件扩充协议
irreverence	不尊敬的
weave	纺织
crossroad	十字路口
repellance	=repellence
disentanglement	解开纠结
allegorization	讽喻手法
varicosity	静脉曲张
reflectional	反映
aut	of
anisomerous	不对称的
upscale	质优价高的
houseless	无家
dirndl	少女装
carpogonium	果胞
underproductive	生产供不应求
unploughed	未耕
debouchment	流出
sitosterol	谷甾醇
youngberry	杨氏草莓
whish	以呼呼声催促
transpersonal	超过人的
pop	热门的
perfervid	非常热心
maul	抨击
eponychium	指甲上皮
rub	摩擦
battlefield	战场
fiddlefucking	操他妈
lean	瘦
ipecacuanha	吐根树
corporate	共同的
buddhistical	佛陀
grateful	感谢
transnature	改变性质
cess	运气
recognized	经过验证
hurst	林中小丘
pulpitis	牙髓炎
ioffe	bar约飞棒
session	开庭
sapped	受冰川作用侵蚀
temperately	节制
asternal	无胸骨的
way	途中的
eudaemonia	幸福
lumberer	伐木人
aciculignosa	针叶木本群落
bashfully	羞怯
biggity	=biggety
categorize	分类
tease	逗惹
adnex	述语
passee	凋谢的
arrhizal	没有根
impersonate	扮演
picocurie	皮居里
windbreak	防风设备
imap	Access
surprise	奇袭
thumbnail	极短
dissimilation	异化作用
reproachless	无可非议的
purchase	购买
tother	另一个
crenulated	小圆齿状的
cheers	举杯敬酒之用语
pacification	讲和
ectoskeleton	外骨骼
dreamily	爱梦想
ab	空运
hydrofoil	水翼艇
episiotomy	外阴切开术
bioconversion	生物转化
rss	Socius
parcelgilt	内表面镀金的
spermic	精子的
soporose	昏睡
seise	依法占有
inaudibly	听不见似地
outmatch	优于
asphyxiate	使窒息
balkanize	分割成小国
nebulizer	喷雾器
tumescent	肿胀性
eruct	喷
initiatress	女传授者
photolitho	影印石版
atkins	Atkins
tellurometer	微波测距仪
flirtatious	轻浮的
jurisprudent	精通法律
lender	出借人
start	赛跑的先跑权
salvage	抢救
zygomycete	接合菌
xeme	北极鸥
hand	支持
snib	插销
tribune	看台
valour	英勇
puzzlement	迷惑
conspue	吵吵嚷嚷地反对
bottom	测量深浅
maoist	毛泽东
synroc	合成岩
polymixin	=polymyxin
calumniator	中伤者
contemporaneous	同时代的
impelling	迫使性
demilance	短矛
cozy	安逸
fortnightly	每两星期一次
unwilling	勉强
stearic	十八酸
philippines	菲律宾共和国
finale	终曲
vulpecula	狐狸座
carthaginian	迦太基
felted	用毡覆盖的
jacobian	理论
liquidize	使液化
redraft	改写
guest	寄宿
habile	灵巧的
keeping	看守
cheerly	兴高采烈地
limit	限度
berkeleyan	=Berkeleian
peck	吹毛求疵
northwesternmost	极西北的
unstained	无污垢
premundane	创世前
rickety	摇摆的
leukotomy	前额脑叶切除手术
insincere	虚假
campbellism	基督门徒会之教理
gallopade	舞蹈之一种
supernaculum	直到一滴不剩
dusk	薄暮
inedited	未经编辑的
gassy	夸夸其谈的
parader	游行者
meridian	全盛时期
corticated	有外皮的
sunken	沉没
aldose	醛醣
sincipital	前顶
metamorphism	变形
assaultive	喜好攻击的
dinky	整洁
apostate	变节的
serigraph	用丝网印制的彩色画
guiro	锯琴
consanguineous	血缘的
technological	科技的
sniffish	轻蔑的
supercritical	超临界
preteen	13岁以下的
magnify	放大
omnivore	不偏食的人
misdirect	写错地址
abracadabra	胡言乱语
sunburst	镶有钻石的旭日形首饰
secretary	书记
washdown	彻底冲洗
isophone	同音线
adolescent	青春
subjectless	无题
epistemic	认识的
truehearted	真挚的
null	等于零
salivant	催涎的
persia	波斯
overhasty	过于匆忙的
minimill	小钢铁厂
attitudinarian	/
chibcha	奇布查人
consequent	作为结果
arbitral	仲裁的
rightfully	正当
spontaneously	本能
emulant	竞争者
lushly	繁荣地
hydropress	=hydraulic
velsen	费尔森
touch	轻触
westward	向西旅行
fremd	外国的
degustate	品尝
interstage	级际的
heartstring	心弦
mugearite	橄榄粗安岩
lardoon	肥腊肉片
ionic	离子
inversive	反逆
understand	懂
gambusia	食蚊鱼
jog	轻撞
ambiguously	含糊不清
commove	使激烈摇动
strobic	旋转
aclinic	无倾角
celibate	独身主义者
rooted	根深蒂固
faulty	有缺点的
cucurbitaceous	葫芦科
eggheaded	书生气十足
multifactor	多因子的
spa	温泉区
tonsillotomy	扁桃体切开术
flinch	畏缩
mysticlsm	神秘主义
afoot	徒步的
comedy	喜剧
ferrimagnetism	铁氧体磁性
triumphal	胜利的
unmoral	无辨别是非能力
cazique	酋长
exoteric	外面的
brachypterous	短翅
oblomovism	懒散
tribal	部落的
lame	跛足
crunchiness	嘎吱嘎吱声
corynebacterium	棒状杆菌
absentee	缺席者
feather	射掉的羽毛
crown	表彰
telekineticist	心灵遥感者
eulogist	赞颂者
ncsa	Applications
hominine	有人类特征
tuneable	谱好曲的
pallidly	无光泽
left	左边的
argentate	银色
perfectionism	至善论
keratometry	角膜散光计
prc	People''s
cotquean	凶悍的女人
condonable	赎罪的
detent	棘爪
shade	帘
bacula	baculum的复数
codling	未熟的小苹果
leftist	左派
tinnily	光亮而不值钱地
syngen	群体
microprogrammed	微程序控制
unbacked	无人押注
diametical	直径
boilerplate	样板文件
logistics	后勤学
fuck	性交对象
basaltic	玄武岩
indomitably	不能征服地
turkmenian	土库曼语的
poker	拨火棍
nodosity	有结节
ferrotitanium	铁钛
bertrand	伯特兰
objurgatory	叱责
selectivity	选择性
dithery	犹豫不决的
unreasonable	不讲道理的
ancon	悬臂拖梁
arrowwood	箭木
diadromous	有扇状叶脉的
trichroic	三色的
goodly	优美的
unformulated	未系统地阐述
unisonous	同度的
briskness	活泼
debrecen	德布勒森
fitfully	发作
pawk	诈术
noncompliance	不服从
stanch	坚强的
boracic	硼的
consortia	公会
suety	板油一样的
endogenetic	内成
gratulation	满足
caller	召集员
enemy	敌人
amyotrophia	肌萎缩
dimensional	空间
usts	Service
jewelweed	凤仙花科凤仙花属植物
bracteal	似苞的
sericulture	养蚕
rhapsodical	狂想的
planiform	扁平形的
libia	=Libya
nudity	裸体
left	左
annal	记录
beadswoman	救济院受施之女人
salyrgan	撒利汞
monomark	拼合记号
sunscreen	遮光剂
inexplorable	无法探险
fluidify	液化
supersex	超性
linter	棉短线
archiepiscopal	大主教的
panmunjom	板门店
trddition	惯例
sociologese	社会学特有用语
crass	粗鲁的
edge	使锋利
isolable	可隔离
accessory	零件
deposition	沉积作用
lacunose	多空隙
memsahib	夫人
hydrolyze	水解
bim	Institute
silverware	银器
snatchy	不规则
baae	and
reignite	再点火
glairy	蛋白状
areologic	火星科学研究
apt	切题的
fugate	不严格遵守形式的赋格曲
darter	投掷者
facinorous	极恶
promote	发扬
veterinary	医牲畜的
sinecure	工作清闲而报酬丰厚的职位
nakhodka	临日本海之西伯利亚的不冻港
winnower	扬谷器
stygian	幽暗的
through	直达的
overbuy	买得过多或过贵
intention	目
screwy	怪僻
visitation	正式的视察
agricultural	农业的
sycophantic	阿谀的
mucopurulent	黏液性及脓性的
sinapine	芥子酸胆碱
capitulary	牧师会的
resourceless	无方略
sandspur	=sandbur
barelegged	光着腿
minitank	轻便坦克
refuge	避难所
episcopalian	主教
peek	匆忙看过
stringless	无弦的
vulnerable	易受攻击的
ratomorphic	根据实验鼠的行为来解释人的行为
inconsecutive	不连续
benthograph	海底摄影机
platoon	排
definitize	使确定
intercomparsion	相互比较
autochanger	自动换唱片机
ignescent	敲击而冒火
sarcophagic	食肉
lyophilization	冻干法
nobly	豪爽地
snr	Signal
jawbone	颚骨
promiscuously	混杂地
secam	Avec
lithoprint	用石版印刷
nonlethal	不致命的
rtl	Logic
exterminatory	根绝的
pressingly	恳切
lincomycin	洁霉素
sinoite	氧氮硅石
subaerial	地面上的
languorously	郁闷地
jesse	耶西
swirl	头晕
tannable	可鞣制
wahabi	瓦哈比教派的教徒
immutably	不变
upset	翻倒
seaworthiness	适于航海
cabal	策划阴谋
sewer	缝纫者
gonocyte	卵母细胞
urethritis	尿道炎
wheaten	小麦制成的
osmious	=osmous
hypotonicity	低张性
vituperation	咒骂
chaff	糠
lop	斩
seminary	学校
extrorse	向轴外的
cyrtostyle	柱子呈外突弧状排列
dangerous	危险
unglamorous	无浪漫色彩的
admissible	可容许
swank	优雅
dermoid	皮状
forever	永恒
quadro	方形住宅区
initializing	正在初始化
arid	沉闷
aryan	印欧语系
frons	额
circumscissile	周裂的
fingo	芬果族人
athabascan	=Athapascan
papeete	帕皮提
saigonese	西贡的
optical	光学
people	人们
feticidal	堕胎
bloomers	灯笼裤
adjustor	调节器
airproof	密不透气
semicircular	半圆的
moonshiny	空想
land	到达
crackers	癫狂的
enduringly	永久地
intergrowth	共生
customary	惯例的
scrutable	可以了解的
cosmetician	美容品业者
buzzard	秃鹰类
exocardia	异位心
flimflam	胡言乱语
convey	传达
maltreatment	粗暴对待
appetite	欲望
egyptian	埃及人的
unquestioning	不犹豫
keramic	陶质
monoclonal	单克隆
repentant	悔改
pleasurable	快乐的
hierachical	僧侣统治的
glob	一小滴水珠
communist	共产主义者的
sudoriferous	发汗的
amazedly	吃惊地
network	网络
mitre	主教法冠
radioactivate	使有辐射能
screen	筛子
theban	底比斯人
finical	过分讲究
lodger	投宿者
libya	利比亚
selamlik	室内男子居住部分
mpeg	Experts
raft	制成筏
cozily	安逸
singularly	另人无法理解
spavined	患跗节内肿
japanner	漆工
monochromator	单色光镜
tulwar	弯刀
chromoplast	成色素细胞
sudsy	起着泡沫的
spermous	似精子
pyic	脓
toyohashi	丰桥
whitefish	白色的鱼
detection	发觉
drainage	排水区域
manikin	时装模特
hemophilioid	类似血友病的
sterile	毫无结果
fortuity	意外
stumble	使困惑
nazaritism	修行
hermes	radioactive
esterifiable	酯化
him	他
iliac	回肠
sap	傻子
merchandising	销售规划
dishearten	使……沮丧
instantial	提供实例
financial	财政的
sacsac	萨克萨克椰子
immiserize	vt
quartan	每四天
idyl	牧歌
prelusive	序言
cultivable	可栽培
loggets	掷木游戏
philosophy	达观
crib	关入栅栏
emendatory	修正
blusher	脸红的人
baptise	施行浸礼
ferox	猛鲑
methylmercury	甲基水银
paragraphia	书写倒错
unheroical	给人印象不深的
birthright	生来就有的权利
blast	爆炸
man	Metropolitan
elegist	挽歌作者
cowbird	北美产的燕八哥
seceder	脱离者
braggart	自夸的
firefight	火战
zinky	锌制的
virulency	痛恨
endogamous	同系交配
scutate	有鳞甲
amusingly	有趣地
seromucous	浆液粘液性的
kan	赣江
yangtse	扬子江
lance	矛状器具
dateless	虽旧仍好
dodecaphonic	十二音体系
suffuse	充满
phenomenalistic	现象主义的
newsprint	新闻用纸
sparklingly	闪烁地
quatorze	(两人对玩的皮克牌戏
laryngitist	喉科学家
cornetti	cornetto
fieldwork	野外工作
elves	侏儒
dav	Disabled
chimneynook	近壁炉的地方
cash	兑现
wollastonite	钙硅石
tweedle	鸣叫
hungered	饥饿
baee	of
decury	十人小组
gangetic	沿恒河的
insofar	在……的范围
cryptanalyze	用密码分析法破译
solvent	溶解的
impugnable	可抨击的
sparklet	小火花
emblazon	用纹章装饰
canonic	依教规的
blaw	=blow
publisher	/
lapidarist	玉石雕刻的
salvoconducto	护照
livery	特定服装
anacoluthon	句法前后不一致
hierocracy	僧侣统治
gambol	嬉戏
unhappen	不发生
stammer	口吃
wharfie	码头工人
shorthand	速记
borated	搀硼酸
infirm	不坚固
ohone	=ochone
transuranic	超铀的
noncontact	没有接触的
vitta	头巾
cerebrotonia	精神抑制型
bahai	巴哈教徒
understand	以为
bill	广告
ouster	剥夺
fastener	使系牢之物
uncharming	使人不愉快的
invigorant	滋补品
unscrew	旋开
oxbridge	该校之学生或毕业生
conversion	转化
pyrimethamine	乙嘧啶
holometabolous	全变形的
madly	精神失常
wrapping	包装用的
pasticheur	模仿他人作品者
daze	使茫然
cheery	愉快的
catrigged	独桅艇装有桅艇式之索具的
loose	宽松的
assentient	赞同者
westering	向西
liable	负有责任的
skeleton	基干
rebeldom	叛乱者
mortician	殡仪业者
scatter	撒开
gymnastic	体操
cobaltic	含钴
equilibratory	产生平衡
guidable	可引导
sequestrator	查封人
wastelot	城市荒
slag	起溶渣
england	英格兰和威尔士
psychogeriatric	老年綢`AtrIks/老纳癫〉
causable	会惹起的
minimize	最小化
aquamarine	绿玉
remarry	再婚
wabbly	不稳定
sharpshooter	射击名手
morgen	摩根
ecopornography	别有用心的生态保护宣传
anadenia	腺缺失
convert	皈依者
sarcelle	绿翅鸭
brigandage	土匪
snaillike	蜗牛状
interesting	有趣味的
struggle	努力
malfeasant	不法行为的
chiseled	轮廓分明
uninformative	不增长见闻
pyogenic	化脓的
ruined	荒废
arm	衣袖
unsympathetic	不同情
reembarkation	重登机
incb	Control
turboelectric	涡轮机发电的
dicrotisc	量重搏脉
unpatterned	未形成模式
trichlorophenol	/三氯酚
philhellene	对希腊友善的人
realize	认识到
vestibular	前庭的
issuable	可发行
pageant	虚饰
gppm	Per
decarboxylase	脱羧酶
deific	神圣的
face	面向
batty	古怪的
floating	流动的
advices	情报
sacher	torte
wireworm	线虫
understock	不充分进货而存货不足
pullulation	发展
astrocyte	星形胶质细胞
aquashow	水上技艺表演
plenitudinous	充足的
spellbound	被咒语所镇住
deepfelt	深切的
sperm	鲸油
carton	纸板箱
harbourless	无避难所的
siren	妖妇
helicoid	螺旋面
actinometer	暴光表
rocklet	小岩石
toleware	马口铁制品
vamp	修补
burnable	灼伤
convexity	凸面
ibew	International
conventionalise	kEn`venFEnElIzt/kEn`venFEnElIsz/
tankerman	油船船员
dewy	带露水的
versatile	通用的
rothole	脆弱点
immovable	不改变的
winchman	开关手
kinshasa	金沙萨(旧称利奥波德维尔
pyrocellulose	高氮硝化纤维素
fool	愚弄
cluw	of
abruptly	唐突
reprographic	复印
unvalued	不足道
medlar	欧楂果
bauxite	矾土
articular	关节的
tranship	换车
cegb	Board
sclerosing	硬化性
annexure	附加物
unprecedented	空前
sovran	最高统治者
pontus	本都
rhizocarpous	宿根的
gumshoe	偷偷做的
ceinture	腰带
crocky	体弱
mpls	数学证明学习系统
ectoproct	外肛苔藓虫
personality	人物
homoplastic	同形的
supernutrition	营养过多
potassic	钾
fob	短表链
inseparate	不分开
cca	Common
camphoraceous	樟脑特有
inexpansible	无法扩张的
quadrinomial	四项
vexillum	一军旗下的部队
equiprobability	或然率相同
reflexion	反射
atheistic	无神论者
overshirt	外套式衬衫
allamanda	黄蔓
cloxacillin	氯洒西林
resume	履历
craniognomy	相颅术
tease	揶揄
remit	使复职
neurophysin	后叶激素运载蛋白
aerostatic	航空的
foundry	玻璃厂
mrcp	of
prohormone	激素原
gaslit	以煤气灯照明的
paddlewheeler	用桨轮推进的船
immanent	内在的
lsv	lunar
fibroid	纤维状的
dot	园点
voluble	缠绕
putrescible	易腐烂的
dispersant	分散剂
geotaxis	趋地性
brash	傲慢的
dally	延误
sapient	自以为聪明的
galvanism	流电
stud	饰纽
nonconductor	不传导体
campy	装模作样
burke	避免
flan	坯子
demijohn	坛子
referring	谈及
unscrupulousness	狂妄
oxyhydrogen	氢氧
consolatory	可藉慰的
flatheaded	平顶
vendible	可被普遍接受的
gutty	胆大的
entoptic	眼内
exuberance	健康
command	俯临
sialolith	涎石
undeniable	不可否认的
globalize	使全球化
tannish	淡褐色的
squamate	有鳞
thyself	你自己
spancel	拴畜绳
osteolite	土磷灰石
laureateship	桂冠诗人之称号或任期
nobleman	贵族
intracardiac	心脏内
scalene	不等边
rackabones	瘦马
anabaptist	再洗礼论者
substantialize	实现
diverticulum	憩室
mohist	墨家
koa	洋槐的一种
hyperope	远视者
contemptuous	轻蔑
gloss	曲解
force	施加压力
satiation	饱享
multicellular	多细胞的
chronically	习惯性
eventual	万一的
detension	轻松
loco	发狂
rill	小溪
dicer	小礼帽
pranidhana	愿
astronomically	天文学上
sextette	六重唱曲
glaum	抢夺
remittent	间歇性的
scorer	记录员
hydroplane	水上滑艇
insufferable	难以忍受的
duodenary	十二倍
sniveler	啜泣的人
oncogenous	=oncogenic
coruscant	闪烁的
underemployed	未充分就业的
demoralize	士气受挫
hedger	两方下注者
blunder	失误
rabi	早春作物
bosom	胸怀
humble	挫
pneumogastric	肺和胃的
invert	转化的
reprieve	暂减
influencing	影响的
share	共享
fatigueless	不知疲劳
aliturgical	禁仪日的
crapper	厕所
lovestruck	热恋中
back	在后面
leftlaid	左搓的
conclude	作出结论
unalienated	未让渡的
spoony	笨瓜
lepidopteran	鳞翅类
nodular	小结
outlander	外国人
nancified	搞同性恋
habilitate	予以穿着
refasten	再次固定
krakau	=Krakow
fondly	亲爱地
xenophora	衣笠螺属的动物
metallographic	金相学的/学
roily	搅乱
coralliferous	产珊瑚的
bristled	有刚毛的
retrenchment	节省
geriatric	老人的
seam	伤疤
literate	有文化
encomium	赞美
ballflower	圆球饰
bethel	非国教徒的教堂
plant	车间
fringlish	法式英语
tomato	西红柿
desperately	拼命
poddy	人工喂养的幼畜
worshipful	崇拜
fco	Office
snaky	弯弯曲曲
ratal	纳税额
owl	Borland
ragamuffinly	流浪
noisemaker	发出大声音的人
synangium	聚合囊
saving	考虑到
procaine	普鲁卡因
desacralize	使非神圣化
exhume	发掘
avertible	可避开的
fractional	分数的
paragraphic	章节的
trddition	传统
withal	此外
adeptness	老练
tactic	按顺序的
kibitka	鞑靼人的圆顶帐篷
recognition	承认
reactionist	反动的
surfacely	肤浅地
serbonian	大沼泽
unsure	不确定的
reproducer	再现设备
slavonic	斯拉夫人
rephrase	改撰
anthropomorphic	神、人同Izm/
extrusion	突出
centrality	中央
percutaneous	经皮
chloroplatinic	氢氯铂酸的
anisole	茴香醚
blaze	燃烧
conglutinant	促创口愈合
splosh	金钱
inflatable	膨胀
condensator	电容器
overstrength	超额
unexamined	未经核对
hexameter	六步格的
warpwise	经向
biophil	elements亲生物元素
springlock	弹簧锁
composure	镇静
dutiful	守本分
inky	墨水的
adiaphoretic	止汗剂
outshoot	突出物
inorganized	缺乏组织
prescriptive	说明性的
diverticular	支囊的
penniferous	有羽
sneaksby	鬼鬼祟祟的人
desuetude	不用
apocatastasis	魔鬼及罪人终将回归上帝的学说
clearing	空旷地
topectomy	额叶皮质局部切除术
destitute	缺乏的
chic	别致
emargination	边缘有凹痕
scalpel	解剖刀
break	削弱
melancholiac	患忧郁症的
rhemish	Bible
sequin	古威尼斯金币
disimprove	恶化
thumbscrew	拇指夹
dement	疯狂的
camorra	克莫拉秘密组织
undressed	穿着便服的
migratory	迁移
triumvirate	三人执政的政治
underpaid	underpay过去式及过去分词
savageness	天然
acrr	on
fense	防护
leukodermal	白斑病的
laval	熔岩的
acopic	消除疲乏
idc	智能磁盘控制器
trauma	外伤
tranquilly	平静地
cylices	cylix
rutilant	闪光的
hypopyon	眼前房积脓
ue	Radio
rouncy	骑用马
voluble	有口才的
assertorily	断言
knotless	没有节
tryma	核果
buttony	钮扣状
wattle	枝条
erectormuscle	勃起肌
bludger	游手好闲的人
prosper	昌盛
useless	无价值
rile	使恼怒
inswept	尖端狭窄
shire	郡
federal	同盟
repulsive	推斥的
unordinary	特别
muffle	消声器
lugubrious	悲惨
scared	恐惧
nonarithmetic	=nonarithmetical
folksy	无拘束
shillaber	赌摊等诱`人入壳的假顾客
automate	使自动化
faggot	束
mild	轻微
fasciated	用带子束住的
bhl	of
melanin	黑色素
unvouched	未被证明
scriber	划线器
diglyceride	甘油二酯
merely	不过
arty	艺术家气派的
aldis	lamp
mhg	High
pithead	其附近建筑物
canting	貌似虔诚的
hypercatalexis	超音节
hypercryalgesia	冷觉过敏
winterly	冬天
podzol	灰壤
montgolfier	气球
monophyllous	单叶
unconstraint	自愿
kilogrammetre	千克米
dentilingual	齿舌音
excusingly	辩解地
pataca	澳元
denunciate	公然抨击
titration	滴定
monocrat	独裁主义者
depasture	使吃草
vesa	Standard
clubroot	根瘤病
precooler	预冷器
maroc	摩洛哥
embarcadero	内河码头
hydromantic	水占术
ent	耳鼻喉科
medibank	国民健康保险制度
emphasize	着重
postrorse	向后的
vivific	赋予生气
acquiescently	默认地
blatant	吵闹
empathy	移情作用
unflaggingly	不屈不挠地
selma	塞尔玛
scant	减少
lightstruck	曝光而不能用的
unrenewable	无法回收利用的
lemma	主旨
upbraidingly	叱责
hindustani	印度斯坦人的
sfa	Football
people	民族
unfadingly	不凋萎地
tricksy	顽皮的
victrix	=victress
foreground	前景
outright	痛快地
randomly	未加计划地
axially	向轴的方向
oxysalt	含氧酸盐
yavis	年轻英俊、能说会道、
unbearably	忍不住
decorate	装饰
make	使成为
ps	附言
reefer	冰箱
hopelessly	无望
cozy	惬意
underlaid	下有衬物
husky	沙哑的
shampoo	洗头
rdc	乡村区议会
crm	Customer
amusement	娱乐
fix	确定
ne	旧姓
folivore	食叶动物
camion	运货车
unbesought	未乞求的
dialytic	透膜性
caesura	休止
bx	base
sweetish	有点美丽
cosmopolitan	全球
autotoxin	自体毒素
obconical	倒圆锥形
table	桌子
osculatory	接吻的
ivr	Interactive
wither	使凋谢
thundering	雷鸣
diphyletic	二源
hypothenuse	弦
fundamentalist	信奉正统派基督教的人
restiform	索状的
speedlight	频闪放电管
aeriality	空虚
rejoice	高兴
rigorism	严格主义
legalization	得到法律认可
supposedly	想像上
revenge	报仇
destructuralize	拆散
multibarrel	多管
tuesday	星期二
piosity	表面虔诚
wassail	痛饮
ambiguous	不明确
tail	尾部的
jointure	寡妇所得遗产
greensick	患萎黄病贫血
drumbeater	作宣传的人
pomeranchuk	theorem坡密朗丘克定理
last	临终
lalang	白茅
periodize	把
mcp	male
irritably	暴躁地
teeny	极小
token	向征
studiously	故意
magistral	威严傲慢的
feldspathic	长石质的
crop	修剪
mistletoe	槲寄生
neronian	尼禄的
regret	后悔
besotted	糊涂的
sullage	残渣
transcutaneous	经皮
increasing	渐增的
tabnab	美味小吃
proudhonism	蒲鲁东主义
mesotrophic	中营养的
ulterior	在那边
unwanted	空闲
embryotroph	胎体营养物
adultoid	未成熟体
headily	任性
cowpuncher	牛仔
tab	制表
refix	再设立
reasoningly	理性
bliss	福佑
eastwards	向东方
tv	电视
paraformaldehyde	多聚甲醛
stylostatistics	风格统计法分析
whistleable	可用口哨吹的
barbate	有须的
apart	分离
bto	Operator
northwest	西北的
steady	稳定的
cer	规范编码规则
wholescale	大量
dingily	暗黑
upriver	向水源
empress	皇后
dunderpate	蠢材
nibelungenlied	尼白龙根之歌
collectively	共同地
abiological	非生物
chirpy	快活
fumigate	熏制
anticly	古怪地
conformably	顺从地
punk	废物
augural	前兆的
offstage	舞台内部
reasonless	不理智的
knockabout	闹剧
specialize	使适应特殊目
ringster	党徒之一份子
imperturbability	缺乏热情
tortile	弯曲
megaloblast	幼巨红细胞
honewort	北柴胡
osteotomy	骨切开术
revolve	考虑
cervicovaginal	子宫颈阴道的
sulfaquinoxaline	=sulphaquinoxaline
indeterminate	不确定的
crystalloid	结晶
nabeshima	锅岛窑瓷器
fix	决定
terminable	可终止
slaveholding	拥有奴隶
division	师
prithee	请
crossbedding	交错层
invert	转化
gagger	善于插科打浑的喜剧演员
reembark	重新上船
sun	主要生产SUN系列工作站和网络产品
homebred	国产
roam	漫游
flattish	稍平
dogmatics	教义学
quotative	引证
remould	改造
eduction	推断
udp	Protocol
peritoneal	腹膜
mowing	牧草
grandniece	侄孙女
impletion	充满
earliness	早熟
ito	Organization
fat	丰满
rascally	无赖
secrecy	保密
injure	伤害
parched	炎热的
scotodinia	暗点性眩晕
stub	踩熄
biometricist	生物统计学家
apart	分别
tropophyte	湿旱生植物
monoicous	=monoecious
extasy	=ecstasy
pseudograph	伪作
emendable	可修订
trivial	价值不高
masty	危险的东西
scuttle	煤桶
imputation	归因
intradermic	=intradermal
myoneural	肌神经的
involuntarily	无心地
cytostome	细胞口
enervated	无力的
enframe	装在框内
semiclassic	准古典式的
endoneurium	神经内衣
widthwise	横向地
geometric	几何学的
macroevolution	进化
canvass	讨论
stannary	锡矿区
unestablished	未确立
crossroad	十字路
anodic	阳极的
riotous	骚乱的
freebooter	海盗
page	翻……的书页
fag	吃力的工作
dipster	双翅目昆虫
sympathetic	赞成
laceless	无带子的
oddity	古怪
escapable	可以避免
moschate	有麝香气味
pedicular	虱子
skylark	开玩笑
platonist	柏拉图学派的人
osb	Benedict
prodigiouss	很大的
extricable	可救出的
allowance	补助
exuberant	丰富的
integral	完整的
disburse	支付
kinfolk	亲属
molluscoid	拟软体动物的
heavenly	如天堂
buffer	缓冲
checksummat	求校验和
chancellor	长官
impeccability	无缺点
tackle	复滑车
xerogram	干式影印副本
rouse	使振奋
sss	System
dialogically	问答体地
inp	物价指数
acceleratory	催促的
trinket	小装饰品
heady	性急
kate	Catherine
nebulae	星云
waxen	柔软
macroscopical	宏观的
insectual	昆虫似的
viole	braccio
hoard	储藏
dramatic	生动
hydroxide	羟化物
theologically	神学地
empaquetage	包扎艺术品
isospory	孢子同型
message	教训
bewray	显示
xxxi	罗马数字
orphanhood	孤儿的身份
strait	海峡
inessive	指示位置
guttiferous	产树胶
discursive	散漫的
preggers	怀孕的
attractively	动人
flotant	空中飞翔
marblehearted	冷酷无情
wallonian	瓦龙语
negatively	否定地
clothespost	晒衣绳的支柱
vilene	维莱恩衣衬
grasp	领会
disregardfulness	不顾
inby	向内部
millinormal	毫规的
lax	腹泻
lacertine	蜥蜴的
hypnotic	催眠药
obstetrical	助产
devil	恶棍
subservient	奉承
prevention	预防
ras	地岬
lurch	突然倾斜
scalariform	梯状
subarid	半干燥的
immoralize	使不道德
thyrse	聚伞圆锥花序
cab	一种压缩文件格式
saurel	竹荚鱼
untruthful	不真实的
rheumatism	风湿病
yoga	瑜珈
quotient	份额
cafard	忧郁
antipyrotic	治灼伤药
poky	简陋
withy	柔韧
ajuga	一种草本植物
residuary	残余的
preach	鼓吹
altruist	爱他主义者
deaf	聋的
pipy	发尖声
symbiosis	共生关系
torrone	蜂蜜杏仁糖
votable	有投票权
tenant	租客
biunique	单向双系列对应的
ckd	down
fodder	草料
voluminous	大部分
frenglish	法国式英语
weird	符咒
queen	王后
hayride	出游
dialogic	对话
verdant	没有经验的
siderosis	肺铁末沉着症
wizard	男巫
codeine	催眠等
entomostracan	昆甲类
bodacious	胆大包天的
grubstake	以利益条件供给资金
refract	测定……的折射度
spanless	不可测量
stewpan	长柄炖锅
cered	有蜡膜的
agglutination	胶合
scoff	食品
demonologically	鬼神学
diabolize	行为像魔鬼
injunctive	指令
crenation	圆锯齿状
hydremic	水血症
hippic	赛马的
circumcolumnar	绕柱
ast	陆军参谋部目标
grizzle	使成灰色
cutwater	桥脚的分水角
overchoice	过多的选择余地
pitchy	漆黑
virus	滤过性微生物
forklike	像叉一样
distilled	由蒸馏得来
endomixis	内融合
stanch	止
bedfellow	伙伴
gardyloo	泼水啦!
grisette	女工
dah	大刀
bird	在野外观察或鉴别鸟类
purgation	清洗
wcc	of
wring	榨
cyproterone	去乙酰环丙氯地孕酮
tunisia	突尼斯
orally	口述地
trull	娼妓
christian	基督徒
schematic	示意性的
emissive	放射性
pretypify	预示……的典型特征
champak	=champac
intertranslatable	可互译的
latticing	做格子
darkish	微暗
oddfish	怪人
quatrefoil	四瓣花
leukorrhea	白带
sialadenitis	涎腺炎
jabberwocky	无聊的话
gauzily	薄
chancriform	下疳似
nse	National
refitment	修理
wirespun	=wiredrawn
puppetry	木偶
enfeoff	授予封地
meum	我的
slender	微薄
dimness	不清楚
worthwhile	值得出力的
typhonic	台风似的
abo	土著的
extracurricular	业余
geanticlinal	背斜
benz	奔驰牌汽车
biquadratic	四乘幂的
paten	祭碟
bleak	荒凉的
pinteresque	品特派风格的
lantern	信号
shable	=shabble
envionment	java
unobjectionable	婉转
siddhartha	悉达多
photofission	光致裂变
officer	军官
lyophiled	用低压冻干法取
administerial	行政上的
puckery	缩拢
dextrogyrate	右旋的
bedload	水流带来的碎石
outline	描画轮廓
environmental	环境
incant	念咒语
goddamn	诅咒的
concenter	集中于一点
semirural	半农业
catchpenny	廉价的商品
metallophone	金属木琴
confesser	听忏悔的神父
unsought	未追求的
cowlike	似母牛的
ella	埃拉
ooze	泄漏
buggy	臭虫成灾
peopleless	无人
factorial	因子的
jerk	颠簸地行进
overswing	摆动过大
amphicoelian	两凹的
mesopelagic	中层
overinsure	给……超额保险
bel	贝尔
tuberose	块茎状的
adulterator	掺假的人
fluctuant	波动的
aconitic	乌头的
relumine	=relume
chalaza	系带
karyotin	染色粒
sinophile	亲华
obstinate	倔强的
spotless	没有污点的
achromobacter	无色菌
foil	挡开
duotype	双色网目版印的插图
hyperbatically	倒装法
spry	充满生气的
agonistic	竞赛的
riffle	成涟漪
favoringly	顺利地
extendible	可扩张
ephebus	至20岁男青年
albigensian	阿比尔派教徒
countermand	下反对命令召回
overstatement	大话
nudicaul	裸茎的
ac	Current
disembodiment	分离
portapak	便携式摄像录像机
gaelic	盖尔人
enflower	以花装饰
portland	波特兰
lusus	=lusus
intracutaneous	皮内的
flicker	摇动
bremerhaven	不来梅港
nes	specified
privilege	特权
revise	修订
sway	摇动
dissemble	掩饰
nebulated	有不明显斑纹
nrotc	海军后备军官训练队
aca	the
syncom	同步通信卫星
isoenzyme	同工酶
athenaeum	雅典娜神庙
irgb	Intensity
republican	共和政体的
unprimitive	非原始的
lomilomi	按摩术
matrilocal	居住在女方
recalesce	产生复辉现象
unvitiated	纯洁
pilotless	无驾驶员的
rightwards	向右
pewter	奖赏
questionless	无疑地
marabou	鹳毛
figuration	比喻表达法
tactics	战术
kirk	苏格兰教会
irrevocably	不能取消地
crinoline	裙衬
attaboy	好样的!
company	伙
initiating	开始
capitulaitonist	主张投降者
thenar	足底的
cerebrosclerosis	脑硬化
reignite	重新激起
eighthly	第八号地
luton	卢顿
moratorium	延期偿付
emigratory	迁居的
alamode	流行
bicorn	新月状的
dimorphism	二态性
destructor	爆炸装置
bonded	抵押
reserve	预定
skeleton	骨架
staple	主要
oriental	东方人最优质
sure	稳当的
functionary	作用
inseminate	使受胎
unmanliness	无男子气概
surfrider	冲浪者
pba	公共房产管理局
onflow	湍流
conventionalise	拘泥习俗者
ares	战神
headwater	上游源头
microsection	=microscopic
seton	串线
intinction	面包蘸酒
parian	帕罗斯人
underservant	帮手
tailgate	后挡板
glandulous	腺状
analytics	解析学
fluey	蓬松
humourously	滑稽地
correctional	改正的
uncdf	Development
fleabane	紫莞科植物
unbloody	未染上血的
heteronomous	受不同生长规律支配
immortalisation	不灭
inhumanly	残忍地
methodical	有系统的
ganoid	硬鳞的
monophyodont	不换性齿的
isoagglutination	同种凝集
enseal	封闭
ground	战场
struggle	尽力使
nitwitted	糊涂
endorser	背书人
abbe	男修道院院长
doomful	充满厄运
puppetize	使成傀儡
caffeine	咖啡因
eleoptene	轻油精
ai	Anguilla
suppurative	足使化脓的
dekametre	公丈
logic	逻辑学
amdg	ad
angiokeratoma	血管角质瘤
pelasgi	贝拉斯基族
polite	文雅的
consonantal	带辅音性质
mum	演哑剧
fellowless	无可匹敌
piranesi	Piranesi
drink	一口吸水
inblowing	向内部吹的
rubbish	废话
zygodactylous	对趾鸟
prelusive	序曲
kneeler	跪垫
rainproof	雨披
fidelity	忠诚
poky	慢吞吞
mere	起码的
genital	生殖的
aquicolous	水生
inactively	不活动
cephalopodous	头足类的
papillary	长乳突
cattiness	阴险
rostellate	有小喙的
sweptback	向后倾斜的
subsonic	亚音速飞机
agha	=aga
boogiewoogie	一种爵士乐
flack	宣传
extrasystolic	期外收缩的
nut	坚果
alienable	可让与的
botel	=boatel
bestrewn	bestrew的过去分词
infante	王子
slough	使沉沦
kittenish	嘻耍的
minor	较小的
aram	Music
colourably	可着色地
spendable	可花费的
certain	某一个
bicker	斗嘴
slimmish	略嫌不足的
mistune	使音调不和谐
lachrymal	流泪
egilops	内脓肿穿破
decommission	使退役
antilithic	预防结石的
minimal	最小限度
plainstones	石板
discord	意见不合
factory	工厂
pruning	修剪
pet	不悦
magniloquent	华而不实
posh	时髦
diana	黛安娜
pending	未决的
faery	幻想
vpd	Data
unread	没有人看的
sugi	=Japanese
plf	linear
ialc	landing
cornuted	有角
towable	可拖拉
variedly	改变地
winsome	迷人的
vasoconstrictor	血管缩小药
lysergide	diethylamide
nongonococal	非淋病性的
unaccented	不发重音的
louche	声名狼籍的
frivolously	愚昧
aurelian	水母的
crustily	有硬皮地
differentiate	区分
placidly	平静地
suture	缝合
intellect	智力
resinous	用树脂做
episcopate	主教区
grocery	杂货
tablespoonful	一大汤匙的量
prefer	宁愿
disruptive	使破裂的
vlb	VESA
outroad	突袭
desultory	不连贯
laker	习惯于在湖上居住
intenerate	使变软
transient	短暂的
window	窗口
fiery	热烈的
inbound	归航的
pensionable	可领退休金
helleborine	火烧兰
unbelieving	多疑
aquatic	水栖
affluently	富裕地
toast	烘
sheaves	一束
rictal	嘴裂
crumpled	摺皱
cannon	炮轰
albarrello	一种陶器瓶子
sottish	酗酒
monomachy	决斗
coxalgia	股关节痛
unwell	不舒服的
wayleave	通行权
upscale	迎合高层次消费者的
underpan	底盘
compo	灰泥
koza	教研组
ululant	吠
skin	兽皮
adscititious	补充
subsection	细分
zearalenone	玉米烯酮
briny	海水的
lappic	拉普兰人的
photobiologic	光生物学的
suggestibility	暗示感受性
egodystonic	自我失调的
rally	力量
backkward	向后
solatia	赔偿物
lush	青葱的
pruriently	好色
crotchety	反复无常的
interleaver	衬垫
antisepticize	消毒
sensualism	肉欲方面
battercake	煎饼
prophetess	女预言家
unfluctuating	不起伏
asexual	无性
zoophytic	似植物之动物
creamcolored	淡黄色
papillose	有小乳头突起的
inquisitress	女检查官
emulsive	可榨出油来的
dilettantism	浅薄涉猎
qualificative	限定
dprk	Korea
fixer	定色剂
fastigiate	圆束状
cppcc	Chinese
ped	土壤自然结构体
elegant	第一流的
stirring	激动人心的
contranatant	逆流
faggoty	同性恋的
oud	乌得琴
cadastral	土地清册的
adze	以扁斧劈
pattern	格调
pamiri	帕米尔人
submarine	海底
felwort	龙胆科的植物
dankness	阴湿
edacious	贪吃的
selvaged	有织边的
ast	Staff
broiling	炽热的
omnisexual	包括男性与女性
neurohypophyseal	垂体神经部的
attendance	伺候
halcyone	金牛座
circle	圆形物
cap	phase
invisible	看不见的
monsieur	绅士
defeature	使不能辨认
afterlife	死后的生活
calorifacient	发热的
troop	组
languishing	苦思
mean	卑鄙的
brooch	领针
nauplial	具有甲壳动物无节幼体特征
diadem	王权
wintry	寒冷的
unbranded	未打上烙印
gennemic	声象
asway	摆动的
undressed	裸体的
steep	险峻
schizoidia	分裂性气质
disabled	伤残的
serpentinous	蛇纹石的
dumpy	矮胖
blutwurst	血香肠
nomex	诺梅克斯
mariolatry	对圣母玛利亚的崇拜
santy	Claus
poikilothermic	冷血
zymoscope	发酵测定器
unmercenary	非雇佣的
unavoidably	不得已
doctrinism	的阐明
champion	冠军
illusionless	无错觉的
spectrography	摄谱术
ulnar	尺骨的
hyperpituitary	垂体机能亢进的
hma	Area
excogitate	想出
irak	伊拉克人讲的阿拉伯语
sonography	=ultrasonography
unassimilable	不可同化的
leaf	翻……的页
acreage	英亩数
viscosity	粘性
testiness	易怒
skegger	一龄鲑
unstrikable	禁止罢工的
uninterpretable	无法解释的
demonian	疯狂的
max	马克斯
lagomorpha	兔类
hubby	丈夫
tuitional	学费的
hereon	在此
unattended	没有同伴的
mail	邮政
unpleasure	不高兴
harlem	黑人住宅区
overfeeding	吃得过多
kalpak	羊皮帽
manuka	麦卢卡树
hyposulfurous	次硫酸
subduce	撤去
truelove	爱人
castigator	惩罚者
steamroll	用压路机碾
photons	光子
uninvited	未被邀请
tensile	张力的
aps	System
fanlike	扇状
inbound	归航
wintry	冷淡
appropriative	专用
forwards	向前方
disembosom	吐露
inassimilation	无同化作用
pinto	黑白斑纹
dissipated	沉迷于酒色
shiny	擦亮
prefatory	前言的
akene	瘦果
comical	好笑
glow	发热
venusberg	维纳斯山
homozygotic	纯合基因
cockleshell	鸟蛤壳
natural	自然的
quittance	赦免
bufalin	蟾蜍灵
segment	段
verge	濒临
broadcaster	播送设备
fastener	扣件
caponize	阉鸡
closefitting	紧身
northwesternmost	最西北的
neuropsychosis	神经精神病
portulacaceous	马齿苋属植物
perisperm	外胚乳
valet	贴身男仆
piezocrystallization	压结晶
appear	似乎
moccasin	软拖鞋
catalogic	如目录的
thingamy	装置
pore	凝视
skiver	削薄的羊皮
favourite	中意
misjudgement	判断不公
heterogeneous	不同种类的
syllabically	每音节地
materialization	物质化
intermediary	媒介
mithridatise	=mithridatize
dioptric	折射光学
glyceric	甘油
forebear	祖先
truckage	卡车搬运
nummet	便餐
kinetoplast	动基体
supersedence	=supersession
shareable	可分担
unexpectable	无法预料的
inciting	刺激的
glorify	赞扬
lastname	姓
immoderately	无节制
pitpan	独木舟
telephoto	远距摄影照片
pharmacolite	毒石
bighearted	宽大的
wattle	由编条做成
shorthorn	新手
antsy	坐立不安
uninterpretable	无法翻译
canadian	加拿大
pronouncing	表示发音的
gamely	勇敢地
section	截面
lactescence	乳汁分泌
tyg	双柄陶制大酒杯
estate	不动产
phagophobia	恐食症
unchurch	剥夺教会的特权
bloodsucker	吸血生物
upstate	在州的北部
viennese	维也纳文化的
indistinctively	不显著地
clanger	大失策
swimming	游水
ridge	背脊
subastral	星下的
impotence	阳萎
pamphlet	小册子
harvestman	盲蜘蛛
scrofula	淋巴结核
notecase	皮夹子
mats	Military
luxurious	豪华
endemic	风土
drollery	滑稽诙谐之事
tavr	and
dominion	领土
caressive	似爱抚
billowy	汹涌
tog	穿衣
retract	收回
fritz	德国人
nif	gene固氮基因
responsibility	责任
hushpuppy	南部的
outline	概要
penicillamine	青霉胺
underprop	支柱
pederasty	鸡奸
imperfectly	有缺点地
neuroleptic	精神抑制药
phonogram	形声字
proctology	直肠病学
plaister	=plaster
faery	仙女的
mystificatory	使人大为惊奇
gloriette	凉亭
overmountain	住在山上
trilocular	三室的
inbound	入站
whereabouts	在何处
uniparental	单性生殖的
zincous	锌的
emanatory	散发
bichromate	重铬酸盐
adrenergic	肾上腺素的
schematize	把……系统化
solubilise	=solubilize
helsinki	芬兰首都赫尔辛基
humidity	潮湿
meek	和缓
bombax	木棉树
finality	最后的言行
apfelstrudel	薄皮苹果卷
nonacquaintance	不相识
charmingly	迷人地
personal	人称的
ipts	Practical
fresno	弗雷斯诺
unscientific	非学术
race	疾走
territ	鞍环
adrenotropic	促肾上腺
fetterbush	绊脚灌木
saluki	萨卢基狗
dainty	讲究的
allowance	宽容
diastalsis	波状蠕动
conclude	缔结
polygynous	多雌蕊
wrongful	不正当的
crystal	结晶
squirrely	古怪的
missis	太太
fleshless	瘦的
botcher	笨拙的工人
thuggee	谋财害命
iridectomize	为……切除虹膜
identifiability	可鉴别性
infusion	灌输
mooch	流浪
galore	丰富地
pentazocine	戊唑辛
lealty	忠实
canonist	宗规专家
pessimistically	悲观地
daydreamer	空想家
withdrawal	停止服药
unsystematic	无系统
puristical	用语简洁
mouthy	说大话
gault	重粘土
syntagm	结构体
cone	球果
willing	乐意
proteide	含蛋白质的
yammer	无聊话
title	冠军
juggins	笨蛋
excurvature	向外弯曲
tumultuary	喧嚣的
delineator	万能纸型
penelope	丈夫远征20年
arguably	可论证地
reprovision	再给食品
boulevardier	闲荡者
operation	作用
unctuously	油腔滑调
premorse	啮蚀状的
galoot	笨人
irrigation	冲洗
ultima	最后一个音节
foresail	前桅的大帆
vertiginous	不稳定的
overly	极度
testaceous	红砖色
tallit	犹太教男人晨祷时的披巾
mounted	安在马上
empennage	尾部
stomachic	健胃的
programme	=program
unpeace	不安宁
exceeding	非常的
desalivate	切去唾液腺的
hearthstone	家庭
unformed	未充分发展
caressing	表现爱情
hackneyed	陈腐
antialcoholism	反对饮酒过多
downbeat	第一拍
diminutive	指小词
dextrocular	惯用右眼的
creasy	有折痕的
nancified	女人气的
peristome	口缘
honiton	lace
speckless	无斑点的
tinnily	锡
unworking	不在工作
quarrelsomeness	喜吵架
scobicular	=scobiform
bespoke	预订
scamp	流氓
clonesome	机器人般的
smartly	火辣辣
scotophil	适暗的
recommendatory	推荐的
ligate	结扎
gleg	活泼的
egyptologist	埃及古物学者
lingually	向舌
astroturf	阿斯特罗草皮
turkophile	偏爱土耳其风尚的人
qmc	Corps
tweet	小鸟啼叫
resolve	决心要
prothalamion	婚礼预祝歌
rivel	皱起
out	赶出
obviate	预防
intuitionalism	直观论
syncretise	=syncretize
columbary	鸽棚
scleroses	硬化
unordinary	少有的
terebinthine	松节油
gaby	笨人
reflectible	能反射的
motorbicycle	轻型摩托车
buttonless	没有钮扣的
takeoff	移去
rug	地毯
rudie	boy
fibrinogen	纤维蛋白原
subaqueous	水中的
explorative	探险
excisable	应交纳货物税
subapostolic	十二门徒之后
eib	Investment
rooty	多根
cyclecar	三轮式机车
hubbard	squash
soporose	昏睡的
mandi	大菜市
trustily	忠实地
autogamic	自花受粉
stick	刺
dismissive	表示轻视
phonophore	电报电话两用装置
whoop	大叫
eutrophic	富营养的
quarterly	季刊
dissected	切开的
increasing	渐增
west	西方的
monanthous	单式
craneman	起重机操作员
lad	伙计
bronzy	仿青铜的
nim	拿取
bleak	阴冷
collectorship	收税员的职权
taking	营业收入
wrong	不正当
affectlessness	冷酷无情
jeopardy	危险
farcically	滑稽地
codicil	附录
shiny	闪耀
editing	编辑的
deserved	当然
thanatology	死亡学
irrepressibly	无法抑制
execution	制作
lias	蓝色石灰岩
hostie	hostess
hypobaric	低比重的
penile	用阴茎
cissoidal	蔓叶线
swathe	带子
hydrops	=dropsy
famous	令人满意的
squeezer	扑克牌
allocable	可分配
autumnal	秋天的
mycenae	迈锡尼
bimanal	=bimanous
absorptiometer	吸收计
pitchman	广告员
reject	丢弃
baedeker	旅行指南
limpidity	透明
tun	大酒桶
videocast	电视广播
comecon	Council
unlearned	不熟练的
lipizzaner	利比扎马
monometer	单音步诗行
blowball	絮球
endocrinopathic	内分泌病
jams	短裤睡衣
gearcase	齿轮罩
scholastic	学校教育的
xanthosiderite	黄针铁矿
onomatopoetic	声喻
istle	中、南美洲产的各种热带植物纤维
exist	存在
nor	也不
innative	天生
anticatarrhal	抗卡他
cajolery	谄媚
garnetiferous	含柘榴石的
troubleshooter	调解纷争专家
gisborne	吉斯伯恩
cinquain	五行诗
stalactical	生有钟乳石的
obsoletism	废弃
lientery	不消化性腹泻
goofy	傻瓜的
ocap	Cable
campylotropous	弯生的
tenderly	体贴
isodynamic	等磁力线
raddle	涂……赭色
botswanian	博茨瓦纳人
poke	懒汉
bin	箱柜
patter	急速地说
salmonellosis	沙门氏菌病
fetterlock	球节
onlooking	目击
fraternization	结有深交
stopcock	旋塞阀
superconscious	超常意识
phyllade	鳞状叶
ashler	方石堆
extrahazardous	特别危险
unskillful	笨拙
sweepforward	前掠
louisville	路易维尔
propaganda	传道总会
wheelwright	车匠
brimming	满溢
breugel	勃鲁盖尔家族
undeclined	无字尾变化的
mischoice	错误的选择
parietal	顶骨的
hemoleukocyte	白血球
alec	亚历克
gastrology	美食家
tailgunning	机尾枪
semainier	七斗橱
hydride	氢化物
primrose	樱草
eminent	杰出
prythee	求您
satiation	饱满
momently	片刻
unjust	不公平的
astatically	不安定
octosyllabic	八音节
section	项
isometry	等距
article	表达清晰的
waiting	服侍的
clearstory	通风窗
by	用
enchantment	魅力
myelination	髓鞘形成
iridaceous	鸢尾科
rubredoxin	红素氧还蛋白
momental	动量
garamond	加拉蒙字体
languorous	怠惰
upsweep	向上曲
wll	无线本地环路
transitivize	使变成及物动词
curite	板铅铀矿
sack	装入袋
spc	Pacific
favous	形似蜂巢的
terrifically	可怕地
clamer	喧闹
redemandable	要求归还的
mononucleate	单核的
unforeseen	无法预料的
racecourse	跑马场
kotwal	警察局长
ensample	例子
superphysical	已知物理定律所不能解释的
lutose	覆盖有泥状粉质物
rye	黑麦
tilth	耕作
tavern	客栈
wacko	发疯的
plurally	以复数形式
faculative	任意
probe	查明
dote	昏聩
hibernation	冬眠
pizazzy	有精力的
ceasefire	停火
fractional	部分
lapel	翻领
flammable	可燃性
towie	托维桥牌
inauguration	开幕式
inclose	围起来
damascene	用波形花纹装饰
unexaggerated	未夸大的
diamond	菱形
hardy	辛苦地
impersonal	非个人的
arlene	阿琳
windblown	被风吹的
snakebird	蛇鹈鸟
echocardiography	心回波描记术
gunman	枪手
postliterate	采用电子传媒的
silica	硅石
washcloth	毛巾
overprescribe	开过量
discursive	不得要领
ambulatory	流动的
aicpa	American
wastepaper	废纸的
skitter	使掠过水面
capriole	跳跃
linguistic	语言上
starchy	含淀粉
caseation	干酪化
literacy	有文化
auriscopically	耳镜
ocdm	of
confusedly	受困惑地
short	短裤
chili	红辣椒
massacre	残杀
iatrical	医疗的
amort	濒于死亡
extraction	提取
ccitt	Telephone
circularity	环状
reduction	缩减量
rbe	相对生物效应
colic	绞痛
tawie	易驾驭
discomfiture	尴尬
surprise	惊人之事
cozzpot	警察
gym	gymnasium
cinnamonic	取自肉桂
eutaxy	井然有序
din	喧嚣
bottlenose	宽吻海豚
squish	压烂
coagulatory	引起凝结
extent	广度
deaminize	去氨基
hero	男主角
natsopa	OperativePrinters
kathi	伊斯兰教律的法官
fear	担心
associative	结合的
fertilize	使丰饶
imbrue	使充满
basso	低音歌手
grisliness	厉害
initio	在之开头
playgoer	爱看戏的人
lengthily	长
jauk	偷懒
hahnemannian	哈内曼
coercively	压迫地
proximate	最近
facility	设备
hydroplane	水上飞机
shred	破布
jar	争吵
placidly	平稳
punctulate	有小点的
soemba	=Sumba
enthronement	登基典礼
thrombocytosis	血小板增多
chortle	咯咯笑
synergize	协同加强……的活动
pyrogenic	高热所产生
malaysian	马来群岛的
diachylum	铅膏
gypsophila	麦的一种
dioxane	二氧杂环乙烷
eerie	怪诞
likely	有希望的
shepherd	带领
coprophobic	排粪恐怖
retardment	耽误
haggard	形容枯槁的
tegestology	啤酒杯垫子的收集
corollary	系
fly	机敏的
distractible	易于分心的
lightsome	轻快
predominate	占优势
vesa	Electronic
luxuriancy	繁茂
exteroceptive	感受外界刺激的的
tuckahoe	美洲茯苓
clearance	清除
intervenient	介于其间的
spartacus	斯巴达克思党
widen	放宽
plagiarise	=plagiarize
fragile	易碎的
mozzarella	一种意大利干酪
runelike	像北欧古文字的
needments	必需品
franco	邮费准免的
unexaggerated	不言过其实
solipsism	唯我论
paintbox	绘具箱
unsuitable	不相称
treacherousness	背叛
lcp	链路控制协议
fandom	影迷
sori	sorus
vibracula	的复数
reintegrate	再重新完整
bumf	纸
plasmapheresis	血浆取出法
haymaker	制作干草
administrators	管理员
embark	上船
commensal	同吃的
alack	表示"忧伤"之义
trivialism	平凡
exhaustibility	可用尽
householder	住户
ssafa	Soldiers''
rage	狂暴
northwards	面向北
indic	印度语
verminous	虫害
coprozoic	寄生在粪便中
cutify	成皮
beethovenian	贝多芬
founder	摔到
pat	合适
dye	染
axe	斧
brandade	鱼羹
soviet	苏联
quadriplegic	四肢瘫痪的
delator	告密者
trespass	过失
peremptory	专横
atmospherium	云象仪
unholy	不神圣
bearish	如熊的
swat	用力打下去
field	扫描场
preform	预先形成
worry	使焦虑
vaginate	似鞘
overfill	把……装得溢出
teasy	令人恼火
erasion	擦抹
jake	上等的
eburnated	似象牙般坚硬结实的
christmassy	有圣诞气氛的
fudge	捏造
spawn	产卵
market	销路
ceremoniously	隆重地
maenad	Bacchus
inseverable	不可分离
entozoic	内寄生的
amendment	改正
gruesome	可怕的
switch	电闸
tupelo	蓝果树
position	决定……的位置
sacculate	囊状
genetical	=genetic
cobaltic	含钴的
grievous	令人忧伤的
secularization	把教育从宗教中分离
predeterminate	先定
telpher	索道
harsh	苛刻的
bibliotheca	图书馆
brash	傲慢
rink	室内溜冰场
slivovitz	梅子白兰地
oldwomanish	婆婆妈妈
editola	影片剪辑机
eatery	餐馆
glen	峡谷
expeditious	迅速
disposal	支配
irretention	失禁
deprecatory	恳求
backslap	拍背以示友好
stealthily	悄悄
estate	时期
gum	泡泡糖
vintage	过时
methodenstreit	关于方法论的讨论
replacer	替代者
lienitis	脾炎
toner	调色者
leatherette	人造皮
zoolater	动物的崇拜者
downfall	落下
fuegian	人
sassy	厚脸皮的
imprinter	印刷机
liwa	省
engage	雇佣
unnoteworthy	普通
aristocracy	贵族
responsible	负责的
matelote	水手鱼
letdown	松弛
blotch	大斑点
fuddle	灌醉
baptisia	indigo
princox	自高自大的人
wash	洗的衣服
hapsburg	哈布斯堡王朝的
bay	狗吠声
interpolation	添写
abiogenist	自然发生论者
impromptu	即兴曲
cynicism	玩世不恭
desired	想得到
kevin	凯文
bosque	灌木丛
gabble	急促讲出而叫人听不清说的话
cyanogenetic	生氰的
unwed	未婚
carny	巡回演艺团
substantiality	实质性
pricer	评价的人
jowled	双下巴
exclusive	排外的
streaking	裸奔
polonia	波兰裔侨民
anomic	社会之紊乱
clearly	无疑
lunatic	精神错乱
slip	减退
fag	疲劳
superannuated	过时
glauconite	海绿石
mythicism	神话主义
examination	检查
unwarrantable	无正当理由的
proclamatory	宣言
hebron	希布伦(即哈利勒
subdividable	适于再分的
nefariously	穷凶极恶
jasmin	茉莉属
expatiation	详述
vivo	=vivace
unmortgaged	未抵押的
pontificate	教皇的职位
hitherto	迄今
hypophloeodal	皮层下
baptismally	圣洗
groundless	没有理由
heavyish	略重的
slip	闪开
usib	美国情报委员会
brigand	歹徒
baseball	棒球运动
wiredrawn	抽成铁丝
swift	立刻
provincialize	使地方化
intuitional	直观
optate	作出抉择
irritability	兴奋性
import	重要性
corrigibility	可改正性
flare	使张开
rap	厉声说出
metabiosis	后继共生
grand	主要的
anemic	贫血的
emerge	显现
dissentient	反对
triecious	=trioecious
sophistic	强词夺理的
pullulate	产生
stoutly	坚决地
paramilitarism	副军国主义
paralyse	使瘫痪
brook	容忍
arachnoid	蛛网膜的
increasingly	日益
allod	=allodium
whereabouts	行踪
kbp	bishop''s
daffodil	水仙花色
dysmenorrhea	痛经
zoopsychology	动物心理学
nonpartizan	无党无派
fore	船头
jaded	疲倦不堪的
decontamination	净化
palpal	须肢
audiotape	录音磁带
postal	邮政的
nonreturnable	不能退给卖主的
aerate	使充满气体
loop	线翻圈飞行
meadow	草
confront	使面临
prevent	预防
amendatory	修正的
ssr	Republic
ungainly	难看
usafe	in
radiance	深粉红色
staphylorrhaphy	悬雍垂缝术
heartrending	悲惨
frothy	空洞
meritocrat	精英领导阶级的一员
sarcolysis	软组织溶解
unstring	把弦解下
protoplanet	原行星
connotation	内涵
giovanna	乔凡娜
undersanded	含沙过少的
polyclonal	多细胞株的
swank	出风头
platyrrhine	阔鼻类的
conspiratory	阴谋
nomarchy	州长管区
chapel	小礼拜堂
resource	资源
sierran	锯齿山脊区
piggin	汲水桶
antiferromagnet	反磁tism/`AntI9ferEJ晕镏
ohmage	欧姆数
parabolic	比喻的
interwar	两次战争之间
epicardium	心外膜
gleam	闪烁
amah	女仆
corroboratory	证实的
connotative	内涵的
conciliative	融和
extrapolation	推断
centripetence	向心运动
narcissi	自恋
weevil	象鼻虫
over	在……之上
vividness	明亮
centisecond	百分之一秒
color	给……涂颜色
pansexualism	泛性论
hydrated	与水结合的
sippet	碎片
taciturnly	沉默寡言
electrician	电工
ancilla	附属物
average	平均的
unplucked	未摘下的
tentatively	暂时
tarmacadam	由其铺成之道路
cavendish	板烟
missile	导弹
dyspeptic	消化不良的人
manyat	村庄
sbc	Single
mycostat	灭霉菌剂
summand	被加数
propertied	使用道具的
entomologize	采集昆虫
puttyblower	玩具枪
hurler	投手
temerarious	极大胆
ruddevator	方向升降舵
etymological	语源
anopsia	上斜视
hydrocyanic	氰氢的
roupy	声音沙哑的
you	你
spindle	锭子的
hydrokinetics	流体动力学
denominative	自名词或形容词派生出来的
prolongate	伸长
fame	名望
customarily	通常
conquerable	可击败
french	法语
hominization	人化过程
harebrained	轻率
strive	努力
muzzy	无精神的
nominalist	名义主义者
legionary	军团
attainture	公权丧失
oneiromancy	解梦
tousy	凌乱
bajree	御谷
blundering	笨拙
diagonalize	循对角线方向移动
unfamiliar	没有经验的
adpress	紧压于……的表面
hexahydrated	六水合物
misbound	装订错误
jiff	瞬间
lives	life的复数
militarism	军国主义
gebang	马来亚棕榈
basketballer	篮球队经理
microstructure	微观结构
man	操纵
smelting	熔炼
lithophile	亲岩性
warrison	=warison
flappy	飞扬的
enneagon	九边形
streptotrichosis	链丝菌病
dissatisfy	不满足
cremate	火葬
narky	易生气
sofia	索非亚
bellmouthed	承口
hypersexual	非常好色
vlb	Local
uncontradicted	未遭否认
keppen	为kep之过去分词
laa	轻型高射炮兵
dimensionally	在幅员上
imitating	冒充
angiocarpy	心血管
cocci	球菌
classic	第一流的
ibew	of
rainbelt	雨带
clone	无性繁殖
thaumatology	奇迹学
giggit	快运
esemplastic	有组织作用的
employee	雇员
grizzle	发脾气
lemnian	利姆诺斯岛的
sideline	倾斜的
swingle	打麻器
wud	疯狂的
enhancive	加强
myosis	缩瞳症
scoriaceous	铁渣子的
chemoimmunotherapy	化学免疫疗法
provencal	普罗旺斯人的
festivity	欢宴
ethos	气质
gunning	用枪打猎
unmediated	未经调停
tired	疲劳的
tripolite	硅藻石
bmx	自行车越野赛
floristic	花
tsaritsyn	察里津
gardenia	栀子
ghetto	犹太人区
militarism	职业军人的精神
rage	狂吹
impossible	不会发生
balcony	包厢
paediatrics	儿科学
osiris	地狱判官
divulsion	扯开
socially	在社交方面
oho	表示惊讶
hood	头巾
direct	直系的
moonlit	月光照耀
foodaholic	老饕
degrading	不名誉的
dor	金龟子
interlocutory	中间
charge	告诫
fenny	沼泽多的
orthodoxy	正统的
chiropodist	手足病医生
talion	以牙还牙的报复法
territory	版图
xenoglossy	讲陌生语言的能力
judicatory	审判
cloddish	土块一样
purchaseless	无立足点的
fan	鼓风机
shoal	水浅的
deadass	头号傻瓜
stirrup	马镫
oarsman	划桨者
scca	Sports
soundrec	声音记录
applicable	可应用的
iaru	Union
swift	立刻的
killick	海军一等兵
coordinate	并列
nutritionist	营养学家
atlantis	传说沉没于大西洋中的岛
tinkerly	拙劣
lithographic	平版的
greasiness	阿谀
harrowing	悲惨的
preferable	更好的
unresponsive	反应迟钝的
vagary	奇特行为
drop	下降
immature	不成熟
maladjustive	不利于调节
needful	必要
arpa	高级研究计划署
calcifuge	避钙植物
lusterware	表面有金属光泽的陶瓷器
arthrodic	摩动关节
undescribable	难以笔墨形容的
nephanalysis	卫星云图
siltstone	粉砂岩
multirunning	多道运行
midlittoral	中沿岸带
belted	束带的
superfilm	特制影片
process	方法
suffering	受难
tradable	可贸易
deepfelt	深深感到
malentendu	错释
freer	给予自由的人或事物
etcher	蚀刻师
antidote	矫正方法
cryosurgeon	低温外科医生
rapture	兴高采烈
restful	宁静
gawp	直瞪瞪地注视
acephalous	无头的
chateaubriand	烤大牛排
advance	预先的
inworks	发生在工厂内的
sneery	讥讽
treasonous	不忠
aberglaube	迷信
infundibulate	似漏斗状器官的
svelte	苗条
kruger	Paul
extramundane	超越现世的
habitually	习惯
unheroical	胆怯
prosiness	散文体
remonstration	抗议
lose	遗失
jowled	有垂肉的
reinspection	再考察
intraepithelial	上皮内
suky	=sukey
fixative	固定
to	Tonga
gleety	慢性淋病性尿道炎
palaeontography	化石学
untruthful	虚伪
bhuket	=Phuket
edo	Output
pepperbox	急性子
wallflower	局外人
bossy	专横
sailflying	滑翔飞行
dominant	显性
befrogged	饰有盘花钮扣
habiliment	制服
cosher	溺爱
medullary	骨髓
geoid	大地水准面
hotspur	性急的人
angelical	天使
pathos	悲怅
citadel	大本营
meditation	冥想
ssafa	陆海空军三军士兵家属协会
limn	描绘
x	X级的
stragglingly	落后地
indictable	可起诉
hypoxaemia	低氧血
sleugh	沼泽
complain	悲叹
accelerator	加速器
undetected	未被发现
call	命名
fortuneteller	算命者
previous	早先的
elaborate	详细阐述的
lumbricoid	类似蚯蚓的
umbilicate	脐状的
illegal	违法的
nifontovite	粒水硼钙石
crossbones	交叉腿骨的图形
streaky	有斑点
haberdashery	缝纫用品商店
nonsked	不定期航线
subastral	地面上的
benedictory	祝福
ripstop	防破裂的
astronome	的形式而成]
covellite	铜蓝
quechuan	盖丘亚人
explanate	展开
facedown	摊牌
ppcp	PowerPC操作平台
faconne	有细花纹的
erom	可擦写只读存储器
memory	存储器
enow	足够的
boart	=bort
bygone	过去的
unliquefied	未液化
stratagem	战略
toltec	托尔特克人
sphygmic	脉搏的
guesswork	猜测
cycadophyte	苏铁亚纲植物
online	在线式
peremptoriness	专横
bhl	Bachelor
briefness	短促
expectably	如所意料或预期
polygonal	多角形
intercolonial	殖民地间的
grazioso	优美地
fore	在前部
abuse	陋习
cavelike	似穴
impalpably	难以理解
synchronize	同步
fluster	使酩醉
bilabial	有两唇
countable	可计算的
blunder	跌跌撞撞地走
defective	有缺陷
pond	池塘
budget	预算
regenerate	改革
poop	疲乏
strobilation	节裂
gnarled	多瘤的
circumnutate	曲卷
vexation	着急
allometry	异速生长
devisor	遗赠者
dispense	分发
sacral	荐骨
turbocompressor	涡轮压缩机
lifelong	毕生
bullrush	=bulrush
cameroon	喀麦隆
hideous	丑恶
shepherd	看管
trapezium	不等边四边形
evolutional	进展
fluorometric	使用荧光测定法的
suit	相配
lapsed	堕落的
patter	饶舌
gallican	教宗权制限主义派的
diglossic	使用两种语言或方言
mistiness	雾
mopey	闷闷不乐的
hexanaphthene	环己
leg	跑
remuneration	报酬
hyperbolic	双曲线
closet	关起门来
finish	结束
eto	Theatre
flop	猛落
unmeaning	索然无味的
thorax	胸
lewis	刘易斯
downstage	舞台的前半部
reviler	漫骂者
gnomic	含格言
afoot	进行中的
theopathetic	神意感应的
concede	退让
chasmic	如深壑般破裂的
gloveman	棒球外野手
electron	电子
browser	n
sloid	工艺教育
snoop	爱管闲事的人
thyrotropin	甲状腺刺激激素
dirt	泥土
schoolbag	书包
co	哥伦比亚
footslogger	步兵
flitter	匆忙来往
minor	副修科目
birchen	桦树
semilustrous	略有光泽
marigold	金盏草
gayly	华美地
strathspey	苏格兰的一种轻快的舞蹈
adversely	反对
buttock	屁股
minever	白鼬皮
vision	眼力
roentgenoparent	用X光可以看见
prodigiouss	惊人
hafta	=have
flaxen	亚麻色的
flimsy	描图用薄纸
extortionate	敲诈的
tempt	使感兴趣
anilin	苯胺
septicidal	室间开裂的
super	极好
furfurane	=furan
skoal	干杯!
diversify	作多样性的投资
aftersensation	余像
survive	幸存
tuberose	似块茎
lookit	看
vesicatory	起泡的
handicap	障碍赛跑
telencephalon	前脑胞
hashhead	吸食大麻麻醉剂者
saithe	=pollack
leapfrog	跃过
headcheese	头肉冻
corolline	花冠的
hypohepatia	肝功能减退
orchis	红门兰
nudge	轻推为引起注意
indiscretionary	轻率的
adjuvant	辅佐
telltale	泄密的
cableway	空中索道
goad	用刺棒驱赶
unserviceable	无用
unprescribed	自愿的
autosomal	常染色体
scissor	削减
oviferous	带卵的
headhunt	出外猎取人头
violet	Violet
personalist	人格主义的
caddo	喀多人
powder	粉末
ancestry	祖先
unmeaning	无表情的
ato	Andeans
prejudgement	预断
unclassical	非经典的
ceratin	表示"角"
geometrism	几何画派
previously	以前
almsfolk	=almsman
connection	连接
dicom	Digital
accusable	可指控的
plantimal	植动融合体
late	迟的
gallstone	胆石
wise	劝导
zinjanthropine	非洲原人
mfn	Favored
abducent	向外扩展
resolutive	消肿药
tympan	鼓膜
merohedral	缺面对称的
epistyle	柱顶过梁
oa	作战分析研究
progenitive	繁殖
overbought	超购的
cummer	女友
flitty	脂粉气的
stateless	没有国家
nomistic	以经典中之法则为基础
unalienable	=inalienable
pocketbook	经济来源
exaggerated	夸大
vasculotoxic	血管毒性的
tomalley	龙虾肝
communicant	传达消息
remonstrate	抗议
tripey	低劣的
flooding	灌溉
manservant	男仆
canadian	加拿大的
expeditioner	远征队员
unintelligent	没有智能力的
impregnate	使怀孕
outside	外表的
diagnostication	诊断
identifiableness	可证实为相同
dic	域完整性约束
beakiron	砧子
stria	线痕
diminishing	逐渐缩小的
ruthenic	钌的
kook	怪癖
welwitschia	千岁兰
monocrat	独裁者
passiontide	耶稣受难节
ai	人工智能
gelding	去势的人或牲畜
shard	破片
hsv	HSV色彩模型
ebullient	沸腾
disrupture	=disruption
choli	短袖外套
saintpaulia	violet
aphanitic	隐晶岩
insubordinately	不服从地
reims	兰斯
ewery	做粗活的小房
inculcator	教诲者
falsehearted	欺诈
samsonite	硫锑锰银矿
valiant	勇敢
irreproducible	不能复制
counterargument	辩论
amimeche	E
extrorse	向外
masterate	硕士身份
hyenoid	像土狼的
intraperitoneal	进入腹膜腔内的
chalk	用粉笔写
magellanic	麦哲伦
rationalism	理性主义
tagrag	褴褛的
whip	抽打
frondescence	发叶期
spillover	溢出
hypobaropathy	低气压病
chief	首领
carsick	晕车
sulphurator	硫磺漂白器
truantry	=truancy
villose	长绒毛
msphe	in
nonfinite	非定式
myriametre	万米
wings	飞行章
electrology	电学
dismission	免职
minus	负
flecker	雀斑
untrod	人迹罕至的
sergeant	警官
combat	战斗
timesaver	节省时间的事物或因素
disfigurement	畸形
tristimulus	三色
parliamentarian	议会
adoze	在瞌睡中
ncte	Teachers
uncomforting	令人不舒服的
subdeaconry	副执事职位
unestablished	未被确认
comical	好笑的
zoolite	化石动物
contingencies	或有费用
leopard	美洲虎
slighting	忽视
biting	刺痛的
nomadism	流浪
seconder	附议者
extraparochial	教区外的
annectent	连接两物
permanently	永存地
amiss	出差错的
somatological	比较体格学
spaeman	给人算命者
sirena	赛丽娜
gag	窒息
scathe	损伤
corkboard	软木公告板
aliped	有翼膜的
timeless	永恒的
garage	汽车间
introversible	可向内翻的
swimmingly	轻易地
telecentric	焦阑
frau	夫人
peacemaking	调解
russet	赤褐色
curtal	被剪短之物
sunblind	窗檐
centimo	分
britishly	似英国人
nark	警察的线民
bank	堤
habitmaker	女用骑马装的裁缝师
potentiostatic	使用稳压器
diazole	此类化合物的衍生物
supercharge	对……增压
bosk	灌木丛
commit	犯
reckon	估计
furfur	头皮屑
audience	观众
yaleman	耶鲁大学毕业生
gramophile	唱片迷
aquamarine	碧绿色
indisciplinable	难以驾驭
proteid	含蛋白质
misty	有薄雾
hypertensive	高血压
nahum	那鸿
superterrestrial	地面上的
sure	当然
pacificator	调节者
flattish	有点平凡的
subterrene	熔岩钻
guilty	有罪
fibrocyte	纤维细胞
idoneousness	适用
second	又一个
sedate	安静
goddamn	讨厌的
equivocal	模棱两可
pittance	微薄的薪俸
dixican	美国南部共和党人
emotionalism	感情主义
unknowable	不能知道
autocoherer	自动粉末检波器
swagger	恫吓
carrel	带书架阅览桌
fylfot	希腊十字形
pseudepigraphy	作者归属错误
disuse	废弃
ignescent	发火物
allude	暗指
warmly	暖和地
euphrates	幼发拉底河
dryopithecine	森林古猿的
yanaon	雅隆
corps	兵种
bronchoconstriction	9brCNkEJkEnn`strIkFEn/
shoppy	商人
grommet	索环
multiparous	经产
hogwild	如痴如狂
osfcw	Office
unexamined	未经核对的
rapaciously	贪婪
sesame	芝麻
pandemic	全国流行的
psalmist	赞美诗作者
lor	上帝!
clemmie	克莱米
anuric	无尿症
slickster	骗子
discredit	怀疑
automatism	自动作用
concinnate	将……作巧妙和谐的配合或拼凑
filigreed	饰有金银丝细工
batty	疯狂
newfashioned	新款式的
pullus	幼鸟
erotophobic	性爱恐怖的
ncte	Council
dubiety	可疑的东西
stymy	妨碍球
predominate	支配
unbuckle	解开
atticism	亲雅典
compartmentalization	粃e/kRmpB:t5mentE
videodisc	影碟
trinitarian	三位一体说的
profoundly	衷心地
chenopod	藜科之植物
underruff	=undertrump
intwine	编织
scummy	满是浮渣的
mystique	神秘性
ingression	进入
fearnaught	开毛机
extortive	勒索的
fire	激情
zookeeper	动物园管理者
impassable	无路可通
pregnant	重要的
glucagon	胰高血糖素
shroff	货币鉴定人
pavement	公路
calvarial	颅盖的
xanthian	赞西亚的的
amazonian	亚马逊河
underprivilege	被剥夺基本水平低下
noumena	noumenon
either	每一方的
depict	描述
eloign	把……移至远处
flivver	乘廉价小汽车
thonburi	吞武里
refulgent	辉煌
sthenic	亢进性的
ineffective	无效
tiddlywinks	挑圆片
hairlike	毛一般的
unwashed	没有洗
last	支持
esol	English
stigmatic	丑恶
factually	真实地
succursal	从属
soviet	劳工代表会议
circumspectly	慎重
greenlandic	格陵兰
vrouw	妇人
togated	着官服
woomph	轰的一声
unroyal	不似君王的
boastful	自夸的
heterometabolic	不全变态
ddk	Drivers
pentalogy	五部曲
regenerate	革新
perdure	持久
cadelle	大谷盗成虫
retiral	撤退
underactivity	缺乏活动
calumniatory	诽谤
symantec	Visual
perverse	不正当的
venerer	狩猎者
unpunishable	不该受处罚的
osmundine	干紫萁根
uncontroverted	无争辩
opprobrium	不名誉
existentialism	存在主义
mediatise	=mediatize
diamagnetism	反磁性学
psychiatric	精神病学
humanize	教化
mechanical	呆板
enamel	彩饰
boloney	胡扯
sixpenny	不值钱的
pother	喧闹
amplificatory	放大的
macrocyst	巨囊
disemboguement	流注
iridosmine	铱锇矿
valiant	勇敢的人
homopolar	单极的
fleece	羊毛大衣呢
karelia	卡累利阿
etesian	季节风的
inexpiable	不能平息的
pilgrimage	朝圣
finitism	有极限论
imperatorial	威严的
hetaerism	纳妾制
daystart	一天开始
marquisate	侯爵的身份
phytogeny	=phytogenesis
whiten	变白
traveled	旅客常到
iblis	恶魔
depressible	消沉
prophet	先知
triplicate	三个一幅
centimetre	公分
observational	观察
napless	没有绒毛
wet	潮湿
isotonic	等张的
mussuck	皮水袋
submicron	亚微型的
archimage	大巫师
rattailed	细长
nardoo	大柄苹
skippy	日本女人
epitympanum	鼓室上隐窝
chufa	油莎果
obstructive	妨碍
subjacent	在下方
kbl	阿富汗首都喀布尔机场之代号
trustworthy	可信赖的
jumper	跳线
quartette	四重唱
unashamed	厚脸无耻的
natural	天生的
darkey	=darky
echo	摹仿
dep	Department
stainless	无瑕疵的
discouragement	气馁
unanimous	意见一致的
red	革命的
macaroni	纨绔子弟
standing	持续
lavish	非常大方
outstation	远的驻扎
brusquely	粗率地
altarwise	在祭坛的位置
codswallop	废话
psychoneurotic	患精神神经症
typhonic	台风似
maurice	男人名
sawmill	锯木机
swim	浸
against	倚着
soutane	修士以往所穿的黑色长袍
unfriendly	不利
ineffective	无效的
willed	有某种意志的
pergelisol	=permafrost
projector	放映机
pothanger	锅钩架
subornative	教唆的
educatory	教育
jolthead	笨头
fomentation	煽动
redargue	驳斥
faustine	福斯丁
imperatorial	皇帝的
dishpan	洗碟盆
flow	溢过
pert	爱管闲事的
opern	曲谱
phonetic	表示语音
spill	洒
responsive	作出响应
unselfishly	无私地
conveyable	可传达
willowy	苗条的
salyrgan	汞撒利
acrophobe	恐高症患者
offprint	印成单行本
age	年龄
inscrutability	不能解
medium	方法
radiochemist	放射化学家
imprudence	轻率行为
smoothly	平稳
flocculate	絮结
supercolumniation	重列柱
respire	呼吸
quadrilateral	四边
futurology	未来学
quinine	奎宁化合物
tetragonal	四角形的
against	相反
profound	深刻的
revolver	旋转者
unswathe	解开……的裹布
diplotene	双线期
unstuck	紊乱的
delete	删除
janizary	土耳其士兵
ribbonman	成员
fat	长肥
wane	消逝
thuswise	这样
signwriter	写招牌的人
samos	observation
sciolto	断音
osp	Signal
monosyllabism	单音节性
hip	给造屋脊
jet	喷气机
misaligned	不重合
misanthropy	不愿与人来往
rancor	怨恨
philter	媚药
punctatim	逐点
unfilial	不孝的
hyperemization	人工充血
declot	去除……内的血块
tog	衣服
avocado	鳄梨树
sensorium	感觉器官
superconscious	超意识
cushy	轻松而容易赚钱
skirret	泽芹
fulminant	爆发性
study	书房
countship	伯爵的地位
autocephaly	独立
ibsenism	易卜生主义
fiscality	检查
fco	and
imperviable	不接受的
bison	美洲或欧洲的野牛
connect	关连
quintant	五分仪
asclepiadaceous	萝摩科
recite	朗读
interdict	阻断
vlsm	Length
minirecession	小规模衰退
glomera	glomus的复数
bitterness	苦难
laparectomy	腹壁部分切除术
abjectly	悲惨地
modernday	当代
unvaryingly	恒久
tutti	全体
bimana	两手类
hornstone	角石
vexillar	军旗的
hesiodian	赫西奥德风格
elbe	易北河
etic	语音学的
mayan	玛雅人的
stub	存根
ocellation	眼斑
cerecloth	蜡布
elope	出走
synonymy	同义字重复
runnel	小河
plexus	丛
complimentary	免费赠送
laryngoscopic	喉镜的
liege	君主的
intact	未经阉割
qualify	限制
peradventure	偶然事情
turtleburger	海龟肉汉堡包
karakorum	古代蒙古帝国旧都遗迹
advocation	支持
injurant	有害物
eternal	没完没了的
venomous	分泌毒液的
towardly	和蔼可亲
bestial	残忍的
procurer	拉皮条者
unfurnish	拆除……的家具
seedbed	温床
backstroke	仰泳
permissibly	得到许可地
haircloth	毛织品
sulfuretted	被硫化
bland	乏味
dutiable	应纳关税
sympathectomy	交感神经阻断术
patriate	的权力从英国政府手中移交给加拿大联邦政府
polyhedral	多面
quackster	庸医
tetrachloroethane	穆纫彝
ravishing	引人入胜的
intelsat	Satellitc
sourly	坏心眼
musa	可变方向图的多元菱形天线
carefree	无忧无虑
cameralistic	财政
soundly	非常好
sophonias	西番雅书
inertially	借助
provinciality	乡下习气
metacinnabarite	黑辰砂矿
polyandrous	一雌多雄
liable	有义务
mspe	Physical
palazzos	=palazzo
procural	取
pictographic	象形文字的
slavophile	亲斯拉夫人的
canard	误传
adjusted	调整过
forceps	镊子
solitarily	独自一人
stray	偶遇
sexangular	六角的
unconspicuous	不明显的
zydeco	柴迪科舞
engrain	使遍体渗透
zarathustra	=Zoroaster
belinda	贝琳达
putter	闲荡
forced	强迫的
gisela	吉塞拉
orle	内缘饰边
laborage	工资
reviviscent	复活
inocula	inoculum的复数
theanthropical	具有神人两性
profiteering	牟取暴利
smaltine	砷钴矿
pent	郁积
snafu	闹成天翻地覆
stradivarius	弦乐器
colubrine	蛇的
reoccupation	再占领
axillary	腋窝
ten	十
reversely	反对
intravascular	血管内的
humanoid	有人的特点
tolerableness	可以
inaugural	开始
grimily	肮脏
ignoramus	无知识的人
stitches	缝线
respirometric	呼吸运动
enmity	敌意
republican	共和政体
nucleoid	类核
sherif	阿拉伯国家的王子
bacteriform	细菌状
wheelchair	轮椅
crepitant	捻发音
riftless	无裂缝的
shandrydan	带篷的轻马车
cheesemaker	干酪制造者
asturian	阿斯图里亚斯
seajelly	水母
unthanked	没有得到感谢
pathography	病情记录
reave	抢走
auctioneer	拍卖人
depreciatory	蔑视的
caecostomy	盲肠穿孔手术
selfless	无私的
atreus	阿特柔斯
contentedly	满足
pitiable	卑劣的
aponeurotic	腱膜的
gemmology	宝石学
organic	有机
waxwork	蜡制品
knout	鞭打
wend	行
fairness	适当
cassis	黑醋栗所酿的酒
fissilingual	舌头裂开
antiemetic	止呕吐的
shelvy	渐渐倾斜
token	代币
sopranist	童声高音歌手
his	pro
mourning	服丧
plumpish	较丰满
niggerize	像黑人一样行事
altricial	晚成雏的
brainpower	智囊
lithotome	膀胱石刀
spiccato	断续的
kedgeree	鸡蛋葱豆饭
disenchanting	使不再着迷的
palm	蒙混
faintish	较弱的
scabbed	有疙瘩
inflictable	可处
gripe	抱怨
amygdalaceous	扁桃类的
celebrity	名声
criticize	批评
mopey	闷闷不乐
drone	嗡嗡作声
aphetic	非重读字首之消失
conurbation	有卫星城的大都市
infuscated	略带褐色
inexpertness	不熟练
folksy	友好
translunary	虚构
pinball	弹球戏
august	八月
hop	蛇麻草
lamellicorn	鳃角类角虫
hoofed	装蹄的
coordinative	同位
bother	麻烦
nerviness	厚颜
perbunan	丁苯橡胶
stripy	有斑纹的
stalworth	=stalwart
fart	屁
chemosphere	光化层
bosom	胸部
referable	可交付的
valor	英勇
pelerine	细长披肩
pistou	蔬菜蒜泥浓汤
houseman	实习医生
skating	溜冰
cyclopic	庞大
eluvium	残积层
asce	American
expressional	表情
mantilla	女用小披风
roughhewn	粗凿的
adown	向下
keitloa	黑犀
fluey	有绒毛的
coffie	系成一串的人
transitional	过渡期
loudmouthed	吼叫的
falange	长枪党
dexterous	灵巧
rutabaga	1美元
undying	永恒
cannonize	褒扬
turbit	浮羽鸽
creesh	动物脂
unknowing	无知
geodesy	测地学
extraocular	眼睛外面
arret	扣押
countercry	反对的叫声
asexual	无性生殖的
peatland	泥炭
maltreat	滥用
shimmy	西迷舞
world	世事
tailband	堵头布
betrothed	已订婚者
intervolve	互卷
stepson	过继的儿子
hypsometrically	测高术地
perennial	终年
tumuli	坟墓
chew	咀爵
facture	制作法
cutthroat	谋杀者
duplicate	复制
those	那些
duplicability	可再发生
ceuca	Union
flintily	无情
diazole	二唑
inexpedience	失策
dies	去逝
capcom	指令舱宇航通讯员
procacious	鲁莽的
forcipate	钳状
seraphic	天使一般
leakiness	泄漏
coercively	强制
schismatic	分裂论的
nigritude	漆黑
rosebud	蔷薇花蕾
psro	review
ricksha	黄包车
ballooner	气球驾驶者
bennington	本宁顿陶器
niaiserie	无知
absolutist	专制主义者
petn	pentaerythritol
waif	流浪者
vacuolate	有空泡
vain	无益的
sari	纱丽
warlord	军阀式首脑
vanadic	钒
blockade	阻塞
anonymously	不具名地
bemegride	贝美格
chandigarh	昌迪加尔
masterly	精巧
unvalued	不足道的
eschatocol	文件的结尾
backwoodsy	粗野的
humbert	亨伯特
examinator	检查人
inequation	不等式
gentilism	非摩门教
compellent	强制性
aiguille	钻石器
baptistry	洗礼用桶
typology	体型学
forwhy	为什么
marital	婚姻的
unimodular	幺模
official	官员
outrageous	可恶的
local	方
membraniform	膜样
zander	梭鲈
usrc	United
supraspinal	脊椎上的
inventroy	列入详细目录
zarzuela	人工养殖海味场
cpo	petty
compurgator	辩护者
delude	迷惑
specialty	专业
sanious	由脓液构成
unbalanced	收支不平衡的
anthophagous	食花
kalifate	=caliphate
logon	登录上网
grayer	苍白的
carry	进位
paganism	异教
claustrophobic	导致幽闭恐怖症的
abasable	可降低
volatilisable	=volatilizable
ser	重量的单位
vulcanisation	=vulcanization
ancestral	祖传的
telltale	证据
hyperpyretic	体温过高的
mutafacient	突变加强
fissive	分裂生殖
myeloblast	粒细胞
quebrada	山谷小溪
inimicable	不利
sickening	使人昏晕
therapeutical	治疗
problematic	问题
monodomous	同巢
italy	意大利
lightplane	轻型飞机
kibitz	乱出主意
komintern	共产主义国际
autobiographer	自传作者
separate	分离的
fattest	胖的
rapparee	爱尔兰的民兵
inchoative	发端的
lockmaster	闸门监视人
capricious	反复无常的
godliness	敬神
ultraminiaturize	超谐⌒
unpicturesque	不生动的
dextrocardia	右位心
patna	巴特那
lupulin	蛇麻素
compulsory	必需做
outperform	做得比……好
gettable	能得到
hedge	树篱
demand	查询
extortionate	勒索
northmost	极北
sensa	sensum的复数
clivers	拉拉藤属植物
titular	有称号的人
latinic	主要是拉丁性质
labiate	唇形科植物
cityward	朝向都市
shamefacedly	羞怯
trifle	小事
sentence	宣判
cormophyte	茎叶植物
caucasian	白种人的
cloyless	不会使人感到腻烦
transreceiver	=transceiver
aquicolous	水生的
parallel	平行
presbytery	长老会
under	低于
prescription	规定
moistureproof	使防潮湿
trotty	轻快
intersterile	互交不孕
ceaselessly	不停地
unexcelled	极好的
leporid	兔科
vaporize	蒸发
by	按照
contiguously	连续
monolog	独白
lazyish	有点儿懒惰的
glair	蛋白状粘液
cavernous	似巨穴的
carking	恼人
laciniate	有穗边
idd	国际直拨长途电话
elenctic	辩驳
barbaric	野蛮
subrogation	代位偿清
feelinglessly	无知觉地
ppm	百万分之……
shirttail	幼小
primrose	淡黄色
sporule	孢子
theonomy	上帝统治
cornaceous	山茱萸科
semischolastic	半教育
unrecognized	未被承认的
downcourt	前场篮下的
mycetoma	足分支菌病
sarawak	沙捞越
equivocally	含糊地
peg	借口
chorizon	淀积层
undissolute	生活规矩的
ventrodorsal	腹背
leeward	下风
napless	没有绒毛的
vulgate	拉丁文圣经
sensorium	感觉中枢
ventriloquous	腹语术的
reflexion	反射光
katusa	韩境美军中之韩国士兵
hummock	沼泽中的肥沃高地
unsullied	无污点的
matchstick	火柴杆
jimp	缺乏
ungimmicky	不骗人
destitute	缺乏
cape	岬
ungainly	不象样的
harpins	临时牵条
righty	右派的
roundabout	迂回路线
rgs	Geographical
liminal	阈限
propylon	=propylaeum
schismatic	分裂者
forestry	森林
guidwillie	高兴的
msph	Health
flinty	坚硬
eerie	可怕的
caricature	画成漫画讽刺
tristful	悲哀
golfer	打高尔夫球的人
sprig	使蔓生
bat	球棒
comatulid	海羊齿
broadcaster	广播公司
grace	格雷斯
decimillimetre	丝米
inboard	舷内的
feat	壮举
synchronization	同步
antifederal	反对联邦的
habitual	习惯
rimal	裂缝的
rascal	卑鄙的
amylopsin	胰淀粉酶
salverform	高脚碟状
malaise	不舒服
unwatered	干旱的
aggravate	使恶化
enhancement	增加
immutably	永恒
transmit	遗传
processional	游行圣歌
aftercooler	后冷却机
hardcore	没有限制
fructification	果实
triangularly	成三角形
morganatic	贵贱通婚的
homochronous	同龄发生的
resilient	弹回
patter	祷告
coach	指导
anteversion	子宫前倾
federally	联邦政府
paginal	每页的
lazyish	懒洋洋的
impersonate	拟人
lionet	小狮子
ocs	候补军官学校
spiculate	针状
reader	读者
angell	守护神
operatic	歌剧风格的
been	的过去分词
cacuminal	翘舌音
seminiferous	输送精子
achaea	亚该亚
crooknecked	颈部弯曲的
aiguillette	肩带
choiceness	优良
universally	普遍地
deliverance	判决
bullhead	鳅之类
zolaism	左拉主义
dalmazia	=Dalmatia
anuclear	无细胞核
foresighted	能预料
garrison	卫戍地
cuttie	海雀
rummage	到处翻寻
romance	传奇文学
raconteuse	健谈的女人
jag	使成锯齿状
carnal	性欲的
wriggler	扭动的人或物
wane	呈下弦
fossilize	使陈腐
brazen	厚颜无耻
unineme	单线
set	坚决
unaptly	迟钝
ultramarine	深蓝色
accessary	帮凶
mundane	平凡
friseur	美发师
tough	恶棍
back	后面的
moselle	法国摩泽尔河流域产白葡萄酒
provide	准备
pantalettes	灯笼裤
expellent	具有驱逐力
summons	传唤
antichurch	反对教会的
hasher	厨师
accoucheuse	产科女医师
attractant	引诱物
zwitterionic	两性离子
avatar	具体化
rejuvenescent	返老还童
gripe	抓紧
trencher	木盘
durham	达拉谟
antifebrile	解热
tastable	=tasteable
multipurpose	多种用途的
hetaira	=hetaera
connivance	纵容
pleadingly	祈求地
suboesophageal	食管下
moistureproof	防潮
notarize	确认
reliable	可靠
sheathy	紧身
litten	点燃的
catholicize	一般化
intersensory	多感官
supposition	推测
blacktop	沥青质原料
korean	朝鲜语的
congeries	聚集体
hinkty	=hincty
flourish	夸耀
pav	=pavlova
hayes	美国著名的通讯器材生产商
egomaniacal	极端利己的
heterosporous	具异形孢子的
ramie	苎麻纤维
reluctation	表示不愿意
oneparty	一党的
polychaetan	疣足多刚毛的
sterilize	使成不毛
exclusive	孤高的
actionless	不采取行动的
backstay	桅杆
passingly	顺便
everyday	平凡
clearly	明显
dialogist	对话者
crackling	猪油渣
evenminded	沉着的
intolerant	偏狭
intertestamental	写于基督教新约与旧约之间
metafiction	超小说
hypomagnesemia	低镁症
dinantian	狄南统
featherwit	笨者
intacta	未遭玷污的
secretory	分泌器官
epilation	头发脱落
soggy	浸水
gavel	槌
totty	发昏的
city	城邦
plutocratical	富豪政治的
substratal	基本
surliness	险恶的天气
sternwards	向船尾
bladdery	膀胱状
unwisdom	无知
nyctitropic	夜间变更方向
unco	没看惯
vibrational	振动
alembicated	过分精炼
dexamethasone	地塞米松
surprise	使惊奇
tetramorphic	四形的
archaist	拟古主义者
dicom	医学中的数字图象和通信
swellhead	夜郎自大者
percheron	佩尔什马
unlearned	不熟练
cabbage	甘蓝
beguilement	欺骗
repechage	补充赛
feathering	羽毛箭
picomole	微微摩尔
blm	Management土地管理局
slip	纸片
whither	无论到哪里
derivable	可诱导
enticement	怂恿
afs	Fire
spheric	球状
lanceolate	披针状的
roric	似露水
napu	矮麝香鹿
nitric	硝石
sharefarmer	与农场工人共享收益的农场主
micrococcal	微球菌的
uniflow	单流的
modelly	模特儿似的
eyebolt	吊环螺栓
eleven	十一
hydroxide	氢氧化物
zoogeographer	动物地理学家
dragbar	斜井矿车防坠杆
remorseless	不知过错
kenspeckle	引人注意
chinar	法国梧桐
infertile	不结果实
toluic	甲苯酸的
pathbreaking	开创性的
emotion	情绪
attributable	可归于……
polyxena	波吕克塞娜
knotless	没有结的
ergograph	肌力描记器
filially	子女似地
worshipful	崇拜的
signaling	发信号
encephalic	头
nc	New
truculence	粗野
carloadings	装车数
prophet	提倡者
goosegirl	照顾鹅群之女孩
jensenism	詹森理论
primidone	扑痫酮
idlesse	懒散
ecp	Port
essential	精华
piratical	盗版
buggy	多虫的
formant	共振峰
alsace	阿尔萨斯
npr	Public
unwilled	非故意
aduncous	向内弯曲
transurethral	经尿道
extensible	可展开的
exit	出口
psammophile	适沙生物
weatherworn	风雨侵蚀的
pulmometer	肺量计
impressively	令人难忘地
antisexist	反对性别歧视
paretic	局部麻痹
rumply	压绉
homostyly	花柱同长
moabitess	摩押族的妇女
headword	中心词
infer	推断
uncreated	未创造的
incandescence	白热
federally	联邦
lack	需要
japheth	雅弗
overdid	overdo的过去式
hong	洋行
hematoblast	血胚细胞
dateline	日期栏
neaples	那不勒斯
antisudorific	止汗剂
convergescence	聚合之倾向
pyrethrin	除虫菊酯
cutesy	矫揉造作的
declension	衰退
rampage	暴跳
monetarist	货币主义者
peace	安宁
exoteric	外界
bicorn	双角的
nutmeg	肉豆蔻种子中的核仁
punitive	惩罚性
teratologist	研究畸形学学者
electropositive	金属的
place	住所
borah	=bora
stereometry	体积测定
overchurched	设有过多教堂的
heteroatom	杂环原子
scurviness	无礼
distance	距离
pickerel	梭鱼子
cry	哭泣
interstitial	形成空隙的
land	使上岸
kibbock	乳酪
cannes	戛纳
swingboat	船形秋千
material	原料
verbalization	以言语表现
massy	巨大
analysable	可被分解的
nonhibernating	不能冬眠
estrogenic	动情激素
investitive	授予
choleraic	霍乱性的
phe	Public
voetganger	南非无翅蝗虫幼虫
archiepiscopacy	大主教
syllabically	分成音节
mina	古代希腊的重量单位
foreland	前沿
luminarist	外光派画家
trendy	穿着时髦的人
conifer	针叶树
quatercentenary	400年的
therapeutist	治疗学家
stale	使变旧
inventroy	详细目录
guzzle	暴食
gruziya	格鲁吉亚共和国名
uppermost	至上
antidotal	解毒的
phytocidal	除莠
babouche	平底拖鞋
electrocautery	电烙术
feculent	浑浊的
ribband	临时装设板
overprotection	过度保护
iliyria	伊利里亚
regalvanize	重新振奋
seminal	生殖
fit	使合格
sloughy	蜕皮的
inequilateral	不等边
glycocoll	氢氨乙酸
glassworm	=arrowworm
frass	幼虫的粪便
eumycete	真菌
sunshade	遮阳伞
madbrain	性急的人
takingly	传染地
chorten	圣骨冢
dressing	穿衣
gangsterism	歹徒及其犯罪行为
parody	拙劣的模仿
desulphurize	除去硫磺
kernel	要点
syllogism	演绎
frenglish	搀杂法语词语的英语
recognizance	保证书
solstitial	冬至
elucidative	解释
dissaving	支出多于收入
brute	畜生般的
bistort	拳参
diabolology	魔鬼研究
donatism	多纳图派教义
bipedal	两足动物
conventionalise	墨t/
organizable	可组织
scion	幼芽
drachm	古希腊的银币名
shipfitter	轮船装配者
such	这样
baroque	形式怪样的
woodpie	斑啄木鸟
crackled	有脆皮的
adjustable	可调整
fashioner	创造者
undo	解开
boldface	粗体铅字
supernal	神的
flashiness	灿烂
unmirthful	一本正经
handsaw	手锯
controvert	参加辩论
graphemic	字形
desire	要求
barkhan	=barchan
zmodem	一种文件传输协议
circumoral	在嘴边的
jv	资浅代表队
golden	金色
altaic	阿尔泰语
nonarticulate	不连接
xylographic	木刻的
deicide	杀神者
handling	操作
hesitance	犹豫
invariance	不变性
horsefaced	似马脸的
malodorant	恶臭物
limation	磨光
papilloma	刺瘤
submillimetre	小于1毫米
venerable	庄严的
glitch	小故障
golly	发誓
miee	Engineers
deoxygenize	还原
dm	Mining
persicaria	=redshank
albata	德国银
elephantiac	象皮病
cannoneer	炮手
spiritualize	使灵化
silicon	硅
cacodyl	四甲二砷
worsted	精纺毛纱
supernal	超自然
rutty	遍地车辙
padrone	包工头
gillian	吉莉安
tailhead	尾基部
tailing	尾料
attention	关心
classy	上等的
epidermal	外皮
weatherboard	护墙板
contempt	轻蔑
redshank	红脚鹬
angelic	似天使的
electroencephalogram	IlektrEJlographic/I`lektlography/I`lektrn5sefElEJ^rAm/
dislimn	变模糊
grinding	碾
strained	紧张
strikeout	失败
query	怀疑
jiggers	小心
qualification	赋予资格
sick	病人
steady	坚定
viviparity	胎生
gussy	粉饰
sleugh	泥沼
uptrend	趋势
courteously	有礼貌
pallidly	苍白无血色地
pullulation	抽芽
spectatoritis	观众病
elegantly	优美地
fancy	异样的
mediagenic	所喜闻乐见
vizsla	维希拉猎犬
sheeplike	绵羊般
craftsperson	工匠
cryoprobe	冷冻器
zooming	快速上升的
bestially	残忍地
lounder	重打
biedermeier	保守
carnally	世俗地
katalyst	催化剂
gullible	易受骗
loneness	幽静
steeper	险峻
ichthyomorphic	鱼所特有
maidless	没有侍女
gallanilide	棓酰苯胺
vindicative	辩明
subsensible	比感觉范围更深的
otherworldly	来世的
hexagonal	六边形
agrometeorological	农业气象的
waggish	爱开玩笑
offertory	捐款
clement	宽大
zenographic	木星表面
covert	隐藏处
salvationism	救世军之教义
prodigal	浪费的
educe	使显出
msdn	Microsoft
yellowhammer	黄鹉
franco	邮费准免
umohoite	钼铀矿
aicpa	Institute
amdg	Dei
postmitotic	有丝分裂期后
piracy	海盗行为
wane	衰退
unmethodical	无方法
godwinian	戈德温派的
genealogist	系谱学者
proof	考验
alleyway	通道
petunia	矮牵牛花
aerodynamics	空气动力学
fortnightly	每两星期一次地
baptismally	洗礼
luster	光彩
brindled	有斑的
semiglazed	略上釉的
expand	使膨胀
fungal	真菌
redeemable	可赎回
daee	航空工程学博士
tan	棕褐色
tenemental	地产的
narrow	使缩小
undigested	未经整理
correctly	正确地
grand	极重要
story	谎话
fuzhou	福州
serotonergic	含血清素的
unsugared	不放糖
ang	Guild
druid	德鲁伊教团员
beatific	祝福的
dissolution	分解
underripe	不够成熟的
lowlihead	低下
unconscious	无意识的
rule	准则
byzantine	拜占庭人
wfdy	Federation
jawline	下颌的轮廓
azus	太平洋共同防卫组织
thunderstorm	雷暴
trichopteran	有毛翅
elastically	有弹性
unspecific	不确定的
tenner	十元纸币
undersurface	下面
aerobatic	特技飞行的
fluidram	dram
cockleshell	海扇壳
discal	圆盘的
hypaethral	露天
defibrillation	去心脏纤颤
unscrupulous	肆无忌惮
freely	自由
atilt	挺着长矛
gsm	一种数字移动电话系统
uranic	天
araneiform	像蜘蛛的
decantation	移注
gillie	侍从
pickwickian	匹克威克
floodgate	防潮水闸
iota	极微小
tuneful	和谐的
demagog	煽动家
ironclad	打不破
babyhouse	婴儿玩具室
professional	专业的
cosmologic	宇宙哲学
endocranium	硬脑膜
strigous	覆盖着糙伏毛的
rhinopharynx	鼻咽
featheriness	轻吹
quickening	兴奋
nontraditional	不符合传统
lallan	苏格兰低地的
rotogravure	照相凹版
feudatorial	封建
life	生活
bowknot	蝴蝶结
nucleogenesis	核起源
detassel	使
lorn	寂寞的
scamper	奔跳
nog	木钉
isobarically	恒压
oleoresin	树脂油
garcon	男孩
vestibular	门厅
scrapnel	炸弹破片
wetland	沼泽
scamper	奔跑
serve	服役
necromimesis	死亡妄想
grail	圣杯
obelize	加疑问号
subastral	面上
utriculate	=utricular
vedic	吠陀梵语
wash	冲洗
seeker	探求者
brs	Services
cryophorus	凝冰器
needlework	缝纫
capacious	广阔的
hood	兜帽
influential	有影响
italianism	意大利式
aether	苍穹
atheoretical	非理论的
encapsidate	用壳体包裹
subdivide	再分
zeolitize	使化为沸石
efficient	能干
slotback	进攻前卫
festive	节日似
savage	野蛮的
fellow	人
grazioso	优美
wordy	冗长
neral	橙花醛
undreaded	不被畏惧
cytaster	星体
unheroic	胆怯
compliable	依从的
trigonal	断面呈三角
rolleiflex	禄来福来反光照相机
debilitate	使衰弱
catty	狡猾的
anthomania	爱花狂
pleasure	愿望
ssr	Socialist
unsanctioned	未通过的
sarcolysis	肌肉分解
toes	脚趾
nsf	国家科学基金会
litholapaxy	碎石洗出术
coppernose	酒糟鼻
unfortunate	不合宜的
cottage	小别墅
forwearied	筋疲力尽
strontium	锶
pierce	刺破
enfetter	使为奴隶
americana	史料
intelsat	Telecommunications
aircraftman	空军士兵
drunken	酒醉的
ethnos	同种同文化之民族
embolum	铁嘴
helvetia	赫尔维蒂
sound	测……深
photochemical	光化学
cementum	牙骨质
stiffener	使僵硬的人
outswing	外弧线球的运动
lubricious	不稳定
hls	HLS色彩模型
chance	机会
counterproductive	使达不到预期目标的
miee	Electrical
hairiness	多毛的性质或状态
marking	作记号
gloss	作注释
scraping	吝啬的
alterne	交替群落
gec	Company
forced	动用武力的
halakist	编辑犹太法典法律部分的法官
vernal	春天发生
msee	Electrical
groupuscule	小派别
calathiform	凹陷的
scapular	肩衣
hydraulic	水力的
outburst	突发
retinispora	扁柏属植物
tediousness	沉闷
preincubation	预诱导
leukovirus	白血病病毒
apyretic	无热
demagnetization	除去磁性
sill	窗台
tentacular	有触手
ccpit	China
velocipede	手压车之一种
ece	for
irrevocably	不能撤回
pouched	袋形
magnetograph	磁力记录计
pianette	竖型小钢琴
commercialese	商业语言
bisulphate	重硫酸盐
plunderer	掠夺者
moonlit	月光照耀的
appointor	指定人
slide	幻灯片
ultramontane	山那边
deep	远离中心
kvetch	老找碴的人
vcd	Video
exumbrella	外伞
henchman	党羽
aeroamphibious	海陆空联合
objettrouve	被发现之物
bacony	脂肪质的
interior	内部的
semievergreen	半常绿
motiveless	无动机
throstle	画眉鸟
investment	可获利的东西
finite	限定的
reg	雷吉
mathematicization	=mathematization
rampant	狂暴
columbine	鸽色的
outright	直率地
zalophus	海驴属动物
envious	羡慕
monopteral	圆形外柱廊式的
undercharge	低的索价
corrector	修正者
experiment	实验
polygonize	多边形化
luetic	梅毒的
disconnected	不连贯
unwittingly	不知情地
advocatory	有关拥护者的
pinstripe	细条纹
tom	雄动物
enclises'	NULL)
coinstitutional	中学
stanch	忠实
felicitous	恰当
damning	受永罚
heterofil	异质复合丝的
goodwife	女子的敬称
yachtsman	游艇所有者
abbreviate	缩写
netted	网状
inkyo	隐居者
alimentative	富于营养的
ultramodern	超现代化的
lubra	女土人
mongrel	杂种的
sink	水池
affection	爱情
supervenient	伴随产生
outright	直率的
suspend	延缓
nuggar	大驳船
digitate	有指
efficacious	灵验的
repute	名誉
pds	Direct
discovery	发明的东西
solemnify	使神圣
cupule	壳斗
aduncal	向内弯曲
chapote	墨西哥柿子
incognizance	不认识
collect	收集
degressively	递减地
euphemia	尤菲米娅
meningitic	脑膜炎的
softhearted	好心肠
eht	tension极高压
bluet	开蓝花的植物
recessional	后退的
roughscuff	大众
catonian	加图式
changeful	易变的
bipinnate	两羽状
unvanquishable	不能征服
assignment	委派
slip	活络的
peaky	尖峰的
filamentous	纤维所成的
ergometer	测功计
mean	低劣的
turkistan	=Turkestan
airframe	机身
after	以……命名
surfboat	冲浪艇
stardom	演员们
omphalotomy	断脐术
propeller	飞机上的螺旋推进器
mujik	农夫
hans	德国人或荷兰人的绰号
viviparism	胎生生殖
canned	喝醉了的
rotiform	轮状
plenitudinous	充足
salify	使与盐结合
unco	不可思议的
denervate	切除神经
derivative	派生的事物
congener	同类的人
interspecific	中间
hotch	使摇摆
sensurround	包围感
bended	弯曲的
narrow	眼光短浅的
valuableness	昂贵
ncaa	National
bidarkee	海豹皮小艇
sudatorium	发汗室
jotunheim	巨人之家
sinister	险恶
poor	可怜
wealthily	丰富地
upturned	翻过来的
economic	产供销的
baitandswitch	"上钩调包"诱售法的
tersely	简洁
lame	不知内情的人
exhaustion	耗尽枯竭
initializtion'	NULL)
dexter	吉利的
etep	Progrom
hollywoodize	使符合美国电影业标准
semisecrecy	半秘密状态
hogwild	疯狂的
easternmost	最东部的
rubrical	仪式指示
certainty	确定
ruleless	无规则
fining	澄清
breadbox	面包箱
mammary	乳房的
athodyd	冲压式喷气发动机
environmental	环境论
quadrisyllabic	有四个音节的
tetragonal	四角形
equivocal	意义不明确的
adviser	顾问
thermalise	=thermalize
coaction	强迫
horatia	霍雷希亚
lampedusa	蓝佩杜萨岛
dewy	如露
noiseless	无声
response	回答
spectrochemistry	光谱化学
actinogram	X光像
lawny	细麻布的
psia	absolute
sainted	德高
bluebutton	"蓝徽"
jockstrap	护身三角绷带
pulpify	使化成纸浆
osteitic	患骨炎的
urbane	文雅
terrorism	恐怖行动
townet	拖网
hemocytoblastic	原始血细胞的
blastocoel	囊胚腔
vinegary	有酸味的
writer	作家
favorable	有利
disparaging	蔑视的
tepidity	微热
reflect	反省
generic	属的
joyful	可喜的
motherwort	茺蔚
mean	惭愧
inhuman	野蛮
earhole	耳孔
popularization	普及
trinary	三重的
enstatite	顽辉石
pasta	意大利面食
meshugaas	疯癫
believable	可信
lacteal	乳状
anatole	阿纳托尔
resolutive	消肿的
legazpi	=Legaspi
lumberly	迟缓
upsweep	向上斜
metropolitan	首都
reviviscence	复活
diseaseful	产生细菌的
hausa	豪撒语
dinosaurian	似恐龙的
popout	劣质冲浪板
tiptop	出色的
dealer	经销商
scratch	凑合的
unsound	不佳的
fetwa	判决
bagger	装袋工
overripe	过熟的
effacement	抹杀
jism	元气
triable	可以试一下
hcs	human
fructuous	会结果实的
toeshoe	芭蕾舞鞋
sizz	使发出嘶嘶声
zone	使分成地带
acne	粉刺
cheesecake	半裸体或露出曲线美的女人照片
estanciero	牧场主人
pregnant	富有意义的
thrill	发抖
silicon	硅元素
polysemous	多义的
priestcraft	神职者的谋略
rodman	垂钓者
selective	选择性
octahedra	的复数
accelerant	促进剂
unfaltering	稳步
premaxillary	前颌骨
underlying	在下面的
crustily	粗鲁地
truant	逃避者
fluorography	X光间接摄影法
fancied	空想
throughother	乱七八糟
gargle	含漱剂
coulometry	电量分析
obscurity	含糊
official	公务的
uncopiable	不能复制的
jazz	颜色过于艳丽
stellated	星形的
escheat	重还
sialagogue	催涎
regard	尊重
endymion	恩底弥翁
casework	生活环境调查
concyclic	在同一圆周上的
unnecessarily	不必要
eniac	ENIAC
lithium	锂
audion	三极管
ai	Aritificial
vhs	System
last	持续
sinitic	中国的
discrete	不连续的
recumbency	躺着
energetic	精力充沛
elegant	雅致
ectal	表面的
heavy	阴沉
hymenotome	外膜刀
diseur	朗诵艺术家
qq	quartos
explicative	解释的
unofficially	非公认
floriated	花形的
liturgical	礼拜式
fibrovascular	维管
heedless	不注意
transvalue	以新价值观重新评估
ophthalmologist	眼科专家
plectrum	琴拨
altar	圣坛
shooting	发射
microscale	微观大气现象的
tvp	protein
putresce	开始腐烂
galvanism	流电学
degree	度
proverbially	如谚语所说的
cataleptic	全身僵硬症
cholane	胆烷
rba	Artists英国皇家艺术家协会
rally	给予新力量
radiantly	清朗地
weather	气候
madid	潮湿的
umbilicate	有肚脐
asparagus	芦笋
didactics	教授法
myopia	近视
scirrhous	硬癌的
excess	超额
material	物资
catamnestic	诊后病历的
ebony	黑檀的
razzle	旋转木马
vulturous	贪婪
caravansary	大旅舍
whippy	鞭子一样
golly	天哪!!
repute	名声
augustan	奥古斯都时代的
devotedly	一心一意
hydrozincite	水锌矿
hypermotility	运动过强
copiously	充裕地
krill	磷虾
curriculum	课程
twirl	快速转动
ungalled	未受伤的
grotesque	奇形怪状
manual	实际占有
grillage	格床
sempiternal	永恒的
shmoo	玩具什穆
snaphaunce	燧发枪
mite	力所能及的微小贡献
basset	一种矮脚的猎犬
resinous	含树脂
lsat	法学院入学考试
tragicomical	悲喜剧
balmy	温和的
numbered	时日无多
crankily	任性
decapitator	斩首者
recolonize	开拓殖民
settler	财产赠予者
rakish	俏皮
vcd	Compact
subside	减退
grown	长大的
kaiser	皇帝
toxicologically	毒理学
gi	直布罗陀
northwestern	西北方的
featherhead	蠢人
cacao	可可树
sinner	不信神的人
outstare	将……瞪得无法招架
motley	穿染色衣的
far	远
substantive	大量
rotfl	Floor
decree	天命
deltawinged	有三角翼
geo	海门口
generalship	将军军阶、地位、任期、或权力
adapt	使适应
cosmopolite	属于世界
parasympathetic	/
subeconomic	不经济的
pieplant	食用大黄
eschatological	末世学的
roundly	完全
devolution	滚下
picayunish	=picayune
blighty	老家
aarp	AppleTalk
anomy	混乱
hidropoietic	流汗的
pore	细想
balneotherapy	浴疗法
haemodynamic	血液动力学
slaky	多烂泥的
tolerant	容忍的
screwy	螺旋形
decrescendo	乐节
piping	滚烫的
underage	未成年的
overprize	对……评价过高
ast	Average
terminal	每期
micra	micron的复数
fat	肥大
hurtlingly	飞奔地
baroceptor	=baroreceptor
extraterritorial	治外法
ovotestis	卵睾
haematoxylin	苏木素的
cleidoic	与环境隔离的
jacksnipe	小鹬
circumfusion	从周围灌注
silicule	=silicle
colourize	使有色彩
visional	梦幻般的
multicentric	发生于多中心的
con	记诵
fullmouthed	威势十足的
angell	天使
beelzebub	魔鬼
lexloci	地方法律
cashaw	长颈南瓜
confucian	儒家的
nepman	苏联新经济政策时期短期经营私人企业者
outboard	向舷外
dustheap	默默无闻
gazetteer	记者
atempo	还原速度
unwarmed	未被激动
tonsilar	扁桃腺的
contemptuous	侮辱
triturator	捣碎者
ammon	阿蒙神
consistorial	红衣主教会议的
telegenic	适于电视广播
subtractive	有负号的
festa	节日
irritating	刺激
winebibber	酒鬼
petrolatum	矿脂
intervene	介入
zoografting	动物体素移植术
parse	解析
unfix	脱下
cleistogamy	闭花受精
uniform	均衡的
phosphoglyceraldehyde	9fCsfEJ`^lIsE^lIsE`rAldEhaId/reIt/
spadicose	肉穗花序
marriage	密切结合
denazification	消灭纳粹化
lamby	羔羊似的
pajamas	睡衣
ternary	三重
to	比
vaalhaai	灰鲨(翅鲨
bask	愉快或舒适
thickly	厚地
brutal	残忍的
distomiasis	肝吸虫病
above	上文
retro	制动火箭
recast	重铸
sixtine	=Sistine
inspirator	激励者
photogun	光电子枪
embarrassingly	使人难堪
upset	推翻
lymphangiography	淋巴管造影术
waveguide	波导
nonage	早期
finite	限定
margrave	边疆伯爵
plectra	plectrum
innervate	使受神经支配
paediatrist	儿科学家
postscript	后记
exceeding	非常
kingpin	主脑人物
salification	成盐状态
muzzy	酩酊
rutile	金红石
interiorly	在室内
lifo	last
cockneyfy	使具有伦敦人的特性
ponticello	琴马
twain	两
winning	成功
tensegrity	无一定尺寸限制的结构
perfect	使熟练
rhapsodic	狂想曲的
experientialism	Ik9spIErI`enFElIzEm/
rational	合理的
actinochitin	放线菌壳多糖
gulch	冲沟
jarless	稳定
bessarabian	比萨拉比亚人的
thinking	思想
episcopalian	主教制度的
vaginitis	阴道炎
liberally	公平地
nyt	New
chemotropic	向药性
syncretize	结合
correct	正确
lawrencian	=Lawrentian
schistoid	片岩状
babiroussa	野猪
fanwise	如扇形地
lickerish	好色的
tongueless	沉默
nuque	颈背
inscape	构成要素
eristic	争论的
zolaesque	左拉作品
bacchantic	崇拜酒神
indecency	下流
involute	纷乱的
cold	不热情
skill	巧妙
optometer	视力计
araliaceous	五加科
tidytips	宽舌莱氏菊
almemar	犹太教会的讲堂
hilac	linear
plazolite	杂水榴石
carbachol	氯化氨甲酰胆碱
film	胶卷
scv	of
daywork	按日计酬的家务活计
chip	碎片
kinsey	Charles
slaver	淌口水
cursely	该受诅咒地
cana	迦南
threaten	预示
inimically	有敌意地
aubrey	奥布里
waste	废弃
clannish	氏族的
erda	Development
doubtful	疑心的
puddling	捣成泥浆
senior	地位较高的
nevada	内华达州
kronshtadt	喀琅施塔
coitus	交媾
draff	糟粕
ingredient	因素
unpaid	未付款的
septuplicate	一式七分的
autorotation	自转
leptospira	钩端螺旋体
emphatic	显著
mithraic	密特拉教
bioscience	生物科学
mounting	登上
pathognomonic	能确定诊断
knitwork	编织业
acculturize	使……接受外来文化
nooning	午休
dewdrop	露珠
fodder	素材
gaekwar	牧牛王(印度西部原巴罗达
promontory	岬
running	流动
tattered	破烂的
declension	词尾变化
algebraical	代数学的
extended	扩大范围的
studiously	故意地
abye	偿
druidical	督伊德教徒的
seventeenth	十七分之一的
excuse	饶恕
reedy	尖声的
satiation	饱享的
cms	color
vitriolic	讽刺
wild	野蛮
fluey	蓬松的
hunky	匈牙利人
gentlest	温和
altai	阿尔泰语
doltish	呆笨
dogra	多格拉族的
refution	反驳
dibber	挖洞具
betweenmaid	女佣
floodwood	漂流木
time	定期的
erythropia	=erythropsia
lcm	最小公倍数
pentachord	五弦琴
scorecard	记分卡
batter	打坏
decapitator	免去他人职务者
disclaimer	不承诺
stand	站起
sudorific	促使发汗的
examinatorial	考试的
leavisian	利维斯风格的
jesuitical	耶稣会士
pharmaceutic	调药
haemagglutinin	血凝素
fruitlet	小水果
hazel	淡褐色的
unwarrantable	不允许
beauideal	十全十美
panhandle	讨钱
curriery	鞣皮业
snipe	猎鸟
tremulant	=tremulous
playclothes	轻便装
scribe	抄写员
alveolate	蜂窝状
criminatory	使负罪
frugivorous	常食果实的
infuse	注入
asthmatic	哮喘的
wash	洼
adgb	of
naval	海军的
pulverulent	粉状的
rebate	折扣
intonate	吟唱
seat	所在地
bolter	常脱缰的马
aspect	面貌
terebic	芸香酸
unfurl	展示
apocarp	离心皮的果实
tartrated	含酒石的
kneebrush	膝上毛簇
synthetically	合成
horopter	两眼视界
clavicular	锁骨的
rhetorically	在修辞学上
beijing	北京
flown	fly的过去分词
maltworm	豪饮者
emancipatory	有助于解放的
starchy	淀粉的
seditionary	骚乱煽动
contention	争论
garrigue	=garigue
whiteout	乳白天空
plumbaginous	石墨的
equerry	侍从武官
filature	缫丝
dissociate	分裂
ulf	Low
ansate	有柄状部分
slp	Labor
fidge	抽筋
topically	谈论地
strepitous	喧闹的
antiballistic	反弹道的
humoristic	幽默的
unmerge	分解
outmeasure	在分量方面超过
chardin	Teilhard
peke	狮子狗
offendedly	生气
testimonial	推荐书
obtrusively	莽撞
jewelry	珠宝类
bfa	Bachelor
jock	运动员
unexpected	未预料到
ratbaggery	古怪举止
phrynin	蟾毒
waywardly	任性
x	罗马数字10
sensualist	感觉主义者
azalea	杜鹃花
dermatophyte	皮肤真菌
endangered	将要绝种
collide	抵触
discriminability	辨别力
unimpugned	未被指责的
hierodule	圣役
epithalamium	喜歌
polygonum	蓼属植物
conflagate	燃烧
landsat	卫星
exilic	放逐
subsynchronous	亚同步
our	pro
nanocurie	十亿分之一居里
buzz	嗡嗡作响
tribunary	保民官的
doctrine	学说
prop	倚靠人
nominate	命名
moonquake	月震
compensator	补偿者
faint	微弱的
drossy	碎屑
preem	首映
assembled	组合
dud	无用的
haussa	=Hausa
borak	嬉弄
detonation	爆炸声
curse	诅咒
intuitionism	直观论
magma	乳浆剂
newsroom	编辑部
magnetite	磁铁矿
signal	用信号通知
lordly	贵族的
agreeably	愉快
footstock	=tailstock
mondial	全世界范围的
quilled	有硬毛的
ndea	国防教育法
retinoscopy	视网膜检影法
quadrisyllabic	有四个音节
tipple	致醉的饮料
apogamous	无配子生殖的
respectant	向后看的
necrophagous	吃腐尸
toneme	调位
occlude	使锢囚
rideress	女骑者
piagetian	皮亚杰关于儿童思维发育理论的
cashmere	开士米
hysteric	歇斯底里症之发作
millepore	多孔螅
sjd	Doctor法学博士
taletelling	讲故事
sphenoid	楔状的
consign	托运
prismy	棱柱
gymnosophist	修行者
metier	工作
synoptic	对观福音书
aminophenol	氨基酸
ceaselessly	不断地
deathplace	死亡
deflocculation	抗絮凝
behoof	好处
eutrophied	超营养作用
process	进行
titular	有名无实
mid	中间
violable	易受侵犯的
settings	设置
inextricable	逃脱不掉
diaplasis	回复
orem	奥勒姆
vigorously	精神旺盛地
reduction	变形
diorthosis	矫正术
conversance	精通
grain	谷物
overroast	把……烤得过度
anoxic	缺氧
shelf	架子
contracted	收缩了
crassilingual	有厚舌的
curvilinear	曲线
gloriously	光荣地
mature	充分考虑
mcluhanesque	麦克卢恩学说的
melitriose	棉子糖
swoop	猛扑vt攫取
microlithic	细石器的
herborize	采集植物
bice	绿色
hypergolic	自行着火的
lay	打赌
sewage	装下水道于
syncretic	融合
degradedly	[
contain	容纳
kvar	kilovar
interstation	台际
caressing	爱抚
dimness	微暗
argufy	说服
impressure	印象
living	起作用的
lockout	停工
ichthyolitic	鱼化石的
genealogical	系谱的
proposal	建议
cantonization	划区
fanback	有扇形靠背
bacterioscopy	细菌镜检查法
now	目前
figurable	能成形的
ineloquent	不传达表情
unilocular	单室
deprecation	祈免
alaskan	阿拉斯加的
columbian	美国的
bluejeans	粗蓝布裤
polypoid	水螅似的
fuzz	作绒毛状飞散
bullpout	=horned
tendril	卷须
fulminatory	怒号
proof	不能透入
unbearable	无法忍受
psikhushka	=psychoprison
cytotropic	向细胞
scapular	无袖外衣
irrepleviable	不准保释
thematic	主题的
quinsy	扁桃腺炎
unreflecting	无思虑的
calculatedly	故意
answer	答辩
fontal	原始
arala	印度产的鹳类
xanthochroism	黄色现象
ned	Edward
chapeaubras	绸三角帽
woolly	羊毛
ashman	清道夫
antifreezing	防冻
dun	微暗
liable	有责任的
petting	抚摸
state	国有
tomium	啮喙
transferrer	转录的人
square	弄平
cloddish	土里土气的
readership	读者人数
calvarial	颅顶的
ultimate	最终
sweepingly	扫荡地
tervalent	三价的
gag	作呕
unwelcome	不受欢迎
upbeat	欢乐
recherche	讲究的
astrophotometry	天体光度测量
appropriable	可侵吞
triggerfish	热带鱼的一种
tatpurusha	两个名词合成的复合词
gayer	华美
chemotropically	向药性地
allopatrically	单独地发生地
fast	忠实的
ravishment	强夺
dissolutely	荒淫
humbleness	卑贱
spermatophorous	精子包囊的
pictorially	绘画般
glycosphingolipid	鞘糖脂
wearproof	防磨损
gushy	流出的
attention	立正!
lankiness	过分细长的
nidi	nidus的复数
bhadon	印度历的6月
existentialist	存在主义者
nematocide	杀线虫剂
subjacent	在下方的
porphyrization	粉碎
expedite	派出
gummiferous	有树胶
tricksy	狡猾的
subaltern	下
boomlet	略为繁荣
elephant	一种纸张的尺寸
predistortion	预矫正
clear	空旷的
roi	of
pleading	答辩
declivitous	向下倾斜的
unshakable	坚定不移
oceanological	有关海洋学
rebut	反驳
catechist	问答式教授者
worship	尊敬
early	早期
orthonormal	标准正交的
teen	伤心
wuzzle	混合
finish	终止
novelese	拙劣小说的写作文体
psn	number
testiness	暴躁
brawly	喧嚷的
gynecopathy	妇科病
dens	齿状部分
lionhood	名人地位
sociobiology	生物社会学
fellmonger	毛皮商
plantigrade	跎行的
med	Sea
virginity	处女
irreproducible	不能繁殖的
chairoplane	旋转飞椅
traveled	旅客多
polynomial	2
hedonistic	快乐论
chlortetracycline	氯四环素
identic	措词相同
congruity	一致
sas	Special
character	字符
choosy	好挑剔的
mechanics	技巧
dagger	匕首
obligatory	必须的
synesis	非成文造句法
aeciostage	锈孢子期
veteran	老兵的
eudaemonic	幸福的
beanball	击中打击手之头的球
wickedly	不愉快地
bilection	=bolection
unsheltered	未遮盖的
shakeress	震颤派女教徒
brachycranial	圆颅型的
unleavened	未受激发的
agriculturist	农业家
penman	书法家
anthropopathism	神与人同感论
sticking	有粘性
summons	召集
theca	鞘
proofmark	验讫印记
ambivalent	矛盾的
destructively	破坏地
ait	河中的小岛
magniloquence	虚夸
thermophil	喜温生物
systematism	体系化
supergalactic	超星系的
squad	班
enveil	覆盖面罩
cowherb	麦蓝菜
residency	高级训练
strained	矫饰的
microphyte	细菌
cases	案例
preceptive	好教训人
floridity	脸色好
docking	入坞的
jalalabad	贾拉拉巴德
wholesaler	批发商
seriatim	逐一地
albumin	白蛋白
unsaleable	无销路
tdma	时分多路寻址技术
attache	大使随员
bisulfate	硫酸氢盐
smidgen	少量
militiaman	全体民兵
indention	锯齿状
ominous	不吉利
contradictory	抗辩的
unscrupulous	不谨慎
directorship	管理者的职位
lepidopteron	鳞翅类之昆虫
somatotrophic	hormone
frisk	快乐的时刻
erudite	博学
compression	浓缩
trapezia	梯形
vestibule	为……设门廊
feces	屎
stereotype	使用铅版
handwriting	笔迹
cephalometric	头部测量法
warrant	许可证
cambodia	柬埔寨
wandering	流浪的
thin	使变细
desiderative	愿望的
urgently	急切
needfire	篝火
whoopla	喧哗
slavophil	崇拜斯拉夫等者
neurotropism	趋向神经性
founder	中国最著名的电子照排系统的生产商
pbx	branch
reaper	收割机
inexpediency	不适当
tenpounder	海鲢
wonna	not
spatchcock	插入
objectivize	=objectify
divulgate	=divulge
dts	数字电影院系统
inflexible	不屈的
stamping	冲压
unpitied	没人同情
concutient	受到震荡性撞击的
obdurately	执拗
badmash	歹徒
spray	喷雾
caressing	亲切的
marshall	~
spice	情趣
undershot	下颚突出的
curling	头发的卷曲
publican	酒馆老板
quadricentennial	400周年纪念的
manger	挡水板
personal	人身的
rapturously	兴高采烈
cocker	放纵
amortisation	摊还
semiurban	半都市的
delicate	精巧的
corroboratory	证实
copious	丰富的
shroud	覆盖物
piggyback	在肩上
harmonistic	悦耳的
capsid	衣壳
expressible	可榨出
responder	响应器
fibrination	纤维素生长过多
current	气流
procuration	获
fulgid	闪耀的
human	人类
unobservance	不留心
moist	潮湿
mock	假
aja	日裔美国人
semiology	症状学
unduplicated	无法模拟
irreproachable	无过失
foal	生仔
inseverable	不可切断
bathed	沐浴
hooch	私运入的劣酒
germanious	含二价锗
phylesis	系统发育
chamber	房间
unpretending	质朴的
bulbaceous	=bulbous
galwegian	加罗韦人
epulotic	结瘢
spotty	多污点的
oeec	Economic
runway	斜坡跑道
epigonus	=epigone
nice	美好
cashboy	传递现款的小孩
revers	翻边
antidiuretic	抑制尿分泌的
nonage	未成年
anthography	花谱
slipstick	计算尺
compartment	车厢
whisper	密谈
mdclxvi	罗马数字
attack	进攻
unequable	不温和
razor	剃刀
fh	hydrant
sloop	单桅帆船
telengiscope	显微望远镜
halide	卤化物
polarizer	起偏镜
anoxic	缺氧的
elastic	弹性的
autoplastic	自体成形术
embryotic	萌芽期的
diminutive	爱称
vendace	白鲑鱼
fetch	吸引
biblical	圣经
homeward	向家
veadar	Sheni
confirm	批准
grimly	冷酷
roblitz	无人飞机的轰炸
apostate	变节者
deerstalker	猎鹿人
pear	梨树
uranous	含铀
wateriness	潮湿
petit	次要
bitterness	辛酸
organisation	=organization
tartrated	得自酒石的
quinoidine	奎诺酊
menservants	的复数
jaded	厌倦的
tabby	起波纹的
opponency	反对
discountenance	阻止
underlie	位于……之下
uncivilly	无礼
plane	平面的
ecdysis	蜕化
antilles	安的列斯群岛
mealanguage	元语言
soerabaja	=Surabaja
unhired	未雇用
wrong	道德不好
emulable	可赶上的
atoneable	=atonable
finback	长须鲸
paludrine	百乐君
superserviceable	过分殷勤
untorn	未撕开的
true	真实的
crown	使圆满完成
teleradium	远距镭照射
dropsonde	下投式探空仪
vilely	卑劣
livelihood	生计
bushelage	以蒲式耳计算的量
odorize	洒香水于
aforetime	早先
maternal	似母亲的
rocketry	火箭学
stupefactive	麻醉性的
chewy	耐嚼的
illimitable	无限
woad	用靛蓝染
angustifoliate	窄叶
monochromatic	单色的
noninflammable	=nonflammable
outward	外面
cancelation	=cancellation
closemouthed	嘴紧的
alkyl	烷基的
sedgeland	莎草地
wintertide	冬季
airwave	电视
snipe	被开玩笑的人物
hesperia	西方之国
phonographic	速记
northwesterly	位于西北方的
abjectly	卑鄙
isolating	绝缘的
ndea	Act
iamap	International
miaow	猫的叫声
fee	酬金
peasantry	农民
agroboy	=skinhead
urethroscopy	尿道镜检查
sobering	使清醒
hydromedusa	水螅水母
fruitery	贮存水果的地方
earthborn	尘世
absent	不在的
deliriant	呓语
decidual	蜕膜的
engagement	约会
