vacuome	液泡系
mandora	大型曼陀琳
mooneyed	眼睁大的
aegisthus	埃癸斯托斯
divorce	使离婚
statesmanship	政治才能
sack	布袋装
contributory	捐助
claustrophilia	幽居癖
deliberate	故意
fizzle	发嘶嘶声
calibre	口径
vxd	Virtual
explicative	解释
nitric	硝石的
gauchist	左派分子
arabization	阿拉伯化
redirection	改道
hotelman	旅馆老板
filature	螺丝厂
thunderboat	大型水上飞机
bonnily	美丽
zolaist	自然主义作家
jar	罐
autoionization	自电离
endophyte	内生植物
priesthood	教士
reincarnationist	灵魂转世说信徒
continuator	继承者
orbicular	环状
medley	混合
containerization	货柜装货
gnomic	格言的
rename	重新命名
necessary	必要的
roentgenite	伦琴石
haematogenous	造血
dauber	涂鸦者
covellite	靛铜矿
zounds	表示愤怒惊讶的咒骂声
carboxylate	羧酸盐
disprove	反驳
condonable	宽恕的
rani	王侯夫人
linked	连接
afrit	=afreet
octahedral	有八面的
upbeat	乐观
choking	透不过气来的
hauteur	自大
villose	象绒毛一样
quetta	基达
wftu	Unions
equivalent	等价物
pyrolysate	热解物
roughout	人造品原型
slavish	奴性的
homeopathist	顺势医疗论者
suck	吸取
spcc	the
gag	塞口物
cdsl	DSL
unadvantageous	无益
moist	潮湿的
gametocide	坏配子素
paladin	杰出倡导者
ipm	per
cowrie	货贝
stereopticon	立体感投影仪
explicable	可说明
polyhedron	多面体
scratch	刮
intercession	代祷
apronful	满满一围裙
scratch	发刮擦声
conquerable	可击败的
victual	食物
oscillation	摆动
zing	活力
harleian	哈利父子搜集的文稿及图书的
abusive	滥用
limousine	豪华轿车
lapidate	投石击毙
chasse	作快滑步
uc	大写
delegate	委派……为代表
noncaloric	无热量
consistorial	宗教法院的
thermostable	热稳定的
promissory	有约束力
oft	常常
unorganized	未加入工会
lactate	分泌乳汁
usual	平常
balneal	浴室
therefrom	从那里
scintillant	产生火花
overtly	公开
grimly	严格地
lenticulated	双凸透镜状的
foughten	曾为战场的
inaccessible	难以接近
whole	全体
irreversible	不能取消的
pignus	典质物
spick	=spic
arm	臂
foudroyant	引起敬畏的
regionalist	地方主义者
affected	假装的
datable	按日计工资
aeronautic	航空
planetesimal	小行星体
shintoism	日本之神道教
exconvict	有前科者
shantung	山东绸
crunkle	弄皱
concutient	受到震荡的
willis	威利斯
retriever	能把猎物找回来的猎狗的一种
suspenseful	悬疑的
ratt	radioteletype无线电电传打字电报机
herodian	希律王室的
thickety	=thicketed
montagnard	山地土著民族
uncomfortably	不舒适
demonolater	崇拜魔鬼者
salmagundi	一种意大利式凉拌菜
squatty	矮胖
ugt	urgent
maidenly	处女般
poisoning	中毒
unchristian	粗野的
ampullaceous	瓶状
incombustible	不燃性物质
winnipeg	温尼伯湖
muscularity	发达的肌肉
opiumism	鸦片瘾
autism	自我中心主义
denuclearise	撤除核武器
consecrated	神圣的
sidekick	插袋
tunisian	突尼斯人的
bargain	成交商品
proprietary	私人拥有的
retract	取消
mass	大规模
higgler	小贩
absorbedly	专心致志地
guttate	滴状
columniation	柱列
position	职位
atmospheric	大气的
lapm	Line
tablecloth	桌布
composedly	沉着
imminent	即将来临的
diethyltoluamide	二乙茎甲苯酰胺
talky	说话过多
searchless	不可测知
unpunishable	不该受处罚
preface	前言
teleview	收看电视
tiptop	出色
oviferous	产卵
gimpy	瘸
ultrarightist	极右分子
moor	沼
fluid	流畅的
fullmouthed	声音响亮
waxiness	可塑
ogreish	恐怖的
cassock	教士
weather	天气
ursiform	熊状
infinitely	无限
jokingly	开玩笑
yond	彼处
crocky	破旧
description	描写
harmoniously	和谐
gastrotrichan	=gastrotrich
lightship	灯塔船
simplism	简化主义
jamaica	牙买加甜酒
gadfly	牛蝇
misguided	被误导的
nonconform	不遵照准则
talking	表情丰富
screenland	电影界
salmonid	=salmonoid
mesh	陷阱
neuter	无性的
coalbreaker	碎煤夫
odorless	无嗅的
washer	垫圈
trainsick	晕火车的
meridian	子午线
ya	young
query	质问
aphrodisiac	引起性欲的
polycondensation	缩聚
rumble	隆隆声
intercollege	=intercollegiate
superconduct	显示超导
fiery	炯炯有神的
chirpily	活泼地
doited	老糊涂的
flickering	闪烁
holophrase	整句字
gustav	即
bms	Matrix
circularly	圆
gastronomic	烹任学
tremendously	非常
allusion	暗示
unbuttered	没有黄油的
conciliate	赢
hydrokinetics	液体动力学
stotinka	保加利亚的货币名
adolescent	青少年
goosey	愚蠢的
ndis	网络驱动器接口标准
wizzled	皱缩的
overflow	超值
nanocurie	毫微居里
toynbeean	汤因比风格的
camping	野营
lord	使成贵族
gag	使呕吐
iranair	National
pseudotuberculosis	假结核病
flange	给……装凸缘
enthrallment	沉迷
usac	Club
c	kEJ/care
pitsaw	大锯
flakey	疯疯癫癫的
siesta	午休
cruel	使痛苦的
wineglass	玻璃酒杯
courtling	小朝臣
compotator	会饮者
inlook	内心省察
excuse	免去
commination	威吓
flycatcher	捕蝇器
burghley	伯利
northabout	向北
farinose	粉末状
upborne	被支撑着的
urethroscope	尿道镜
xylocaine	赛罗卡因
hemimetabolic	半变态
deaerate	使除去空气
bruiser	职业拳击家
staphylococcus	葡萄状球菌
fashionmonger	创流行的人
insufflator	指纹印显示器
either	pro
afc	自动频率控制
tosspot	醉汉
excitron	汞气整流管
honied	多蜜
remythologize	以新神话解释
windblown	被风吹
majoritarian	多数主义者
jackpot	累积赌注
overturn	翻转
consentient	同意
friability	脆弱
chingkang	Mountains
enargite	硫砷钢矿
faulty	有过失的
emmarble	刻成大理石像
rente	年金
accrual	获利
copula	系动词连系
seedsman	卖种子的店铺
connecter	连结物
dart	镖
fantod	惊恐
insatiable	不知足的
daintily	讲究
postmitotic	有丝分裂期后的
wanta	to
gigmanity	市侩阶层
autism	孤独症
jadish	毫无价值
fervently	热心
slam	砰地关上
wastebin	废物桶
undercharge	未给……装足够的火药
pure	纯洁
neoprene	氯丁橡胶
linen	亚麻制品
ungual	有爪的
phylloid	叶状的
ungalled	未擦痛
urolith	calculus
diaspora	离散的犹太人
gayety	愉快
breathlessly	气喘
lavation	洗涤
quintic	五次量
involvement	连累
stiffly	僵硬
dissonate	刺耳
caac	中国民航
bough	主枝
pe	体能训练
troposcatter	=tropospheric
maxilla	上颔骨
rough	粗暴的
soporose	催眠的
whiff	一点点
vrml	Virtual
genitals	生殖器
jurisprudence	法学
maneating	凶悍
swang	swing的过去式
masterless	无主人控制的
refold	再摺起
flange	边缘
slashing	乱砍的
dislikeful	讨厌
gneissic	像片麻岩的
stepney	备用轮胎
junkyard	分类、出售处
relate	使联系
acadian	阿卡迪亚人
clientage	委托关系
muckworm	粪蛆
bitterly	悲痛的
kaddish	祈祷
idiochromatic	自色的
aeromancy	气候占卜学
cormel	新生小球茎
manufactory	制造厂
colligable	可连结成类连结
rylean	赖尔理论
yokemate	伙伴
transom	横梁
formulize	公式化
aposematic	警戒色
antecedence	先行
cyclone	气旋
gentleness	柔和
metopon	麦托朋
choriambi'	NULL)
boracic	含硼
baiza	派沙
antiimperialism	反对帝国主义
dominion	支配
jagged	锯齿状
unsoldierly	非军人的
unflawed	无缺点
unbelief	疑惑
hopscotch	"跳房子"游戏
sided	有面的
vibrissa	鼻毛
basicity	碱性度
hyperirritable	应激性过度的
fadge	成功
strange	奇怪的
rafferty	无组织
new	初见的
icaaaa	Amateur
epithalamium	颂歌
qnp	knight''s
acetaldehydase	乙醛酶
amaranthine	紫红的
benthamic	功利主义
tetrachloroethane	:rEJ`eWIli:
maximus	敲奏编钟的一种技巧
disorder	使紊乱
through	从开始到结束
supernormal	异于寻常的
madcap	轻率的
trifle	开玩笑
ceramal	合金陶瓷
fantastically	捕风捉影地
bms	Screen
visibility	显著
possessed	着魔
apa	Agency
bale	包装
ametabolic	不变形
plane	平
sedately	镇静地
intercalary	被夹于中间的
wilding	野生的
quandong	檀香科树木
gutter	水槽
repulsion	推斥
misconduct	处理不当
emend	修订
spacefarer	航天员
touch	感动
veritably	真正
steep	峭壁
sabotage	破坏
respect	注意
ispy	一种捉迷藏游戏
lubricious	淫荡的
mutability	性情不定
scenography	配景图法
cooperativity	协同
knitwear	编结的衣物
gemini	双子宫
escarpment	断崖
turbulence	骚乱
confect	调制
roue	放荡者
nurser	培育者
nestlike	巢状的
pamphrey	洋白菜
commensal	共食伙伴
craterlet	小坑洞
froth	使生泡沫
cres	防锈钢
codeine	可待因
assafetida	=asafoetida
dumpling	团子
slough	使陷入泥沼
etymologic	语源
recallable	可回忆
penial	阴茎
exhalable	可吐出的
lysergide	acid
recalcitrance	顽抗
ppt	thousand
cordial	兴奋的
pattern	以图案装饰
pastorium	牧师宅邸
incapacious	狭小的
moppy	拖把似
soap	Object
cerebrotonic	孤僻气质的
exemplify	作为……例子
quinquereme	五段帆船
prominently	显著地
cabana	小屋
theanthropic	把神性表现于人身
dm	Medicine
preimplantation	胚胎植入前的
bait	把饵装上
scar	使留下伤痕
righten	使恢复正常
bigamist	重婚者
unexpiated	未抵偿的
isp	Internet
superradiant	超辐射的
outrode	outride的过去式
gyroidal	螺旋形
cathartic	导泻的
turgor	细胞的膨胀
unspotted	清白
spruce	云杉
antiradical	反激进主义的
pyrolyze	使热解
associate	同事
edgily	尖利
sarcastic	讽刺
biased	有偏
garbageology	垃圾社会学
traitorously	不忠
queendom	女王国
stipple	画点画
cordial	诚恳
photoelectric	光电的
tousle	糟乱
tessera	镶嵌物
portress	女门房
geminal	偕的
quemoy	金门
specific	细节
algerian	阿尔及利亚
mccarthyite	麦卡锡的追随者
niffy	散发恶臭的
sched	时间
staminiferous	具雄蕊的
fugue	记忆丧失症
stadia	stadium的复数
noisy	吵杂的
divine	非常可爱的
curvilinear	由曲线而成的
unplucked	未扯掉的
scv	Confederate
fuller	漂洗工
trustfully	信任
microvessel	微脉管
calcareousness	石灰
scrumptious	极好
bucko	欺凌弱小者
handworked	手工的
endwise	向前的
fast	彻底
computative	推算的
polygonal	多边形
voodooist	魔术师
reason	理由
farmerly	像农人般
starchy	拘泥的
liberation	释放
objectivity	客观性
burnish	磨光
pohai	Sea
anil	木蓝属植物
oligochrome	只用少数颜色的
typhomania	热病谵妄
fairly	清楚地
mannerly	有礼貌
unaware	不知道的
indic	印度
umpire	作裁判
anemic	患贫血症
duodenary	十二的
eudaemonic	幸福学的
irreplaceable	不能代替
unselfish	慷慨的
tankie	=tanky
animality	动物性
cover	包含
biparietal	二顶的
horological	钟表的
messroom	食堂
slade	Workers平版及套色印刷工人工会
volcaniclastic	火山碎屑
radwaste	放射性废物
disconcertedly	不安地
curse	咒骂
quartziferous	石英质
kinsey	Alfred
oddity	奇异
procacious	勇敢的
clannishly	团结
purgation	洗罪
rowlock	桨架
lomentaceous	具节荚
gammy	跛行的
grana	granum的复数
wrcb	War
conchology	贝壳学
unci	的复数形式
pogonia	朱兰花
rightly	正当地
exalted	兴奋的
munition	供给军需品
ossiferous	含骨化石
hopper	单足跳者
queenly	女王
arrhythmically	没有节奏
southdown	无角短毛羊
inexcusably	无法原谅地
economic	产供销
muttonhead	傻瓜
hrip	在此安息
attention	注意力
inobtrusive	不冒失
valetudinary	=valetudinarian
syren	妖女
draughty	有隙缝风吹入的
theologian	空头理论家
rumble	低沉地说
plonko	饮酒过度的人
dhofar	佐法尔
heliochromy	天然色照相术
wintertide	冬
savvy	头脑
abstention	节制
undress	使脱衣服
gyrose	波状
defer	听从
unicef	联合国儿童基金会
mrbm	中程弹道导弹
balzacian	巴尔扎克学者
executorship	遗嘱执行人的职责
breakwater	挡浪板
stumble	绊倒
aeronaval	海空联合
lode	矿脉
pattern	样品
uba	缅甸联邦航空公司
fiducial	根据信仰的
medially	中间地
hippomanic	有爱马癖
charming	娇媚
reversal	颠倒
invaluable	价值无法衡量
villeinage	隶农身份
epiphanic	使人顿悟
bent	爱好
somatotonic	体力旺盛性格的
flee	逃跑
wild	狂热
faultfinding	喜欢挑剔的
mowburnt	因堆积发热而霉烂的
hempie	似麻
warring	交战
politic	策略性的
hornless	无角
chlorinate	用氯消毒
bogus	假的
agriculturist	农场经营者
reform	重新组成
ineffectually	无效
hindrance	障碍
staff	五线谱
pleasurable	愉快的
shortfall	不足
chansonette	小调
mean	吝啬
comer	新来者
vestryman	教区委员
lard	猪油
palliard	无赖流浪汉
danewort	矮接骨木
posy	花束
pyrolatry	拜火教
pop	突然行动
plane	刨
chill	寒冷的
tenancy	租佃
mould	用土覆盖
luster	使有光泽
polymeric	聚合体
strictly	确实
flop	笨重地摔
streptokinase	链激酶
hazing	被欺侮
abuilding	在建造中
probate	检验遗嘱
putschist	暴动者
finale	终了
peccary	野猪类
buret	滴定管
infinitesimal	极小的
cobblestone	圆石
marshy	沼泽般的
induration	硬化
neutral	中立的
calendry	轧光车间
nonfreezing	不会结冻
victorious	获胜
phosphorescent	磷光性
sigmatropic	σ移位
odontalgic	患牙痛
ethnics	人种学
tension	张力
simious	猴
decade	十年
leiden	莱顿
bulkily	庞大
bouquetin	羱羊
delay	耽搁
aver	断言
meltability	可熔性
optically	眼睛
depressing	沉闷的
stealthy	掩人耳目
heterocyclic	杂环的
cellule	小细胞
geminiflorous	二花合生的
desire	希望
reinstall	重新设置
hoagie	=hero
sandy	含沙的
embedded	植入
farming	畜牧
halophilous	喜欢盐的
deuteranomalous	绿色弱
rehabilitative	复职的
ectoparasite	外寄生虫
incompetent	无能力者
senhora	夫人
quacksalver	庸医
aerolite	陨石
feldspathic	象长石
ecliptic	蚀
lappet	垂片
swat	Armored
zee	Z字母
alit	aligh
monotrichic	单鞭毛的
becloud	蒙蔽
dekameter	=decameter
quatorzain	十四行诗
oat	燕麦
chirk	有精神
northing	北距
multicoloured	五彩缤纷的
reschedule	重新计划
paragenesia	共生
hydrologist	水文学者
bareboat	空船
oviparity	卵生
exclusivist	排外主义者
sealift	海上补给
linsang	麝香猫
policier	侦察影片
ideogram	表意文字
blueness	蓝色
continuous	连续
primrose	樱草的
zolaesque	左拉的
discreditable	丢脸
hexabasic	六盐基
jazzily	愉快
semioval	半椭圆形的
metallurgic	冶金学
disassembly	拆卸
meaningful	意味深长
scarce	稀有
raptorial	捕食生物
lipophilic	亲脂性
rld	dealer零售酒商
purulence	化脓
barbule	鸟的小羽枝
mordacious	刻薄的
misinput	输入遗漏
gunslinging	带枪
seditionary	骚乱煽动的
agonistic	动机争胜性的
advocacy	辩护术
pyrola	鹿蹄草
musingly	冥想地
adagietto	更缓慢的
congruous	一致的
explicatory	解说的
interscholastic	学校间的
sempstress	女裁缝
suberect	几乎直立的
ptolemaic	托勒密
foresaddle	前脊肉
photolithoprint	=photolithograph
grafter	贪污者
subtropical	亚热带的
akin	同族的
lovesick	害相思病的
ranchero	大农场经营者
escap	Economic
bluntness	率直
grandmotherly	祖母的
dependance	=dependence
home	产地
kmt	Kuo
difference	差别
xanthin	茜草黄质
navigate	航行
kandy	康提
eerie	不安的
hades	地狱
fairway	水上飞机升降用的水面跑道
colligation	结束
distant	远
wagonlit	欧洲大陆的铁路卧车
imagine	想象
thermophil	适温的
fortifiable	宜于设防的
striptease	脱衣舞
courtyard	庭院
ryot	印度农夫
farfamed	驰名的
unreaped	未收割的
kevlar	凯夫拉尔
suzerain	封建主
labyrinthine	迷宫
sjd	Juridicae
mechanistic	机械论的
christian	信基督教
afterlight	晚霞
rehearsal	排演
traducianist	灵魂遗传论者
hamburger	牛肉饼
landworker	农业工人
laggardly	缓慢
corrody	=corody
semipalmated	具半蹼的
question	疑问
hydration	水合作用
acceptable	合意
foolish	笨的
faery	仙子
flustration	激动
plangorous	悲哀
coastward	朝着海岸
overpraise	过度称赞
mould	霉
dishevel	使衣服弄皱
pivot	在枢轴上转动
hydratable	能水合
coincidental	符合的
rallymaster	公路汽车赛主持人
mayotte	马约特岛
scalariform	阶纹的
cytotropic	亲细胞的
killing	致死的
elysium	极乐世界
hyacinthine	紫青色
childproof	不会被孩童弄坏
townlet	小镇
diffusedness	普及
npa	Newspaper
rescue	援救
melon	瓜
meridian	顶点的
barbital	巴比妥
abettor	教唆犯
airiness	通风
pdsa	Animals
trimeter	三音步
pupa	蛹
kodak	美国柯达公司
ioof	Odd
antipathetic	讨厌的
anaphrodisiac	制欲
rancour	敌意
putty	油灰
nephanalysis	云层分析
thunder	雷鸣
drownproofing	防溺法
barococo	过分纤巧
ominous	不吉利的
impish	似顽童
strut	支撑
underline	在……下面划线
unstrained	不勉强
deambulatory	走动
mitten	拳击手套
hohum	令人生厌的
chilblain	冻疮
firmly	坚定地
affinal	姻亲
uncontainable	难以克制
vapor	无实质之物
sneezy	打喷嚏
si	硅
broadside	侧面
affidavit	宣誓书
encomiastic	阿谀的
earwitness	以耳闻情况作证的人
inoxidizable	不能氧化
par	票面价值
mean	中间
finnicking	吹毛求疵的
baffleboard	任何灭音装置
phono	留声机
legatee	遗产受赠人
recreant	怯懦的
flakey	古怪
diamagnetic	反磁性
uncoffin	把……从棺材中移出
uml	Unified
kicker	抱怨者
lipless	无嘴的
trisomic	一套半染色体
amniography	羊水造影术
chinar	悬铃木
helvetian	赫尔维蒂
carmelite	派的托钵僧
caveator	申请中止诉讼手续者
inquiring	打听的
curragh	小型手推货车的一种
lactoscope	乳酪计
aggressive	敢作敢为的
innocuously	无害
betcher	=bet
one	某一
guesstimate	依推测的估计
stupefy	麻木
bim	of
winglike	翼状
green	无经验
ldc	不发达国家
thornbush	多刺疏林
impeller	叶轮
ascus	子囊
prolixly	冗长地
aciculate	粗面的
gaffer	乡下老头
granulocytopoiesis	粒细胞生成
bumptious	盲目自大
dyschronous	时间不一致的
mounted	裱好
touch	触摸
hydric	氢气
confidently	信赖
dimensional	空间的
medullated	有髓的
letterspacing	字间隔空
grette	烟卷
yokohama	横滨
debris	碎片
colorful	有趣的
strict	精确
unforced	不勉强的
latex	乳胶
indian	印度
hermitage	偏僻的寺院
competency	作证能力
pelt	疾行
filibuster	暴兵
endogenic	内生
macle	斑点
sufficient	充分的
bush	衬套
tearing	撕开
sad	忧愁的
moreton	fig大叶榕
fiddler	小提琴家
quarterfinalist	四分之一决赛选手
semiclosure	部分关闭
conjugal	结婚的
sunbath	太阳灯浴
galla	盖拉族人
baaskaap	白人优越
arjuna	阿朱那(印度古代梵文史诗
infallibilism	教皇绝无谬误主义
uranography	天体学
backless	无背
spinachy	具菠菜特点的
standard	标准的
paediatric	儿科
pseudocode'	NULL)
sound	有效彻底的
rvsvp	vous
epicondylian	上髁的
anthelmintic	驱虫的
heterokaryotic	异核体的
ripsnorting	大不了
score	得分
spongious	海绵般多孔
unambiguous	明确的
vulgarize	使通俗化
painful	使痛苦的
pallet	棘爪
cannon	大炮
scurril	恶语毁谤
sri	Romanum
omnivorously	随手地
gst	Greenwich
carbonari	烧炭党人
guile	诡计
reindoctrination	向……再灌输
kookaburra	笑翠鸟
bonsai	盆景
tetradynamous	四强雄蕊的
iconograph	插图
lingy	遍生石南
status	情形
kindjal	高加索双刃刀
understandable	可以理解
physicist	物理学者
rebuttable	可反驳
fayum	=Faiyum
prorogate	=prorogue
anamorphosis	畸形
vein	心绪
sibilant	咝咝作声的
dreamland	梦乡
lithesome	轻快的
planter	殖民者
ticket	入场券
lindesnes	林德斯内斯角
whisk	搅拌器
folklorish	带民间传说的
keratoid	角质
smart	剧烈
indefinably	无法下定义
accumulation	堆积物
affrontedness	被侮辱
indivisibility	不可分割
offset	抵销
liquor	酒精饮料
retranslate	重译
wolflike	狼一般
amain	全力
apropos	恰好的
inaugural	就职
ps	/
kinaesthetic	运动感觉
impassably	无法通行地
pack	一副
propagandistic	宣传
macrocephali	macrocephalus的复数
nicety	美好
clothes	衣服
abalienate	让渡
urbanization	文雅化
browningesque	勃朗宁风格的
extemporise	=extemporize
slipsheet	插页
coloration	染色
espieglerie	戏谑
effrontery	厚颜无耻
billionth	第十亿
peaceably	温和
phillip	即Philip
nous	常识
basis	主要成分基本原则或原理
modernity	现代性
pedestrian	徒步的
epicanthic	内眦皮
skookum	强壮的
defilement	污辱
bottine	女靴
certificate	以证书形式授权给……
galpon	给农业工人使用的房子
cannibal	食人者
hyperphagic	食欲过盛的
collaborative	协力完成的
igmp	Management
misestimate	错估
polyonymous	多名
fancy	奇特的
sabian	塞比教徒
stabbing	刺穿
roxburgh	罗克斯巴勒郡
monestrous	=monoestrous
reinsman	骑师
aborative	仔细的
scrapground	=scrapyard
sprinter	赛跑选手
untaa	Administration
thriftily	繁荣的
prefatorial	=prefatory
bands	牧师或博士服之领饰
wonder	非凡的
scent	闻出
ultrastable	超稳定的
japanophobia	憎恶日本
nymph	美丽的少女
nonrecurrent	不反复出现
skillful	灵巧的
semicolony	半殖民
spurn	弃绝
monobloc	整体
illfare	困苦
crossly	相反
ligamentous	韧带的
imparticipable	不可分享
scrophulariaceous	玄参科的
richly	丰富
subtotal	几乎全部的
syren	诱惑者
working	劳动的
untense	放松
corpulent	肥胖的
dunce	傻瓜
latticed	装有格子
homeric	荷马的
bathypelagic	居于深海区的
phenology	生物气候学
guesstimate	瞎猜
cogent	恰到好处
amylogen	淀粉溶质
foxed	变色的
fill	饱
arteriolar	小动脉
repulsive	严拒的
ostrich	鸵鸟般的人
axial	轴向的
weave	组合
symbiotic	共生
tintinnabular	铃声
syzygy	朔望
satiety	过饱
marl	泥灰土
carnally	世俗
diploma	证明权力、特权、荣誉等的证书
livid	铅色的
sententious	很多说教式
ridiculously	可笑地
flinty	冷酷的
puree	面包的一种
blamelessly	无可责难地
patina	铜绿
eutrophication	超营养作用
bondslave	农奴
mouldwarp	欧洲鼹鼠
decubitus	褥疮
gardner	加德纳
scanty	稀疏
gearshift	变速排档
factor	因数
refluent	退潮的
tansy	艾菊
whorish	妓女
insurrectionist	起义者
mould	发霉
do	解答
underplay	使没有充分发挥作用
pageantry	华丽
stuffy	乏味的
troat	叫春
bornite	斑铜矿
inhomogenous	异成分
panglossian	认为一切都趋于至善的
sheshbesh	子游戏
seigniorial	领主的
dysmenorrhea	月经困难
dominical	主日的
wurley	土著棚屋
garnierite	硅镁镍矿
appurtenance	附属物
campcraft	露营术
tilbury	二轮轻便马车
macromolecule	巨大分子
semimoist	微潮
nighted	入夜的
downward	向下
hyoid	舌骨的
irradicable	根深蒂固的
cometary	彗星的
wide	广阔的
perform	履行
punctulate	有细孔
diminution	减低
immerge	埋头
bilge	舱底
grizzly	呈灰色
uncreated	尚未产生
austenite	体
dexiotropic	右旋
tetrandrious	具四雄蕊
sango	桑戈语
form	形式
gynoecium	雌蕊群
pintoresque	似画的
culpably	可恶地
atremble	颤抖
mulligan	蔬菜烩肉
embody	包含
unclassified	无类别的
qp	queen''s
clementine	克莱门氏小柑橘
reseat	使复位
adultly	少年老成者
unforced	自然
uvulotomy	悬雍垂切除术
tapsalteerie	=topsyturvy
drumbeating	宣传
mean	普通的
quadricentennial	400周年纪念
proportional	均衡
fimbria	伞
rollpast	重兵器行进
provisionally	暂时
defrayal	支付
retake	取回
bodacious	胆大包天
down	在下面
engage	使从事于
johnsonian	约翰逊的
opalesque	发乳白光
ptolemaism	托勒密体系原理
aftermath	结果
overclaim	过分的要求
frye	boot弗赖伊皮靴
alalia	言语不清
interception	拦截
trashy	没有用
poker	烙制
dictatorially	自大
restoration	修复物
frcp	Fellow
fluster	激动
akyab	阿恰布
decennium	十年
bedim	模糊
proscription	禁止
skegger	幼鲑
cogwheel	木齿铁轮
paleocene	古新统
reapparition	再出现
inbreaking	侵入的
spherosome	圆球体
breakaway	脱逃
gelong	西藏僧人
meliorative	改良性
frittata	菜肉馅煎蛋饼
regress	归复权
puglia	普利亚区(即阿普利亚区
vagile	漫游
moral	精神的
bully	欺凌弱小者
spiccato	断续
tenebrosity	暗
jingly	叮玲响
ursuline	乌尔苏拉会的修女
indigested	未消化
intercoastal	两岸间
hydropathic	水疗法
tribrach	三臂动物
turfite	赛马迷
asterism	三星符号
instrumentalism	工具謘t/
survey	勘定
unerring	正确
limbers	通水孔
rabid	激烈的
pruning	修枝
angelophany	天使显现
muntz	蒙知黄铜
boathook	一端有铁钩的撑篙
joss	神像
caulomic	茎的结构的
sharif	=sherif
stringboard	楼梯斜梁侧板
shunless	不可避免的
body	身体
necrotic	坏死的
sombre	昏暗
scabbed	生疥癣
josh	说笑
undistorted	不偏激
resipiscence	认错
heterospory	孢子异型
ialc	and
isodiaphere	同差素
gelding	去势
heretofore	迄今
barrow	手推车
beetleheaded	笨
labyrinth	迷路
apple	似苹果的果实
casein	酪蛋白
niflheimr	=Niflheim
pride	使自豪
daylong	终日
athenai	=Athens
refrangibility	折射度
mention	论及
benet	诱入陷阱
notion	观念
posteen	阿富汗羊皮大衣
hazard	冒险的事
viridescent	淡绿色
fasciculi	纤维束
austerity	朴素
monarchic	君主政体
incomprehensibility	费解
eristic	争论家
turnverein	体育协会
homebred	土产
tassie	=Tasmania
discretional	任意
financial	财政
intersymbol	符号间
membership	成员资格
apulia	阿普利亚区(即普利亚区
wilhelm	威廉
atherogenesis	动脉粥样化形成
frse	of
organic	建制
unpresentable	拿不出去
nighted	黑暗像夜
baccate	浆果状
abranchial	无鳃的
trephine	用环锯行手术
zuidholland	Holland
windup	装有发条
spirituel	愉快
boeotian	愚笨
arenaceous	沙的
poppied	多罂粟的
ratfink	卑鄙的人
tudor	都铎王朝的
medium	中等
probate	遗嘱
acupuncture	施行针刺疗法
tubful	一桶
hippic	马的
unprinted	未经印刷的
allpowerful	全能
proceeding	行动
prayerless	不祈祷的
harmlessly	无恶意地
protogenic	原生
nasty	凶相
originative	有发明之才能的
triform	以三种形式存在的
spacing	间距
literalist	拘泥字义者
bally	非常
clypeiform	有唇基的
nailless	不用钉的
purply	略成紫色
polymastia	多乳房畸形
subrogation	更替
buddybuddy	非常友好的
intruder	入侵者
gioconda	迷一般的
testaceous	贝壳质的
loris	尤指懒猴
southing	南行航程
dichogamous	雌雄异熟
uscg	Guard
dampness	湿气
irruption	急速增加
biannulate	具两个色环的
bimillennial	两千年的
unsympathizing	不表示同情
trichomonal	毛滴虫的
adios	再见
encapsulate	形成胶囊
pugnacious	好斗的
unexploded	装着炸药
helicopter	直升机
beggary	赤贫
subcylindrical	近圆柱形
looie	中尉
biotic	关于生命
inceptive	起初
cell	蜂房
whisker	胡须
subprior	修道院副院长
concentrative	集中性
overhaste	过于急速
deceased	已故的
emprise	行动
victualing	装贮粮食
amate	使挫折
nork	奶子
jambe	侧柱
leiomyoma	平滑肌瘤
hairclip	发夹
untaa	Nations
monoblastic	单核细胞性的
mixture	混合
coagulative	凝固物的
dinothere	恐兽
anodontia	先天性无齿症
sabbatarian	守安息日
provisionally	暂时地
thankless	不讨好
creeping	爬行的
sprue	熔渣
nrotc	Corps
frenzied	狂热
swimming	会游泳的
retinued	在随员簇拥下的
preggers	怀胎的
contumely	傲慢
characterful	有特殊风格的
subliterate	略具阅读写作能力
healable	可治好
inchling	小生物
volution	涡旋
townee	本市人
ventriloquy	腹语术
electrothermics	电热学
oppidan	城里的
nonbank	不由银行办理的
matripotestal	母权的
grill	铁格子
stagflation	不景气状况下之物价上涨
rectificative	纠正
skunk	讨厌鬼
bender	弯腰者
disclimax	人为顶级群落
saransk	萨兰斯克
europocentric	欧洲中心论
livable	适于居住
propoxyphene	丙氧芬
undignified	有损尊严的
pragmatize	合理地解释
croatan	克洛坦族
conquer	战胜
velaria	遮阳帐篷
unprevailing	徒劳
granophyre	花斑岩
zayin	希伯来文第七个字母
strutbeam	支梁
ne	氖
tackle	解决
fervently	热诚
anytime	任何时候
node	节点
unspent	未耗尽的
whereof	以什么的
scanty	不足的
unmixed	未混杂他物
tammy	一种便帽
environs	郊外
perennial	多年生
corrupt	贪污
aps	Physical
redivious	再现的
hbms	Majesty''s
unnoteworthy	普通的
shakily	不坚定地
mid	中央
geographic	理学
dray	用马车运载
metrificate	=metricate
extortionate	昂贵的
polyesterification	聚合
glary	光辉的
adversative	意义相反的
troupial	黄鹂
compellation	姓名
object	抗议
fleetness	无常
gnomic	格言
maying	五朔节的庆祝
schizoid	精神分裂症
eusocial	完全社会性的
potty	琐碎
flexuous	之字形
nicish	精密
ionicity	电离度
privilege	基本公民权力
toplofty	自负的
monteverdian	蒙特威尔地音乐的
unmeaning	无意义
austenian	奥斯丁作品
wnp	Welsh
victorious	胜利
sublimate	气质高贵
cruciate	十字形
thermonuclear	高热原子核反应的
christiana	克里斯蒂安娜
terracotta	陶瓦
pullulate	充满
dinitrophenol	二硝基酚
available	可利用
incog	用化名的微行者
auditoria	观众席
bicoastal	大西洋和太平洋东西海岸
mulierty	嫡生
fractographic	金属断面的显微镜观察的
bloodless	不流血的
bliny	的复数
quit	辞职
weasel	狡猾的人
ointment	油膏
inconformity	不适合
clearstarch	给上浆
reform	改良运动
acosmism	无宇宙论
unscientific	不科学
titer	浓度测定
floeberg	冰山
kummel	莳萝利口酒
phyllome	叶
ceroplastic	蜡塑工艺
ghats	高止山脉
simple	朴素的
mutably	性情不定
extortionate	昂贵
whoa	惊叹声
cursoriness	粗率
dirge	挽歌
priority	优先权
preconscious	前意识的
counterproductive	使达不到预期目标
unwearied	不疲倦
abuse	虐待
hippish	有点忧郁
spiritualization	净化
rising	有前途
umbrette	鹭类
idealize	理想化
diel	一昼夜
cotyledonous	有子叶
nagpur	那格浦尔
lauraceous	月桂科属的
ketol	酮醇
syllepsis	轭语法
astoundment	震惊
drudgingly	苦役般地
vietnik	反越战分子
prelibation	先尝
higgle	讲价
dubitable	怀疑
offwhite	灰白色
patulous	张开
kerflop	扑通
dismally	阴暗
accessible	易接近的
locusta	状花序
abby	艾比
compliable	屈从的
encephalic	颅内
megalomania	夸大狂
ruridecanal	乡村主任牧师的
metamorphosize	=metamorphose
aver	主张
stook	整理成堆
rouse	觉醒
apse	教堂半圆形的后殿
african	非洲人
spc	South
clatter	咔嗒
pullout	拔
unreasonable	不切实际的
consortion	结合
prudently	慎重
calando	减小音量
rigorous	严格
lighter	驳运
unchurched	被逐出教会
nodous	多节的
kite	轻快地移动
perissad	奇价原子
ablaze	激动的
foremastman	水手
roister	喝酒喧嚣
yaf	Freedom
acronical	薄暮的
ectogenous	体外生活
hempy	爱恶作剧的
gulfy	多旋涡
sidelight	舷灯
sinuous	动作复杂的
rug	垫子
indetectable	不易发现的
henroost	鸡窝
marish	沼泽
unput	未提出
settleable	会沉淀
expressionistic	有表现派作风
poop	冲打
sustain	撑住
hamamatsu	滨松
corny	粗野
babyism	愚蠢
sulphide	硫化物
telltale	泄密
cling	粘紧
supercolossal	极大
zymosterol	酵母甾醇
retour	回到原
tontine	唐提联合养老保险制
rhodic	高价铑
monostome	具单盘
furibund	愤怒的
hirudinoid	似水蛭
aeroballistic	空气弹道学
reformatory	感化
physicky	药物似
carom	连击
bramley	绿色大苹果
fcic	Corporation联邦农作物保险公司
aeneid	作的叙事诗
dodo	渡渡鸟
pietistic	假装虔诚
incage	囚禁
mmm	移动媒体模式
poohed	疲倦
balmacaan	宽身连肩袖大衣
waveless	平静
cosmogeny	=cosmogony
besiege	包围
transvalue	重新评价
pirogue	独木舟
hinder	后面
hydric	氢气的
rensselaerite	假晶滑石
juristical	法律
peronism	庇隆主义
entry	条目
brand	牌子
replevin	财物的发还
suctorial	吸的
aeromedical	航空医学
explicit	直率
grey	灰白的
elaborately	精巧地
plated	装甲的
gutty	生气勃勃
unretarded	未被妨碍
omniscient	上帝
reversal	撤销
binding	捆绑
laundry	要洗的衣服
cadmean	卡德摩斯式的
jittery	战战兢兢
quaere	询问
balky	执拗的
kilt	撩起
saturant	使饱和
zuidholland	=South
hepatotomy	肝切开术
shutdown	关门
indictable	可起诉的
impartial	不偏不倚
gramdan	赠
quantivalence	原子价
widthwise	横着
toothbilled	有齿喙的
dormantpartner	隐名
oxybenzene	羟苯
spastic	痉挛的
brutish	粗野的
ringsider	在近处观看者
cupferron	铜试剂
albuminose	含白朊
abbreviatory	省略
novocain	奴佛卡因
tactless	不老练的
blurry	不清楚的
budo	日本武术
rebutment	辩驳
sizzler	极烫的东西
askance	斜视
soil	污辱
darg	一天的工作
tarry	等候
clubland	俱乐部区
tripping	流畅的
machinate	图谋
rsn	Real
ate	Test
velites	轻装步兵
tramontane	野蛮
transit	经过
parallelism	对应
mesh	落网
contiguously	接触地
maundy	濯足仪式时分发的救济金
gravy	肉汁
penological	刑罚学的
oviform	卵形
everyone	人人
headstrong	刚愎
handbookinger	赌马
afdc	Dependent
cavity	洞
mediatrix	mediator的女性
safeblowing	炸开保险箱行窃的行为
floatable	可航行的
brackish	可厌的
solidungulate	单蹄的
degree	度数
vituperation	辱骂
vault	拱顶
import	有重要性
espiegle	爱戏谑的
supinate	旋转
discoidal	=discoid
hippocampal	海马趾的
rivel	弄皱
fixure	坚定
subchaser	驱潜艇
popinjay	鹦鹉
thrift	海石竹
run	浇铸的
macronutrient	大量养料
dioptre	屈光度
boule	立法会议
monostome	具单口
cosmochemistry	天体化学
abskize	逃亡
manageable	便于管理的
enwind	缠绕
athenian	雅典人的
tedder	翻晒机
unconcernedly	不在乎地
lineament	面部轮廓
standaway	不贴住身体的
postmortem	死后的
supportable	可支持
polymolecular	几个分子厚度
acyclic	无环
funfest	娱乐会
matrass	蒸馏瓶
newsstand	杂志摊
swad	一群
ethnologist	民族学者
holyday	宗教节日
impatiens	凤仙花属植物
hesiodian	赫西奥德风格的
caddy	茶叶罐
disembogue	注入
pharmacy	药房
trinity	三个一组的
emotively	使感动
onstage	台上演出
arabesque	阿拉伯式图饰
napiform	上部粗圆下部细长
stream	流注
drizzly	下毛毛雨的
heah	多用于黑人英语
makeevka	=Makeyevka
necessitude	=necessity
lapidescent	石碑似
durable	持久的
paradise	天堂
pleading	起诉
tumefy	隆起的
phimosis	包茎
cloudwards	朝着云
rift	长狭谷
foremost	最初的
epochal	新纪元
indolently	不痛
yeastlike	似酵母的
screwball	精神有点怪的
dualpurpose	作两种用途
exuberant	华而不实
gayety	轻快
footrace	赛跑
ritzy	讲究的
gentle	温和的
relative	有关系
gks	计算机图形核心系统
paralyze	使瘫痪
unbalance	紊乱
excrescency	自然长出物
transpositional	变调
roseate	愉快的
veil	面纱
nabob	富豪
coleopterous	甲虫类
bonaci	鲈科食用鱼
decrepitude	老耄
examine	考试
metewand	尺度
another	另外
lola	洛拉
radiogoniometry	无线电测向术
peppercorn	空有其名的地租
bemist	笼罩在雾中
upborne	被举起
horologe	钟表
unlace	解开带子
antihemophilic	抗血友病
gneissose	像片麻岩的
idiolect	个人习语
sale	销售额
mullet	鲻鱼
cannular	管
rhodic	四价铑
sylleptic	兼用法
technosphere	技术领域
xerantic	除湿的
fauna	动物区系
classical	古典文学的
beefy	象牛肉的
teleprompter	讲词提示装置
languidly	无力地
thermometric	温度计的
tactical	战术的
argumentum	议论
evasion	逃避
sexto	六开本
contour	等高线
nounou	奶妈
replacement	复位
isobar	同重元素
unstep	由桅座移去
monobasic	单碱
unci	uncus
wadable	可涉水过的
cowpoke	牛仔
mcm	罗马数字
hippophagistical	食马肉
trapes	邋遢的妇女
pottery	陶器场
unapproved	未经同意
platinoid	假白金
reparations	赔款
acoasm	幻听
deerweed	菽豆科植物
weird	命运
beluga	白色大鳇鱼
ecologist	生态学者
contranatant	逆流的
swiple	连枷头
deckle	手工制纸的毛边
unveracious	假的
study	研究
nematocidal	杀线虫的
orthoepy	正确法
aquavit	白兰
limites	lime@的复数
allegiance	忠贞
brace	带子
retractile	缩回的
gunbattle	枪战
restlessly	不安
iconoduly	崇拜偶像
patresfamilias	paterfamilias的复数
parathyroidectomize	`dektEmI/
dixieland	爵士音乐的一种
calisthenic	柔软体操的
incompetent	不合格
gently	轻轻
howtowdie	配有水煮荷包蛋和菠菜的白汁鸡
unflaggingly	不屈不挠
unambivalent	明确
hydrotropically	向水性
pale	苍白
ignobly	下流地
expiable	可赎
extrachromosomal	染色体外
regret	惋惜
norbert	诺伯特
tetrahydrocannabinol	四氢大麻醇
unput	未放置的
hydrostatic	静水力学
solion	沙立昂
placate	安抚
steamship	汽船
cocurricular	辅助课程
delphi	因Apollp的神殿而著称
transpose	移项
gynaecomastia	男子女性型乳房
annihilationism	灵魂涣榛昙琶鹇
dinosauric	恐龙般大的
dou	Gerard
azeotropy	恒沸性
cumbersome	讨厌的
antidiabetic	抗糖尿病
doeth	do的第三人称单数现在式
unbalance	使心情紊乱
lashing	大量
antiemetic	止吐的药
tibial	胫骨的
yowie	野人
eddie	埃迪
roundworm	蛔虫
thunderation	到底
falteringly	支吾
yawper	抱怨的人
unobjectionable	不会招致反对的
theolatry	拜神
waterscape	海景
denim	粗斜纹棉布
squash	镇压
bazookaman	火箭筒操作员
orphean	迷人
potshot	肆意抨击
citrous	柑橘属植物
eccrine	外分泌腺
cataphract	古希腊之重装备战船
far	遥远
forecast	预报
octothorp	"#"号
thitherward	向那边
hesitant	吞吞吐吐
hasty	草率的
heavy	阴沉的
bto	Time
scoffingly	带冷笑地
discriminative	有区别
inequality	不平等
frug	跳扭摆舞
nobody	pro
blusterous	叫嚷
aqua	水
gi	Gibraltar
squabbish	有点胖的
twill	斜纹织物
tulsa	塔尔萨
yankeefied	美国化的
forested	被森林所覆盖的
wide	张大的
mfn	最惠国
engineering	工程
audiodontics	声齿学
perambulation	巡视
sigil	印记
quoit	铁环
serrulate	细锯齿边
deforciant	非法占有者
lps	Lord
logged	劈成木材
phosphene	压眼闪光
hunt	搜寻
agonistic	动机争胜性
testaceous	贝壳质
sheave	反桨划船
dowse	探寻水源或矿藏
aileron	副翼
animatingly	有生气
failure	不及格
rabid	狂暴的
bicapsular	两蒴的
tuberculate	结核性
zif	零插入力组件
oblong	椭园形
annalistic	编年史
gazette	政府的公报
devoted	深爱的
caseose	酪朊
mock	假的
home	国内
invent	发明
girondism	吉伦特党的政见或主张
shiny	晴朗
yoghourt	酸奶酪
buildup	集结
peart	快活的
archwise	成弓形
dishwatery	枯燥的
inhospitality	不和气
boulevard	林荫大道
sanguine	乐天
incurment	惹起
semihyaline	半透明
fossette	小窝
agenda	议程
gpi	the
barye	微巴
aversion	讨厌的事和人
atheneum	文艺协会
eeling	捕鳗
hellgrammite	翅虫的幼虫
array	排列
incommunicability	难表达
cockspur	鸡距
entirely	全然地
centaurae	矢车菊
snobol	SNOBOL语言
incb	International
joycean	乔伊斯的
appulsion	趋向
dulosis	奴役现象
mitchell	米切尔
endoscopic	内窥镜的
thundering	非常
fractious	倔强的
mythologize	讲神话
laputa	勒普泰岛
thermochemistry	热化学
ppb	10亿分之……
retroperitoneal	腹膜后
abetment	帮助
hamitic	哈姆
aeroamphibious	海陆空联合的
stale	变无味
glauconite	海绿沙
patroclus	普特洛克勒斯
keeve	洗矿桶
unashamed	问心无愧的
proclamatory	公告
socket	牙糟
livraison	分册
underwood	树林下的草丛
proptosis	突出
overcareful	过分用心的
voluntarily	自动地
pretersensual	感觉不到的
canaliculated	有细管
nyctitropism	感夜性
anchylosis	长合关节
sole	单独
tricarpellate	三心皮的
tryout	试用
escapement	逃亡的出口
downstate	在州里的南部
nondestructive	非破坏性
oxter	二腕的内侧
goldeneye	白颊鸭
tebriz	=Tabriz
crystallitic	微晶
maypole	五朔节花柱
feeling	触觉
dicom	Medicine
jenny	纺织机
drugstore	药房
broad	广泛
hearting	石墙的衬心
daredeviltry	鲁莽大胆
hyperkeratotic	角化过
childish	幼稚
crura	似腿的部分
osteal	侵袭骨
alligator	产于美洲的鳄鱼
moonlet	人工卫星
manual	手的
fledging	无经验的人
entrain	使乘火车
intitule	称为
whim	怪念头
strep	链锁状球菌
stead	对……有利
turncap	旋转帽
boiling	激昂
ethanolamine	胆胺
saving	节俭
testa	介壳
villatic	别墅
alterative	改变
gumdrop	水果糖之一种
adamite	裸体的人
unworthy	不值得的
camerawork	摄影操作
suspensive	暂停的
dialytic	透析
passado	向前交叉步
primary	根源的
samely	无变化的
consummate	完美的
qarnns	Service
orthodonture	=orthodontics[讹音变体
reflorescence	再开花
stuporous	麻木的
joint	大块肉
citadel	根据地
sib	有血缘关系的
unequally	不公平
fighter	奋斗者
swindle	诈骗
cfs	cubic
doloroso	感伤地
pitch	坠落
guiltless	无辜的
aciculate	针状的
littlish	相当小的
unexhausted	未用竭的
upcountry	向内地
cockcrow	破晓
predecessor	前任
garrison	要塞
magniloquent	华而不实的
neuroactive	刺激神经组织的
unhired	未租用的
martensite	马氏体
psn	serial
enantiopathy	对抗疗法
cattail	香蒲
transit	搬运
corkily	像软木地
mondrian	蒙德里安绘画风格
foretype	前面的典型
apologetically	辩解地
undisposed	未分配的
crackjaw	反常的
woodsy	树林多的
subside	平息
kokeshi	小木偶
acetaminophen	对乙酰氨基酚
aponeurotic	腱膜
nutritional	营养
pursiness	肥胖
isotactic	全同立构的
simulacrum	影
backlist	重版目录
underproduction	供不应求
courtlike	彬彬有礼的
songlet	短歌
knower	理解者
endurable	可忍受的
nucleophilic	亲核
dour	阴沉的
cryptographical	号
summit	政府首脑
adh	hormone
contest	争辩
calculably	可预料地
eventuate	结果为
topgallant	最高
downhill	每况愈下
exit	退场
playshoe	轻便鞋
seen	see的过去分词
psychophysiology	精神生理学
lensed	有透镜的
indented	犬牙交错的
muster	阅
frizzle	使卷缩
rectangularity	成直角
larksome	好嬉戏
cachinnate	哄笑
delimit	定界限
airlog	飞机计程器
emplacement	放列动作
effort	成就
irascibly	易怒
remove	搬家
sitting	孵卵中
carpeting	地毡毛毯
obtusely	圆头地
sports	有关运动
porteress	=portress
remind	提醒
reserve	预备队
headhunt	野蛮人猎取人头的出征
tholobate	圆屋顶座
canadien	加拿大的法国移民
ukrainian	乌克兰人的
mixage	影片剪辑
shirty	心情坏
hypaethral	露天的
abiotic	无生命的
endogamous	同族结婚
faint	衰弱
caterer	包办伙食者
hammering	锤打
tyrannically	专横
override	践踏
rhizoctonia	丝核菌
caliper	弯脚器
shimonoseki	下关
lunabase	月球上低平面的
raven	狼吞虎咽
angerly	愤怒地
scarfskin	表皮
semiarboreal	半林栖
pillory	使惹人嘲笑
strickle	刮光
azimuth	方位
epexegesis	增词
cetacean	鲸的
israelitic	希伯来人
recordak	文件微缩复制系统
presentational	直觉的
peroxyacetyl	硝酸过氧化乙酰
capsule	蒴果
converse	相反的事物
occident	西洋
nark	密告
unroyal	非君王
liposoluble	脂溶
scoff	狼吞虎咽
paraphrastic	说明性的
jealous	猜疑的
bifacial	有两面
strawy	稻草状的
antarctica	南极洲
dungy	肮脏
invidious	诽谤的
eucaryote	真核细胞
insurgently	汹涌
decanal	南侧唱诗班
sheerlegs	起重机柱
biceps	二头肌
earthling	凡人
sternum	胸骨
locomotive	运动
erotological	色情文艺
libellee	被诽谤者
desalination	减少盐分
telediagnosis	远距离诊断
xenial	异花受粉的
hippolyta	希波吕忒
epsomite	泻利盐
juridic	司法上
somnifacient	催眠药
synaesthesia	牵连感觉
fortitudinous	坚忍不拔的
dsp	Processing
equivalent	相等
decrease	减少
wynd	狭巷
prolocutor	主持会议者
couchy	茅草丛生的
coverley	Sir
vendeuse	女售货员
joint	共同的
wearisome	使疲倦的
kryptol	碳棒
prepositional	当前置词
laggardly	落后的
opern	歌剧
whisper	谣传
entophyte	内生植物
hyperthymia	情感增盛
welldoing	行善的
ipecac	n
gunnery	炮术
afforcement	加强阵容
snaphaunce	早期燧发机
uh	half
silkscreen	丝网印刷
health	健康
infructuous	不结果
aeronomy	超高层气流物理学
ensate	剑形的
conjurator	法师
comportable	适当的
versant	熟悉
sigmoid	S形
neurotomy	神经切断术
downswing	向下之一挥
flakily	薄而易剥落
urgently	迫切地
unblest	不幸
ferox	大湖鳟
assistant	助理的
grungy	脏的
monomerous	一基数的
baddeleyite	斜锆石
immalleable	非柔顺的
scaled	有鳞状斑点的
dysphasic	患言语困难
abo	土著
inappropriate	不相称
prelingual	有语言能力前的
gliding	滑顺
buckled	有扣
basilica	长方形基督教堂
judgement	判断力
compliably	屈从
loneliness	寂寞
autocue	自动提词机
spurious	伪造
battlesome	好争吵
icing	糖衣
inquisite	调查
tavr	Volunteer
ventriloquous	用腹语的
unthoughtful	考虑不周
radically	根本上
tweedle	琴声
kindergarten	幼儿园
filamentary	似丝的
infanta	郡主
determinately	有限花序地
blinding	使失去判断力的
irenicon	和平提议
running	连接的
huffish	生气
girlygirly	娇气十足
time	次数
proportional	相称
popular	通俗的
future	前途
exorcize	=exorcise
contributory	贡献人
fanatic	狂热的
vintage	葡萄收获期
flosculous	=floscular
phlogistic	热素
hydranth	水螅体
adiaphoretic	止汗药
zen	禅宗
vedic	吠陀
lampstandard	路灯柱
frequently	频繁
present	提出
levity	多变
aeronautics	航空学
excuss	依法索取
frostbitten	生冻疮的
gesture	手势
misrepresent	说假话
frightful	可怕的
brash	仓促的
hackle	乱砍
skete	隐士团体
bravo	好啊!妙!
ostium	口
octette	八重唱
deaccession	出售
hypotheses	臆测
therewith	于是
squall	哇哇地叫嚷
butcherly	如屠夫
galla	盖拉族
kolyma	科累马河
pukras	=pucras
goonda	暴徒
ingenital	内在
droppable	适于投下的
undiscernible	无法看出的
photodrama	电影剧
epizootic	家畜流行病
vanguard	领导者
age	时代
ineffectively	无效地
acetone	丙酮
continental	大陆性的
orthoepic	正音法的
sourly	坏心眼地
pit	使凹下
ballsy	有胆量
mixer	混合者
grenadilla	=granadilla
pillared	成柱状
slinkskin	胎牛革
serious	认真的
carbuncle	红宝石
transmitter	传达人
handpick	用手挑选
rim	为……装边
rasping	令人焦躁
liver	居住者
bluff	直率的
inhomogenous	非齐次
walty	易倾侧的
adverbially	当副词地
hydropical	=dropsical
locknut	对开螺母
vincible	容易征服的
vivacity	活泼
overcurious	多问的
exquisitely	精巧地
insensate	没有感觉
incretionary	a
trying	费劲的
print	印于
heredity	遗传
predicatively	肯定
rhine	莱茵河
lento	柔和的
makable	可制造
whoops	哎呦
relaxative	缓和
schoolroom	教室
padrone	主人
anticlastic	互反的
ease	灵活地移动
esurient	贪婪
death	死
spirochetic	=spirochaetic
schematic	示意性
entomophily	虫媒传粉
zemindar	收田赋者
disputed	争议
gdi	Devive
paralysis	瘫痪
callow	年轻而无经验
cheskey	捷克人之后裔
befog	使朦胧
majesty	雄伟
sheepish	懦弱
allose	阿洛糖
spermatocyte	精母细胞
banteringly	半开玩笑地
birefringence	双折射
kit	成套工具
rubricity	红色
hunchbacked	驼背
sealless	未盖印
ominously	不吉利地
antique	古时的
exonerate	免除
dialogic	问答体
reportable	值得报告
swag	垂下
skin	皮
crases	crasis的复数
seasonal	季节性的
gradient	倾斜的
envelop	包封
yap	狂吠
antitail	逆向彗尾
primrose	樱草花
playgame	玩笑
decoration	装饰
manageable	便于管理
bossy	专横的
unseparated	不分离
synthomycin	合霉素
zygospore	接合子
church	教堂
stable	稳定
osmoregulatory	渗透调节
lienteric	滑肠
unorganized	无组织的
polka	波尔卡舞
coppery	含铜的
consuetudinary	习俗的
benelux	比利时、荷兰、卢森堡三国经济联盟
array	编队
unwakened	未被唤醒
tremulousness	胆小
seaside	海边的
silkweed	芳草属植物
bilharziasis	裂体吸虫病
denudate	赤裸的
naillike	像钉
fishlike	似鱼
puberal	青春期
varangian	拜占庭皇帝的卫士
scotophil	适暗
esteem	尊重
bloat	肿胀病人
mucronulate	具尖突的
withershins	左向转动
retake	再取
cad	计算机辅助设计
polyhistor	博学的人
loxodromic	斜航
chargeable	可充电的
fluky	不可靠
jansenist	詹森主义者
astonied	大吃一惊
exigency	紧急
corrective	纠正的
uncap	打开
omega	欧米加
warn	通知
saponated	皂化的
farmhouse	农家
backstairs	后面楼梯
multipoint	多点的
filipine	菲律宾的
unenlivened	不活跃的
detectable	可发觉
contiguous	接近
hawaiian	夏威夷语的
podium	乐队指挥台
recapitulatory	概括性
distinct	清楚
inarguable	不容争辩
gnomical	=gnomic
mamillated	有乳头状突出物的
fjp	York纽约犹太慈善团体联合会
parade	游行
passim	到处
powerful	有力的
crackajack	杰出的
npa	报纸出版商协会
dominion	主权
redevelopment	重点恢复
logion	基督的话
caudal	近尾部的
bulgy	膨胀
glamourize	=glamorize
extrality	治外法权
transferrer	转送者
vermes	vermis
hommock	堆积冰
drubbing	殴打
sentiment	情绪
bicuspid	两尖齿
current	电流
coplanar	共面的
odds	不平等
service	耐用的
circumradius	外接圆半径
complicit	有同谋关系的
mythologize	编神话
lotusland	安逸乡
honeybunch	亲爱
embourgeoisement	变成资产阶级
victoriously	获胜地
scopulate	有花粉刷的
conglomeration	聚集
hibernian	爱尔兰的
morelia	莫雷利亚
bloodshot	有血丝的
apochromatic	高度消色的
counterpane	床罩
hershey	bar
waiwode	=voivode
entail	限定继承权
madman	疯子
viny	葡萄树
incendiary	煽动者
isdn	Integrated
falstaff	福斯塔夫
argentine	阿根廷的
suez	苏伊士
intangibly	不明白
golan	Heights戈兰高地
vesicular	小泡的
wpc	女警官
dihybrid	双因子杂种的
likewise	也
thesp	=Thespian
undiscipline	无纪律
seducement	怂恿
fencing	篱笆
forever	永远
thinnish	较瘦
unrent	未撕裂的
chilliness	寒意
momently	暂时
coastal	沿海的
fancied	空想的
swish	好看的
dare	敢
rejuvenate	使回春
owl	C++
honkers	喝醉
thyrotropin	促甲状腺素
twite	黄嘴朱顶雀
whyever	为什么
blusterous	夸大的
nunnery	女修道院
buddybuddy	亲热
leftover	剩余
reassign	再指定
will	意志
singularly	异乎寻常地
cacophony	刺耳的音调
everlasting	持久
geophyte	地下芽植物
ungraceful	下流的
journey	旅行
witchery	巫术
extemporal	脱口说
herniary	疝的
furthermost	最远方的
katrina	卡特里娜
endoergic	吸能的
emerge	暴露
encapsulate	装入胶囊
insensibly	徐徐
tripod	三脚架
maniacal	发狂的
fighting	好战的
voltage	电压
rockbound	僵硬
padrone	船主
sack	解雇
nematic	向列的
gladly	欢喜地
preventible	可预防
wire	金属丝制的
complimentary	称赞的
photoabsorption	光吸收
boodler	受贿者
satanize	使变得邪恶
agonizing	苦恼的
concussion	激动
xpvm	for
arpa	Agency
afebrile	无热的
land	田产
firefight	交火
gruffly	粗暴
copeck	货币单位
posttonic	重读音节后的
lateralize	使向侧面
striking	罢工
touching	至于
additional	另外
escapeproof	防漏泄
dyeability	可染性
jook	闪避
crumpled	弄皱的
poleaxe	战斧
convinced	深信
madrileno	马德里人
fighter	斗争者
redeemer	救世主
shul	=synagogue
afterdeck	后甲板
solanine	茄碱
temporary	暂时
taedong	大同江
homeward	在归途上的
abustle	忙碌的
insusceptibility	无感觉
xyloglyphy	木刻术
detectaphone	窃听器
tailband	书脊底带
chemosynthesis	化学合成
compelling	强制的
phenix	绝代佳人
putrid	腐烂
apriority	先验性
alienator	疏远者
photoflash	使用闪光灯的
wettable	可湿的
timesaving	节省时间
philomena	菲洛米娜
remorseful	懊悔
hypallage	换置法
timing	时间选择
sandy	桑迪
argillaceous	粘土的
zoom	使摄象机移动
asinine	象驴一样
imagist	意象派的
autoplastic	自体移植
hearsay	传闻的
saleroom	销售额
scanty	不充足
manifestation	显示
haemopoiesis	=haematopoiesis
excitant	使兴奋的
crisis	决定性时刻
flatling	直挺挺
counteraccusation	反控
underside	下腹
reblossom	重呈繁盛
supersubstantial	超物质的
rebroadcast	重播
ingeniously	贤明地
joke	玩笑
machineable	=machinable
hesitative	支吾其辞的
unifacial	单面精细加工
esculent	可食用
eudiometrical	空气纯度测定管
weenie	细小的
unsophisticate	单纯
sheria	=sharia
hammering	锤打的声音
rswc	right
perennial	长期
asean	of
unthought	未加思考的
overmatch	打败
inthral	迷惑
doctrinal	学说
coarseness	粗糙
feedback	回授
vitrophyre	玻斑岩
bathwater	浴缸里的水
financially	金融上
bullet	子弹
willingness	积极肯干
brachycephal	圆头型的人
sicilia	=Sicily
tyro	生手
interpellation	质询
derbyshire	德贝郡
transworld	环球旅游的
gummous	树胶
thrombi	血栓症
substratal	根本的
waspy	似黄蜂
respirable	可呼吸的
amniocentesis	羊水诊断
equanimously	安静地
cutthroat	杀人的
done	妥当
upswept	向上弯曲的
drearily	沉寂地
unpropitious	恶运
autofocus	自动对光装置
alumroot	矾根草
paillasse	草褥
whop	抽出
uncontested	无竞争的
menstrual	月经
circumcolumnar	绕着圆柱的
raptured	欢天喜地的
exosmic	渗入的
shaven	修过脸的
moonstruck	耽于幻想
cahier	笔记本
rascal	不诚实
nemesia	龙面花
gfr	German
bodleian	牛津大学图书馆
ironic	讽刺
scribble	杂文
unshed	未吐露的
halobacteria	盐杆菌
irrigator	灌溉车
moronic	低能
veil	戴面纱
baroque	巴洛克时期艺术和建筑风格
cristate	有冠毛的
supplely	易弯
autogenic	=autogenous
bba	of
lambdology	λ噬菌体学
traversing	穿越
unexploded	装着炸药的
stane	=stone
myotic	促成瞳孔缩小
pettitoes	脚
ibew	Brotherhood
freak	奇异的
syncrude	合成原油
gauffer	皱褶
tridimensional	`traIdI9menFl/
burstone	磨石
clincherwork	瓦叠排列
cerebrotonic	大脑紧张型
allround	多才多艺
dietotherapy	食物疗法
parian	帕罗斯岛产白色大理石
pocket	袖珍的
risc	Computer
hyperuricaemia	尿酸过多
riftless	无裂缝
recollected	被回忆起的
divulsion	撕开
atwirl	快速旋转地
sauerbraten	糖醋烤牛肉
underlay	向下延伸
molectron	集成电路
unneighbourly	不睦邻的
polemic	争论的
lunchroom	餐厅
carabine	卡宾枪
unregretted	无人对之表示悔恨的
cosily	惬意
tentatively	试验性
galoisian	伽罗瓦
isobathytherm	等温深度线
clipboard	有纸夹的笔记板
secondary	中级
optimal	最佳
subepidermal	表皮下的
anaphylactic	导致过敏
emr	mentally
displease	冒犯
mindon	心灵感应粒子
hydrophobe	憎水物
hoggish	贪婪的
isogeneic	同基因
palaeoanthropic	古人
tufoli	意大利通心面
acyclic	脂肪族的
lactonization	内酯化
micella	=micelle
analysable	可以分析
revokable	可取消
weasel	鼬鼠
gooney	bird
girlhood	少女们
barley	大麦
interconvert	互换
usage	用法
slack	闲散
pfeffernuss	番佛努斯香酥球
discipula	门徒
examination	考试
chingkang	Mountains见Jinggang
prosthesis	添字首音
overgrew	的过去式
override	不顾
neurofibroma	纤维神经瘤
dopant	搀杂物
terrine	陶制盖碗食品
reimpression	增印
godlike	庄严的
icekhana	赛车
slobber	口水
ruffian	流氓
dateable	可确定时代
acanthoid	刺状的
schmoll	笨蛋
dynamo	发电机
trot	骑马小跑
erotogenic	动欲的
uninformative	不增进知识
inconsequentia	InkRnsI5kwenFl/
binate	成对的
overhead	在空中
hincty	神气活现的
assessor	辅佐人
wither	使消亡
nds	Novell
devise	发明
flix	毛皮
sdram	同步DRAM
nyctitropic	夜间变更方向的
giraffine	像长颈鹿
scleroblast	骨针细胞
vasoactive	血管活性的
floral	花的
undercooked	得火候不足的
cdma2000	Division
merchantable	可买卖
nymphae	若虫
dynamoelectric	电动的
senatus	=senatus
itching	渴望的
savvy	了解
theater	手术教室
scrambling	不规则性
qualify	证明合格
easement	在他人土地上的通行权附属建筑物
stockman	仓库管理人
gouge	欺骗
confirmatory	证实的
asid	Designers
clef	音部记号
throughother	混乱地
clamjamfry	群众
tripterous	三翅的
rummy	拉米纸牌戏
thanks	感谢
comprehension	包含
scs	Soil
mysticism	谬论
disallowable	可否决
information	知识
hydrogenate	使氢化
desquamative	脱屑的
architectonics	结构设计
disrupt	使瓦解
propertied	有财产的
rapine	抢夺
cobbra	头
laborsome	吃力的
modelly	模特儿似
arabism	总称阿拉伯国家
baptismal	洗礼的
overfired	过烧的
aerial	生活在空气中
cultivatable	可栽培
deliberatively	慎重审议地
insobriety	无节制
shm	motion
concern	所关心的是
competent	有能力
bloated	傲慢的
numidian	努米底亚的
padishah	君主
extorsively	勒索
judicatory	审判的
sink	下沉
swami	哲人
blatant	俗丽的
schizogony	=schizogenesis
valency	化合价
jointly	共同地
eyeglass	眼镜
baseballer	棒球选手
orbit	绕……轨道而行
panduriform	提琴形
solon	梭伦
ogee	弯曲
fusiform	纺锭状的
revulsant	引起诱导
thujaplicin	苧侧素
diamantiferous	产钻石
graunchy	考验
nora	Eleanor
dowable	有权得亡夫遗产的
witty	富于机智的
whitecap	白帽队队员
nightmarish	不愉快的
subscript	写在下方
brindled	有斑纹
tearproof	撕不破
pained	痛的
stepdance	踢踏舞
justification	认为有理
legroom	踏脚处
xanthopsy	黄视症
trench	掘沟
regress	退回
kiloampere	千安培
astrobleme	陨星坑
onwards	向前
nonparous	未生过婴儿的
rfc	Comments
interstellar	星际
ultimata	根本的原理
combination	结合
basidia	basidium
more	多
sear	凋谢
twinned	孪晶生成
pli	磅/英寸
dynein	动力蛋白
gymnastic	体育的
leiotrichous	有直发的
runabout	小型单座敞篷车
renormalization	重正化
infective	有传染性
adjacent	邻近
syllogise	=syllogize
celebration	庆祝
emersonian	与爱默生有关
tracheal	导管
panhandle	狭长的土地
gasless	不产生气体的
signalize	使著名
fearfully	非常地
gonfalonier	中世纪意大利都市国家的行政长官
pituitous	黏液
spew	喷涌
appurtenances	附属物
squeegee	橡胶滚轴
penetration	突破
splenic	脾的
ruefulness	可怜
aprism	Apra
overhasty	过于匆忙
unusual	不寻常的
skullfish	两岁以上的鲸
peccancy	违章
tubercled	生有结节的
defrost	解冻
biolysis	死亡
turntail	开小差者
trouper	老练演员
lofi	低保真度
positive	积极的
corticole	生于树皮上
education	教育学
fool	白痴
nee	旧姓
fallacy	谬论
wellspring	水源
exploiter	开发者
structuralist	构造主义的
decelerometer	减速计
aliquant	不能整除
roentgenoscope	=fluoroscope
ballplayer	棒球手
fidate	稳固棋子使它不被对方吃掉
fuddled	醉的
bluster	风狂吹
landlady	女房东
tormentor	长肉叉
unconsolidated	疏松
sulphurator	硫化器
legerdemainist	魔术师
deficient	缺乏的
unaffected	自然
wysbygi	在获取之前所见的
meadow	草地
acrux	南十字星座中的一个星
denudate	裸体的
botryoidal	一束葡萄状
harewood	染色槭木
scarce	缺乏
aerobiologic	大气生物学
faciolingual	面部与舌
grinder	磨工
filipine	菲律宾
prejudicial	引起偏见的
melkite	=Melchite
rethink	再想
taking	可爱的
salutatory	致敬意
sweetly	香郁地
schoolteaching	教师的职务
ornamental	装饰性的
confidently	安心地
heterofil	异质复合丝
vida	维达
parthenospore	非接合子
guncotton	强棉药
assertion	主张
cryptic	秘密的
kingbird	必胜鸟类
northwestwardly	向西北的
devotional	祷告的
premarital	结婚前
vinylbenzene	苯乙烯
unwisdom	愚昧
feodal	领
phylloclade	代叶枝
questionmaster	答问节目的主持人
jauntily	活泼
tickler	备忘录
zone	分成区
pantopragmatic	爱管闲事的人
loyalize	使忠诚
hypersexual	性欲过度的
sulfurate	如硫磺
nucha	项
exodermis	外皮层
maddish	有点疯狂
xylophonist	木琴演奏家
heartland	心脏地区
phosphate	磷酸盐
pleuston	水漂生物
unlikely	靠不住
tacitly	肃静地
usac	States
function	功能
like	同样
heyday	全盛期
rowen	一季中牧草之第二度收割
committal	承担义务
nyctitropism	就眠性
endosome	内涵体
oscan	欧斯干人的
biographically	传记体
dcm	Medal
northwestward	向西北的
ozokerite	地蜡
ruminatively	反复思考地
ridgepole	栋梁
sagittarius	人马图形
redemptor	=redeemer
impotency	性无能
pyogenic	生脓
delphinium	翠雀花
promulgator	发布者
inequiaxial	不等轴
excessively	非常
gymp	绒丝带
inconsequent	不一致
epicurean	信奉伊比鸠鲁学说者
bunko	诈欺
discreetly	谨慎地
skiogram	=skiagram
expectorant	化痰
compliableness	依从
san	Area
anyway	无论如何
diocesan	主教管区
shipshape	井然有序的
verecund	忸怩的
cosmopolitanism	四海一家
dwarf	侏儒
curvature	曲率
canorous	音调优美
uncase	从箱子取出
stainer	色料
unprescribed	非指定的
matsudo	松户
ilici	为西班牙厄里奇市的古名
soulful	感情上
fibrocystic	纤维囊性
traumatologist	创伤学专家
reimportation	再输入的东西
gustiness	狂风
incursion	侵入
mastersinger	=Meistersinger
beefwood	澳洲产红色坚硬木材
idiocratically	癖好地
fissive	分裂
megalithic	巨石造成
lymphocyte	淋巴细胞
cresting	顶饰
pharyngal	咽
fornicate	拱状的
salle	大厅
ponderability	可秤性
saccate	囊状
ticklish	不稳定的
valence	价
semidomesticated	半驯养的
nether	下面
birdbrain	轻佻的人
utopian	乌托邦
squelcher	毫不放松的反击
charrette	专家研讨会议
plebby	平庸的
presto	极快
sleight	技巧
aspersion	洒水
pastorate	牧师的职责
decipher	译解
eutomous	裂隙清楚的
dashy	浮华
embezzlement	盗用
ever	不断
contingency	偶然
subdeaconry	职位
trochilic	旋转机械运动的
staple	来源
odor	气味
conventionally	照常套
vomitive	呕吐
budgetary	预算的
stance	姿态
illicitly	违法
renegotiation	重新商议
sir	阁下
quaintness	离奇有趣
putridness	堕落
personalist	人格主义
archduchy	大公国
egoistically	利己地
cegb	Electricity
desirable	合意的
nielsbohrium	鈹
imprecise	不严密的
amdg	majorem
pcav	Constant
delinquent	失职的
wattle	金合欢树
siphonet	腹管
unsicker	靠不住的
bareback	不用马鞍地
bill	用海报宣传
vulgate	通行的
renovator	革新者
coact	共同合作
unawakened	未醒的
dialytically	用透析法
share	份额
hemiplegia	半身不遂
slub	粗纺线
pancreatin	胰液素
ipa	国际药物摘要
unqualified	绝对的
roundabout	转弯抹角
evangel	福音
corporate	全体的
operation	业务
superb	华丽的
simile	明喻的词语用法
ribbonman	绿带会
isapi	Internet服务器应用程序接口
fallen	陷落
mym	myriametre
independent	不受约束
dewindtite	磷铅铀矿
fagot	束
semicentury	半个世纪
caduceus	MERCURY的手杖
floatage	漂浮
hypothetical	假设的
nonconformist	非国教徒
conveyable	可移动的
fornix	穹
flange	轮缘
digital	数字式
recremental	废物
abroad	广泛
angiosperm	被子植物
carelessly	不注意
defeminize	使失女性态
railcar	铁路车
ingeniously	有才能
zwitterion	两性离子
arbitrator	仲裁人
flowering	开花的
egodystonic	与自我不相容
lightless	暗
plough	犁
crockery	陶器
tarpeian	塔尔皮亚岩石
drivership	驾驶
gynaecoid	女性的
civicism	市民政治
dichromism	二色
knight	爵士
oracle	预言
ferocious	凶恶
puppy	小动物
guilty	心虚的
brahmanic	婆罗门
unsaleable	非卖品的
boeotian	愚笨的
rainily	下着雨
retrude	在……造成后移状态
tot	合计
hartshorn	氨水溶液
withering	使干枯
safety	安全设备
unprescribed	自由的
rotisserie	烤肉店
badman	不法之徒
oracle	哲人
dopester	预测结果的人
uloid	瘢痕状的
hedonistic	快乐主义者
cliquy	私党的
alfa	希腊字母第一个
lassock	少女
explorative	探测的
biogenic	源于生物
stagecraft	编剧才能
putto	丘比特裸像
silverless	无银的
delphi	特尔斐
relative	关系词
devocalization	清音化
brand	打火印
slavish	奴隶
literate	有文化的
toilless	容易
unsoiled	清洁的
asap	Possible
nagoya	名古屋
vilma	薇尔玛
vertiginous	旋转的
sumpsimus	正确措辞
activity	放射性
shred	切碎
supremacy	地位最高的人
disinhume	掘出
pockmark	痘痕
dockworker	码头工人
bps	位/秒
cosupervision	共同监督
contradictious	爱反对
level	水平面
fosterer	鼓励者
disunite	变得分离
hyetometer	雨量表
colicroot	各种可用以治腹痛植物
crisis	疾病的转折点
rummage	检查
sdcd	Density
politesse	礼貌
grafter	嫁接的人
dramatic	生动的
white	白种人的
catamount	猫科动物
sirupy	糖浆
normally	正常
slide	滑行
circumnavigate	环航
ragazza	女孩
greedily	贪婪地
subdividable	可再分的
brokenhearted	极度沮丧
laminated	层压的
down	往下
swimfeeder	水下给饵器
brand	污辱
potsdam	波茨坦
teller	讲话的人
paean	赞美歌
fool	傻的
playmate	游伴
unbar	拔去门闩
bonded	存入保税仓库的
protracted	拖延
youthy	少壮的
facp	Physicians美国内科医师协会会员
functionalist	机能主义
unoiled	未加油
negationist	否定论者
hyposecretion	分泌不足
array	穿着
countable	可数名词
oilstone	油磨刀石
iyft	at
unphysiologic	不符合生理规律的
languorously	疲倦地
tenant	承租人
dilettante	业余艺术爱好
nsf	National
impetrate	祈求得到
effectiveness	效力
sheath	护套
blocking	舞台场面设计
knockwurst	大香肠
unformulated	未系统地阐述的
egomaniac	自大狂
counterblast	反向气流
precedable	可能被超先的
circumstantiate	详细地说
narrow	严密
favoritism	得宠
pane	窗格玻璃
atechnic	无技术知识的人
shipwright	造船工人
discontentedness	不满
bomb	投弹于
grained	有木纹的
bleak	阴冷的
charnel	停尸房
aiguille	锥状的岩石
disintegrate	碎裂
calculus	微积分学
transoceanic	横越海洋
contemporaneity	现代
saw	锯
catilinarian	谋叛者
personality	人格
lymphous	淋巴样
waec	West
raca	无价值的
unsuccess	不成功
expresser	表示者
incarnate	体现
scuff	以足擦
nitid	发光
ghosty	幽灵的
introductive	介绍的
mugger	泽鳄
foregoing	在前的
darkle	变暗
carpogenic	生果实
tenuirostral	细喙的
changepocket	大口袋中装硬币之小口袋
sure	稳当
poddock	蟾蜍
forecast	先见
filial	子女
avellan	四臂榛果形的
xanthomelanous	有橄榄色皮肤和黑色头发
gerbil	沙鼠
cast	铸件
mohican	莫希干人
sagamore	酋长
velveteen	平绒
caespitose	簇生
frowsty	闷
corba	Architecture
trueness	真实
graphotype	白垩版
connotative	隐含
unembellished	未修饰的
resolve	决定
discipular	门徒
pose	姿态
accurst	可憎恨
acervate	成堆生长的
enfeoff	授予封
shorthanded	人手不足的
emasculate	阉割了
shonk	犹太佬
nanna	奶奶
solemnify	使严肃
invert	使颠倒
anam	=Annam
slatted	装有板条的
flurry	使狼狈
acerbity	涩
basanite	试金石
dhahran	达兰
contiguous	邻近的
ergataner	类似工蚁的无翼雄蚁
expressional	表现
yellowstone	黄石国家公园
candid	无偏见
downturn	低迷时期
tendential	=tendentious
sidelight	杂闻
pupae	蛹
farrandly	壮丽
kotwal	行政长官
reform	改善
synchronal	同步
groom	推荐
swim	游泳
chantable	可歌的
braver	勇敢
santy	=Santa
contiguous	毗边的
recurved	后弯
homebred	不懂世故的
afraid	担心
dudish	纨裤子弟的
storehouse	仓库
jesuitism	狡猾
canvass	拉选票
parc	Palo
hominine	人的
backwardly	往后地
notate	把……
sioux	苏语的
tutania	锡合金
ideaistic	观念的
gassy	含气的
escap	the
cycloheximide	放线酮
fly	飘扬
goshen	歌珊地
multiparous	经产的
rejective	排斥
extraovate	卵外
fubsy	矮胖的
timing	适时
oaten	麦杆制
distortedness	扭歪
pungle	捐
heartfelt	衷心的
hedonistic	快乐主义者的
briquet	煤饼
profundity	深处
unsuppressed	未压制的
incoherent	不连贯
despiteously	可鄙
conspirator	阴谋者
illogic	缺乏逻辑
informative	见闻广博的
cockneyese	伦敦方言
termini	目的地
kidskin	小山羊皮
pull	拉力
spaceman	太空船上的飞行员
checkman	查票人
checked	棋盘状
polynesian	玻利尼西亚人
methane	沼气
verify	核实
cataclysm	地震
insipience	愚蠢
subjoint	副关节
ingression	进入许可
injured	受委屈的
spaz	笨家伙
giraffine	长颈鹿的
silken	柔软光滑
nonmonetary	非货币的
monachism	修道生活
mill	磨粉机
flagelliform	细长而柔软
spread	传播
undissociated	未离解的
spcc	to
scurvily	粗鄙
applique	贴花的
rbs	Society
beltline	一贯作业生产系统
omniscient	全知
pediatric	小儿科的
regional	域性
scanner	扫描器
referring	谘询
yesty	yesterday
ignore	驳回诉讼
hydrometer	浮秤
nymphlike	似的
indecency	不适当
ingrained	彻底
tupian	图皮语的
thecate	具膜的
calloused	变得无情的
bullionism	金银通货主义
embacle	河中之碎冰堆
knight	武士
optate	选择
silanize	使硅烷化
disenthrall	释放
themselves	他们自己
clemency	温和
jokingly	打趣地
bringdown	使感失望的
woodenheaded	愚蠢的
cinchona	金鸡纳皮
smart	轻快地
costa	前缘脉
interlacement	交织
taxpayer	所收租金只够支付地产税的建筑物
accusatival	宾格的
erotogenic	动欲
belletrist	纯文学作者
republicanize	实行共和政体
extract	榨出物
adulterate	通奸的
gis	system
phonovision	=phonevision
smart	灵巧地
reverent	尊敬的
cv	=cv
ephebus	的18
renominate	再任命
experimentation	实验
administrative	law//
bmj	British
osmolarity	同渗容摩
pigheaded	顽固的
trash	无价值之物
ruffianly	恶棍般
pitch	掷
succedaneous	代用
amnicolous	栖沙滩的
swallowtail	风蝶
favorable	起促进作用
possess	拥有
aquiver	颤抖的
formal	形式的
contrary	逆的
tacmar	Multifunction
mounted	安在马上的
feebleminded	低能的
equal	胜任
aniconic	象征
female	雌兽
film	生薄膜
whiter	苍白的
mayoral	市长的
yellows	黄疸病
delivery	传输
assorted	分类配全
rancorous	怀恶意
riverward	向河地
laminated	层压
bluff	绝壁
woodworking	干木工活
academe	学院
cellularized	分裂为许多小室的
willpower	毅力
broadax	大斧
phalanstery	空想的共产村庄
fend	努力
limnological	湖泊学的
isospondylous	等椎目的
tentative	暂定的
laticifer	乳汁管
batata	山芋
halibut	大比目鱼
perchlorethylene	=perchloroethylene
sepulchral	坟墓的
lankly	细长地
biovular	二卵生双胞胎特有
dinky	不足道
mhs	Handling
vacationland	度假胜地
literate	学者
quittance	免除
wealthy	丰裕
ruined	毁灭
delegitimation	权威丧失
repaint	重新绘制
asocial	缺乏社交性的
acridity	辛辣
curiosity	好奇心
vagabondize	漫游
sulfa	磺胺基
immortalize	使名垂千古
sussy	可疑的
erect	竖立的
chilean	智利人
tdy	duty
marrowless	无髓
dat	Audio
unmeant	无意
unattainable	做不到的
fastigiate	锥形
version	译本
binal	双重的
contributing	起作用的
ultrashort	超短波
intercurrent	并发
discredit	耻辱
tope	佛塔
primal	最初的
duds	旧衣
pentalogy	五部互相连贯的作品
condemnatory	非难
soberminded	持重的
rarotonga	拉罗汤加岛
labret	嘴唇装饰品
coda	完结部
pothead	迷幻药服用者
overtime	延长时间
purl	倒针
byob	booze请自带酒来
bragger	吹牛
depersonalization	失去人性
cockeyed	荒唐的
wampumpeag	白贝壳串珠
vaunting	吹嘘的
corsetry	紧身衣裁制业
awane	衰落中
inauthentic	不真实
cemental	白垩质的
samoyedic	撒摩耶人的
corneous	角状
msfm	森林管理学硕士
equatorial	n
tannin	丹宁酸
particularity	特性
rosedrop	酒糟鼻
submissively	顺从
healthy	健康
trivially	无能
matey	平易近人的
dia	Intelligence
cdsl	用户DSL
flowing	通顺的
xizang	西藏
zirconic	锆的
unpaid	不受报酬
macabre	恐怖的
unanimity	全体一致
cuba	古巴
percival	珀西瓦尔
foppishly	浮华
municipalism	自治制
pit	陷阱
unquestioning	不犹豫的
spine	中心
presession	会议前的
neapolitan	那不勒斯的
lapp	拉普兰人
rhapsodize	写狂想文
coincide	一致
unexpired	未到期
unemotionality	无动于衷
nimble	敏捷
feebie	联邦调查局特工
antipole	相反的极
sheepish	羞怯的
uneven	不均匀的
acephalous	群龙无首
shady	阴暗
assimilate	吸收
mlf	multilateral
beggary	乞食的习惯
applicably	可适用
smotheration	窒息
frostbound	冰冻
twinge	刺痛
accrual	利息
heterosexual	异性爱
rhinosporidiosis	鼻孢子虫病
bloodless	苍白的
smart	刺痛
erigeron	飞蓬属植物
ungated	无门的
irruptive	穿入
hielamon	树皮盾
supremacy	无上
excursionist	旅行者
visit	视察
methyl	甲基
shaman	萨满教的道士
ineloquent	不雄辩的
veronica	婆婆纳
monstrous	荒谬的
tartarize	使酒石化
programable	=programmable
outspread	延伸
magellanic	麦哲伦海峡
miocene	中新统
persimmon	柿子
bvm	Blessed
bactrian	大夏的
cytometry	血细胞计数
joltily	摇动
factualistic	尊重事实
cofacter	余因子
unmew	解放
issuable	可提出抗辩的
beatific	幸福
baluchi	俾路支人讲的伊朗语
airproof	不通气的
coordinate	调整
unmoral	不道德的
irresistible	不能压制的
iotp	Internet
ectropion	睑外翻
tenable	可维持
mailer	包装邮件用的箱
marengo	油炸后加西红柿和蘑菇一起炖
daylong	终日的
unlanded	没有
cherrystone	小圆蛤
dingus	那玩意儿
metaphorical	隐喻性
copperworm	蛀船虫
bimestrial	每两个月发生一次的
tamperproof	可防止乱摆弄的
exterior	外交
polymorphic	多形的
aculeate	一针见血
boulevardier	经常逛林荫大道的人
package	包
radioluminescence	辐射发光
nauseating	厌恶的
joltily	摇动地
trifurcate	三叉的
contumacy	倔强
vibist	=vibraphonist
msts	Transportation
amour	恋情
carnallite	砂金卤石
naiad	水中的仙女
probe	探针
lettered	有学问的
kiruna	基律纳
lordly	有贵族特点的
super	十分
fidgety	难以取悦
hippologist	马学
gal	女孩
gynecium	=gynoecium
theology	神学
wadable	可涉水过
parolee	获假释者
gastroderm	=endoderm
fallacious	虚妄
lashio	腊戍
cointelpro	反谍计划
papalism	教皇制度
dnotice	国防机密通知
fine	晴天
snackery	点心店
thermoscope	验温器
chopper	断路器
enzyme	酶
breton	法国布里多尼人
rangeland	放牧
table	搁置
kidlet	羔羊
analyser	分析者
sweatband	吸汗带
cyathiform	杯状
mediumship	灵媒
puny	小的
mycosis	霉菌病
hyoid	U字形
tong	钳
autumnal	秋的
landslide	崩塌的泥石
radiocardiogram	放射心电图
revealed	透露
energize	给予精力
flockmaster	牧羊人
unbirthday	非生日那一天的
scoticize	=Scotticize
vindicatory	惩罚
monobuoy	单点
photodisintegration	光致分裂
amphimictic	杂交繁育
gotcha	=got
spreadsheet	电子制表软件
shoemaker	皮鞋匠
distinguishing	有区别的
apocalyptic	启示录的
cullis	墙槽
wicked	淘气
unworthily	可耻地
semicolon	分号
crumb	搓碎
tractable	驯良
theatric	剧场
unsized	不依一定尺寸制造
concernedly	担着心
pvt	temperature
laze	偷懒
unjoined	不连接的
cream	乳酪
heady	任性
phototopography	=photogrammetry
brash	碎片
hardhack	绣线菊属的植物
clerk	职员
choanocyte	环细胞
whacking	惊人地
automatize	使自动化
abstinent	禁欲者
created	创造的
ventrotomy	剖腹术
tutor	辅导教师
glair	蛋白
redox	氧化还原作用
serotonergic	血清素激活的
hough	踝关节
surplusage	剩余物
bucketsort'	NULL)
perigon	周角
exertive	费力的
tungstic	五价钨的
kirsen	命名
veblenism	学说
strawboard	硬纸板
blind	瞎的
rwanda	卢旺达
corrupt	被破坏
throatily	喉音地
pragmatics	语用论
oestrus	牛虻
depot	公共汽车站
sob	哭诉
galop	该舞曲
paisana	女伙伴
morphinism	慢性吗啡中毒
nocent	有害的
ncaa	全国大学生体育协会
loggia	房屋敞向花园的部份
mistaken	错误的
thievery	偷窃
monochroic	单色的
cooptative	增选的
abortion	中止
uneducated	没有受过教育
preeminence	卓越
flask	烧瓶
violence	暴行
hurtfully	有害地
aonb	Outstanding
amphion	安菲翁
ternate	三个的
putsch	政变
ecru	本色
fukuoka	福冈
cheek	类似颊的事物
cppcc	Conference
calcium	钙
perilous	危险
farthing	1/4旧便士
invocatory	祈求
sentence	句子
colourcast	彩色电视
middleweight	体重中等的
dawdling	懒散的
uppermost	最高
verdant	青翠的
escritoire	有抽屉的写字桌
replacement	代替者
nicotinism	烟碱中毒
gwyniad	白鲑
olive	奥利夫
primrose	淡黄色的
studious	慎重的
daemonic	似魔鬼
irrationally	不合理地
imagination	听觉
kennel	宿于狗舍
xsl	可扩展样式表语言
flycatcher	京燕
pongee	茧绸
microtektite	微玻陨石
leviathan	海中怪兽
radar	电波探测器
tasmania	塔斯马尼亚州
beneficial	有使用权的
urinant	头朝下的
intrusive	插入
cavendish	烟草饼
preindustrial	工业化前的
tame	乏味的
modom	=madam
hurtling	疾驰的
hardly	几乎不
tap	水龙头
chesterfieldian	柴斯特菲尔德爵士所有的
thatchy	像茅草
incorporable	可包含的
subacute	稍尖
nejd	内志
nondescript	无可名状
socialism	社会主义
nozzle	喷嘴
blackout	眩晕
psychomotor	精神运动的
cyesis	怀孕
theory	学说
evaluate	求……的值
bailiff	地主管家的
mcpo	Master
dumpishly	迟钝地
scenic	布景的
agonisingly	苦闷地
polyneuritis	多神经炎
rap	斥责
apt	切题
amende	赔偿
archine	俄尺
ballroom	跳舞场
struthonian	不敢正视现实
frugally	节省
speciosity	似是而非
prosocial	忠实于既定社会道德准则的
ancient	旧
arbitrariness	霸道
thereout	从其
woodbind	五叶地锦
metacmpile	元编译程序
dvi	Digital
hardware	五金器具
russianise	=Russianize
hominoid	人科之动物
boss	指挥
transitivize	使及物
approximatively	接近
dbms	Management
closer	靠近的
assure	担保
iaupe	Association
esthetical	美
time	时机
terminus	终点站
mordacity	讽刺
irreproachability	无可责备
hag	砍
armistice	休战
ravel	使纠缠
extravaganza	狂妄的言行
crowded	塞满
last	结论性的
rustical	=rustic
unneutral	偏袒的
recolonize	再度移民到……
haematinic	补血药
censorial	检查官
kilovolt	千伏特
estonian	爱沙尼亚
mealymouthed	转弯抹角说的
desirable	令人想要
siliceous	硅土的
mazdaism	拜火教信仰者
chop	剁碎
vagotonia	迷走神经过敏
jwv	War
invidiously	惹人怨恨
flotative	浮力的
proconsulate	总督的职位或任期
theileriasis	泰勒尔梨浆虫病
recherche	讲究
exenterate	用外科手术去除
suffumigate	用烟在下面熏
minuscule	极小
deductible	可扣除
nonpersistent	非持久
fasces	束棒
exceed	超越
lambdacism	把/l/读作/r/的错误发音
foist	私自添加
foreseeingly	深谋远虑
posh	时髦地
volcanically	猛烈地
grandiloquent	浮夸
playground	运动场
scar	疤痕
zg	garden
lactescent	分泌乳液
unseemly	不适宜的
concessional	让步
ramshackle	摇摇欲坠
emasculate	阉割
manageability	易处理
unacquirable	不可取
retrovirus	逆转录酶病毒
cryptic	秘密
manatee	海牛
huskily	嘎声地
rapturously	狂喜
scoliid	土蜂科
closeness	狭窄
deflationist	主张通货紧缩者
vicarial	教区牧师
perithelium	周皮
iffy	不确定
fasciated	带化的
inappreciably	微不足道
bathysphere	深海调查用球形潜水装置
estreat	摘抄
dwarfish	矮小的
compliably	依从地
nape	项
sore	疼痛
queue	长队
unlearned	没学好的
overdress	外衣
tailfirst	尾在前
thorax	胸腔
stream	涌
reenaction	再扮演
joke	开玩笑
ddn	数字数据网络
lance	切开
suspensive	可疑的
costarica	哥斯达黎加
fibroelastic	纤维弹性组织
leisured	从容不迫
unglove	脱下手套
rld	retail
overearnest	过于热切
pluralistic	兼管数个教堂
sulfuration	硫化
pellicular	薄膜
kookiness	傻
rsvp	please
primiparous	初次分娩
descending	递减
related	叙述
western	西
catface	畸形
dazed	头昏
oratrix	=oratress)
indigitation	肠套叠
nondiapausing	非滞育中的
vesical	膀胱的
snorer	打鼾者
rappel	用绳索下口
aperiodic	非周期的
riverine	河流
gerontophobia	赠恨老人
piquant	辛辣的
splenetic	脾气坏
sneezy	有喷嚏
corrigibility	可订正
sparing	保守的
enaction	=enactment
succinctness	简洁
ventriloquial	口技的
lifesome	生动
effectually	有法律效力
cold	使人战栗
anthropological	人类学上/人类学上的
fulminous	像迅雷
rubensesque	具有鲁本斯绘画特征
clanger	过失
heliotaxis	背日性
parosmia	嗅觉异常
wight	人类
par	平价
breathless	喘不过气来
tame	被开垦
prehension	抓住
quencher	淬火
satellitic	卫星的
kitty	基蒂
catkin	柔荑花
ambiguously	引起歧异地
spur	剌激物
ionophoresis	离子电泳作用
illude	置……于幻觉中
blepharoplasty	眼睑整容术
ensate	剑状
windup	结束
ocean	广阔
unrent	不受侵扰
dormin	休眠素
autolithograph	直接苀I/
geisha	艺妓
ctol	and
alberich	矮子国国王
overwrite	写得过多
overheat	变得过热
cautiously	慎重
soggy	沉闷的
cracky	多裂缝
altho	虽然
bronchography	支气管造影
goatling	小山羊
hyperaphic	触觉过敏的
malone	Edmond
sbr	Styrene
rarest	最珍贵
malariology	疟疾学
bucketeer	股票投机行的老板
interdependent	相互依存
procurance	获得
resumptive	概括
roundup	围捕
gallery	画廊
vainglory	自负
begun	begin的过去分词
ultimate	根本的
inturned	性格内向
robert	罗伯特
with	赞成
hades	阎王
out	出局的
britishly	似英国人地
interjectional	感蘨ze/9IntE`dVekFL敬实
sexual	性的
refreshing	凉爽的
loose	不牢固
unfindable	找不到
predigest	简化
jnd	Difference
put	掷
coly	齿鹑
golgotha	基督被钉死之
burl	去掉节
numerate	数
laniferous	有羊毛的
mariology	关于圣母马利亚的学说
corruptibly	易腐败
ephemerality	朝生暮死
staphyloplasty	悬雍垂成形术
pietermaritzburg	彼得马里茨堡
unconscious	不省人事
clinging	执着的
fenny	沼泽的
fenian	芬尼亚会的
detectible	可发觉
analects	论集
slip	串行线路接口协议
indefatigably	不厌倦
outshoot	外角球
parry	躲避
creepered	蔓草丛生
pasquil	=pasquinade
justification	理由
hypnopompic	半有意识状态
hungarian	匈牙利的
studhorse	种马
discarnate	脱离肉体的
posthole	地上所掘的插旗秆或电线用的洞
unworthily	不相称
israelitic	希伯来人的
essay	散文
specilize	特殊化
collaborative	协作
synchroscope	同步检定器
fixup	固定
demonic	恶魔
fluke	意外受挫
subsection	分部
ahem	咳嗽或清嗓子的声音
crossly	横
indrawal	内流
bosk	树丛
frank	弗兰克
anecdotic	爱谈轶事的
mystagogical	解释神秘
imitator	模仿者
chaucerism	乔叟式的文体
eurythmy	=eurhythmy
needlessly	无用
soigne	整齐的
appetizing	促进食欲的
ledgy	有暗礁
exiguity	微小
sizable	相当大的
antidiphtheritic	抗白喉
swannery	天鹅饲养
tumultuate	引起骚动
incongruously	不调和地
saree	纱丽服
phanerogamic	显花植物
centum	百
vandalic	汪达尔人
activity	行动
educe	导出
extemporaneous	无准备的
unwavering	不动摇
chitchat	闲谈
hdcd	Disc
grillroom	炙肉房
hepatogenous	肝原的
objectivity	客观现实
prongy	叉状
sleet	冰雨
anymore	不再
ancestry	家系
jesuitical	狡猾
zif	Force
buoyancy	浮性
plastid	成形原体
undependable	不可靠
flex	vi折曲
tcp	/TCP/IP栈
myg	myriagram
bucketful	满桶
geocentrical	由地球中心所见或测量
thundering	非常的极大的
dmt	discrete
baton	司令棒
reversedly	反转地
longe	使用练马绳练马
cocktail	鸡尾酒的
weather	迎风的
positive	实际
despairingly	绝望地
musicologist	音乐学者
aurae	气氛
manageable	易处理的
renegue	出牌违例
numerously	无数地
paperless	无纸传输信息
forehanded	对将来有预备的
reliant	信赖自己
verus	真的
rajaship	君主、王公或酋长的地位
fleetful	大批
dud	哑弹
rah	激动
disadvantaged	贫穷的
salted	有免疫力
interdependent	相互依赖
budding	萌芽的
nickelous	二价镍
circle	圆周
fitment	装修
jitterbug	跳吉特巴舞
headguard	橄榄球员的头盔
demandable	可请求
heathy	石南似
lambkin	宝贝
crusian	carp
pedagese	教育界行话
melissa	蜜蜂花
palliative	辩解
upmost	最高
fascinating	着魔
mask	化装
jarrah	红柳桉树
wild	疯狂的
quickness	急速
uneducable	不堪造就的
cowhearted	怯懦
refractional	屈折
bookcase	书架
declaratory	宣言的
scared	恐惧的
spoken	口语的
debatable	可争议的
noncombustible	不燃物
fit	安装
pratfall	不象样的失态
convincingly	有说服力地
flush	晕红
reducible	可简化
awshucks	羞怯的
ground	具有基础
preemption	取代
unpolluted	清洁
clamant	急迫的
marriage	结婚
floating	不固定的
smell	散发气味
comeliness	好看的
static	静力
churn	搅动
filtration	筛选
reactivity	反应
sinless	清白
dare	不惧
ration	分发
iniquitious	邪恶的
pacesetter	步调调整者
wildfire	散布极快的事物
unresponsive	无答复的
poodle	狮子狗
whiff	一吸
failing	弱点
hagiarchy	圣人之间的尊卑次序组织
pityingly	可怜
loss	浪费
total	全部
sneeringly	轻蔑地
osteal	骨的
characterisation	=characterization
tumefacient	使肿胀的
hydrobiology	水生生物学
confection	调制
expeditious	迅速的
epifocal	震中的
nog	钉
loadage	装载量
blandly	殷勤
sackless	无害
notate	以符号表示
polydomous	多巢
flanker	侧面部队
insectival	昆虫
arcaded	有列拱
finnip	英国五镑钱币
cuboid	立方的
falconer	放鹰者
refreeze	再结冰
qarnns	Royal
definitive	确定的
federate	同盟的
fatigueless	不会疲劳的
serous	含浆液的
lather	涂以肥皂泡
sel	=self
arabian	阿拉伯人的
pestle	用杵捣
dynameter	倍率计
hedgepig	环形筑垒阵
prepared	精制的
fastish	有些放荡
accord	协定
pdq	马上
provisional	临时的
defeminize	使去女性化
assumed	假装的
lutetian	巴黎的
pluteus	长腕幼虫
ahead	向前
underdo	使做得不够
plethoric	多血症
actionability	可控诉的情形
cloud	烟云
mumm	=mum
unfeigned	真实
typically	作为特色
medicable	可治疗
fortnightly	隔周发行的
railwayed	有铁路的
hieratic	僧侣用的
fetichist	盲目崇拜者
viticulture	葡萄栽培
vulcanic	硫化
frumpy	心地不良的
hippus	虹膜痉挛
resite	给……择新址
most	极其
hunter	猎人
superheterodyne	超屯獠钍绞找艋
nicish	精密的
polyspermous	多种子的
forgivingly	宽大
dress	穿衣
commove	使动摇
argonautic	号远征的
actinolite	阳起石
uniparous	每次只产一卵的
hyperphysical	与肉体分开的
mercantilism	商人本性
dispersion	差量
hypnotize	施催眠术
asturian	阿斯图里亚斯人的
giardiasis	贾第鞭毛虫病
unsubmissive	坚强不屈
leprous	患麻疯病的
deodorizer	除臭剂
hysterics	歇斯底里症的发作
anglophobia	恐英病
reinsertion	再插入
palmatifid	掌状半裂的
tenpence	十便士
msha	Hospital
purr	咕噜咕噜声
interbedded	夹层之间的
loose	自由
pachinko	弹球盘
homopause	均质层顶
raggie	非常亲密的朋友
wreathe	环绕盘旋
euxenite	黑稀金矿
yammer	叹息
uneducated	无知
candela	小雪茄烟的
permeate	充满
fluid	不固定的
ridicule	嘲笑
abrader	研磨器
peg	Peg
quintuplicate	五倍的
didy	尿布
grain	谷粒
deformable	可变形
enteroptosis	肠下垂
hopping	忙碌的
corticate	有树皮的
pigfish	鸡鱼科的小鱼
nationalism	民族之特性
vindicative	惩罚的
downswing	下降趋势
fibroid	纤维瘤
lighting	舞台灯光
highly	高地
alternately	交替地
husky	像谷的
underserved	服务水平低下
parcae	命运三女神
verve	神韵
whys	原因
stateside	美国本土
philanthropize	慈善地对待
moocher	鬼头鬼脑的人
drinking	喝
peacebreaking	扰乱治安
shad	西鲱
allantoid	尿囊样的
quadrillionth	千万亿分之一的
hoot	猫头鹰叫
niggard	吝啬的
cruelly	残酷地
literality	直译
directtissima	直接攻击
polder	开拓地
sootlike	似煤炱的
availability	实用性
loun	笨人
demotics	社会学
nodus	结节
haplont	单倍体
sonarman	海军声纳兵
uncreolized	未克里奥尔化的
formulable	可用公式表示
farfal	=farfel
parti	理想配偶
finitary	有限性的
exiled	放逐
unparalleled	无比
eva	舱外活动
linoleate	亚油酸盐
fireless	没有火焰
tax	使负重担
ravel	错综复杂的一团
dispassionately	不动感情地
calumet	和平的象征
olympiad	四年周期
cornucopian	丰饶
piratical	剽窃
acuate	锐利
treat	作东
gyrectomy	脑回切除
boisterous	狂暴的
sneeshing	鼻烟
horseless	无马的
uncarpeted	未铺地毯
panouchi	=panocha
monochromatic	单色
crossbreed	异种交配
deodand	赎罪奉献物
ingenerate	内在
whoopee	欢庆
consolidate	巩固
toothsome	好看
deviltry	残暴
twybill	=twibil
intertangle	使纠缠
foreclose	阻止
sickee	精神病患者
nephrocardiac	肾脏和心脏的
anaesthetization	麻痹
goethean	歌德的崇拜者
tipsy	喝醉
impractical	昧于实际
zaikai	商界
keystone	基本原理
struggling	努力的
score	抓痕
arbitrational	关于仲裁的
gaily	欢乐地
essentialist	基本教育说
upturned	朝上的
puzzling	使莫明其妙
iaaf	Athletic
valetudinarian	dI`IEn/
untamed	不能抑制
detritivorous	食粪
abirritation	镇痛作用
gast	使惊讶
filmstrip	电影胶片
gpd	day
meticulous	小心翼翼的
early	早期的
adriatic	亚得里亚海沿岸居民
anuclear	无细胞核的
upheave	隆起
epigeal	浅水生长的
treadboard	踏板
imperfectly	没完
incivilization	野蛮
unfelt	不感动
debasement	改造
intromittent	插入
cub	幼兽
azide	叠氮化物
pretonic	重读音节前的音节的
marsh	沼泽
infinite	无穷
withal	又
tristesse	悲哀
vocable	词外壳
egypt	埃及
drear	阴沉
motley	混杂的
combatant	战斗
sylvics	=silvics
heteroploid	非整倍体的
norsk	挪威人
scrubby	树丛繁盛的
clatter	喧闹的谈笑
butut	布图
larker	嬉戏者
confucian	儒家
unsoldierly	不像军人的
yager	狙击兵
rhodamine	若丹明
capitalintensive	资本集约的
locksmithing	锁匠行业
abrase	磨损
garment	衣服
whorl	轮生体
stupefactive	使失去知觉的
unkindly	不亲切
totem	标识
venturesomely	卤莽
deuteronomic	申命记
ocso	Observance
atactic	不合语法的
tanniferous	生丹宁酸
antimonarchic	反君主政体的
hardcore	绝对
rolled	包金箔的
ruthenious	二价钌
syringomyelia	脊髓空洞症
clypeate	有唇基
inturned	内弯
redistribute	重新分配
outside	在外面
obituary	死亡
steamy	多蒸汽
devotional	信仰
speaker	说话者
coloured	有彩色
barbarous	沙哑
elytra	翅基
nogging	壁砖
methodologist	方法学学者
cloak	宽大外衣
pubic	耻骨的
qaranc	Army
grike	岩沟
similarity	类似
eyestalk	眼柄
matchwood	做火柴杆的木料
station	驻扎
dermoidal	=dermoid
imperfectible	不可能完美的
adamic	亚当
nontitle	赛的
flounderingly	总是失败
gynaecoid	具女性特点
anisocercal	不等尾叶的
bereavement	丧亡
outlandish	奇异
actinoid	放射线状
synectics	共同研讨
controversial	争议
erotophobic	憎恶性爱的
christless	违反基督精神的
reference	涉及
nullarbor	Plain
quizzical	引人发笑
symmetrical	对称
direttissima	陡峭攀登
ceraceous	蜡状
ectypal	复制
readiness	准备就绪
mesothorium	新钍
conceivable	想得到的
alphanumeric	包括文字与数字
diphycercal	圆尾鳍
nonpositive	负值
winning	赢得物
clansman	同族的人
narcotic	致幻毒品
amphicoelian	两凹
irrepealable	不可废除的
bluesy	布鲁斯乐
improvisatore	即兴诗人
inadvisability	失策
primy	在最佳期
crust	面包皮
fair	公正地
coastel	水上营房
lathing	覆以板条
gunport	枪眼
chip	碎裂
ceresin	地蜡
misfit	不适合的东西
i2o	智能输入/输出技术
pascual	牧场
anamnestic	记忆的
tranquilly	安静地
already	已经
gannet	塘鹅
cochleate	状如蜗牛壳
mucosa	membrane
flambe	烧过的
biconditional	双态
ccitt	Consultative
klipspringer	山羚
prevue	预告片
sfx	effects
breaststroke	蛙式
ultramarine	天青石做成的蓝色颜料
liberative	同意释放
toothful	微小
hologynic	全雌遗传
crosslet	小十字形
skittish	轻佻的
fallen	陷落的
sulfur	硫黄
shortweight	重量不足
currently	通常地
flaring	燃烧的
apothecial	子囊盘的
alliterative	头韵
unadvised	未曾受到劝告
loggerhead	傻子
average	达到平均水平
nerf	冲撞别的汽车
flyer	传单
desirability	希求
comate	有毛
polypragmatical	爱干涉的
mere	纯粹
swaybacked	弄伤了背
karyosome	染色质核仁
fixedly	不变
flutter	鼓翼
proposal	提议
spectrally	幽灵似地
unwind	展开
nupe	Public
insobriety	饮酒过度
outline	外形
ondometer	频率计
undo	撤消
admiral	海军上将
emarcid	枯萎的
condensability	可简约性
noaa	Administration国家海洋和大气局
endamage	使损坏
ethnoarchaeology	种族文化考古学
phonolite	响岩
lapidarian	刻在石头上
befuddle	使迷糊
telecom	电信
condignly	应受
underlet	转租
christless	违反基督精神
harmine	骆驼蓬碱
beckon	召唤
yttrium	符号Y
dprk	Republic
stainless	纯洁的
enunciator	声明者
wise	博学
vinca	长春蔓
orismology	术语学
selenous	=selenious
menagerie	动物展览
keratometric	角膜弯度计
unboundedly	无限制
reconstructed	改造的
atrazine	莠去津
efflorescent	风化的
shoofly	摇动木马
vatic	预言的
necropolis	大墓
debouchment	河口
diluent	稀释
smalt	深蓝色
etherization	化为醚
questionable	可疑
fissionable	可裂变物质
bioenergetics	生物能学
path	通道
plant	种植
tupelo	紫树木材
tweak	拧
cardinal	红衣主教
wormseed	土荆芥属植物
definition	清晰度
sclerodactylia	指硬皮病
intersidereal	=interstellar
erratic	奇怪
unclamp	松开……的夹钳
displeasure	不满意
vilyui	维柳伊河
girdle	围绕
britisher	英国人
trillionth	第一百万兆
criminy	老天
counterappeal	抗告
sexagesimal	六十进位
impertinently	不礼貌地
alight	点着
debilitated	操劳过度的
mlw	mean
veritable	真正的
theropod	兽脚亚目食肉恐龙
bios	Input
tetraalkyllead	四烷基铅
guggenheim	=Guggenheim
gram	鹰嘴豆
hesped	悼词
balminess	爽快
unreligious	非宗教
unpliant	不柔顺
guide	引导者
constabular	保安队的
vicenary	20的
whig	辉格党
tyrolean	提洛尔区居民
early	早熟
vmtp	多用报文处理协议
german	德国人的
leaden	沉重的
love	性爱
eth	=edh
alluvium	冲积层
execute	制成
tramp	践踏
plaintful	悲叹的
serialize	连载
helleri	剑尾鱼
foreboding	预兆的
besieged	使烦恼
jank	同时改变飞行高度和方向
columba	天鸽座
xylophilous	适木的
cripplehood	无能
wolf	极度的穷困
fibrillous	纤丝状
lacy	花边
do	制作
eccentricity	偏心
jumbuck	绵羊
mall	林荫路
console	控制台
p	人员
cruelly	残忍地
skytroops	伞兵部队
incapable	不能的
tutelary	保护
unguligrade	蹄行的
cannonade	连续开炮
messidor	收获月
wolf	残忍贪婪之人
insectivize	施行强暴统治使沦为奴役
petrinism	彼得首位论
fungistat	抑真菌剂
august	令人敬畏
horsefaced	似马脸
frostbound	不热情
superradiant	超辐射
thin	薄地
recrementitious	垃圾造成的
hmv	His
trapes	懒妇
adiaphoretic	止汗
lumbricoid	蛔虫
coach	长途汽车
suberose	软木质
praetorian	禁卫队的
cuso	加拿大大学海外服务处
tahine	芝麻酱
aids	爱滋病
autostrada	意大利的高速公路
dishonorably	卑劣
cambogia	藤黄
cupric	二价铜
injunctive	指令的
bedehouse	=beadhouse
phonematic	音位学的
bluesman	的人
maddish	有点疯狂的
kunzite	紫锂辉石
pornography	色情文学
plectognath	愈颌目鱼
gabble	七嘴八嘴地说
smallholding	小农场
wolf	狼
recapitulate	摘要
debacle	崩溃
hieland	易上当
overproportion	不平衡
motherboard	底板
drunk	的过去分词
sedulous	坚韧不拔
noways	一点……也不
reprogram	改编
gingival	齿龈的
prediabetic	前驱糖尿病
partner	合伙人
methodic	有组织
dignified	有威严
unmarry	和……离婚
reflexible	反射性
bagged	松弛下垂
tarsal	跗骨
bloodshot	有血丝
mirthful	愉快
gradualness	逐渐的
noumenon	本体
epigenous	生长于叶面
cervine	鹿
scepticize	怀疑一切
cubital	前膊
anzac	新西兰军团之士兵
smsa	Standard
contextless	无连贯性的
sulphurator	硫磺熏蒸器
cervelat	熏香肠
honied	多蜜的
spend	消磨
indecorousness	无礼
hydrofluoric	含氟化氢
koala	树袋熊
mind	精神
radio	用无线电发送
isoagglutinin	同种凝集素
lifesome	有力的
hypothecate	担保
nooky	性交时的女性
toffee	中褐色
allantoid	尿囊的
discipula	门徒的
swingeing	极大的
cation	阳离子
dependent	依赖的
acclivous	向上斜
abandon	遗弃
nautical	船舶
tall	夸大地
pasquinade	讽刺诗
nasty	威胁
acetic	醋
themselves	她们自己
ochlocrat	主张暴民政治的人
rantipole	喧闹的
roentgenolucent	X光可通过的
subsequent	并发
ruckle	起绉褶
recalcitrate	顽抗
wattle	用编条做成
mridang	姆里丹鼓
floriated	具有花卉装饰
dioptometer	眼折光力计
vagabond	流浪的
equinoctial	春分或秋分时的暴风雨
crenel	城或墙顶之垛口
creationary	创造性
misdiagnose	错误地诊断
fiat	批准
jacobian	雅可比行列式
molder	分裂
foliiform	叶形
bazaari	店主
nop	not
deliration	精神错乱
illusionism	幻想说
guarantee	担保
parallel	平行线
sedentary	久坐的
annihilative	有消灭能力的
earworm	一种有害幼虫
revise	修改
snipe	鹬
immanency	内在性
exalted	尊贵的
cleansing	有去污作用
ratafee	果酒
ophidian	蛇
fowling	打鸟
managership	经理的地位
lithotritist	膀胱结石碎石专科医师
mongoloid	先头愚型患者
calciphobous	不适于石灰质土壤之植物的
underfinanced	资金短缺的
spermic	种子的
gnawing	咬的
around	在……周围
yourself	pro
coupist	政变支持者
flourish	繁荣
ncv	commercial
isobutylene	异丁烯
deepwater	靠近海洋的
protanope	红色盲者
information	报告
misspoke	读错
breadbox	面包盒
deferentially	表示敬意
buprestid	吉丁虫
fslic	Savings
thankfully	感激地
raphide	针晶体
grim	严酷的
reward	奖金
boardroom	交换场所
undertake	保证
purgation	净化
reflectional	反映的
balloonist	气球驾驶者
ungual	爪似
overexert	用力过度
boottree	鞋楦
bechic	治咳嗽
courtyard	院子
organically	器官上地
coagulation	凝结
scrap	文章
precaution	防范
heliotactic	向日性的
embossment	浮雕工作
lounder	重击
aristotelian	亚里斯多德
linkup	会合
yeanling	小羊
reducible	可减少的
debut	开张
lung	呼吸器
duplicity	狡猾
nights	夜间
aqua	浅绿色的
keening	哭丧
franciscan	圣芳济会的
lineskipper	不按排队顺序抢先的人
superexcellent	卓越的
iadl	国际民主法律工作者协会
lovable	可爱
choreographic	舞蹈术
monstrous	凶暴
coi	Office
matinee	白天举行的音乐会
accommodationist	妥协者
schismatic	分裂论
collapsar	为blackhole之别称
promulgation	颁布
ruthless	无情的
airsick	晕机
ineradicable	根深蒂固
sempiternal	永久
convertiplane	可以垂直升降的飞机
wilson	威尔逊云室
misdistribution	不当
probationership	试用期间
runnerless	无长匐茎的
oreshoot	富矿体
featly	优美
ambrosia	特别美味的食物
phlogopite	金云母
aghast	吓呆的
moujik	农民
ludicrously	滑稽地
federal	联邦制
caveat	告诫
erotogenic	引起性欲
moony	恍惚的
creamer	乳酪分离器
proselytism	改变信仰
lean	倾向
tutelary	守护神
hominoid	似人猿
disambiguate	消除……的歧义
overassessment	估价过高
pardonably	可原谅地
subtitle	副题
colonnaded	有列柱
indefinably	不明确
moulder	制模工
judgement	审判
ammoniacal	氨的
course	运行
timeous	=timely
supercolossal	巨大的
perfoliate	茎贯穿叶而生长
jeopardousness	冒险
pilgrimize	使成为朝圣者
stylebook	时装式样本
outvalue	比……更有价值
chapbook	小本的诗歌集或故事书
featureless	无特色
audacious	大胆创新
immorality	不道德
worldful	全世界所能容纳之最大容量
childbed	产褥
weatherproof	不受天气影响的
vertebra	椎骨
monostome	具单盘的
prancy	腾跃的
coccus	球菌
veterinary	兽医
antalkaline	抗碱
chowderhead	愚笨的人
unpopular	不受欢迎的
dance	跳舞
polenta	以玉米或大麦或栗粉等煮的粥
contagion	歪风
taboo	禁制
knifepoint	刀尖
clarinet	竖笛
brackish	有盐味的
slack	懒散
lettered	精通文学
facilely	轻易
haifa	海法
levelpeg	保持势均力敌
rare	半熟的
muchly	长久
nonresidence	不住在任所
interoperability	/互用bIlEtI/互用性
prescience	预知
hatty	Harriot
republican	有关共和
hadron	强子
dropout	中途退学
ssr	苏维埃社会主义共和国
bulbous	球根状
anoa	小野牛
fingery	排成指状
dna	Distributed
sapient	伶俐
indent	契约
outward	在外
congratulatory	祝贺的
costotome	肋骨刀
despondency	失去勇气
automorphism	自同构
confluent	汇合的
lithophilous	生长在多石环境的
neglected	被忽视的
valiantly	勇猛地
weatherboard	装以护墙板
exceptional	异常的
vatic	预言
shirr	拉成褶
skelp	快步走
mitigatory	缓解的
tinty	色彩不调和的
prominently	显著
archangelic	天使长
unenlivened	无生气
minish	缩小
euphuism	夸饰文体
zorille	臭鼬动物
battels	学生膳宿杂费帐目
kanarese	卡纳拉人的
remove	升级
metafemale	超雌
incretionary	激素的
incognito	隐名埋姓的
antipyrotic	消炎
favoringly	有帮助地
plead	托称
hereditarily	世袭
indigently	穷困
luminaire	泛光灯
manufacturing	制造业
recuperative	使恢复
gadolinite	硅铍钇矿
vasotomy	输精管切断术
foretop	前桅楼
hydroid	水螅虫
moldingplane	=mouldingplane
grungy	丑的
swanky	爱出风头
humidify	使潮湿
avens	水杨梅属植物
unbenefited	未得到好处的
wampee	黄皮
lisping	口齿不清
rye	绅士
fauvist	野兽派风格
trainsick	晕火车
astable	非稳态的
indigent	贫乏
wolfer	狼吞虎咽的人
cretan	克利特岛的
nibmar	先组成由非洲人代表占大多数的政府然后准许独立
england	英格兰
multipurpose	多目标
apocalypticism	启示论
macropodous	大胚轴的
prevaricator	说话搪塞的人
cryptozoite	潜隐体
calculous	结石的
corpselike	似尸体的
lacunose	多空隙的
vend	公开发表
primrose	报春花
staph	=staphylococcus
fuscescent	略带暗褐色
embryon	表示"胚
asio	Stream
intubate	把管子插进
barebacked	无鞍的
whaleback	鲸背船
unlively	无生气
polyglot	通晓数种语言
holozoic	全动物营养性的
slablike	板状的
supposition	想象
leavy	多叶的
swarthily	黑黝黝
spoilbank	矸石堆
cordilleras	南美安地斯山系
vulcanizate	硫化产品
gray	老练的
junkyard	旧汽车丢弃的地方
whence	从哪里
helsingfors	=Helsinki
vox	声音
currier	鞣皮匠
pukkah	纯良
appositive	同位格
exceptionable	可反对的
conte	小故事
bicker	流水声
subtilise	=subtilize
carcass	畜体
fearful	吓人的
scant	节省
otto	玫瑰油
arbitrative	有权公断
alary	翼状的
precedents	引用单元
motley	混杂
unco	不知名的
bewray	泄露
petticoat	裙子
mtbf	Failures
thallous	铊的
visionally	梦幻般地
centric	中心
comminatory	威吓的
jaundice	使患黄疸
straggling	脱离队伍的
clearing	空旷
counterplea	抗辩
canvass	劝诱
lambkin	小羊
strained	做作
flexural	弯曲
polyprotodont	多门齿类动物
rhymist	诗人
insusceptibly	不受影响
eyealyzer	眼测醉
refreshing	提神的
generation	发生
rigidify	僵化
invertebrate	无骨气
ossification	骨化
waspish	如黄蜂的
annunciatory	预告的
apheliotropic	背光性
semiuncial	半恩锡尔字体
chink	中国佬
wake	警觉
librarian	图书管理员
thud	重击
urinose	尿的
unwelcome	讨厌的
swirl	漩涡
cubeb	含有荜澄茄粉的药用香烟
violet	紫罗兰色
lemma	辅助定理
furibund	愤怒
pindaric	风格的诗
intracutaneous	皮内
ochreous	赭石的
atherogenic	导致动脉粥样化的
hexahydrothymol	六氢百里香酚
immiserization	悲惨化
inapplicable	不适用
claudian	克劳狄族人的
joyo	卓越网
socialistic	社会主义的
exhaustion	筋疲力尽
shoppe	专柜
sennight	一星期
kmps	kilometres
homoscedasticity	同方差性
usha	美国住房管理局
beplaster	布满
uncommitted	未遂的
wrcb	Board
captation	以狡猾手段谋取利益
armipotence	兵力强大
limited	高级快车
vamp	捏造
apollinian	=Apollonian
axinite	斧石
winning	胜利的
residual	剩余的
power	能力
contrived	做作
sweeping	彻底的
coordinate	整理
unido	Development
downy	多丘岗的
hereditarily	遗传
excremental	排泄物
blueing	带青色
coarsely	鄙俗地
frock	僧衣
astasia	不能站立
ccpit	Trade
rough	粗野的
aspca	to
arioso	咏叹调的
sodomist	尸奸者
piccaninny	小孩子
minor	二流
plebs	平民
twiggy	多细枝的
everglade	沼泽
pentagraph	个字母
ghibli	朝向风
lunkhead	呆子
bowed	有弓的
ipsu	Utility
porphyrization	研细
phoniatrics	语音矫正法
gravific	使变重
unperfect	=imperfect
sententious	警句
paternal	象父亲
verminicide	灭虫剂
seedily	心情不佳
accentual	重音的
finely	美好
combination	联合
wee	很早的
disclaimatory	否认的
carla	卡拉
ubication	场所
perceptible	显而易见
capnomancy	用烟占卜
admirably	极好
impossible	难以忍受
reradiative	再辐射
retaliation	报仇
contributory	捐助的
psychometrics	心理测验学
misaligned	不重合的
trichomonal	毛滴虫引起的
drophead	活动帆布车顶
plutus	财神
telecurietherapy	=teletherapy
wheeled	有轮的
vertebratus	脊状
prejudiced	怀偏见
stupid	麻木的
amok	杀气腾腾地
godfather	当教父
exemplar	模范
pococurantism	不热心
cadmiferous	含镉的
rabbiter	捕兔者
pish	表示轻蔑
cloak	披斗篷
acanthi	acanthus的复数
muzzleloading	前装式的
unprovided	无供给的
unpatterned	无图案装饰
kotka	科特卡
oberon	之夫
actual	目前
roomie	=roommate
diffusive	散布性的
drop	落下
dispope	罢黜教皇的职位
anthophagous	以花为食
knobbiness	多小丘
classwork	在教室做的功课
psychogeriatric	`psaIkEJ9dVer`AtrIk/
vestibule	前厅
ensanguined	满身染血的
monohydroxy	一羟基的
collude	串通
valuable	颇有价值的
voluntary	自愿
puerperal	产后
abiogenetic	偶发的
complainant	原告
colonic	结肠的
aconitic	附子的
unhcr	for
epicondylar	上髁
assuage	减轻
soundproof	隔音
flourish	手舞足蹈
armature	牙齿
tolerant	宽恕的
bmr	metabolic
allophane	水铝英石
minoan	克里特文明的
plutocratic	财阀
necessity	需要
atomization	分离成原子
kithe	证明
upriver	在上游
telophase	末期
humiliating	羞辱性
shyly	害羞
provocate	惹起
yamoussoukro	亚穆苏克罗
homeomorphous	同胚的
nowaday	当前
bps	second
safedeposit	安全保管
bft	Transfer
treblinka	特雷布林卡
mammock	碎块
shoeless	无鞋的
cacodyl	二甲砷基
sorbonnist	=Sorbonist
limit	限制
nickeline	红砷镍矿
rounding	舍入
unhip	不谙时髦的
worshipful	值得尊敬
voyeur	窥淫狂病人
carcinoid	良性肿瘤的
barouche	一种四轮两座大马车
easel	黑板架
handwoven	以手织机编织
disagreement	意见不同
quaintly	古雅别致
episcopalian	主教派会员
labour	支持工党的
edgeways	以刃向外
stop	被塞住
unappealing	不能打动人
god	上帝
poll	选举中获
barred	被禁止
sedimentable	可沉淀
nasara	Nasrani
hypodorian	副多里亚调的
smd	of
algebraist	代数学家
institute	协会
unattained	未获
insessorial	适合于栖止
deficiently	不充分地
retrodisplacement	后移位
hairdresser	理发师
konstanz	=Constance
funicle	纤维
favela	贫民区
extrabold	用特黑体字排印
excentral	中心以外
ue	Electrical
chattily	爱讲闲话地
belligerent	好战
cuss	坏话
recondense	再浓缩
gastrostege	蛇腹部之鳞
linty	有棉絮的
onstage	台上的
unplagued	未染瘟疫
driftage	风落
chuffy	像农夫
worsen	变得更坏
misdiagnosis	错误的判断
synovia	关节骨液
gymnosophist	天体主义者
vapidness	无趣
conduit	泉水
mandatory	强制的
licensee	获许可的人
unseconded	无人后援的
mobbist	暴徒
hieland	易受骗
quotha	确实!
merryman	丑角
combustibility	燃烧性
charge	责令
governable	可统治的
unsaddle	使坠马
coranto	=courante
biquadratic	四次
nerd	卑微的人
whole	所有的
rate	被评价
limonitic	由褐铁矿构成的
distribution	分配
mock	模仿
gneissic	像片麻岩
lacustrian	湖的
felicitation	庆贺
infinitesimal	极小
smith	金属品工匠
postcode	邮递区号
mina	古代希腊的金额单位
photolyze	用光分解
karabiner	岩钉钢环
arid	贫瘠的
fulminatory	爆鸣的
lixiviate	浸滤
irreclaimable	不可矫正的
retardance	阻滞
jauk	拖延
breadthways	横
androgenous	雄性单性生殖
wvf	Veterans
filigree	饰有金银丝细工
muzzy	无精神
unwarmed	未被激动的
hereupon	因此
pogonip	冰雾
archaist	爱写古体文者
sarcoma	肉瘤
bibiolatrist	书籍崇拜者
floating	流动
overflow	泛滥
wood	木材
sculpture	雕塑品
glandular	有腺的
aok	完美的
cony	兔毛皮
impromptu	即席的
peaceably	温和地
shufty	=shufti
caiaphas	该亚法
aduncate	向内弯曲
stingy	有刺的
distinguishing	有区别
basipetal	由上往下
resource	智谋
unmeasurable	不可测
phyllotaxic	叶序
mechanical	呆板的
convulsion	惊厥
essential	提炼的
whitehanded	清白的
eunuchoid	惧内
untapped	塞子未开
interlinear	隔一行书写原文和译文
handicap	阻碍
introspective	反省
internationally	国际性地
wheeze	喘息
identifier	标识符
impropriety	不适当
fool	莽汉
leucopoiesis	白细胞生成
ylem	伊伦
snorty	心眼小的
dawk	非鹰非鸽派
elbert	埃尔伯特
polemology	战争研究
netop	伙伴
riparian	水滨
pocket	隐藏
thinker	心智
epical	英勇的
trichocyst	丝胞
soil	土
unconsolidated	松散
fecund	多产的
blithely	愉快地
tambov	坦波夫
hahnemannian	哈内曼的
proprieties	礼仪
sombre	昏暗的
unbirthday	非生日当天送
sagittate	镞型
prettiness	漂亮
laying	产卵数
bid	投标
controllable	可操纵
vivific	赋予生气的
fnma	National
vertigo	晕头转向
regress	复原
ampullae	壶腹
institute	制定
subornative	买通
preestablish	预先设定
musaceous	香蕉科
nikethamide	可拉明
subtitle	说明对白的字幕
sliver	长条
physiographical	地文学的
pearly	珍珠似的
briefly	简要
convulse	震撼
bannerol	小旗
electricize	使带电
crankish	古怪
flexuous	弯曲的
hyena	鬣狗
jellied	涂凝胶物的
tubilingual	有管状舌的
mediterranean	地中海的
dump	倾倒
fairyhood	魔性
contemplate	企图
lh	LH
there	在那里
oscular	嘴
pare	削减
graven	雕刻
night	夜
barware	酒吧酒具
polocyte	body
destructor	破坏者
pebbly	多卵石
handbill	招贴
ischium	坐骨
jank	闪避
petiolule	小叶柄
inertially	借助地
belligerent	交战国
spine	书脊
petrographical	岩类学
ovariotomy	卵巢切除
subset	子集
unimpressionable	无情的
scholastic	经院的或经院哲学家
dantonesque	大无畏的
actually	竟然
intermontane	山间
verus	确实的
leprose	皮屑状
droit	所有权
archducal	大公爵的
anthropoid	似人类
fillip	刺激
fissiparous	分裂生殖
foreman	工头
semismile	勉强的笑
tumid	肿胀
undistracted	不分心的
nitroguanidine	硝基胍
metathesis	交换
unsoiled	未弄脏的
plantation	种植园
millennialist	的信徒
cryptography	密码使用法
quasimodo	=Low
occidentalist	西洋崇拜者
ganoid	表面光滑的
ally	支持者
heavenly	如天堂的
plodding	沉重缓慢的
premature	太早
excuse	为……免去
orthoepic	发音正确的
voyeuristic	喜好窥阴的
besieged	围绕
episcopalian	主教派的人
slaughter	屠杀
depletion	损耗
devilish	精力旺盛
apices	apex
bodily	全部
resettlement	重新安置
reject	不及格者
bionic	利用仿生学的
spokewise	辐射状
mellita	的复数
lh	把驻留程序装入高端内存
gibing	嘲弄
semicolony	半殖民地
slashing	苛刻的
schism	教派
animalization	动物化
spinstress	=spinster
humidity	湿度沼泽中的肥沃高
award	奖
scenograph	透视图
scavenge	打扫
rancidly	讨厌地
blodge	污点
animatism	万物有灵论
sylvicultural	造林学的
falda	白丝法衣
detoxicant	麻醉
medieval	仿中世纪
deutschland	德国
choroid	脉络膜的
material	重要的
controversial	争论的
warty	似疣
reign	占优势
retrenchment	删除
semibold	半粗体
raven	乌黑的
galactosamine	氨基半乳糖
attributive	定语
mungarian	匈牙利
sabalo	=tarpon
narcissi	自我陶醉
chimaeric	=chimeric
tearaway	行为鲁莽的人
supposable	可假定的
miogeosynclinal	冒地槽的
ethical	民族的
discover	发觉
inimitable	无法模仿的
butcherly	残忍
revolutionist	革命家
dovish	鸽派的
stocky	健壮结实
putty	用油灰接合
coagulation	凝结物
suprafacial	同面的
hqmc	Headquarters
hexaemeron	创世之六日
elitist	优秀人材的
densify	使增加密度
noncommunicable	不会传染的
encephalograph	en9sefE`lC^rEfI/
harvest	收割
unsophistication	纯正
executive	行政
worried	闷闷不乐
ocdm	Mobilization
replicable	可复制的
virginal	无瑕的
undertenant	=subtenant
smartly	潇洒
intranasal	鼻内的
towmond	1年
obadiah	俄巴底亚书
bigeminal	成对
whisker	扫拂者
maintopsail	中帆
unuseful	无用
loudmouthed	高声讲话的
forbearing	宽容的
elspeth	埃尔斯佩思
supposedly	按照推测
typically	代表性地
olein	脂肪之液状部分
prostyle	前柱式构造
philanthrope	=philanthropist
servia	Serbia
numerical	用数表示
equipment	器材
boding	先兆
unpolluted	未受污染
motile	能动的
gioconda	不可思议
erratic	不稳定的
emasculate	删削
shade	微减
ludicrous	滑稽
threaten	似有发生或来临的可能
stagnantly	淤积地
iad	Astrophysical
unmalicious	非恶意
extrapolation	外推法
syph	=syphilis
deflexed	向下弯曲
mycelioid	菌丝体状
jelly	一种果冻甜品
tackle	固定
decimalize	使作十进制
mollify	平息
raisonneur	说教者
gular	咽喉
allmains	万能供电
maillot	紧身衣
snuffless	不需剪烛花的
audiometric	听力测定的
colorific	给予颜色的
chromoplasmic	染色浆的
body	尸体
illegibly	暧昧地
forebode	预言
heirless	无继承人的
cancer	毒瘤
cmb	Bank
sublessor	转租出人
victress	女胜利者
phoenix	完美之物
former	从前
chut	咄!
peroxid	过氧化物
flooding	溢流
rugby	橄榄球
toplofty	自负
molina	de
dagger	用剑刺
cpa	加拿大太平洋航空
tripper	远足者
hike	远足
nonprotein	不含蛋白质
sat	sit的过去式
beagle	小猎犬
germinant	发芽
compounding	混合
anachronous	年代错误
cocky	自大
suspensive	未决定的
foreclose	预先处理
unliquidated	未清算的
dialyzate	=dialysate
minacity	威吓性
slipway	下水滑道
sumpter	赶驮兽的人
foolish	可爱
waywardly	刚愎地
fairytale	优美无比的
smacksman	小渔船的船员
rswc	side
antonymy	反义词组
triassic	三叠系的
cgh	Cape
mauve	紫红色
residency	住院医生实习期
manual	体力的
karyolymph	核液
inductile	不能延伸
muscatel	麝香葡萄
translucent	透明的
upperclassman	高年级学生
overprint	添印
resume	再继续
ammoniate	以氨处理
detrimental	有害的
guianese	圭亚那人的
uncorrectably	不能补救
pop	Post
scalper	黄牛
vigilantly	警觉地
viennese	德语维也纳方言
sporozoon	=sporozoan
pregnable	可攻击的
lumper	码头工人
primarily	主要
acclamation	拥护
adumbral	遮阳的
blowpipe	吹风管
autodestruction	art
inobtrusive	谦虚的
crossgrained	纹理不规则
manhunt	搜捕
driller	钻孔者
delustre	消去的光泽
auburn	赤褐色的
nabi	伊斯兰教的先知
pyrethroid	合成除虫菊酯
acrodromous	脉向尖聚集
subtype	图表类型
fy	fiscal
pyramidalist	埃及金字塔传说的解说者
run	使流
appurtenance	从属权利
cannonade	炮击
erosive	侵蚀性的
incestuous	乱伦
cytotropic	亲细胞
thermometrical	寒暑表的
streamy	流水般
redid	重做
nundine	市集日
unexcited	镇静
atonism	对太阳神阿托恩的崇拜
shortcake	脆饼的一种
humous	腐殖质的
spiel	故事
maternity	孕妇的
quarterdecker	高级船员
viron	瓦伊伦
forested	草木丛生的
marmot	土拨鼠
rhinolaryngitis	鼻喉炎
stearic	硬脂
ultrafine	非常细微
semiglazed	具半光泽的
princesse	紧身连衣裙的
incarnate	使成化身
buxom	体态丰满的
sedgeland	苔草
fixative	定影液
tarantism	跳舞病
catholicness	普遍性
mobster	匪徒
teleosaur	完龙
countrywoman	村姑
vain	愚蠢的
exsanguine	贫血症
region	地方
rhinestone	水晶之一种
dedalian	=Daedalian
downcast	气馁
guggle	人高兴发出的咯咯声
nationalism	民族独立运动
overhead	天花板
lithotomist	切石专家
steam	蒸
exospheric	外逸层的
alarming	使人惊动
breezy	通风好
airfreight	货物空运
probational	试用
mycophagist	食菌动物
theaceous	茶科
shady	多荫
cassie	卡西
informosome	信息体
therapeutics	治疗学
parabombs	集束炸弹
prolong	延长
rakish	轻快的
lomentaceous	具节荚的
spumescent	起泡沫的
glucosan	葡萄综合物
youthy	年轻的
eclaircissement	解说
flashback	倒叙
ncsa	National
cppcc	People''s
prayerless	不做祷告
plainspoken	直言不讳
savourless	不风趣
help	有用
custodial	保管人
biochemical	生物化学
shade	使阴暗
reverberatory	回响
savage	残忍
galenic	其医术的
social	群居
ungual	爪的
programmable	可编程的
asana	瑜珈的任何一种姿势
tragedian	悲剧演员
sdram	Synchronous
seething	火热的
bonkers	疯狂
ceremonial	正式的
glimmer	闪光
slim	细长的
fancy	想象
sedate	稳重
octocentenary	800年的
hypospray	无痛皮下喷射器
lichenometry	地衣测量年代法
extremity	非常手段
talc	用滑石粉擦
theater	全体观众
electronic	电子
envelop	遮盖
penetralia	密事
influencing	影响
night	黑暗
gallantly	漂亮
incontrollably	不能控制
cagy	小心
adversely	反对地
senior	资格较老
breathalyser	酒精测定计
perceptive	有理解的
ectype	复制品
compost	混合肥料
keynesian	凯恩斯理论
taxless	无税的
vitriolic	硫酸
ankerite	铁白云石
beelzebub	魔王
icccm	客户间通信约定
un	United
desmotropy	稳变异构
recliner	斜躺者
detractor	恶意批评者
disqualify	使丧失资格
frill	装饰
majorcan	马略卡岛
aboulia	意志力丧失
pigmentary	颜料的
foxy	狡猾
exculpatory	辩明无罪
