caudillismo	军事独裁者的统治
samoan	萨摩亚人的
schussboomer	直线下滑滑雪者
decretory	法定的
umbrous	被遮荫
clavicembalist	大键琴演奏者
overlearn	超量学习
unifactorial	单基因
calorize	以铝处理表面
conjugality	夫妇
zinco	锌版
melodize	谱成乐曲
semicontinuous	半连续的
quagmiry	多泥泞的
megrim	眩晕
priceless	无价的
anabasin	杀虫剂
enterozoon	=entozoon
mime	笑剧
airborne	空降
sengi	森吉
serumtherapy	血清疗法
puri	宫
montadale	蒙特代羊
homopolar	同极的
zootechnical	畜牧学
ultralight	超轻型的
pertinent	有关的
still	尽管如此
forgivingly	宽大地
plough	在考试中淘汰
transracial	不同种族间的
lending	贷款
unpresumptuous	不骄傲
nephritic	肾脏的
meaning	意图
inconsistency	矛盾
walrus	海象胡须
bibliomancy	圣经卦
heliocentric	以太阳为中心的
flaked	睡去
downbent	弯腰驼背的
piteous	可怜的
sebum	皮脂
impermeable	不能渗透的
swayless	不倾侧的
restharrow	匍匐芒柄花
flattery	阿谀
hpv	papillomavirus
lie	谎话
sab	Board
piping	管道系统
revers	翻领
hyacinthine	紫青色的
paisley	佩斯利螺旋花纹呢
teleset	电视机
priority	前
gratuitous	免费
caliper	测径器
immingle	搀和
choreiform	舞蹈病样的
overfleshed	过肥的
extra	特佳
communist	共产主义者
set	固执的
needments	随身用品
isodimorphism	同二晶
picking	采摘
restaurateur	餐馆老板
hermetical	与外界隔绝
reprobation	斥责
shareholding	股权
lcf	factor
intimity	亲密
rumor	谣传
wampum	贝壳念珠
weathercast	气象报告
rbi	打点
foppishly	浮华地
haybox	以干草填箱保暖的一种炊具
jingo	沙文主义者
recrudescent	复发
proprietorial	所有
disquietude	不安
coprological	淫秽的
streetworker	街道工作者
condemnation	指责
sympatric	同域的
yawl	快艇
biotic	生物
manned	有人操纵的
unavailable	难以获得的
shoulder	肩负
inadequately	不适当
pickaroon	=picaroon
qwerty	标准的传统键盘
corps	军团
pelvimeter	骨盆计
apograph	誊本
sidewise	横斜
consequence	因果关系
reinflame	使再点燃
exclusivism	专有主义
atempo	以原来的速度
ovariectomize	切除
athonite	阿陀斯山的
ampliative	扩展的
ontic	实体的
muscle	肌肉
whelp	小狗
caliga	主教穿的长统袜
snackery	快餐部
trimeter	三音步的诗
dziggetai	骞驴
sporulate	形成孢子
moonbeam	月光
mas	Military
ciliate	有睫毛
smoothbore	无膛线枪
nonnasally	口腔
preconcerted	预定的
unmiter	=unmitre
trieteric	一次
iranair	Airlines
zwinglian	茨温利教义
following	下列的
keratometric	角膜弯度计的
fastening	系结物
pent	pen的过去式及过去分词
saran	此种合成纤维的商标名
toxaemic	患血毒症
gansu	甘肃
gramercy	多谢!
pratincolous	栖草原的
gaming	赌胜负
finsbury	芬斯伯里
viscerate	取出内脏
libertine	玩乐者
db	数据库
zymometer	发酵测定器
exterior	外用
accessory	同谋者
fine	精巧地
gliadin	麸朊
rectangle	矩形
ibew	Workers
postliterate	采用电子传媒
tetrandrious	具四雄蕊的
plumicorn	羽角
gallery	美术陈列室
wacke	玄岩石
opec	石油输出国家组织
milk	挤
smutch	污迹
barrette	发夹
pdq	很快
majesty	王权
cablegram	海底电报
charmed	喜悦的
punjab	印度西北部的一地方
calculi	微积分学
chromite	铬铁矿
resister	反抗者
procreate	生殖
darius	大流士
antipruritic	止痒剂
tattered	褴褛
passively	顺从地
missable	可能打不进穴
heavyweight	聪明绝顶的人
grid	格子
rencontre	漫谈会
pictorial	图示
jest	笑话
irrigate	进行灌溉
gynobase	雌蕊托
entasia	强直性痉挛
absorb	吸收
birmingham	伯明翰
monocular	单眼的
revokable	可废除
drumstick	鼓槌
wineshop	酒馆
actinicity	光化性
semidiurnal	每12小时一次
inosite	肌糖
overage	过剩
renavigation	再领港
ifo	flying
arsenotherapy	砷剂医疗
rv	娱乐车
ial	Language国际代数语言
nerc	Council
fine	细
witted	智力……的
essentic	表露感情的
ishmael	以赛玛利
granddaughter	孙女
eschatological	来世论
anaheim	阿纳海姆
effervescency	冒泡
prepossessing	引人注意
apostate	脱党
sultrily	粗暴地
status	身份
cannibal	吃同类的动物
superradiation	超辐射
huxley	Aldous的祖父
cpaffc	People''s
neck	颈
expostulation	谏言
digitate	指状的
hencoop	鸡笼
sublimate	高尚的
zowie	好!
nicotin	=nicotine
mitreblock	斜锯架
nitrogenous	含氮
soothsaying	占卜
gastroesophageal	胃食管
reiterant	反复
grave	墓穴
dullhead	笨蛋
reprobative	指责的
ftp	Transfer
hear	允许
vehicular	车
receivability	可以接受
gilder	镀金工人
janissary	亲信
cramming	填鸭式的用功
kcps	千周[秒
clever	聪明
croat	克罗地亚人
matin	早课的
floral	植物的
errantry	侠义
dangly	摆晃的
complaining	诉苦
redeemer	赎身者
prance	腾跃
haematopoiesis	生血作用
pinkish	略带桃色
caesaropapism	君王对教会及国家的绝对控制
damaged	被损坏的
triplicate	三份中之一
compounder	混合者
people	人
westernmost	最西
contrariness	乖张
reedy	芦苇做
unselective	不加区别的
sharper	磨具
taboo	禁止接近
mulattress	穆拉托女人
dentary	有齿
disrepair	破损
historiette	小史
german	德语的
cryptographic	用密码写的
woopie	"幄庇士"
somatotropin	生长激素
orad	向口区
fidget	不安定
diffused	散布的
selected	挑选
paramagnetic	顺磁性
exhibit	展示
puzzling	使莫明其妙的
bruin	熊
uncorrupt	未堕落的
unlatch	拔掉门栓
cuso	University
shiny	晴朗的
mothering	省亲
extensively	广阔
sociable	喜欢群居的
systematization	组织化
opioid	=opioid
overtly	公开地
frizzle	卷发
latvian	拉脱维亚语
algesia	感觉过敏
pilgrimize	去朝圣
arthrectomy	关节截除术
capable	能干
knotweed	蓼科杂草
cheekily	厚脸皮
prewar	战前的
tetrazzini	烤制成脆皮的
scansorial	适合于攀登
cambrel	马脚形铁钩
flinty	强硬
transubstantiate	使变质
conservatorship	英国管理委员之职位
uneducable	不可教育
textured	织地粗糙
intercrop	间作作物
tummler	滑稽演员
exculpation	辩解
manhunt	追捕
migrate	移往
embodiment	具体化
grimily	污秽
featureless	平凡
wainscoting	壁板料
advertise	做广告
verbid	动词性单词
pukeko	紫水鸡
dread	可怕的人
warily	警惕
balloonfish	河豚
visive	视
hemotherapeutics	血疗法
laryngismus	喉头痉挛
subclavate	略似棒形的
null	无效的
giraffe	鹿豹座
hike	步行
supersymmetry	超对称性
maile	齐墩果状念珠藤
televisionless	不看电视
interfoliaceous	两叶间的
froward	难驾驭
failing	如果没有……
vesica	囊
flimflam	胡扯
pervasive	普遍深入的
jackleg	不正直的
euroky	广适性
shag	蓬乱一团
commercioganic	有市场的
pediatric	小儿科
brs	British
seignorial	=seigniorial
microkernel	微核
bronze	青铜色
brawly	好口角
holocrine	全浆分泌
duyker	=duiker
rhetoric	花言巧语的
diacritical	可区别
hornbill	犀鸟科
repulsive	令人厌恶
mildly	温和
compactly	细密
undecomposable	不可分解的
dromedary	单峰骆驼
demented	精神错乱
merciless	残忍
retractive	缩进的
revelatory	启示性的
assumption	圣母升天
secund	侧方
flattish	有点平凡
regality	国王的特权
bathypelagic	深海区
tennies	网球鞋
bndd	Drugs麻醉品和危险药品管理局
wise	贤明的
chromoneter	精密计时器
virbius	威耳比俄斯
fissile	裂变
hegemonism	霸权
resend	再差遣
discoverist	发现教学法的
nonbank	非银行的
cinematographic	电影摄影术的
hewer	砍伐者
fulgurite	熔岩
cany	藤制
gammy	跛行
database	资料库
zygodactylous	前后有双趾的
aerosol	气溶胶
besot	使迷糊
anteprohibition	禁令前
prescription	指示
garrison	守卫
wiretapper	窃听器
unmoving	不动人
zither	扁琴
college	公学
intermedial	=intermediate
sinister	险恶的
anamorphosis	变体
hardcase	倍受艰苦锻炼
bill	票据
engrossment	专注
versicolor	色彩变换的
run	融化的
cunene	库内纳河
anetic	缓和的
intensification	增强明暗度
littorinid	滨螺
fading	褪色
clypeate	圆盾形
race	赛跑
redirection	改变方向
squire	随侍
gbf	名著基金会
oopm	面向对象程序设计方法学
substantive	真实
collogue	密谈
sweetmouth	奉承
subacute	亚急性的
mts	Simulator
stingy	吝啬
campong	=kampong
cheloid	蟹状肿
autogeny	自生
baronial	男爵
vicarial	代理的
consequentially	必然地
milldam	水闸
scurvy	无礼
rheumatoid	患风湿症
confrere	同事
alsatian	阿尔萨斯人
wolves	色狼
sendout	输出量
rifling	装膛线
parasol	阳伞
unadvised	轻率
allotment	分配
canework	藤品
ceeb	College
poodle	剪毛
anteriorly	先前
meed	报酬
astrictive	止血的
unrazored	未修过面
admonitor	劝告者
dc	Digital
panellist	猜谜参加者
lancewood	一种强韧木材
adulterator	劣品制造者
clavichord	翼琴
coolth	冷静
antianxity	抗焦虑的
cirrose	a
camphol	龙脑
quadricentennial	400周年
qoph	=koph
hereat	于此
justificative	用以辩解的
drecky	低劣的
federate	同盟
intracerebral	大脑内的
reminder	提醒的人
bakeapple	云莓
samlor	三轮出租汽车
infractor	违反
sapa	葡萄浓汁
arboricultural	培植树木
phonochemistry	声化学
redemptioner	出卖劳力来抵偿船资之移民
unpersuaded	不被说服
marinescape	海上风光
dichromic	二色的
dumbstruck	被吓得目瞪口呆的
incumbent	负有……义务的
communicative	爱说话
conciliatory	抚慰
flowery	华丽的
frigging	可恨的
attabal	=atabal
fragmentized	破碎
cacodorous	有恶臭的
circumvolution	旋转
hyphenated	带有连字符号
moorwort	马醉木
syrupy	像糖浆
rising	有前途的
volante	轻快
slithery	滑
proventriculus	前胃
billiardist	打台球者
offendedly	生气地
egoistically	任性
athermanous	不传幅射热
multichain	多链
cysticerci'	NULL)
suspensive	悬念的
archwise	拱廊似地
rhenic	含铼的
saucerful	一碟的量
underpowered	由动力不足的发动机驱动的
barbellate	有短硬毛的
soil	土壤
krantz	峭壁
swift	快的
fallacious	谬误
dorking	肉鸡的一种
arid	无趣
ghast	可怕的
either	或者
ultramicrobalance	超微量天平
bunned	挽成小圆髻的
adduce	引证
tayra	白头鼬
beneficent	慈善
matronly	尊严
unpitied	没人可怜的
manure	施肥于
coplanarity	共面
gaga	非常起劲
symbolic	象征的
clocklike	有规律
chromatrope	旋转彩色板
stylish	时髦的
proprioceptive	本体感受
deadsville	令人厌烦
dismay	惊慌
rattle	急忙地做
drably	无生气
bumf	卫生纸
help	接济
amorously	妖艳地
seamanlike	海员般的
chaetognath	毛颚类动物
hydrocinnamic	苯基丙醛
cycle	轮转
scramble	爬行
tumular	如坟墩
hodiernal	今天的
conversable	易开口
nincompoop	无用的人
sublime	壮观的
heathenry	信仰异教
amphigenous	生于叶子两旁
gag	插科打诨
unido	United
moony	月形的
singular	异常的
stuffless	不充实的
nitinol	镍钛诺
ptomaine	肉毒胺
ignescent	引火物
boxful	一箱的
resolutely	坚决
dissyllabic	二音节
lone	独立的
inquisitorial	好询问
nonprotein	非蛋白质
tridactyl	有三指的
traitorously	叛逆
jameson	詹姆士
mildewy	发霉的
talmudic	犹太法典
uncoped	无法与之竞争的
manoletina	马诺来特斗牛法
conspecific	同种
brute	畜生般
ascensive	强调的
seeker	搜索者
silken	柔软光滑的
quintuplet	五个一组
gey	相当
produce	农产品
oppress	压抑
rubbly	碎石状
necessitarian	必然论的
deep	深处
vitrify	使成玻璃状
dangly	摆晃
conciliative	安慰
hypogenous	在下着生的
spurry	大竹草
arrogant	自大
sulphurous	硫磺的
unearned	不应
stygian	阴黑的
yesterevening	昨晚
succumb	死
barker	剥树皮工
pamphrey	卷心菜
founder	使摔倒
penile	阴茎
relegate	转移
lasso	以套索捕
transit	横越
virucide	=viricide
flurry	飓风
moctezuma	即Montezuma
aiguille	尖峰
sarre	萨尔河
yearningly	怀念
semidiurnal	半天
unwearied	孜孜不倦的
armet	头盔
drily	干巴巴
decadal	十
sweatbox	发汗装置
dextrous	机巧的
socle	台石
seam	线缝
qkt	queen''s
forewoman	女工头
lax	不严格
thermoplastic	热塑性
insipidity	枯燥无味
magpie	鹊
tinder	火绒
ominous	恶兆的
vision	显示
undissembled	不加掩盖
aquatic	水生的
cankerous	溃疡
proximity	接近
zymoplastic	凝血的
consequence	结果
ninny	傻子
repletion	饱满
actaeon	亚克托安
ethereality	如醚的性质
enchant	施魔法
basebred	下贱
boulangism	布朗热主义
senatorial	参议院
vermifuge	驱虫
clarice	克拉丽斯
corporative	社团的
epigenous	上面生
counterintelligence	反间谍活动
ece	Commission
astrogate	驾驶
tail	嵌入
snide	赝品
metalist	=metallist
swim	覆盖
titograd	铁托格勒
inerrably	无误
beaux	喜修饰者
computerizable	可以电脑处理
cigar	雪茄
corel	出品的软件有CorelDraw等
multiprogramming	多道程序设计
ravenous	贪婪
desiccative	去湿的
npr	National
showplace	名胜地
somniferous	催眠的
irrefutable	不能驳倒
quackish	庸医的
feverish	热病
instantiation	例示
parashot	反伞兵射手
leave	遗忘
instantaneous	即时的
cosmoid	具有齿鳞质的
stonecast	短距离
dank	透水
crass	愚钝
adperson	从事广告业的人
accurst	可憎恨的
ovarian	卵巢的
baroque	结构复杂的
candidiasis	念珠菌病
born	出生
epitoxoid	弱亲和类毒素
geomagnetic	地磁的
thallogen	=thallophyte
celebrity	名人
rosebud	妙龄少女
semicircular	半圆
abyssalpelagic	深海水域的
strikeout	三击未中出局
incorruptibly	不被收买
pure	无垢的
userkit	用户套件
burtonize	作硬化处理
necessity	必要性
higgler	叫卖商人
charm	魔力
atypic	不定形的
workerist	强调工人利益的社会观的
system	秩序
grammatical	文法的
swash	摇晃
hashimite	哈桑王族的成员
pyralid	螟蛾
congruity	适合
tan	晒黑
rusticate	去乡下
vihara	寺院
mousseline	真丝薄稠
altiplano	高原
eophyte	始生代植物化石
asexuality	无性别
snaky	阴险的
microcrack	显微裂纹产生微裂纹
wonna	=will
enamel	指甲油
photoptometer	光觉计
rigmo	=rigor
cimbalom	钦巴龙
ferocious	凶恶的
countertrend	逆倾向
lumirhodopsin	光视紫红
rpc	Royal
hundredweight	担
eximious	卓越的
hushpuppy	南部
humoristic	诙谐
francophile	亲法
subtilize	使稀薄
monoacidic	一价
tolstoian	托尔斯泰的
discrepantly	不一致
avocado	鳄梨
muzhik	农人
undiluted	纯粹
unclarity	不清澈
roughly	粗糙
pipul	=pipal
whew	吆
antibiotic	抗生
compelling	强制
nightwalker	夜间为非作歹者
exclosure	围地
synergism	神人协力合作说
unwitnessed	未察觉到
fortieth	第四十
gumminess	树胶质
fluffhead	没头脑的女人
wardenship	warden之职权
vagotropic	向迷走神经
rabble	拨火棍
hydroponist	水耕式经营者
monophyletic	单元的
uncopiable	不能抄写
scribe	用划线器划
slanchwise	斜向
solstitial	至的
valse	轻轻地走
catamnestic	病后经过
severalfold	几倍的
tuffaceous	凝灰质的
antisocialist	反社会主义者
fabian	费边式的
fit	符合
passional	热情
opera	歌剧
reducible	可减少
singular	单一
ane	一个的
unimpeached	无可指摘的
spectrograph	光谱摄制仪
mycoplasma	支原菌
sedgy	莎草密茂
equijoin'	NULL)
gory	血淋淋
commercially	商业上
space	空
unction	油膏
smoke	吸烟
untilled	未耕种
hitchhiking	搭乘
hols	休假
galyak	羔羊皮
nuts	呸
encomiast	宣读或写颂辞之人
mongolian	属于蒙古人种的人
changeless	稳定
hyperplastic	增生
frenzy	狂怒
slantindicular	有点斜
myeloblast	原
explosibility	可爆炸
dependence	依赖
twoscore	四十
aleph	希伯来文的第一个字母
sociopolitical	同时涉及社会和政治的
potman	酒馆的侍者
scraggly	凸凹不平
prevail	获胜
photometric	光度测定
ambidexter	两面讨好者
idolatress	女性的偶像崇拜者
ratisbon	=Regensburg
beachhead	滩头阵地
fontanelle	囟门
inherent	固有
tristylous	三花柱的
infundibuliform	漏斗状的
bia	Business
hilly	多小山的
youthy	少壮
toothless	无齿的
throstle	纺织机的一种
airhouse	充气屋
flank	侧面
hilac	accelerator
indistinguishable	无差别礔Ebl/
rollei	=Rolleiflex
hydronic	液体循环加热
amicably	友善
samlet	鲑科的幼鱼
phylloerythrin	叶赤素
delude	蛊惑
present	举枪瞄准
unemotionality	冷漠
serbian	塞尔维亚人的
seraphic	六翼天使
psychoactivity	作用于精神
hemichordate	半索动物纲
maestro	名作曲家
anchoret	隐士
transformative	变化的
filamentous	细丝状的
herodian	希律一世
dispossessed	无依无靠
flagellate	鞭打
onstage	舞台表演区
irgb	Blue
sba	Small
citywide	全市
deoxidize	还原
badge	徽章
unfearing	不畏惧的
buster	非凡的人
unmerited	无功受禄的
rate	责骂
provable	可查明的
peacockery	虚饰
quarterly	每季地
eben	埃本
xerophthalmia	眼球干燥症
buckled	有扣的
cotyledon	子叶
unhired	未租入
dichroitic	二色性的
cataract	白内障
sneakingly	卑鄙地
vertebratus	脊状的
nodose	结节多的
halvah	土耳其的碎芝麻蜂蜜糖
anomalous	不规则的
supermundane	世外的
enantiotropy	互变形
fool	欺骗
paraphrastic	改写成容易明白的
phocine	海豹
rim	形成边状
true	正确
noaa	and
lithemia	尿酸血症
miesian	密斯建筑式样
shopworn	陈旧
pollyanna	盲目乐观的人
phonotype	音标铅字
ethanethiol	乙硫醇
agreeable	适合
specilize	详述
omnisexual	全性
explant	移植
terribly	十分
easternmost	极东的
magic	不可思议
yarrow	西洋蓍草
book	预订
help	佣工
polychrest	有多种功效的贵重药品
aarnet	澳大利亚科研网
dolman	土耳其式长袍
tergeminate	三次双生
malign	诽谤
limy	石灰似
hamulate	顶端弯折
faciend	被乘数
tup	冲面
photopia	眼对光调节
flightily	轻浮地
slack	使缓慢
opalesque	似蛋白石
failingly	似将消失地
moksa	解脱
juso	青年左派分子
vindicative	辩护
thyiad	梯伊阿
oary	桨状的
napier	象草
coleopteran	甲虫类之昆虫
regality	王国
bachian	巴赫音乐
kidnapper	拐子
verdant	生疏的
generous	有雅量
unaccountably	不可解释地
grey	灰色的
fin	露鳍于水面的
trigeminal	三叉神经
frad	Relay
albigensian	阿比尔派教徒的
unstirred	未受激动
thermogeography	温度地理学
neddy	驴
dermatological	皮肤病学的
system	制度
doughhead	笨蛋
concent	同意
mezzo	适中
slype	走廊
flexowriter	电传打字机
castigate	严惩
mallein	鼻疽菌素
alway	永远
petroleum	石油
baku	巴库
unrelenting	不宽恕
smoke	冒烟
transcriptase	转录酶
noetics	纯理性论
mib	管理信息库
homoscedastic	同方差
bear	带给
arises	发生
bat	用球棒击球
help	帮忙
degrading	可耻
sneaker	鬼鬼祟祟的人
systemic	身体组织的
homogamy	雌雄同熟
bellicism	好战倾向
homebred	没有教养的
bokhara	=Bukhara
tribal	种族的
kor	侯尔
circumoral	绕着嘴
greenfinch	绿黄色科鸣鸟
reupholster	给……装新椅面
pluralistic	兼职的
spray	喷射
quadrangle	四角形
sweaty	吃力的
copernican	哥白尼学说的
paralegal	辅助律师业务
strikeless	无罢工的
illegality	犯规
inauthoritative	非权威的
autography	石版印刷术
kappa	希腊文字母第
synopsis	大纲
discard	放弃
emancipatory	有助于解放
crumple	弄皱
correct	恰当的
styliform	尖笔状的
sateless	无厌的
bald	枯燥
hideous	丑恶的
sophistry	诡辩
key	基调
orbit	势力范围
themis	西弥斯
resubject	使再服从
homebred	土产的
amylose	直链淀粉
silence	压制
infamatory	中伤
mythoheroic	歌颂神话英雄事迹的
educationist	教育理论家
yankeefied	美国式的
bifurcated	分为两部分
uncovery	揭露
ippf	国际计划生育联合会
naziism	纳粹主义
rp	Republic
predominance	优势
idealistic	唯心主义者的
scout	侦察机
price	给……定价
anosmia	嗅觉缺失症
leto	勒托
ripely	圆通地
djokjakarta	=Jogjakarta
unhcr	Nations
mitral	僧帽状的
fucking	用以增强表示愤怒
unpleated	不打褶
briquette	煤饼
quilled	有硬毛
rounce	手动印刷机把手
buccaneerish	海盗似的
out	从头至尾地
apogeotropic	负向地的
inauspicious	不吉利的
alterative	改变的
subservient	有用
very	真正
procurement	取
suprapersonal	超个人
octosyllabic	八音节的
lobbyist	活动议案通过者
hanepoot	非洲白葡萄酒
hyperrealism	照相写实主义
leave	休假
foreseen	foresee的过去分词
ellipse	椭圆
chelifer	螯蝎
tolstoyan	托尔斯泰的信徒
immigrant	移民
venerable	古老
sagacity	聪敏
incarcerate	幽闭
rideable	=ridable
deputy	代表
protease	蛋白酶
screen	银幕
linty	有棉絮
exophasia	有声的语言
rampart	用壁垒围绕
orinoco	奥里诺科河
jejune	贫瘠的
quick	活泼的
burrawang	螺旋大泽米
centralisation	=centralization
amphibiotic	长大生活在陆地的
steal	偷窃
trifling	不重要
relabel	重新用标签标明
portly	一表人材的
polaroid	人造偏光板
bioelectronics	生物电子学
cryptogamous	隐花的
grope	摸索
typhoon	台风
hemp	纤维
exposure	暴露
parorexia	食欲倒错
unbalanced	错乱
fedayee	阿拉伯游击队队员
gradual	渐进的
tightwad	吝啬鬼
unenlightened	落后
autocephalous	独立的
impavidity	无畏
vacuolate	有液泡
deltawing	有三角翼
abradant	摩擦着的
wananchi	劳动群众
disablement	无力化
warrant	担保
gripe	紧握
flush	使激动
pincette	小镊子
plan	设计
pacesetting	定速度的
rejuvenescent	回春的
grayback	灰色动物
terminable	有期限的
grandiose	宏伟的
octastylos	八柱式建筑物
recover	重新获得
bedlam	疯人院
undeflected	不偏斜
fondly	怜爱地
weariful	厌烦的
scrubland	灌木丛林
negotiatory	协商
failure	缺乏
quantification	量
cymoid	状似聚伞花序
shade	使渐变
difform	不同形状
gasifiable	可转化成气体的
copyright	著作权
ogygia	奥杰吉厄岛
paediatrist	儿科医师
trackway	踏出来的路
quizzery	考查
sacral	圣礼的
chattanooga	查塔努加
luteous	略带绿色之黄金色的
livelily	活泼地
toucan	巨嘴鸟
shipwright	造船木匠
campus	校园
doss	睡眠
karman	Karman
coloratura	花腔音
nisi	非最后的
urology	泌尿学
qbp	queen''s
twelvefold	十二倍
ruly	有条不紊
incurvation	内曲
sgml	General
boundlessly	无限地
seminary	神学院
crassly	愚钝
peach	告密
urbanologist	都市学家
limoges	法国中部Limoges地方产的瓷器
chastening	精练
diphenylhydantoin	苯妥英
flock	众多
barring	不包括
verily	真正地
conceit	自负
forcible	暴力
summon	召唤
anathematically	憎恶
lucubration	学术作品
ungraceful	不优美
menisci	meniscus
outlook	前景
determined	坚决的
primiparous	初次分娩的
discipular	崇奉者的
livable	适于居住的
deactivate	解除动员
southing	南进
viennese	维也纳人的
lion	社交场合的名流
incendive	易燃烧
ticktock	滴答声
lewdster	好色之徒
pithiness	有力
leeway	风压差
gpi	paralysis
proofless	无证据
pillared	成柱状的
hyperpiesia	血压过高
separatory	用于分离的
indwell	存在
corotate	同步旋转
hydromancer	用水占卜的术士
cesarian	凯撒
circumterrestrial	在地球周围
module	登月舱
haunch	腰部
parleyvoo	讲法国语
fluxion	飞跑
sudamina	粟疹
portico	门廊
selflessness	忘我
amazonian	亚马逊河的
supernormal	非凡
hyperpyretic	高烧的
tattersall	塔特萨尔花格
dreamily	梦似地
comity	团结
hazily	朦胧
russell	英国工程师
muttonchop	羊排
dolichomorphic	部分肢体特别长的
still	剧照
syllabification	划分音节
knowledgeable	有见识
hedge	避免作正面答复
unpatriotic	不爱国
heliotropic	向日性的
graphomotor	运动
haberdash	做
gneissic	片麻岩
vpd	Device
panmictic	随机交配群体
tidily	整齐
bicorporal	有两个主要部分的
explicit	直接付款
warsaw	华沙
photosensitivity	光敏性
psychosexuality	意淫
safekeeping	保管
caesural	主要停顿
khud	峡谷
fibre	纤维
flechette	由飞机投下的一种小钢矛
consensus	多数人的意见
hominization	人化
gst	sidereal
inchoate	不完全的
pensile	悬挂
jubilant	欢呼的
bowed	弯如弓
jurat	宣誓证明
chi	22字
ragefully	盛怒
millesimal	千分之一
pyrotechnics	烟火制造术
pallette	调色板
preappoint	预先约定
quibblingly	吹毛求疵
carsick	晕车的
poofy	脂粉气
one	一
constantly	坚持不懈
domain	领域
emulsive	会流出乳状液的
clocker	赛马预赛时计速员
gunmetal	炮铜色
dislikable	可厌的
carfare	电车费
grewsome	令人厌恶的
circumambient	围绕的
gastronomy	美食法
husk	皮
poe	Of
msp	信息安全协议
delomorphic	显形的
zestful	有滋味
sudsy	起着泡沫
jelly	果子冻
tubbing	制盆材料
pluckily	有勇气地
painfully	痛苦地
cacique	领袖
nethermore	较深的
scathing	严厉的
uhf	UltraHigh
innovationist	主张革新者
edifying	有教训意味的
undissembling	公开的
accelerando	渐速音
dep	and
owl	Library
screen	拍电影
everbearing	连续不断结果的
beneficial	受益的
hieroglyphist	象形文字研究者
thermoperiodicity	温周期现象
extraofficial	职权外
autobiographic	自传作家的
tung	桐树
cfs	立方英尺[秒
disentitle	剥夺……的称号
moleskin	鼹鼠毛皮
tarok	塔罗克纸牌戏
ambagious	迂曲的
inexactly	不精密
quenchable	可熄灭的
bulk	大多数
lustily	精力充沛
geocentrism	地心说
inartistic	无味的
bim	British
disorient	使迷惑
divagation	流浪
scramble	杂乱蔓延
dissipator	放荡者
factualistic	尊重事实的
cribriform	筛状的
spermatic	精液
supremely	崇高
col	峡路
thaumaturgy	奇术
ballot	投票
gypsy	流浪
scathe	痛斥
ersatz	假的
johnsonian	约翰逊流派
subdeacon	副执事
gertrude	婴儿内衣
epicurean	享乐主义的
recoat	重新涂
congregational	会众
interactional	相互作用
worm	小人物
incompletive	=imperfective
degustate	尝
zing	子弹声
calloused	变硬
piccadilly	伦敦繁华的大街之一
wise	明白的
phasemeter	相位计
congenial	性格相似
devalue	贬值
serve	适合
spiky	长而尖的
society	社会
exclosure	围
zonal	带状的
front	对付
tdn	nutrients
fawning	奉承
hibernacula	离体冬芽
calcimine	墙粉
regosol	粗骨土
assess	评定
outlive	渡过……而存在
togae	制服
aerodynamically	空气动力学
invigorant	补药
phot	辐透
churchillian	邱吉尔作风的
crinoid	海百合类
elaphine	红鹿
kep	扣留
hydroextractor	脱水器
approachability	易接近
predacity	食肉性
rear	背后
flimflam	荒唐
rx	治疗方案
lankester	兰基斯特
tun	发酵桶
rend	撕碎
sei	大须鲸
imperence	无礼
scoriaceous	烧石的
mica	云母
nomadise	=nomadize
newsvendor	报纸经销人
maccaroni	s)
dohc	overhead
jejuneness	幼稚
oophoritis	卵巢炎
soaprock	=soapstone
unwooded	无树木的
gynecoid	=gynaecoid
demoded	过时
or	Research
forepaw	前脚
reenact	再扮演
catamount	美洲豹
posthypnotic	催眠后的
asshead	傻瓜
embroil	使纠缠
problematic	有疑问
unawares	不知不觉地
ichthyophagy	以鱼为食
lawcourt	法庭
pim	Information
sedate	给……服镇静剂
caitiff	胆小鬼
sap	逐渐侵蚀
misuse	误用
execratively	诅咒地
tenancy	租赁
flaring	花哨
becquerel	贝可
moocher	闲逛者
alcheringa	黄金时代
leaning	清洗
buttle	做男管家
fallfish	小眼须雅罗鱼
nolle	=nolpros
slack	呆滞的
titrator	滴定仪
pyroligneous	焦木的
veil	幕
unpick	拆散
lotiform	莲花状
unplucked	未拔毛
sins	navigation
cooperancy	一起工作
rob	抢夺
recognizably	可辨别
costly	贵重
fixup	修正
weak	淡
quibbling	诡辩
iab	Internet
yarage	可操纵性
proseminar	研讨会
titanic	四价钛
boastful	自夸
schlep	携带
floodmark	高水标
double	加倍
chemigraphically	化学镌版术地
gripe	肠痛
swag	摇晃
hagiographer	圣徒传作者
seaquake	海啸
clannish	氏族
peccancy	罪行
skillful	熟练的
batch	一炉
inviolate	无污点
biotic	生物的
svelte	体态娇美
dignified	有品格的
acryl	压克力
seducer	玩弄女性的色情骗子
quirkish	讥讽的
decilitre	1/10公升
habituate	使习惯于
furioso	演奏得很有力
antisudorific	防汗剂
pule	抽咽地哭
auditorial	查帐官
nasute	头部有鼻形突出
cannon	加农炮
merely	只
cornered	被逼至绝路
gerontomorphosis	成体变形
sclerotoid	=sclerotioid
sentence	文句
natural	天赋
customs	海关
agelong	持续很久
benty	硬草
aaronic	亚伦
devotional	虔诚的
cyclostomous	有圆口的
slot	细长的孔
tropine	托品碱
helvetian	瑞士人
verification	确认
isobath	等深线
feastful	过节的
kanone	善于滑雪的人
oophorectomy	卵巢切除术
slantindicular	偏斜
indebted	感恩的
sorcerer	男巫士
arbiter	仲裁者
tome	卷
medley	集成曲
ideational	概念
hypoesthesia	感觉迟钝
confine	界限
coccolith	球石
freshwater	湖水
practised	熟练
heterotrophic	不是自养的
manoir	乡间别墅
toot	纵乐
wilful	任性的
whilst	同时
sphragistics	金石学
chairwarmer	不务正业者
subpolar	靠近北极或南极的
monarchial	帝王风度
procacious	勇敢
hearten	鼓励
publishing	出版
weftwise	横向
flighty	轻浮的
severance	断绝
talnakhite	硫化铜铁
pyrotechnic	出色
evince	表明
urubu	食腐肉的乌鸦
minster	修道院附属的教堂
salome	萨乐美
lymphadenitis	淋巴腺炎
spline	方栓
skeletony	骨架似
concomitance	相伴
groom	整饰
calling	行业
fingerpaint	用手指画
reticulose	网状的
serendipitous	偶然发现的
hubei	湖北
sinuous	蜿蜒
irc	Chatting
sutural	缝合线的
scandal	流言蜚语
lissome	柔软
trigamist	三重婚者
sorcerer	魔术师
louvered	装有百叶窗板
upside	上边
macrocephalic	大头的
crassitude	粗大
cuspidate	有尖头的
babesia	巴贝西虫
passivism	被动性
amos	阿摩司
cigarette	纸烟
gustaf	古斯塔夫
withdrawal	退回
spotty	质量不一的
ioof	独立共济会
nefandous	讨厌
plasmatron	等离子体管
mandrill	山魈
jnd	刚刚能够看出来的差异
snubber	缓冲器
rammish	淫荡
decuple	十倍于
voluminous	著书多的
hermes	=herm
sympathectomy	交感神经切除术
subaerial	接近地面的
toom	空的
dialyzer	滤膜分析器
evaporative	成为蒸气
lark	戏弄
nincompoop	傻子
interphone	对讲机
catarrhal	鼻黏膜炎
bearable	支持得住
token	表示
unture	不合标准
nonvolatile	非易失性
astable	不稳定的
hectic	发热的
ankylose	长合
solen	竹蛏
dimension	尺度
sinful	有罪的
jot	少额
smooth	平滑
dorothy	桃乐茜
perdure	继续
mesophyte	中生植物
ethnologic	民族的
zenocentric	木星中心的
mapai	以色列工人党
rough	粗野
polak	波兰
postfigurative	成人社会
quintuplicate	五倍
fastidium	厌烦
concupiscent	好色的
uninsured	未保险的
reaganism	对里根主义的信奉
seamost	最靠近海
doll	美男子
drooping	下垂
fortifier	筑城者
virulent	刻毒
unaccepted	被拒绝的
causticity	苛性度
outfit	配备
elastin	弹性蛋白
expedition	派遣
rate	比率
feature	面貌的一部分特征
western	西方的
nondecreasing	不减少
swahili	斯瓦希里人的
ashy	灰烬
gladiate	剑状的
oratorio	宗教剧
knockback	拒绝
sydneyite	悉尼人
bfa	of
bobbinet	机器编织的一种花边
featherless	无羽毛
mutually	互相地
bmj	Medical
oxidative	氧化的
unprejudiced	公平
constructively	建设性地
msph	Master
pdq	Quick
religioso	虔诚地
suitable	适当
vizor	面颊
clubbable	善交际的
unhealthiness	不干净的
outpoint	得分多于……
credenza	书柜
endocarditis	心内膜炎
turgescent	浮夸
wearisome	乏味
anesthetic	麻醉
judea	古代罗马所统治的Palestine
easter	复活节
dominance	优势
adularescent	淡蓝色变彩的
filipina	菲律宾妇女
kananga	卡南加(旧称卢卢阿布尔
copperhead	南北战争时同情南方的北方人
dimorphemic	双词素的
sahra	=Sahara
uncleanness	不纯洁
gawain	亚瑟王的圆桌武士中之一
gnotobiotics	无菌生物学
scousian	利物浦的
microampere	微安培
intramuscular	肌肉的
standing	停滞的
meditative	沉思
replamineform	有机骨架复制
experimentalism	实验主义者
purine	咖啡碱
despecialize	非专门化
telediphone	录放话机
lose	受损失
thresh	打
starchy	浆硬的
jeffersonian	派
luciferous	光辉的
suspensive	悬而不决
microfluorometry	显微荧光测定法
boustrophedon	右行左行交互书写
wintry	象冬季的
acidize	使酸化
pane	尤指窗格
easterly	从东方来的
archdeacon	执事长
kindy	幼儿园
unanimously	全体一致地
execute	实行
trailerite	活动房屋居住人
clew	提示
auriform	耳状
feat	合适的
banteringly	戏谑
seilbahn	缆索铁道
fleeceable	可以欺诈的
recross	再穿过
billabong	干河道
palpebra	眼睑
human	有同情心
file	把……归档
mephistophelean	冷酷的
eradicator	墨水擦
loathe	厌恶
steeper	陡峭的
monterey	Jack
workable	可经营
hippocampal	海马趾
nymphomaniacal	女色情狂
carcinoma	癌科
kickback	退回赃物
conscienceless	没良心的
lineation	划线
suberize	使栓化
lush	豪华的
shoddy	以次充好的
ferrosilicon	铁矽
handrail	扶手
aarp	AppleTalk地址解析协议
tommyrot	无聊
nomology	法理学
warmer	使热的人
pat	合适的
ventriloquous	腹语术
plagiarist	文抄公
dutiable	有税的
deepfelt	深切
unfoiled	未受挫
nhk	Nippon
culpa	疏忽
wobbulator	摆频振荡器
clean	清扫
phonodeik	声波显示仪
rattly	格格响
faithfulness	诚实
vext	=vexed
biggish	较大的
repurchase	买回
tolerableness	可容忍
veil	掩饰
relativism	相对主义
crinoidea	海百合纲
hun	野人
desire	想望
ablatival	离格的
colorless	无趣味的
kaunas	考那斯
naice	=nice
teachy	爱说教的
narrowfisted	小气的
intramarginal	边缘内的
bfa	Arts
enemy	仇敌
featherbed	使任闲职
snappish	急躁
flunkee	因工作表现不佳而被开除的人
unprofitable	不赚钱的
unwrought	未加工成成品
versify	用诗表达
lucullian	富裕的
upperpart	位于上身的部分
institution	协会
unforced	非被强迫
os	元素锇
queasy	不稳定
ophiuroid	海蛇尾纲动物
pleistocene	更新世
niobous	亚铌
punctuation	标点
reservist	在乡军人
bracing	令人鼓舞的
hatikvah	希望之歌
redundancy	冗余
calamity	灾难
recorder	录音
mustang	海军行伍出身的军官
loanable	可借出
amphitheatre	圆形剧场
distinguishable	可区别
swat	用劲打击
martian	火星
dendrophilous	寄生树上
denticule	齿状装饰
timorous	胆小的
fecal	排泄物
swingaround	绕行星返地轨道
cpff	plus
isorhythm	等同节奏
guangzhou	广州
keerect	正确的
anaesthetist	麻醉师
gel	成冻胶
abiogenist	偶发论者
kalimpong	噶伦堡
nice	和蔼
antiforeign	排外
featurish	像特写文章的
fancied	被特别爱好的
illegally	不法
chamberlaine	侍从
oblomovism	懒惰
un	东西
ciliolate	有纤毛
sound	听诊
hanuka	光明节
saturnic	铅毒的
elitist	杰出者的
sonorously	朗朗地
stickybeak	爱打听的人
diversely	不同
mucky	肮脏
hosteler	旅馆主人
mound	堆起
beautydom	花国
conformation	构造
spellbinder	能吸引听众的演说家
sopor	迷睡
unswathe	揭开……的覆盖物
despotism	专制
ungalled	未擦痛的
barelegged	露腿
aspca	Prevention
raises	扬起
crusher	压碎的东西
thiram	二硫四甲秋兰姆
catlike	象猫
psychotechnology	心理技术学
carrollian	具有卡罗尔风格的
certificate	证书
guide	向导
impressionist	印象派作家
salvationist	传道者
nainsook	印度产的一种薄棉织物
balmusette	大众化舞厅
nunatak	冰原岛峰
astrolabe	星盘
looseleaf	各页可任意装拆
agricultural	农艺
ostensible	表面的
average	通常的
acquirability	可获
netman	网球选手
lucknow	勒克瑙
disquisitive	研究
timeworn	老朽的
submillimetre	亚毫米的
trilaminar	三层
abstinency	禁欲
polydispersity	多分散性
shoo	发出嘘声赶
osiris	司阴府之神
horticultural	园艺
welsh	威尔士的
breeder	种畜
dandle	逗弄
clan	部落
pfda	Drug
extracapsular	囊外的
cursoriness	疏忽
muriphobia	鼠科学
spurge	大戟
foxhole	散兵坑
inauspicious	不幸
outmaneuver	以策略制胜
insect	虫的
prentice	无经验
trust	信赖
intropunitive	内罚型
ciphering	算出
multilateral	多边的
nonsensical	荒谬的
spieler	专事欺诈者
rightful	公正的
biotope	生境
bicentric	双心的
unrepulsive	未被击退的
log	园形木材
wry	扭歪的
furunculous	=furuncular
megalopsia	视物显大症
finitist	有限论
odalisque	女奴隶
appeasable	缓和得了
fastball	快球
abstinent	饮食有度
illation	推论
lippy	出言不逊
theodicean	神正论者
epidotized	形成绿帘石的
overlook	没注意到
deplorably	悲惨地
shakily	摇动着
backgrounder	政府官员举行的记者招待会
remover	搬运工
sociable	友善的
preequalization	预均衡
anonyma	头臂干
extract	榨取
pandoor	残忍的士兵
rtm	The
effective	被实施
streamlined	改进的
perishingly	讨厌
multiparous	多产的
convolve	盘旋
uniform	使成一样
overhead	在头上的
euphemism	委婉的说法
crenellation	开垛口
fairytale	童话中才有的
leucin	白氨基酸
cotidal	同潮
rabbitbrush	金花矮灌木
admissible	可接纳的
monometallism	单本位制
homburg	汉堡帽
archaeology	考古学
arrival	到达者
fatso	胖子
interethnic	不同种族间
doubly	双重地
eagerness	热心
gosport	戈斯波特
overwear	使过度磨损
clear	晴
simple	易受骗
commute	交换
catechize	以问答法讲授
conceptually	概念地
meltwater	冰雪融化成的水
fenland	沼泽地方
poikilocyte	异形红细胞
fructuous	多果实的
flurry	小雨
unfaltering	稳步的
ingrained	生染的
constanta	=Constantsa
twentieth	二十分之一的
external	外国
myself	我亲自
gleam	微弱的闪光
mothery	含醋母的
kewpie	小娃娃玩偶
one	一方
sensation	感觉
geo	长狭潮道
athambia	不动声色
pnr	return
exultantly	欢欣鼓舞地
glutethimide	导眠能
firmly	稳固地
survey	概观
turing	图灵机
quaveringly	震动地
justiciable	可在法庭裁判的
spinous	多刺
piezometer	压强计
rhizopodan	根足虫纲动物的
batata	白薯
loaves	块
beamed	定向的
experimenter	实验者
ribbing	肋骨
nucleon	核子
dipterous	两排柱式建筑物
cementitious	有黏性的
unstirred	没有被搅动的
accrual	自然增长
radiochromatogram	rEJmE`tC^rEfI/
michigan	密歇根州
quinquina	金鸡纳树皮
letterpress	拷贝机
regional	整个地区
interactional	相互影响的
germen	子房
biannulate	有二环纹的
mgd	day
glucosamine	葡糖
entomostracan	昆甲类的
aprism	的主义
septicemic	败血病的
afternooner	下午报
solar	日光的
astatically	不安定地
avowed	自认的
reversal	反转
photostat	直接复印件
bacciform	浆果状的
fatten	发财
heteronomous	他律
floating	移动
tough	强壮
domineering	作威作福的
fatiguesome	令人疲惫的
ecliptic	日食的
cheering	令人高兴的
fan	扇子
ecc	错误检查与纠正
kbp	pawn
warring	交战的
sas	Airlines
steamy	多蒸汽的
greenish	呈绿色的
serigraphic	绢网印花
potbellied	大肚子的
pluriaxial	多轴
miniver	白鼬毛皮
glance	匆匆一看
inflammable	易燃
hobbadehoy	蠢笨的年轻人
maffia	秘密政党
bongo	一种用手指敲的小鼓
raca	无价值
innovatory	革新的
hinterland	内地
bigeminal	成对的
tarvia	他维亚
bogey	妖怪
incept	摄取
favorable	讨人喜欢的
courtesan	情妇
psychopath	精神病患者
asp	Service
thew	活力
arret	命令
breasthook	船尾肘材
gyroidal	螺旋形的
dst	Test
coed	男女同学的
matricentred	母权的
arresting	引人注意的
ritualistic	仪式
abstractively	抽象性地
lazaretto	检疫船
tannable	可鞣制的
unretarded	未推迟的
xpvm	A
carbonaceous	含碳的
nonaqueous	非水
gumption	进取心
inessive	在内格的
formyl	甲酸基
suspender	吊杆
plantigrade	跎行类
iota	希腊语字母第
wraith	鬼魂
mrcp	Physicians
underhung	下颚突出的
sierran	内华达山区
revisory	修订的
xenophobic	恐外的
shortening	简写
hackneyed	不新奇
gearcase	齿轮箱
rear	栽种
tipple	不断喝
archimedes	阿基米德
oecumenicity	=ecumenicity
maenad	的女侍
one	任何人
polycrystalline	多晶
utensil	器具
docetic	幻影说的
maximum	最多的
archegoniate	颈卵器植物
northwestward	西北部
broad	明朗
heteronymously	相关而异名
dissatisfaction	令人不满的事物
vizor	腹面
illiberality	吝啬
heptathlon	七项全能
jaspagate	玛瑙碧玉
site	地点
carnal	淫荡的
beaky	像鸟嘴的
peacekeeping	维护和平
lumber	喧闹地向前走
fairyland	仙境
corpulent	肥大
rowdyish	吵闹
reckon	依赖
circiter	=circa
cern	欧洲粒子物理研究所
youthfulness	青年
foamy	全是泡沫的
nim	偷窃
dangle	摇摆
leewardly	脱离航路的
antifeudal	反封建的
deploitation	开拓
abyssinian	阿比西尼亚
whiggery	辉格党的原则
imperceptibility	没法感知
undebatable	无可置疑的
furry	盖着毛皮的
alacrity	敏捷
fut	=phut
halyard	升降索
sideseat	边座
pathometer	探谎器
carbonate	使充满二氧化碳
spinous	刺状
nighthawk	夜鹰
cestoid	象绦虫
helplessly	无能为力地
interborough	区与区之间的
wisla	维斯瓦河
abetment	支持
syncopal	晕厥
weal	幸福
automobile	汽车
proprietary	所有者
wiredraw	对……牵强附会
alliterative	头韵体的
flask	瓶
melitriose	蜜里糖
guileless	不狡诈
malcontent	不满
monotony	单音
rongeur	骨钳
fisher	捞取者
polocrosse	兜网马球
broad	广泛的
slash	大量削减
rankle	激怒
fjp	of
voyeurist	窥阴部色情者
faculty	本领
whitleather	=white
fellmonger	羊皮商
offside	后面
spanking	拍击
transworld	环球旅游
microtechnique	显微技术
quixotic	唐吉诃德式的
ultraminiaturize	9QltrE`mInIEFEraIz/
kaif	麻醉品
nick	阻击
harmonical	音乐般
dividual	分享的
simulate	模仿
quixotism	不切实际的思想或性格
tacmar	Tactical
upborne	被支撑着
capetown	南非共和国立法机关所在地
raunchy	邋遢的
specialize	使适应特殊目的
colossus	巨像
jokesmith	编笑话者
ozone	新鲜的空气
rhythmically	有节奏
multicolor	五彩缤纷的
unlovely	讨人嫌
euripides	欧里庇得斯
unshaken	不动摇的
cystiform	囊状
mantelpiece	壁炉的前饰
dairy	牛奶场
choybalsan	乔巴山(旧称克鲁伦
schizothymic	分裂样人格的
gitgo	开端
posting	置入
throughput	吞吐量
craped	戴黑绉纱
reporting	报告
ilka	每一个的
olivaceous	橄榄色
depside	缩酚酸
liquefier	液化器操作工
humoral	由体液引起
cyanobacterium	藻青菌
solecistic	违反语法
propel	推进
ridge	起皱
make	性情
spud	剥树皮的铲凿
signable	可签名的
unreceptive	接受能力不强的
killing	致死
einsteinian	爱因斯坦理论
laminar	由薄片或层状体组成
courlan	库隆鸟
brake	闸
filter	用过滤法除去
aal	Adaptation
tetramorphic	四形
retire	撤退
ventriloquous	口技
cruel	残酷的
tocsin	警报
separately	个别地
crawlway	天花板很低之走廊
humiliator	羞辱者
perisarc	围鞘
decahydrate	十水合物
chance	偶然发生
lockhouse	船闸管理人值班房
sheryl	谢乐尔
lapidescent	石头似
fetial	处理国际问题的
pronate	使伏身
broadwise	侧面地
selves	自我
reconstructed	重建
veronica	印有耶稣面像的织物
gppm	每分钟可打印的图形页数
mossback	极端保守的人
tootle	胡说八道
solvent	溶媒
adiposis	肥胖病
lowlihead	谦卑
valedictory	告别词
project	企业
poppa	大伯
heddle	综片
methinks	据我看来
brooder	孵化器
wipo	Intellectual
triable	可以试一下的
overcapitalize	过分投资于
ato	Teaty
dbms	Database
teacake	当茶点用的饼干
abidance	遵守
spill	使溢出
flay	去皮
poolside	在游泳池边
touraco	蕉鹃
produce	结
hypoxemic	血氧不足
octocentenary	持续800年
bitonal	双调
roar	咆哮
clocklike	准时
asphyxial	昏厥的
workerist	强调工人利益的社会观
lorikeet	青绿色小鹦鹉
equivocator	说模棱话的人
wend	回
supremely	崇高地
sottish	酗酒的
haemolytic	溶血
irq	request
hypertherm	人工发热机
sanious	脓液的
pigpen	猪舍
prednisolone	脱氢皮质
wiredrawn	太琐碎的
septuple	七的
compression	压榨
unifoliate	单叶的
papyraceous	纸草
bowhunt	用弓箭狩猎
davit	吊柱
malnourished	营养不良
eristic	好争论
unlikelihood	不可信
informally	非正式地
sinew	肌肉
filbert	榛树
abm	Missile
widow	使成寡妇
prometheus	普罗米修斯
decaliter	十升
excess	无节制
unaided	未受协助的
crmp	of
able	能干的
literaryism	过度讲究的辞句
angelica	当归
accessory	同谋的
fulcrum	杠杆的支点
auspice	占卜
feijoa	费约果
cryocable	超导电缆
ramp	狂跳乱撞
bimeby	不久以后
weird	预言
extemporal	脱口说的
fingerprint	指纹
elated	兴高采烈的
asyndetic	连接词可省略的
out	暴露
psammite	砂屑岩
commemorate	纪念
matted	纠缠的
errata	勘误表
aeolic	伊欧里斯人
jackey	杜松子酒
dropping	滴下物
tritiate	使氚化
cineol	桉油酚
leisurable	不慌不忙的
snuffling	抽着鼻子的
favoritism	偏袒
uplooking	有志气的
span	跨度
polybasic	多碱的
polarisable	=polarizable
anthropopathism	拟人说
secondary	次要
hubris	傲慢
upstate	偏僻
peremptorily	紧急
ideaistic	思想
offhand	随便地
sanitarist	=sanitarian
cyetic	怀孕
methemoglobin	=methaemoglobin
lugubrious	悲惨的
rotiform	轮形
tonsillotomy	扁桃体部分切除术
satanic	魔鬼般
limpness	疲倦
aonb	杰出自然风景区
irreligionist	不信宗教者
nasally	鼻声
schlockmeister	劣货制造者
gamely	勇敢
actinal	口侧的
mu	12
unregarded	不受注意
signior	先生
amperage	安培数
kingfisher	鱼狗
nether	下面的
ripplet	小涟漪
hmas	HerMajesty''s
death	毁灭
bopomofo	汉语拼音字母
kinsman	同族者
ensnarl	使被纠缠
shipmate	同船水手
illutation	泥浴
oblong	长方形
mac	Control
transact	交易
signed	有符号的
legerdemainist	变戏法者
bona	good好之意的
intertriglyph	=metope
pragmatist	爱管闲事的人
warangal	瓦朗加尔
generate	发生
ala	翼
masterplan	根据总体规划设计
obbligati	肋奏声部
csce	Cooperation
unprepare	使不适合
rechabite	禁酒会员
nutwood	坚果树
inimitably	独特地
parhelion	幻日
veiled	以面罩遮掩的
grape	葡萄树
swim	眩晕
trattoria	饮食店
maoist	毛泽东的
informality	非正式
zygosity	接合性
spiritualistic	唯心论的
corepressor	辅阻遏物
delighted	快乐的
phosphorylcholine	磷酸胆碱
precipitate	猛地落下
qualify	限制修饰
pictorial	图示的
undated	未标日期的
nematicidal	杀线虫
dekko	一瞥
aboriginal	土著居民
existence	存在物
sooty	煤烟熏黑
seed	播种
working	工作
intoxicated	喝醉的
shambles	肉店
caller	访客
subscriber	捐献者
nonhibernating	不冬眠的
superaltern	全称命题
deniable	可否认的
geoponics	乡间
thiram	双硫胺甲酰
assiut	=Asyut
joinery	木工职业
infallibilism	教皇绝对可靠主义
corruptive	使腐败的
kindly	爽快的
uncharitable	不宽恕
innumerous	=innumerable
grison	灰鼬
mekka	麦加
cave	使凹陷
inarticulately	笨嘴笨舌地
bottom	末端
stereotypy	铅版印刷术
phoebus	太阳
arctic	北极圈
nightclothes	睡衣
groom	男仆
sensuous	给人美感的
steatite	滑石石瓷
hippocampus	海马
osteal	由骨构成
preadult	成年前
autogeneration	自动产生
stroke	击
indiscretion	轻率
acropolis	古希腊城市的卫城
greyhound	快速船
uae	阿拉伯联合酋长国
conservative	保守派
redeliver	再交付
hlf	Heart
excusingly	辩解
arson	纵火罪
warden	一种冬梨
aspirant	上进的
coprolagnia	粪性淫乐
enfranchise	解放
falcongentle	雌隼
shebang	工作
sapphiric	蓝宝石质
pustulous	有小疙疸
fasten	强加于
cupid	爱神丘比特
fuzzbuzz	喧闹
curtsy	屈膝礼
unthanked	未受答谢
perimeter	周长
thermomechanical	热机械
ventage	小口
ocap	Open
walkthrough	预排
plangorous	哀号的
compressional	与压缩有关
catheter	尿液管
varsity	大学代表队的
featheredged	薄边的
penicil	一簇细毛
jarring	辗轧声
literate	有阅读和写作能力的
heraldry	纹章学
blighted	毁灭的
auc	ab
wino	酒鬼
kalium	钾
neuromuscular	神经肌肉
unannounced	未经宣布
clear	光亮
pretrial	审判前
nudie	裸体表演
northeasternmost	最东北的
spice	意味
madbrain	头脑发热的人
heap	堆积
deva	提婆
cog	小船
expulse	开除
allegheny	spurge平铺富贵草
spud	小锄
fictitious	虚伪的
clear	有条理
juvenilize	抑制……的生长
arteriogram	动脉波
sapphirine	蓝宝石的
ruralism	乡下风味
sins	system
imprecision	不精确
interlinear	写在行间的
sachsen	=Saxony
rdo	远程数据对象
difference	分歧
jibb	船首三角帆
attitudinarian	装腔作势者
unchoke	疏通
barbarous	残暴
dimmer	调光器
fractional	分馏的
foal	驹
darkish	浅黑的
reformative	改进
booted	穿靴
becoming	适当的
nightlong	通宵的
ephemeralization	非耐用商品的制造
sputter	喷出
aftercooler	二次冷却器
cryptographical	号的
outmoded	过时
orange	柑
removable	抽取式
hectic	兴奋的
ungual	有爪
wad	填塞
scraping	刮
semicylinder	半柱面
hymenopterous	膜翅类
tutwork	计件工作
trisomic	三染色体的
perspective	观点
cardan	=Cardan
dumpy	矮脚鸡
vinyl	乙烯基
clownish	滑稽的
bonavacantia	无主财物
enantiomorph	对映体
elliptical	省略
invigilate	看守
depreciation	贬值
apical	顶上的
defence	防卫
drugget	厚毯
ems	特快专递
complyingly	遵从
agreement	一致
whine	报怨声
disciplinarian	规律
softish	有点柔和
lengthy	过分
basilect	下层方言
charpoy	行军床
medicable	有疗效的
sufferance	忍耐
pedestrianise	=pedestrianize
antiheroine	不按传统主角品格塑造的女主人公
isobutyl	异丁基
tritural	适合于研成粉的
plutolatry	拜金主义
stockrider	牛仔
diplont	二倍体
spicy	辛辣的
solstitial	夏至
hatmaker	制帽匠
catachresis	修辞生硬且自相矛盾的误用
ergometer	测力计
hers	她
phonocardiogram	心音图
bushfighter	灌木地战士
nestlike	巢状
podunk	无名小镇
carelessly	粗心地
nihilistic	虚无主义
aseasonal	无季节性的
thermotropic	向温的
embarrassment	困窘
flectional	屈折的
cognominal	同名的
preemption	抢先占有
astatically	不稳定地
hearty	精神饱满
msphe	Science
bup	United
knurly	多瘤
hackbuteer	火枪手
rosinweed	松脂植物
literate	有阅读和写作能力
signature	签名
strawy	稻草状
pesky	烦恼
contribution	贡献
vectorcardiogram	^rAm/
kona	=kona
suspenseful	悬疑
antimeric	对称部分
inspiratory	吸入
inthral	迷醉
subtle	敏感的
cipherkey	暗号解答
biyearly	二年一次的
janissary	古时土耳其苏丹的禁卫军
infuriation	激昂
intensively	集中
tinker	焊锅
robin	知更鸟
baleful	有害
gore	血块
motherfucking	不要脸
hummum	=hammam
redfish	雄鲑
cevennes	塞文山脉
erudite	博学的
supplicatingly	恳求似
diametric	直径
prodigalize	挥霍
crisp	脆的
fastidious	需要复杂营养地
era	纪元
mts	资金传输系统
final	结局
mangonel	军用射石机
prattle	说孩子气的话
grapestone	葡萄子
nsf	The
sforzando	加强地
ambivalent	好恶相克
sarcenet	薄绸
douroucouli	夜猴
papillary	乳头状突起
wicked	刻毒
limacine	似蛞蝓
newspeak	官方宣传语言
unwanted	有害
assessable	可估价的
craniocerebral	颅与脑的
beery	啤酒喝醉
lst	Time
illiquid	无流动资金的
fatuity	愚蠢的言行
melting	溶解
evangelical	信福音主义者
solutrean	梭鲁特期
producer	演出人
enalite	变铀钍石
duopsony	由两家买主独揽的局面
limited	有限
israelitic	犹太人的
bicorn	双角
domineering	极权
adiaphorous	无作用的
humanize	变为有人性
deweyite	J
nonhibernating	不冬眠
unawakened	未醒
conciliatory	调和的
colossal	巨大的
prussian	普鲁士的
wazir	=vizier
laa	轻型高射炮
wizardly	神奇
vascar	and
ardently	热心地
hypersensitivity	超敏性
phonematic	音位
provoke	煽动
penstock	水阀门
revert	回复
kit	用具包
music	乐曲
historicizer	撰史者
unsling	自吊索上放下
ambrosial	芬香
far	甚远地
contraceptive	避孕的
expansible	会膨胀
imperatorial	皇帝
effectually	有效
greaten	使伟大
perim	丕林岛
ectypal	副本
nonsteroid	非甾类化合物
winter	萧条期
darkroom	暗室
vendeuse	女店员
prosecute	实行
astable	不稳定
szechwan	四川
tupek	=tupik
carking	烦人的
acanthoid	刺状
unific	倾向于联合
intentness	专心的
genevan	日内瓦
gassy	空话连篇的
remains	残余
parish	教区
communise	=communize
conqueror	征服者
unnumbered	未编号
syphilide	梅毒疹
follow	遵循
resplendently	耀眼
bistro	小咖啡店
axillary	叶腋的
gapemouthed	张大嘴
undiluted	纯粹的
cock	龙头
gymnoplast	裸质体
vambrace	全臂铠甲
brilliancy	出色
gooky	肮脏的
spirochete	螺旋菌
landlady	老板娘
numerous	众多的
sacking	帆布
cyclostomate	有圆口
larghetto	稍缓慢曲
dvd	Versatile
refundable	可偿还的
distinction	差别
priestly	僧
consummately	完成地
patientless	无病人的
shogun	幕府时代的将军
complacent	自满的
handloom	手摇纺织机
offstage	舞台后面
heterogeny	自然发生
lunary	月亮
calender	以砑光机砑光
backroom	私下
raf	英国皇家空军
vasculitic	脉管炎的
quintile	五分之一对座
hercules	大力英雄
curtainfall	幕落
remigration	重新移植
headquarters	总部
detin	除去镀锡物的锡
consumable	消费品
antihuman	反人类
aimer	瞄准手
languishment	呆滞
acold	寒冷的
balladmonger	街头卖唱者
standing	名望
clostridium	梭菌
nuppence	无钱
foregather	相遇
irenical	和平主义
freak	反常
pronaos	门廊
remeasure	重新测量
covey	一队
rockfall	岩崩
francophil	崇拜法国的
workman	男工
rba	Society
spermaceti	鲸油
coffeepot	咖啡壶
age	使用年限
lame	不完全
albumenize	涂蛋白于
position	立场
acqierement	学得
tierce	三度音
oldwomanish	大惊小怪
healing	康复
continuator	继续者
cannibalize	拆用……的配件
impassably	不能通行地
moppy	拖把似的
impellent	推动的
pollinctor	殡仪员
anyway	总之
phlogistic	燃素的
unbroken	未破损
oops	狼狈时所发的喊声
abasable	可贬黜的
handsel	彩金
lithesome	柔软
invectively	非难
carboniferous	含碳或煤的
solmization	阶名唱法
robustly	粗鲁
desiderate	渴望
foa	Foreign
transferee	承让人
propagable	可传播
etcaeteras	等等之人或物
nonaqueous	非水的
unwitnessed	无证人签字的
misogynic	厌女的
bronchopneumonia	支气管肺炎
ulotrichous	鬈发
interferometric	用干涉仪测量的
chloritic	亚氯酸盐的
complimentary	免费赠送的
permeability	渗透性
plafond	天花板画
upu	Union
shanty	简陋小屋
medic	实习医生
piagetian	皮亚杰关于儿童思维发育理论
diggable	可挖掘
stagecoach	公共马车
unweeded	未除草的
fuzznuts	小子
spill	倒出
hurriedly	慌忙地
workhorse	驮马
plead	辩护
serena	爱情小夜曲
alecithal	无蛋黄
halloa	啊呀
sultrily	闷热地
keir	煮布锅
cryptology	密码术
billionth	十亿分之一的
metric	米制的
lenitive	缓和
pedantocracy	腐儒政治
gravelly	多碎石
troy	金衡制
notoriety	声名狼藉
decennial	十年一度
veracious	准确
hand	雇员
megaera	墨纪拉
coercively	压迫
gummous	树胶的
invisibility	看不清
multipage'	NULL)
comatulid	放射状海百合
criticastry	不恰当之评价
dropwort	六瓣合叶子
sanctionist	制裁国
ac	Car
polemonium	花荵
oleiferous	含油
harrumph	哼声
downcast	向下看的
undersupply	对……供应不足
soogee	冲洗
solemnity	一本正经
haematopoietic	造血的
disheveled	凌乱
winter	冬天
elysian	乐土的
chary	仔细
zooecology	动物生态学
pseudomycelium	假菌丝体
forelady	女工监督
iyft	Your
silverly	银一般地
occidentalist	西化主义者
unqualified	没限制
transient	瞬时
harelip	兔唇
uncreate	灭绝
contaminative	污染的
impedient	阻碍的
unanswerable	无法回答的
daily	每日
netting	网鱼
nincompoopery	傻瓜
excisable	可割取
dexiotropic	向右
egp	Protocols
endlong	纵
menisci	的复数
out	击倒
hormonal	荷尔蒙
poppet	提升阀
succus	体液
ebonite	硬化橡皮
rhinal	鼻腔
discal	圆盘
quizzy	爱打听
booted	穿靴的
ringlet	小环
glumpy	脾气坏的
firewall	Internet防火墙
cherish	怀抱
clypeiform	有额板
gemel	孪生的
valla	眉毛
buckle	扣住
yearling	一岁家畜
rossiya	=Russia
accepted	一般承认的
involucel	小总苞
norland	北国
werwolf	狼人
tributary	进贡的
conchiferous	含贝壳的
checkerman	西洋跳棋棋子
haptoglobin	结合珠蛋白
framboise	木莓白兰地酒
regardant	头朝后看的
warehouseman	货栈主
fixation	定象
filmgoer	上电影院的人
famous	极好
object	拒绝
cockeyed	斜的
columned	立有圆柱的
amplexus	抱合
roseate	红润
hydraemic	水血症的
steely	似钢的
jimsonweed	蔓陀罗
effectual	奏效
experientialism	论
moonshine	妄想
impertinently	不切题地
conspecific	同种的
teratogenesis	畸形生长
gadsbodikins	温和的诅咒语
multienzyme	多酶的
bib	围兜
ensepulchre	埋葬
wb	World
phosphopyruvate	=phosphoenolpyruvate
awag	摇摆
lingam	男性生殖器像
atom	原子
traditionarily	传统上
paradox	自相矛盾的话
deice	防止结冰
disruption	破坏
orgiac	=orgiastic
debt	债务
elementary	初步的
samarinda	三马林达
chaff	愚弄
expositive	说明
obsolescent	荒废
crafty	善于骗人
execratively	憎恶
subgroup	给……加副标题
plantigrade	跎行
unselective	没有选择性
intactness	未受损伤
directorate	董事会
shroud	用裹尸布裹
since	既然
pedodontic	儿童牙科
unloved	未被爱
mancunian	曼彻斯特的
misspelt	misspell的过去式及过去分词
spendable	可使用的
morphine	吗啡
punk	低劣的
eyeless	盲目的
voyeurist	窥淫癖者
muteness	无言
sunrise	日出
closefitting	紧身的
bewitching	迷人
pushiness	一意孤行
quaestorship	刑事推事之职务
fratry	僧院中之餐厅
criminative	控告的
stray	偏离
chromotype	着色石版图
hotly	暑热
pathologic	病理
ayrshire	该州产的乳牛
wive	娶妻
neanic	青年期的
naughty	不适当的
effectuation	实行
needlefish	颌针鱼
either	每一方
bureaucratism	官僚主义
noctilucent	夜发光
psychrometer	干湿球湿度计
strain	张力
substantiality	实在性
prune	剪除
gentlest	优雅
ecclesia	古希腊城邦的国民大会
albuminoid	蛋白质的
lavabed	熔岩层
geist	理智感受性
upward	声高的
regardlessly	不受注意地
edemata	edema的复数
dexie	右旋安非他明药片
larvivorous	以幼虫为食
instructor	讲师
pitchy	沥青的
investitive	赋予
matador	斗牛士
strain	尽力
crepuscular	微光
fissile	易裂的
drayage	运货马车运送
seam	接缝
takingly	迷人地
showfolk	文艺界人士
underage	久缺
resonantly	反响
exosphere	外大气层
image	极为相象
nintendo	任天堂
preludious	=preludial
photoperiod	光周期
pendeloque	鸡心形垂饰
vitriolic	讽刺的
inconsistently	不一致地
nonconductor	绝缘体
superincumbent	横在上面的
gal	少女
aerogenically	产气
predicative	肯定
irdp	Discovery
triplicate	三乘
trinitarian	信仰三位一体的
besot	使沉醉
inexhaustible	无穷无尽的
impeccant	无缺点的
wittily	机敏
untamed	未驯服的
garrison	驻防
citybred	在城市的
sternly	严厉地
forcibly	强制地
verbatim	逐字地
semisolid	半固体
unvexed	镇静
kidnapee	被绑架的人
august	威严
diffusedly	散布
kooky	乖僻的
silentious	沉默寡言
elm	榆树
slough	在泥浆中跋涉
newsgirl	女报童
dispersion	驱散
umbilical	母系的
immersible	可没入
mildly	略微
hydremia	水血症
equational	方程式
agreeably	欣然
aslant	倾斜
aphis	蚜虫
rhonchi	鼾音
intuitional	直觉的
mopus	es)
qda	discount
expensive	花费
notion	主张
siva	湿婆
futuramic	设计新颖的
katydid	纺织娘
snooze	懒散地打发日子
epidermization	皮肤移植法
midst	在……中间
apriority	先验法
supermassive	特大质量
renitent	僵硬
zonked	吸毒而恍惚
nanofossil	=nannofossil
phleboid	静脉的
freak	怪诞的思想、行动或事件
purpuric	有紫色
aureate	灿烂
hairdress	=hairdo
introductive	前言的
commercialese	商业用语
rhodoplast	藻红体
icaaaa	Intercollegiate
conspire	阴谋
looky	看
dead	呆板的
calkage	塞船板隙缝用的材料
arousal	激励
greensickness	黄萎病
sazerac	萨泽拉克鸡尾酒
marxize	使马克思主义化
microsection	section
cheerily	快活地
salvageable	可挽救
exopoditic	外肢节的
reservedly	隔阂地
fusible	熔解
jesuitical	耶稣会士的
ocher	黄土
fool	愚人
complete	完全
dissolvent	溶剂
vlaie	池塘
informant	密告者
surgical	外科的
excellent	极好的
commeasurable	可成比例
removable	可移动的
ingenuous	坦白的
contratest	对照试验的
unlikeness	不象
cmos	Metal
kermit	一种文件传输协议
physicky	药物似的
divert	转移
mucedinous	霉的
teratogenic	产生畸形的
whirlabout	盘旋
rigour	严格
unpunishable	不能受惩罚
centrosphere	中心球
agrapha	耶稣之遗言
didactical	教导
panoptic	展示全景的
plumbeous	铅
bedewed	为……所沾湿
spotty	多斑点
azul	警察
septuple	七倍的
oblique	不坦率
frantically	疯狂似地
summing	求和
caravaggesque	卡拉瓦乔
felicitous	善于措词
blindfold	蒙骗
locutionary	非语内表现行为的
larcenist	盗窃犯
fyke	长袋网
apache	美洲印第安人的一种族
mixer	搅拌器
composedly	从容地
proconsular	地方总督的
opisthograph	古字板
register	把……挂号
credenza	餐具橱
nonofficial	非公式的
pleasurably	快乐
yestermorn	在昨天早晨
undersecretary	次长
softgoods	纺织品
josh	戏弄
pure	无垢
tarpon	大海鲢
jumbled	混乱
absorbability	可吸收性
since	自从
acclamation	欢呼
chromoprotein	色素蛋白
acd	Distributor
hostess	女老板
lousily	不洁
demotic	通俗
aconitum	=aconite
beerburst	=beer
cotquean	好骂街的女人
apoplectic	中风的
dockize	为……设船坞
supersecret	绝密
crampon	铁钩
photoenvironment	光照环境
msee	of
waltz	旋转
ruggedize	使坚固
yseult	=lseult
extendible	可扩张的
dahabiah	尼罗河的三角帆客船
fenny	住在沼泽地的
misfit	与……不相称
depredation	破坏痕迹
subseptate	具有不完全隔膜的
amitosis	直接核分裂
giggly	傻笑
gripesack	旅行包
pecuniary	金钱的
vocational	职业
commute	减刑
verbicidal	滥用词语
bookbinder	装订商
puffy	自大的
slate	含板岩的
congratulation	贺辞
dahomeyan	=Dahoman
tother	另一个的
sussy	可疑
picnicky	行乐
hummock	小丘
ruttish	淫荡
executor	执行者
birdcage	鸟笼
omicron	15
techy	暴躁
temperable	可回火
bathymetric	测海学的
multilateral	多国
freeload	不劳而获
perissodactylate	奇蹄
riverway	河道
automobilism	汽车使用法
lambdoidal	人字形
axillary	腋生的
oddish	有点怪
operationalize	使用于操作
ethically	伦理上
calcariferous	有距的
animative	使有生气的
homothermal	=homoiothermal
shoddy	假冒
pursy	肥胖的
thermolysin	嗜热菌蛋白酶
morganatic	贵贱通婚
mdr	Daily
nailer	自动敲钉机
overproud	太骄傲
uda	Access
abyssinian	阿比西尼亚的
indra	因陀罗
nannyish	正人君子
infective	影响别人
fumagillin	烟曲霉素
fearful	可怕的
extractible	可引出
diaspore	传播体
gsc	Corps参谋团
hyperadrenalism	肾上腺机能亢进
byzantine	东罗马帝国
imaum	=imam
cowson	狗养
neocolonial	新殖民主义
aristaeus	阿里斯泰俄斯
cauterant	烧灼物
fra	兄弟
longhand	普通书法
speck	斑点
posted	有地位
psychotogen	致精神错乱药物
inflator	充气机
elaterite	弹性沥青
ichor	腐流
tilburg	提耳堡
lymphous	淋巴的
pararuminant	类反刍动物
anathematise	咒
present	赠送
gin	轧
peaky	多峰的
liege	臣民的
ceremonially	仪式上
oxyhemoglobin	氧基血红素
acetabuliform	碟状的
gape	呵欠
checkgate	堰门
freeform	任意
dimitrovo	季米特洛沃(保加利亚西部城市佩尔尼克
undissembled	非伪装
dcs	Stimulator脊柱刺激器
smart	聪明的
oersted	磁场强度的CGS
musicalize	编成音乐剧
bisectrix	等分线
panglossian	过分乐观
exility	稀少
fissipedal	足趾分裂的
deuteranomal	绿色弱者
cliquy	分为派系的
permeate	透入
incidence	落下的方式
spancel	拴马索
denish	丹麦
rubbaboo	=rubaboo
substantiality	实体
haikou	海口
asocial	自我中心的
cautionry	替人作保
cultivation	教养
psammophile	喜沙生物
sellout	背叛
concoct	调制
fetch	取得
laxatively	有轻度腹泻
insessorial	习惯于栖止的
ohmage	欧姆阻抗
receptive	善于接受
unstriped	无条纹
fescennine	粗俗的
paraplegia	截瘫
guitar	吉他
waterfall	瀑布
breechblock	闩体
tabernacular	临时房屋的
epicontinental	陆缘的
firecracker	鞭炮
odds	优势
craped	戴黑绉纱的
firmly	坚定
witty	诙谐的
wonderment	惊奇
tachyauxesis	局部生长过速
inundatory	压倒性的
boatyard	造船厂
flaunt	夸耀
triplicity	三位一体
unwedded	没有结婚
stannous	含有锡
precatory	委托的
upcast	向上投掷之物
jobseeker	求职者
refinement	精巧
unflawed	完美无缺
lowery	阴暗
workday	工作日
accelerograph	加速器
umw	Mine
sometimes	不时
binovular	=biovular
hirsutism	多毛症
widen	扩展
knight	授以爵位
england	英国
valiantly	英勇
flatheaded	平顶的
dcvo	of
stemware	有脚的器皿
motorial	发动
fellowship	团体
harpy	残酷贪婪的人
camelback	一种翻新的橡胶
immiserize	使贫苦
wound	伤寒
mort	通知猎物已死的号角声
clonic	阵挛
gautama	释迦牟尼之俗姓
junky	无价值的
antibacterial	抗菌药
indeterminable	不能解决
astolat	阿斯托拉脱
mild	轻微的
searcher	搜索者
sarcoplasm	肌浆
vanishingly	消遁似地
milankovich	米兰柯维奇理论的
finnicking	挑三拣四
wink	眨眼
praiseworthy	值得称颂的
hearse	灵车
retorsion	报复行为
charcutier	食品商人
impartiality	公平
msy	maximum
genal	颊的
concomitant	伴随的
giddily	头晕
favorable	起促进作用的
checkroll	点名簿
ptv	television
barney	大吵大闹
fughetta	小赋格曲
dovap	多普勒测速和定位系统
misdeem	错认
wow	使叫绝
conicity	锥度
pad	垫
received	被认为标准
dodecagonal	十二边形
netted	用网捕获
xystus	小径
lollardism	罗拉德派的教义及信仰
uranology	天文学
aggression	进攻
gag	随口科白
exertion	发挥
quadrable	可为平方
shade	颜色深浅
scent	发觉
skerry	孤岩
subepidermal	表皮下
rowanberry	花楸浆果
pvm	Parallel
negrophile	亲近黑人的人
lamaite	喇嘛教徒
communicant	报导者
heterogenous	异源
aphanitic	非显晶岩的
motory	运动神经
abluent	洗净的
ocdm	Civil
pretensive	=pretentious
dinosaurian	似恐龙
mace	豆蔻香料
viticultural	葡萄栽培的
plicate	有褶的
swapo	西南非洲人民组织
laminar	薄片状的
handmade	手制的
srs	Societatis
current	涌流
congealment	凝结
devilish	如恶魔般的
flirty	=flirtatious
apyrexia	无热
nerc	Environment
lateralization	偏利
harddisk	硬盘
staff	杆
ruthenic	钌
tantamount	等价
hitlerian	希特勒政权的
emanative	发散
inefficiently	无效率
asinine	愚蠢
versitron	高敏度温差遥感器
marigold	万寿菊
chesterfieldian	温文儒雅的
doozy	非常显眼
unlighted	未被照亮
slumberland	睡乡
conduit	导管
wolf	狼吞虎咽
erythrism	红须发
cataphract	古罗马军人或马匹之甲胄
unavoidably	不得已地
happening	意外发生的事
slim	变细
thermal	热量
unprejudiced	公平的
lumbaginous	腰痛的
scraggly	起伏
floorer	使人沮丧的消息
pubic	阴部
pandemic	全国流行
entrance	入口
foudroyant	爆发的
inflation	夸张
cognate	同词源
trepan	陷阱
zootechnical	畜牧学的
slic	储蓄借贷保险公司
sack	麻布袋
exosphere	外逸层
brcs	Cross
aswoon	晕倒
point	点
pion	介子
directionality	定向性
gastroenterology	肠胃病学
acadian	阿卡迪亚的
gummatous	似梅毒瘤
whereby	凭什么
battlewise	富有战场经验
seventeeth	十七分之一的
reducing	减轻体重法
nucleolonema	核仁丝
coptic	埃及基督徒的
podzol	灰化土
evertor	外转肌
lessened	减少
galluses	吊裤带
suckle	吸奶
vivandier	随军小贩
feather	翎毛
choice	抉择
exorable	可说服
bittersweet	又苦又甜的
tail	为……装尾
continued	延续
jawbone	下颚骨
metacercaria	后囊蚴
epaxially	轴后
fytte	诗歌的一节
fiver	五元美钞
espanol	西班牙文
contradictious	异议多的
websterite	矾石
udder	乳房
monthly	每月的
protestant	新教
fair	直接地
portliness	肥大
transcaucasia	外高加索(指高加索地区
menopausic	=menopausal
nonnutritive	没有营养
peremptorily	不容分说
depressible	可抑低的
atheneum	雅典庙宇
plangent	凄切
fijian	斐济语
glottal	用声门发声
dicky	衬衫的胸襟
typhlosis	视觉缺失
esol	for
ingratiatory	讨好的
tryout	预赛
esc	EPSON公司开发的页描述语言
aspishly	似毒蛇
collodium	火棉胶
pekalongan	北加浪岸
status	状况
imperatorial	至尊
dink	漂亮的
trepan	钻孔机
distant	冷漠
unendowed	不赋有
uptodate	直到现代的
remote	遥远
affection	疾病
scalar	梯状的
exuberant	非凡的
emasculate	柔弱
arbutus	杨梅属
tamely	没骨气地
rotational	转动
garlicky	大蒜似的
uncensored	无保留的
cosign	连署保证
orthotics	矫正术
podded	富裕的
divine	神
chill	寒心
finegrained	有细密纹理
phony	假冒的
varied	各式各样
deluxe	豪华
hoppingly	卖力
nympha	小阴唇
lathwork	覆以板条
snuggery	舒适的家
diligent	用功
reattempt	再尝试
transmitter	话筒
sowntown	商业区的
megarian	麦加拉学派的
dish	碟
abate	使被废除
tripeman	牛肚商贩
sulphurous	含有硫磺
fashionable	时髦的
safety	保险装置
solidarist	社会连带主义者
anatomise	解剖
perpendicular	垂直
spinsterhood	未婚
radiation	辐射
belly	涨满
ruder	rude的比较级
strangles	腺疫
anchorage	抛锚地点
zanu	African
hydrotropically	向湿性地
unexaggerated	未夸张
floatability	浮动性
unfrequent	不常见的
tetraspermous	四种子的
roentgenolucent	X光可通过
construct	构造
inspectorate	检查员
enlarger	放大机
ethnology	人种学
rodent	啮齿目
final	最后的
denegation	否认
matsu	见Mazu
scale	依比例决定
utilitarian	功利主义的
tibiotarsus	胫跗节
procryptic	原隐色的
jab	刺戳
backroom	暗中的
bioplast	原生体
reindoctrination	再予以思想训练
gangster	士匪
damsite	水库所在
orthopterology	直翅目昆虫学
pohai	Bohai
fantabulous	极妙
dependent	随……而定
vastness	巨大
ball	球
somniferous	使爱睡
nabobess	财主的老婆
schipperke	狐头竖耳无尾短毛小黑犬
cloistral	隐居的
civilize	使开化
scaphoid	船状
repaper	用纸重新包
bedevil	使痛苦
receving	接受
prostaglandin	前列腺素
recess	隐窝
mistaken	犯错
inunction	涂擦
fan	扇
home	深入
pintoresque	可作绘画题材的
jackaroo	实习
laurette	劳蕾特
sirius	天狼星
newfashioned	新型的
indelible	去不掉的
unquestioning	不问是非
candidly	率直地
unguardedly	没防备
zapu	People''s
politeness	优雅
unsubmissive	不顺从
extensible	可延长的
salary	薪水
march	使行进
obsequious	拍马屁
frump	邋遢的女人
warehouseman	仓库老板
trailer	用拖车载运
triunitarian	=Trinitarian
boracic	含硼的
wring	扭绞
syllabically	每音节
beguilement	欺瞒
byland	半岛
phlogistic	炎
hematothermal	温血的
aggravation	更恶化
land	使登陆
length	时间的长短
consols	统一公债
acanthous	=acanthoid
incised	有锯齿状边缘
fiend	撒旦
seaside	滨海城镇
eisegetical	穿凿附会的
astride	跨着
lawks	糟了!
neurohypophysis	神经垂体
musca	苍蝇座
ergotoxine	麦角毒碱
futilitarian	悲观
gasbag	气囊
erythrism	异常的红色素沉着
sillographer	讽刺文学作家
psychoactive	作用于精神的
antimonsoon	反季节风
limbless	无大枝
bonaire	博内尔岛
limonitic	褐铁矿
belting	调带装置
miniskirt	迷你短裙
catalina	Catalina
tenderer	偿还人
formulist	形式主义者
heterogametic	形成两种胚细胞
gasiform	气体状
admit	承认
entomolite	昆虫化石
yaqui	雅基族
sustenance	生计
acta	America''s
winelist	酒单
renminbi	人民币
pa	私人助理
advance	提升
culpable	不周到的
vitalist	活力论者
unitarian	一神教派信徒
discomfiture	失败
sup	啜饮
uppermost	最初
smooth	一块平地
piquant	开胃的
predormition	半睡期
aswandam	阿斯旺水坝
enamel	瓷釉
blastocoel	分裂腔
recallable	记得起的
advocacy	拥护
financing	筹措资金
lumber	废物
sobering	使清醒的
photoelastic	光弹性
bulldoze	威吓
apoplexy	中风
upset	使不适
truman	杜鲁门
dyspeptic	消化不良
blowout	保险丝烧断
ethical	与伦理有关
dichromism	二色视
misdoer	做坏事者
proconsul	地方总督
explicit	清楚
negatively	消极地
abutter	相邻房地产的业主
plicate	折成扇状
nav	value
interterm	小学期
weirdie	怪事
charm	迷人
hook	钩住
smallage	块根芹
outdoor	野外
tide	潮汐
kelep	肉食蚁
blindfold	看不清的
disputative	爱争论
gormandizer	狼吞虎咽的人
sensualism	肉欲主义
shiny	闪耀的
parlous	极
consultant	商议者
compulsively	禁不住
bearish	粗暴
nother	各异
npl	National
trailing	蔓延的
ellipsoidal	椭圆体的
tale	故事
virelay	古代法国的一节二韵诗
tractable	易管教的
examinator	主考人
dislocation	脱臼
piscatology	捕鱼学
kelp	海藻灰
salpingogram	输卵管造影图
antifebrile	解热的
khond	孔德人
allosteric	变构的
reason	辩论
field	领域
rabies	狂犬病
easement	减轻
enforcement	执行
hydraulics	水力学
eradiculose	没有小根
lacrimal	泪的
prawn	捕虾
wrecky	身体垮了的
sealery	海豹渔场
recording	记录
mill	打
unholy	不洁净
irreversible	不能撤回的
narita	成田机场
immortalize	使不朽
heliotype	胶版画
riyadh	利雅
pleonastic	冗言
phlegmasia	炎症
tcs	traffic
diocese	主教教区
remorseless	冷酷的
desinence	末行
scan	浏览
embay	成港湾状
microzyme	酵母菌
journalize	在日记中记录
plasticine	橡皮泥
bilocular	二格
bnoc	英国国家石油公司
shm	harmonic
panetela	一端尖削的细长雪茄
distinct	清楚的
csma	载波侦听多路访问/冲突避免
eucharistic	圣体
antichristianism	反基督
risk	冒险
coryphaeus	领导者
oap	Old
pilot	引水
entopic	正
compulsory	必修
ramous	多枝的
magnisonant	夸大
surround	围绕
disciplinarian	训育的
minutiose	注意琐碎细节
revalidate	使从新有法律效力
flinthead	朱鹭
caliper	用卡钳测量
cell	电池
inosculate	密切结合
inveterate	根深
rompy	=romping
farthing	英国最小的钱币
lidar	激光雷达
crinoid	海百合类的
imperturbable	冷静
drearily	可怕
businesslike	有效率
inkling	暗示
cumulus	堆积
tough	吃苦耐劳
winking	瞬眼
jinnee	神仙
holozoic	全动物营养性
lousy	生虱的
hernial	脱肠的
laughter	笑声
triumphal	凯旋
tincal	粗硼砂
conglomeratic	=conglomerate
ardent	燃烧般的
headband	头饰带
jade	老马
interpolatory	撺改
prodigal	浪费
circumvolute	缠绕
mabela	南非高粱粉
incalculably	不可胜数
cupbearer	上酒人
wee	一点点
semidocumentary	半记录性电影
internuncial	中间人
boffo	卖座的好戏
mtu	Test
elbowy	用肘推
unromantic	平淡无奇的
foamy	全是泡沫
counterworker	对手
aerobiosis	好氧生活
smegma	包皮垢
indetectable	不可察觉的
leadsman	测深员
denverite	丹佛人
lad	少年
balanced	安定
speos	古埃及的洞穴庙宇
rot	腐败
gossip	闲话
tricerium	三支烛台
cockshut	暮色
abstinent	禁欲的
millstone	磨石
difform	不相似的
bullish	似公牛
isophene	=isophane
tocopherol	生育酚
ivb	invalidity
undulated	波状的
hypomnesia	记忆力减低
direct	由西向东运行的
fiery	暴躁的
stratocruiser	同温层飞机
racemiferous	长总状花序的
enterprise	进取心
haft	把手
run	参赛
underproduce	使生产不足
gaga	天真地
wilco	照办!
style	风度
cummin	孜然芹
drably	无光彩地
variational	变化性的
nephrite	软玉
vacuum	用真空吸尘器打扫
weight	势力
dismission	不予考虑
uncorrupted	未腐败
osteoarthritis	骨关节炎
methimazole	他巴唑
clamorously	鼓躁
audiometric	听力测定
gis	information
congenitally	先天地
nib	钢笔尖
plangorous	悲哀的
wheatland	适宜种小麦的
phantasmagoria	千变万化的风綞l/
decarbonization	脱碳
hep	消息很灵通
pix	影片
thump	重击声
indri	马达加斯加大狐猴
caldera	喷火山口
imitator	仿效者
execution	完成
tentatively	试验性地
hanepoot	非洲白葡萄
digitize	将资料数字化
contemporaneity	同时代
overconfidence	过分相信
amantadine	金刚
behead	砍头
sorority	女学生联谊会
placentiform	胎盘形
oniony	洋葱似
youngly	以适合年轻人的方式
junketing	旅游
makah	=Makkah
turkmenian	土库曼人的
adopted	被采用
entry	进入
gooseberry	醋栗酒
jet	墨黑
theirselves	=themselves
jadish	下贱
bale	灾难
earthfall	塌方
mmpi	Inventory
philological	文献学的
lycian	利西亚
peacherino	惹人喜爱的事物
proof	有耐力
niftic	俏皮
circumterrestrial	围绕地球的
gagger	塞住别人的口
radiovisor	电视
hexastyle	六柱
nonexistence	不存在的事
pectoral	肺病
nipa	尼巴椰子
technopolitan	技术社会
vamp	鞋面
unblushing	不脸红的
howl	怒号
undiscernible	辨别不出
umbrellawort	紫茉莉属植物
punitive	刑罚的
uranous	四价铀的
suggest	提出
tubulate	成管
barococo	过分精雕细凿的
motoscafo	摩托艇
unmoving	不动人的
leisurable	从容
steading	小农场
datary	负责审查僧职候选人资格之主教
cunner	青鲈
undermanned	人员不足的
erection	勃起
corrugated	缩成皱纹的
senior	年长的
usom	States
inconsiderable	不足取的
snr	Ratio
roric	带露水的
mcat	Medical
footsie	调情
meandrine	成襞皱的
rule	裁定
equinox	昼夜平分点
branch	分部
electrical	电
burghley	Baron
trivial	琐细
theocrat	神政主义者
montera	布帽
desiccant	去湿的
uda	通用数据访问
cystinuria	胱氨酸尿
electrotherapy	电疗法
commonwealth	联邦
trampolin	弹床
rejigger	重新安排
untrammeled	无阻碍的
chipper	活泼的
fwpca	Control
caballer	与别人合作图以阴谋手段达成目的者
carp	吹毛求疵
bitumastic	沥青砂胶
guileless	正直
revivable	可苏醒
nutwood	坚果树的木材
nonmedical	非医学的
unisonance	=unison
afterhours	业余
phantasmatic	=phantasmal
transpositional	置换
filemot	枯叶色的
plank	支架
bethanechol	氨甲酰甲胆碱
roller	滚筒
vermifuge	杀虫药
pandemonium	混战场
aviculture	养鸟
usurious	进行高利剥削的
valentinite	锑华
leg	腿
ideological	意识形态的
uscf	Federation
flense	剥皮
betacism	音的混淆
chiastic	交错法
zahidan	扎黑丹
thermolabile	热不稳定
hippish	悲伤
adiaphoresis	不能出汗
gunning	射击
bailiwick	执行官之职
cemetery	公墓
debilitated	操劳过度
cocurriculum	辅助课程
swingeing	猛烈的
transplant	迁移
general	常规
preatomic	原子能利用以前
surveying	测量
styrofoam	聚苯乙烯泡沫塑料
travesty	漫画
resultless	无结果
tumult	骚动
kmps	second
bullmastiff	牛头獒
gunfignt	枪战
outsit	比……坐得更久
huh	哈!
styrolene	=styrene
anorthic	三斜
keeler	驳船船员
blocking	舞台场面调度设计
molestation	调戏
shift	移位
yauld	活跃的
lacet	带子
steering	指导
palship	好友关系
stannous	锡
anthropomorphosis	AnWrEpEJ5mC:f:fEsIs/
supervisory	管理
imperturbable	沉着的
analgesia	无痛觉
divisionism	点彩派
countryfolk	同胞
cocky	过于自信
illogic	不合逻辑
interuniversity	大学间
jaundiced	患黄疸病的
insensibly	没有知觉
endways	末端向前地竖着
felicitous	快乐的
claque	拍手喝彩者
infective	感染别人
unpromising	无前途
flyman	轻便马车之御者
recumbently	躺着地
reconstructive	改造的
image	偶像
bland	柔和
unbridgeable	不能架桥的
licet	那是准许
supernal	高的
fatiguesome	令人疲惫
ephyra	蝶状幼体
limy	含石灰
convention	大会
bisque	桔黄色的
primary	初级
wongai	枣子
sheeplike	绵羊般的
ludicrously	可笑
microstomatous	小口
embassy	大使的派遣
plummet	垂直落下
coadjutress	女助理
streaked	有条斑纹的
humble	粗陋的
magnetizer	导磁体
calory	小卡路里
unclubbable	不爱交际
visive	可看见的
catheterize	将导管插入
oleiferous	含油的
precoital	性交前的
intergovernmental	政府间
lossmaking	老是亏损的
aok	一切正常而顺当地
adele	阿黛尔
extra	额外的
unnecessary	多余
ancillary	补助的
hypertonic	张力亢进的
briery	多荆棘
undoable	不能做不了的
saprobe	腐生生物
unpriestly	不适于教士的
sneaker	卑鄙者
lathy	细长
stem	阻止
fix	整理
unstained	无污垢的
canna	美人蕉科
libertine	放荡不羁者
leaven	酵素
polarise	=polarize
noctambulism	梦行症
screwy	疯疯癫癫
incontrollable	不能控制的
dishwatery	枯燥
cornball	不懂世故的
trichroism	三色性
swash	吓唬
bosk	丛林
concurrence	同时发生
snuffer	以鼻吸表示轻视者
anthropophagite	食人的野蛮人
copolymerize	共聚合
peaceably	和平地
uninterpretable	无法解释
hoot	呵斥
sporular	孢子
heteropolar	异极
unofficially	非正式地
harsh	荒芜的
wildling	野生动物或野生植物
pecul	=picul
excitement	激动
bankroll	提供资金
vestibule	前庭
material	具体
bergson	柏格森
cassock	法衣
nineteenth	第十九
adamic	亚当的
lifer	无期徒刑犯
polyclonal	多细胞株
field	原野
astronaut	宇航员
reedbuck	小苇羚
nettie	内蒂
justly	应得地
stipe	叶柄
ordinant	命令的
overweighted	重量超过的
cardsharper	以诈赌纸牌为生者
istanbul	伊斯坦布尔
approbate	承认
foreplay	性交前的爱抚
thanedom	=thanage
granger	农民
affront	冒犯
blessedly	神圣地
fos	on
annihilationism	t//
enterological	肠病学的
freeway	高速公路
overdrive	虐待
saurophagous	以蜥蜴为食的
catalogic	如目录
toyland	小人国
waste	地面风化物
mertensian	mimicry
uncombed	未梳理过
bugbear	吓人的东西
secondhand	间接地
sunfed	United
capybara	水豚
quietus	解除
chastise	惩罚
jugulum	翅轭
organza	透明硬纱
quench	平息
puppet	傀儡
heaviest	巨大
penelope	Odysseus的忠实妻子
photoactive	光敏的
fabrikoid	一种防水假皮
interpenetration	渗透
scape	表示"景
mokha	=Mocha
wrinkly	老人
homilist	怖道者
abortive	夭折
predestinarian	命运注定的
external	外用的
prognostic	预兆
gasification	气化
charismatic	超凡魅力的
pilot	飞行员
fascis	束棒
biggish	颇大的
reduction	缩版
paranasal	鼻旁
cushitic	库希特语族
mdr	Minimum
cream	奶油
recrimination	揭丑
fixative	定色的
gibli	=ghibli
omigod	天哪
annelida	环节动物门
sonorific	产生声音的
ravel	弄清
guidance	领导
determine	确定
bait	饵
rework	改写
incident	事变
reprocessed	再经过加工的
centrality	集中性
dome	圆屋顶
afoot	在进行中
insurgent	起义的
grinding	磨的
nethermost	最底下
derelict	遗弃物
alight	发亮的
ironize	挖苦
creatureliness	动物或人
riddling	谜一样的
forsythia	连翘属植物
lobeliaceous	山梗菜属植物
highbush	形成高灌木上的
varietist	有怪癖的人
dairyman	乳牛场主
cocarboxylase	辅羧酶
female	雌
dialectal	乡音的
bbb	and
motionless	不动
damned	糟透
yet	至今
inopportune	不合适的
pigeongram	传书鸽传送的信
underclothe	为……提供内衣
converted	修改
entertaining	有趣的
novell	以开发网络产品著称
pauperise	=pauperize
mingy	卑鄙
totalitarianize	把……置于极权主义控制下
preussen	=Prussia
trimethylglycine	=betain
auger	螺丝钻
polluted	污染
sandhi	连接音变
shakily	不稳定
fishbolt	鱼尾板螺栓
cuneatic	楔形的
transformation	=trans适
acquisitive	有获得可能性
more	更
gamekeeper	猎场看守人
cribellum	筛器
consubstantiate	n/
vortex	涡流
exhaustive	详尽
deism	自然神论
patriarch	创办人
posb	bank
kindle	激起
arresting	引人注意
fogbroom	除雾机
cospar	Committee
hegemonist	鼓吹霸权者
limpid	清澈的
narghile	水烟筒
wy	Wyoming
coder	编码器
bouillabaisse	浓味鱼肉汤
crumbly	易碎的
mim	假正经的
topographic	志
unsoiled	清洁
porosity	多孔性
pyrochemical	高温化学
hibernal	冬天
zelda	塞尔达
nsm	New
diazo	二氮化合物的
hyperirritable	应激性过度
meagerly	贫乏地
preantiseptic	防腐法采用前的
spadework	挖掘的工作
jealous	嫉妒的
fostress	保姆
unbitter	非恶意
lowery	阴霾
regenerate	再生
discursion	推理
shmoo	什穆模型
melitriose	蜜三糖
osteologic	骨
race	种族气质
wintery	冷漠的
dividual	可分割的
fond	温柔的
russety	枯叶色
slash	鞭打
unnilhexium	106号元素
substernal	胸骨下
acrophobe	高空恐惧症患者
watchable	值得注意
wringing	淋湿
prematurely	过早
narky	脾气坏的
idealistic	唯心主义者
tritiate	用氚浸渍
biorheology	生物流变学
wee	很早
unfatherly	不像父亲的
underexpose	使曝光不足
credal	=creedal
nonfarm	非农场的
avp	Program
impayable	极贵重的
aethereally	飘渺地
shanghailander	上海人
homoplastic	类似
beep	哔哔声
israeli	以色列共和国民
ornl	Laboratory
fishing	钓鱼
supernal	神
land	地产
aquatic	水生
entice	诱惑
jal	Lines
dispermous	具双种子的
thundersquall	雷飑
contagion	蔓延
ceremonious	隆重
brushy	如毛刷的
lockian	=Lockean
wraac	Army
dejecta	排泄物
soddish	极坏
febrifuge	解热的
sex	男性或女性
pussyfooter	抱骑墙态度者
subliminal	下意识
superaddition	添加物
commissary	代表
deduction	扣除
gambado	乱跳
palatinate	palatine的职位
motley	穿染色衣
antimonial	锑的
gallize	加水和糖于……
iturup	=Etorofu
willinghearted	心甘情愿的
haulm	茎
retiring	退休的
gutty	胆大
roulette	轮盘赌
blae	深蓝色的
greensick	患萎黄病
uptown	住宅区
bichrome	双色
legioned	组成军团
irritative	刺激
pixie	小精灵
rhopalic	楔形诗的
smart	严厉地
ore	含有金属的岩石
begirt	被包围
fraudulency	欺诈
civicism	市政
leiotrichi	直发人种
propeller	推进物
personal	亲自的
erodent	腐蚀
sesquicentenary	=sesquicentennial
pungent	刺激性的
deromanticize	使非浪漫化
avatar	化身
yew	红豆杉
cowled	带头巾
gain	腰槽
calaboose	拘留所
eraser	尤指墨水消除剂
gaudiness	俗丽的美
moxibustion	艾灼
idioplasmatic	种质
prelection	讲课
strangeness	奇妙
feigned	伪装
chatoyance	闪猫光
preem	初演日
unweighted	未加权
plaintive	悲哀的
brisk	敏锐的
stodge	艰难地行走
sawbones	n医生
semitic	闪族的
shoshoni	=Shoshone
intrados	拱之下面
seagoing	适于远航的
triform	以三种形式存在
diffusive	散布性
palatably	美味地
threesome	三倍
endoparasite	体内寄生虫
time	时期
nongreen	不含叶绿素的
scholarly	学者风度的
attempt	尝试
columniation	列柱法
noncountry	不具备国家特征的国家
neuropterous	脉翅目的
ebullient	冒泡的
mamie	玛米
sneaksby	偷偷摸摸的人
stria	条纹
ccsa	公共控制交换设备
phosphureted	与磷化合的
romping	乱蹦乱闹的
rule	支配
hemofuscin	血棕色素
hypoxia	氧不足
nemertinean	纽虫
fixation	定影
waltz	华尔兹舞曲
classical	正统派的
caraqueno	加拉加斯人
singly	个别
mrbm	medium
malicious	恶毒
physical	自然
mammiform	乳头状的
outgush	喷出
truckman	卡车司机
take	抓
unimaginative	无趣的
organic	器官的
resting	静止的
vaccinotherapy	菌苗疗法
savoury	可口的
dress	童装
cuso	Services
bookstand	书摊
draggletail	遢女人
great	重大
recess	凹进处
antivivisection	反痘钐褰馄/物实验手术
acetophenetide	=acetophenetidin
opiophagy	吸食鸦片
ascogonial	产囊体
tenent	=tenet
megaparsec	百万秒差距
neurogenic	起源于神经组织的
calcific	钙化
obdurately	执拗地
mut	狗
bypath	小路
polloi	=hoi
err	犯错
nakedly	露出地
gooseberry	醋栗
insinuative	讽刺的
ex	无权得到
mischoice	不恰当的选择
murrhine	默勒石制
decrescendo	渐弱的
maidenish	似处女
strum	乱奏
reecho	再反回响
riba	Architects
antidepressant	抗抑郁剂
changjiang	长江
smtpd	邮件传输服务器软件
languidly	疲倦地
summary	摘要
unknown	未知
nominate	提名
disme	1角硬币
hogwild	疯狂
dapple	起斑纹
selves	自身
ruddleman	卖赤铁矿的人
risc	Instruction
latewood	=summerwood
sympatric	分布区重叠的
specky	有斑点
irradiant	灿烂
daf	Air
expedite	迅速的
ceasefire	停战
graduation	分等级
tenability	可保持的性质或状态
japonic	日语的
apprehensible	可理解的
nemertine	纽虫
triacetin	=acetin
flammability	可燃性
isogenic	同基因
ganov	扒手
steamboat	轮船
listenable	值得一听的
peremptorily	专横地
jacketing	上衣
cryptogram	密码
ctd	on
pastorate	牧师团
shalloon	斜纹里子布
kouros	青年雕像
rhizomatic	根茎
rebutment	举反证
anticoherer	反粘合器
conclusive	确实
impoliticly	不得当
wireless	无线的
kinemometer	流速计
wrangle	口角
clew	绕成线球
ichorous	脓水的
prosaically	散文式地
alleviative	减轻的
bromoform	三溴甲烷
pacificist	和平主义者
defiant	挑战
competency	资格
precedency	上席
erogenous	唤起情欲的
vine	蔓
antidrug	反对服用麻醉品
radicle	根
great	伟大的
lisbon	里斯本
brilliancy	光辉
richly	贵重
appropriable	可挪用的
clubman	交谊性俱乐部的会员
blackfin	黑鳍白鲑
unutterably	非言语所能表达
pyrogravure	烙画术
rampion	匍匐风铃草
banefully	致害
jibuti	=Djibouti
inferrible	可推断的
kbe	Commander
unequal	不平衡的
homolog	同族体
arrhythmically	没有节奏地
ah	啊
practicing	开业
phrenitis	横隔膜炎
megashear	巨横推断层
officinal	成药的
historied	史上所载
confoundedly	恼人
comradeliness	同志爱
chasten	磨炼
illusory	错觉的
antiperiodic	抗疟药
accusingly	责难地
zapu	Zimbabwe
tetrarch	一州的四分之一的领主
luxuriant	丰富
kibbitz	=kibitz
filling	填充
lapse	背离
plenteous	丰富的
quadricorn	有四个角的
synthetist	综合者
unitary	一元的
lighterage	驳运
billycock	低圆顶的毡帽
benactyzine	苯乃静
push	逼迫
neaped	搁浅的
branch	枝
spcc	Society
heterography	违反规则之拼法
magyar	马扎尔语
comonomer	共聚用单体
carload	车辆所载的货物
ovovitellin	卵黄磷蛋白
thud	砰地击中
unskillful	笨拙的
iridocapsulitis	虹膜晶状体囊炎
necrobacillosis	坏死菌病
crevasse	裂缝
flyway	候鸟迁徙所经的路径
fancydan	华而不实的运动员
gypsyhood	=Gypsydom
under	在……之内
afterhours	业余的
estimate	估价
nostradamus	占卜者
adiaphoretic	止汗的
inculcation	谆谆教诲
sley	筘座
tittlebat	刺鱼
abuttals	地界
shiny	擦亮的
saiva	湿婆教徒
labour	努力
astigmatoscope	散光检查器
burnisher	磨擦者
excuse	清借条
kwangchowan	广州湾
founder	倒塌
peptogen	助消化制剂
inductance	自感应
phenoxide	苯氧化物
eventually	最后
numberless	无号码的
overly	过度地
dahomey	达荷美共和国
lymphocyte	淋巴球
civil	公民的
honeymouthed	嘴甜
inaptly	笨拙地
hotch	坐立难安
buckboard	四轮马车的一种
peacekeeping	维护和平的
redissolve	再驱散
apparel	装饰
laudability	值得称赞
trowel	移植泥刀
flush	淹没
participancy	参与
brandied	加白兰地酒来调味的
fortunate	幸运
slp	社会劳工党
dolce	悦耳而柔和的记号
immanent	无所不在的
squamate	有鳞的
imperceptible	极细微的
dolce	温柔
idyl	田园诗
themselves	pro
unsc	Nations
athwartship	横过船
climactic	高潮的
wfdy	Youth世界民主青年联盟
flexuous	弯曲
demothball	解除的预备役状态
blindfold	眼罩
hydrometallurgical	湿法冶金学
colonialist	殖民主义者
gorge	塞饱
unharmed	未受伤害的
hardhearted	心肠硬
qanat	暗渠
simple	简易的
blagueur	吹牛者
cuirassier	穿着胸甲的骑兵
come	嗨!
try	考验
unemployable	不能受雇者
walkable	可以走去的
lardon	肥碱肉片
ungraceful	没有风度的
boughten	买来的
wise	博学的
heterogeneous	不同种类
feathered	像鸟般飞得快
sure	可靠的
indianness	印度安人的身份
toxicologist	毒物学者
oligophagous	寡食性的
fireballer	投快速球取胜的投手
hydrothermal	热液
bouncing	跳跃
millirad	毫拉德
remontant	一季多个花期的
superweak	超弱
consolatory	慰问的
asexual	无性的
utopia	理想的完美境界
pnr	point
wysiwyg	所见即所得
billingsgate	下流的
yeh	而且
liberian	利比里亚人的
radius	有效航程
appear	发表
unexcited	不激动
transmitter	让渡者
cladistics	遗传分类学
havelock	遮阳布
perfectionist	至善论者
neatness	干净
highbinding	欺骗行为
incognito	化名的
paramagnetism	顺磁性
astringently	收敛性地
parpen	穿墙石
prejob	就业前的
geotropism	屈地性
favourer	保护者
polite	有教养
manager	经理
butcher	屠户
sheepcot	羊圈
curator	监护人
laotian	老挝人的
rutland	拉特兰郡
periostracum	角质层
pony	每日摘要
mitomycin	丝裂霉素
fellate	吮吸口交
wimple	起涟漪
payslip	工资单
fattest	胖
tortive	扭曲的
loyalism	忠诚
lexical	词汇
lenticulated	小扁豆状的
capitoline	Jupiter神殿的
slopewash	斜坡冲刷
mathematical	数学的
ultrashort	极短
trivial	价值不高的
raec	Educational
damnification	损害
pouch	育儿袋
exoteric	通俗的
tass	Agency
morbid	恐怖
pyrrhonist	Pyrrho
meek	和缓的
mis	Information
optophone	光声机
superweapon	超级武器
aut	Association
earthward	向地面
ossifrage	鱼鹰
tricolor	三色
corban	对上帝之奉献
junky	无价值
muffle	包
microscale	微观大气现象
burglarproof	避盗
advocatory	拥护者的
airfreighter	运货飞机
bask	感到温暖
affected	假装
hierodeacon	身兼执事之僧侣
fiefdom	封
bathos	突降法
macrostomia	颊横裂
goniometrical	测角计的
arsis	强音部
resummons	再传唤
unary	一元
sneaker	运动鞋
quadrillion	千的五次方
hypochondriacal	过分担心自己健康
scs	水土保持局
detruncation	切
thrift	节约
gradus	韵律
congener	同种
desirably	愿望
yogism	瑜珈的教义
feracity	丰富
hatband	服丧时帽子上的黑带
grace	Grace
barebacked	无鞍
pansophism	万事通
aboil	沸腾的
oily	油腔滑调
butterfly	蝴蝶
vacancy	空
grysbok	羚羊之一种
siphonal	虹吸的
lamby	羔羊似
moxie	勇气
wga	Guild
arboricultural	培植树木的
haemolyze	使溶解
bisector	二等分线
ocd	民防局
poignant	刺激的、辛辣
citramontane	阿尔卑斯山北侧的
quaint	做得很精巧的
cpsu	Union
antarctic	南极地带的
awag	摇摆的
swabian	斯瓦比亚人
crystallize	明确
effusiveness	吐露
spumous	起泡沫的
siratro	大翼豆
fathom	长度单位
chaperon	女伴
former	样板
specialize	使专用于
oceanographic	海洋学的
woolenette	=woollenette
regular	规则
nitrification	硝化作用
lobulate	由小叶片组成
shapelessly	不成形
dockmaster	码头现场主任
demimonde	暗娼阶层
changeroom	更衣室
individualistic	个人主义
supine	仰卧的
dalailama	达赖喇嘛
frypan	pan
supplementation	补充
polt	阴谋
pugh	呸
fluorometric	使用荧光测定法
quickly	很快地
film	薄膜
pellucidly	易懂
anthropometer	人体测量器
squawkbox	扬声器
rhovyl	聚酰胺纤维
dinky	极小的
peritonealize	使腹膜化
conventionality	常规
tousle	弄乱
population	人口
subcompact	微型汽车
substation	变电站
indochina	印度支那
lighthearted	心情愉快
coliseum	大剧场
upton	厄普顿
crawler	爬行者
sensibly	明显
substantive	巨额
honorary	道义上的
obstruct	阻塞
hamose	具钩的
ddk	设备驱动程序开发包
awaken	醒来
coreper	常驻代表委员会
unhasty	不急躁
larky	爱闹玩
metalworking	金属工
freemasonic	互助团的
escapement	卡子
papyraceous	纸状的
eyeable	赏心悦目的
league	盟约
laddish	男孩
unset	未安装
sextillion	千的七乘方
sunnily	快活地
annuity	年金享受权
costful	昂贵的
eventless	平凡
rhapsodize	作狂想曲
antiglobulin	抗球蛋白
manicure	修剪
ridgetree	栋木
phaseout	分阶段
working	施工用
institution	公共机构
tindery	易燃的
verticil	轮生体
cistron	顺反子
septuple	七
tabularize	把列成表格
coalescence	合并
gouge	沟
hydraulician	水利工程师
engraver	雕刻师
interlaced	交织
movably	可动性
thuggish	杀人的
ruritanian	理想王国的
bierkeller	德国式小酒店
ophthalmic	眼科
calathus	古希腊水果篮花瓶式果篮
psychotherapeutics	精神疗法
meaty	肉
downright	明白的
freckly	多雀斑的
whithersoever	到任何地方
trustee	保管人
uncombed	未梳理过的
lavvy	厕所
coloury	色泽良好
canephorus	古希腊之顶篮少女
thetatron	θ收缩
japanese	日本人的
ironhanded	严厉的
sorta	可以说是
alluvia	的复数形式
syndactyl	并指
malaprop	用词错误可笑的
granivorous	食谷类
astrictive	使收缩的
indiaman	大商船
endogamy	同系交配
carlsruhe	=Karlsruhe
polymath	博学者
dentiform	齿形
ventriculogram	脑室造影照片
judiciable	应受审判的
hodographic	矢端曲线
fls	Linnean
posnet	金属器皿
summing	做加法
stoniness	一文不名
areopagy	古希腊的最高法院
embryonated	具胚的
computable	可计算
quotidian	日常
cephalitis	脑炎
cartographer	制图师
concoction	调合物
sonifer	=Sonifier
hepatitis	肝炎
dewlap	喉部之垂肉
reductive	还原的
varied	各式各样的
fibrillous	纤丝状的
parlor	业务室
exaggerated	夸张
anteriorly	先前地
miniaturize	使小型化
contract	契约
fenderbeam	护舷材
micrurgy	显微操纵
grizzly	呈灰色的
xenogeny	=xenogenesis
stabling	马厩
tremulously	发抖地
substantive	名词
disedge	除去……之锋刃
allomerism	异体同晶
postpose	用在后面的
disparaging	毁谤的
hypercorrection	矫枉过正
erstwhile	以前
guido	导航控制中心负责人
philatelic	集邮癖
immunotherapy	免疫疗法
clouted	凝固
campfire	营火
core	中心
avascular	无血管
vetchling	连理草
boundlessly	无限
worthy	杰出人物
ourself	自己
talcous	滑石
feveret	轻度发烧
nervy	冷静
montane	山区的
wonderworld	=wonderland
nickelic	含镍的
fluey	绒毛似的
vain	空虚的
ravage	破坏
gorgy	多峡
pyrosis	胃灼热
sidetrack	次要地位
agglutinative	胶合性的
renogram	肾探测图
hylozoism	万物有生命论
mesenchymatous	间叶细胞
recess	休假
visually	真实
batrachoid	似蛙的
unpeaceful	不平静的
avernus	阿佛纳斯
septate	被隔膜分开
succotash	豆煮玉米
permissibility	容许性
stannary	锡矿山
eudiometric	空气纯度测定管
briskly	精神勃勃地
smear	涂上
division	分开
sins	船舶惯性导航系统
limited	缺乏创见的
israelitish	犹太人的
horological	钟表术
superincumbent	在上面的
touch	达到
kindly	亲切地
sanitarian	保健专家
crossed	十字
lar	家庭守护神
refractory	难控制的
yellowbird	黄雀
caravansary	商队旅馆
impiously	不虔诚
extroversion	外倾
spur	驱策
parergon	第二职业
chemotropism	向药性
iatrochemically	化学疗法
una	巫娜
satellite	人造卫星
tumorous	浮夸的
jackass	愚人
pesky	麻烦
initialize	初始化
galvanometer	检流计
uncultured	未开垦
autosomal	正染色体
doxy	淫妇
ally	与……有关联
beforehand	预先
firry	冷杉木制的
amnestic	=amnesiac
fatuous	昏庸
halloween	万圣节前夕
thalamus	丘脑
goddam	讨厌
magellanic	麦哲伦的
unrounded	不圆唇
drivel	胡言乱语
primiparity	初产
congruous	符合
nonproliferation	防扩散
ichthyophagist	食鱼的人
aback	向后
swivet	极度的激动
ball	球状物
egomania	极端利己
amdg	gloriam
bullhorn	手提式扩音器
maytide	五月时节
headwork	劳心的工作
archaise	=archaize
operatic	歌剧风格
eely	滑头滑脑的
cultch	贝壳屑
soln	solution
meandrine	多纡曲
edge	开刃
antipathic	不相容的
hearth	家庭
racquet	球拍型雪鞋
incommutable	不能交换
aestivation	度夏
alternant	交替的
pdsa	Sick
solutizer	硫醇溶解加速剂
delegate	代表
zs	Zoological
flotage	浮力
quadrilingual	四国语言
incendiary	纵火
antemundane	世界形成以前
torpefy	使迟钝
bilsted	胶皮糖香树
intentional	有意图的
bojardo	Maria
roesti	瑞士式炸土豆
level	标准
emparadise	=imparadise
knobbly	有节的
farming	农业
ruth	怜悯
cardiotachometer	心率计
probenecid	羧苯磺丙胺
flocculent	柔毛状的
gorge	暴食
adversely	逆地
elementary	基本
cleverly	灵明地
unnoted	无价值
uncharming	使人不愉快
saltimbanque	骗子
largo	缓慢
pinnatifid	羽状半裂的
pedagogic	教育学
decimally	用小数
zecchino	古金币
malcontent	不满的
bemegride	美解眠
paragraph	节
emarcid	凋谢的
cellularized	分裂为很多细胞的
infant	幼儿
ganglionic	神经节的
ratton	老鼠
impregnation	注入
thinnest	薄的
ratoon	长出截根苗
elvan	淡英斑岩
dankish	潮湿的
evangelic	福音传道的
hexapodous	具六足
tensity	紧张度
technism	=technicism
masonwork	砖石建筑物
prepunch	预先在……上打孔
fluvioglacial	河冰生成
telesport	瞬间移动
resolvent	使溶解
scoriaceous	烧石
decennary	十年
ergophobia	工作恐怖
swept	sweep的过去式和过去分词
paludism	疟疾
plashy	湿
refreshing	使人喜欢
pickin	小孩
craniometrical	头盖测量的
evangelism	福音传道者的工作
ontogenetic	个体发育
supernatural	不可思议的事
homoplastic	同形
nephridial	肾管的
nonnutritively	与营养无关
streetward	向街
germanist	德语专家
sexennial	持续六年
synovial	含有滑液
voltammetry	伏安法
heyday	喜悦、惊奇时所发声音
draconic	古代执政官的
commissary	物资供应所
emmer	二粒小麦
meniscus	新月
humble	谦逊的
constant	持续的
succose	多汁
grammarian	文法学者
samely	无变化
slugfest	激烈的殴斗
rhadamanthus	拉达曼提斯铁面无私的法官
participial	分词的
yeggman	恶棍
compunctious	惭愧
pileorhiza	根冠
girasole	青蛋白石
unforced	不费力的
tig	拍着
approvingly	满意地
wifeless	无妻
arroba	阿罗瓦
gnarled	多瘤
kaffiyeh	头巾
visualiser	=visualizer
takeoff	开始
inexcusable	没法辩解的
sauropod	蜥脚类动物
pfc	class
illuminant	发光
ern	白尾海雕
nab	捉住
assentor	同意者
perfoliate	贯穿性的
foliiform	叶状
gandhian	甘
longbill	长嘴的鸟
quadriform	有四种形态的
masterate	硕士学位
unseaworthy	不适于航海
consult	商量
agrologic	农业土壤学的
following	其次的
faulty	不完善
smoking	冒烟
canis	犬属
enervation	虚弱
anticathode	对阴极
barren	无聊
inapprehension	不可解
bogeyman	可怕的人或物
nitrobacteria	硝化细菌
priestly	僧侣似
clearinghouse	票据交换所
enshroud	隐蔽
medium	中等的
unprofessional	外行
ethnomusicological	人种音乐学/y/`eWnEJ9mjU:zI`zIkE`lCdVIkLl/ad音乐学地
coverall	无所不包
perchromate	过铬酸盐
bgp	Gateway
waiver	弃权
orach	=orache
obsession	迷住
laudator	赞美者
trump	吹喇叭
leninist	列宁主义者
predicatively	断然
hjs	hic
colicweed	荷包牡丹
uneducated	没有受过教育的
unassuming	谦逊的
neurone	神经元
additional	额外
petrifactive	造成石化的
gassy	夸夸其谈
uncle	姨丈
trimness	整齐
subungulate	次有蹄类
communicative	畅谈
fly	溃逃
saucerman	乘坐飞碟的外星人
wise	聪明
academicals	大学制服
fissionable	可引起核分裂
octosyllabic	八音节的诗句
bilsted	北美枫香树
consequent	随之发生的
teleplay	电视剧
reredos	祭坛背后有装饰的屏风
monomania	偏执狂
texian	=Texan
gruff	粗哑的
condemnatory	非难的
cinquecentist	作家或诗人
cockish	自负的
widespread	分布广泛
petrifaction	化石
subtropical	亚热带
sprawl	蔓延
sext	第六时祷告仪式
disenroll	除名
diecious	=dioecious
pantun	隔行同韵马来诗体
bloom	旺盛
transfluent	越流的
mediatress	mediator的女性
parabolic	寓言似
at	奥地利
tell	讲的事
reductivism	极少艺术
mild	温和
carefulness	仔细
monetarily	在货币问题上
simplehearted	天真无邪的
oversailing	挑出的
swoop	飞扑
damnatory	该死
spectacled	戴了眼镜
icky	粘得讨厌的
vernal	春天的
checkage	核对
hilly	多小山
bahamian	巴哈马人
labour	劳力
inp	International
planula	浮浪幼体
flightily	轻浮
say	背诵
endostosis	软骨骨化
innerspring	内装弹簧的
yellowbill	黄嘴鹃
episcopacy	主教制度
cumbersome	麻烦的
reduce	还原
abbreviative	缩写的
impress	留下印象
laicize	摆脱宗教色彩
strongbox	保险箱
onrush	洪流
wizardly	神汉
path	轨道
completely	完全地
regionalization	分成地区
megabuck	一百万美金
lingala	林加拉语的
unrelenting	冷酷的
starveling	饿瘦了
basque	巴斯克人
allotrope	同素异形体
gorblimey	竟有这等事
benthoal	海底
campanologist	鸣钟术专家
ruby	红宝石
chaw	咀嚼物
fetoscope	胎儿镜
repower	重新提供动力
xciii	罗马数字
courageously	勇敢地
sulphamate	氨基磺酸盐
suspensible	可悬浮
homograph	同形异义字
pluralistic	兼管数个教堂的
pleonasm	烦冗
preoption	优先选择权
disentrance	使清醒
orthodox	保守
add	添加
assignment	分配
whin	棘豆
comicality	滑稽性
dignify	使高贵
bogle	妖怪
unashamed	不害羞
allopelagic	生于不同深度的
archetypal	原型
systematization	系统化
deflation	通货紧缩
flex	松紧带
arid	干旱
suffixation	加后缀
heavenly	极优美
folkloric	民俗的
pinnated	羽状
debe	罐头
bactericide	杀菌剂
labour	与工党有关
tensometer	=tensiometer
style	使合潮流
trick	恶作剧
apolaustic	放纵的
prophetic	预言的
established	确定的
expressive	富于表情的
tall	高
constantly	不变
basan	栎鞣羊皮革
assheaded	笨蛋
meow	猫叫
oak	橡木
smallpox	天花
cca	通用通信适配器
demurely	装成端庄地
weftwise	纬向地
ruefully	可怜
zenophobia	=xenophobia
taking	迷人
beryllium	铍
haemic	血
stateless	没有国家的
protonation	加质子作用
laniard	=lanyard
relucent	明亮
lewis	Lewis
reliable	可信赖
calabar	西伯利亚之松鼠皮
oloroso	西班牙甜雪利酒
performance	表演
stanvac	Vacuum
maidhood	=maidenhood
coversed	余矢
coloured	有彩色的
semiscientific	不十分科学化
fib	无伤大雅的谎言
inessive	指示地点的
possession	拥有
remanet	残存
undefended	无辩护人的
republican	有关共和的
blustering	狂暴的
sogat	Allied
flsa	Fair
fretwork	浮雕细工
immune	免疫的
tartrate	酒石酸盐
wwf	世界摔跤联合会
hexahydric	六元的
conventionalise	传统主义
outstep	走过头
excremental	粪便的
smart	时髦地
infaust	不吉
fossilate	使僵化
pots	Old
suspectable	可疑的
distress	悲痛
repolish	再润饰
bantu	班图语
antielectron	正子
mammary	乳房
call	认为
vagarious	越出常规
bloodily	血迹斑斑
quadrasonics	=quadraphonics
gyrose	波状的
doll	洋娃娃
unenlightened	落后的
suriname	=Surinam
another	不同的
odic	颂诗
peroxisome	过氧物酶体
vitrectomy	玻璃体切除术
phytopathogene	植物病原体
debug	调试工具
foreseeingly	深谋远虑地
slog	艰难行进
admiral	舰队司令
butyl	丁基
disappointing	令人失望的
sebaceous	脂肪分泌的
duke	公爵
uncertainty	半信半疑
hairpin	发夹
regress	使倒退
medic	医师
jingoist	侵略主义者
aphorism	警语
infamous	声名狼籍的
tentative	尝试的
occident	欧美
phenocopy	拟表型
scandic	钪的
organophosphorous	9R:^EnEJ`fCsffLrEs/
intragroup	社会团体内部的
enduringly	耐久
ticklish	易痒
unprescribed	自由
reserve	储备
abustle	忙碌
retarded	发展迟缓
metz	梅斯
kionectomy	悬雍垂切除术
prowler	徘徊者
ingenious	有独创性
paralyse	使无助
dissolute	放荡
overearnest	过于认真
concupiscent	沉迷情欲
shoreless	没有陆
adenoids	腺状肿大
partite	深裂的
object	提出……来反对
retransfer	再转移
agonize	感到极度痛苦
canalicular	似微管
eld	古代
exemplarily	作为模范
machair	沿岸沙质低
natural	关于自然界的
shandong	山东
syriac	叙利亚语
synchronal	同步的
fuliginous	烟垢
slim	减肥
ageing	成熟
hankou	汉口
ascensionist	上升者
thermotropic	向热
unscientific	不科学的
spark	火星
vapor	自夸
indwelling	存于内心中
sear	烤焦的
unashamed	不知耻
triaxial	空间
collop	小肉片
turkeytrot	火鸡舞
sessional	开会的
benthal	海底的
chanceless	无接球机会
hellebore	菟葵
imperfection	不完整性
alienism	精神病学
stumble	蹒跚
athermancy	不透热
serigraphic	绢网印花的
aheap	堆积地
igbo	伊博人
lease	租出
comicality	诙谐的事
decidual	蜕膜
bioflavonoid	生物类黄酮
hymeneal	婚姻的
rear	背面的
bookmobile	流动图书馆
shit	粪
bracket	括在一起
symptomatic	有症状
ostium	门口
diamondback	菱形斑纹
narrow	变窄
cyproheptadine	赛庚啶
snowmelt	融雪水
inferior	次
lamentoso	哀怨地
transpose	颠倒顺序
tough	坚持
neosalvarsan	九一四
etypic	由某种形态转变的
inlet	入口
tenpenny	十便士的
learning	知识
axenic	无菌的
noseless	无喷嘴的
eutherian	真哺乳亚纲
indentureship	学徒契约期间
overdesign	超安全标准设计
baae	航空与航天工程学士
educatory	教育的
wallwasher	墙照明装置
psychoenergetic	精神能dVetIks/
feat	漂亮的
jew	犹太人
illimitable	无限的
distance	远景
thresh	翻滚
lightsome	轻快的
hydria	提水罐
semimythical	半神话的
crake	秧鸡般叫
fellow	伙伴
device	安装设备驱动程序
excogitate	发明
bather	浴疗者
vraic	海草灰肥料
zip	拉开或拉上
aps	美国物理协会
sas	英国空军特别部队
banditi	强盗
javaite	爪哇熔融石
transvestism	异性装扮癖
improperly	不正确地
lazar	麻风病患者
abstruseness	难解
roughage	粗糙的原料
termagancy	脾气不好
pungent	苦痛
photoinduced	光感应的
teardrop	泪珠
magnetofluidmechanic	[用作单
scorekeeper	记分员
yezo	虾夷(日本北部大岛北海道
bacterial	细菌的
mignonne	小巧玲珑
protonotary	首席书记官
unprevailing	无影响
drillmaster	教官
altisonant	冠冕堂皇
preconceive	预想
maladaptive	适应不良的
fishing	捕鱼
toedrop	趾下垂
semicomatose	轻昏迷
conceptism	格言派
nomocracy	依法成立的政府
whirl	急动
symphony	交响曲
unshapely	丑怪
repairman	修理工
venereal	性交
flavourful	有香味的
great	伟大
degerm	除去……的核或仁
adoringly	敬慕地
anisodont	牙齿高低不齐的
stubbed	株状
multiphoton	多光子的
accessorius	副腺
upsweep	活泼化
tamperproof	可防止乱摆弄
warrantee	被保证人
didymous	双胎的
far	久远
bequest	遗产
waffie	漂泊者
position	形势
diseconomy	经营管理失当
engineer	工兵
ole	Embedding
unobstructed	畅通无阻
syngas	合成气
manna	精神食粮
trippy	由致幻药引起幻觉的
negatively	消极
unreversed	非倒转的
antimonarchist	反对君主制度者
goosey	呆子
byzantium	拜占庭
sure	对……
arthrodial	摩动关节
fingerparted	如手指状辐射的
clonal	无性系般的
langoustine	海螯虾
cretinoid	矮呆病样
wide	广阔
proximal	最接近
peopleless	无人的
become	适合
unrope	解绳放开
huffish	不高兴的
squinny	使斜视
inductee	应召入伍的士兵
poignant	令人痛苦的
autocratic	独裁的
peacemaker	和事佬
dihydric	二羟基
warrior	战士
gently	逐渐地
pastorale	牧歌式歌剧
identically	相等地
unflaggingly	不衰
for	至于
inquest	审讯
fluerics	=fluidics
sequential	有继的
gesticulate	用手势谈话
horehound	苦薄荷
lillian	莉莲
solarise	=solarize
hibernant	冬眠的
allround	多方面
prepensely	故意
checkroom	衣帽寄放处
wry	歪斜
triturator	捣碎机
bisque	浓汤
ergosome	多核糖体
xeromorph	旱生型
fitfully	断断续续
infanticidal	杀婴儿
flit	掠过
stripper	剥离器
changeless	稳定的
convert	使转变
aiff	Interchange
machiavellian	马基雅弗利
bughouse	发狂
metonymic	换喻的
fungistatic	抑制真菌的
lifo	first
ectotrophic	体外营养
hexode	六极管
oos	Stock
prelatic	主教制的
deoxidant	除氧剂
tamandua	小食蚁兽
bisector	平分线
thievish	象窃贼
roquet	用自己的球碰击对手的球
rasorial	抓地觅食
iconodule	崇拜偶像者
aftertime	后世
primary	初级的
covenantor	契约之授方
euclidian	欧几里得几何学
crackbrained	精神错乱
tolstoyan	托尔斯泰的
urbanization	都市化
governessy	一本正经
ashur	阿舒尔
italianism	意大利的爱好
malic	由苹果取得的
unsocial	非社会
superfoetation	=superfetation
turmeric	姜黄
subhumid	半湿润气候的
pekin	北京鸭
sweltering	酷热
mythical	虚构
aerotropic	向气性
baron	男爵
immediate	直接
pretty	优美的
atmolyzer	微孔分气器
dexiotropic	向右的
proclamatory	公告的
unlistening	不敏感的
hexachloride	六氯化合物
truest	真
obeisance	敬礼
ashpan	炉火盘
redowa	雷多瓦舞
plp	Labour
dowd	邋遢的人
suspectable	值得怀疑
transpositive	互换位置的
argumentive	=argumentative
entrain	使空气以气泡状存在于混凝土中
gnomology	格言集
monocular	单目镜
maugre	不管
taligrade	行走时重量落在足外侧的
beefburger	德式牛排
vaginismus	阴道痉挛
ahemeral	不足一天
genevieve	吉纳维芙
fielding	守备
statistic	统计量
mince	切碎
appendicitis	盲肠炎
fleecy	以羊毛盖上
dung	施粪肥于
uncomforting	不舒适
gazoomph	=gazump
mending	修补工作
pectin	胶质
unshrinking	坚定的
sum	总数
niobous	亚铌的
thews	筋力
goggle	睁眼
mend	改正
complice	同伙
hemochromogen	血色本质
wise	贤明
underplay	表演不充分
extort	敲诈
ambisyllabic	属二音节
ceuca	and
extra	特大
ucky	脏兮兮
patagonian	南美南端地方的
boring	钻
asphyxy	窒息
exoteric	外界的
lush	繁荣
exultancy	大喜
circumspective	慎重的
arrogantly	自大地
indiscernible	难识别的
alba	Alvarez
emergent	浮现的
potestas	字母的音值
most	最多的
somatopleure	胚体壁
uncertainty	无常
aborative	精心
semiautomated	半自动的
waspish	尖刻
shipment	出货
bosom	怀抱
usa	美国
lawrentian	劳伦斯
quota	配额
knowledgeable	有见识的
heavier	沉重的
hydrosulfuric	含氢及硫
volcanically	火山似
serotype	决定……的血清型
vanish	突然不见
rammish	腥臊味
odeum	奏乐堂
preexilian	放逐前的
benignly	亲切
registered	已注册
revisionist	修正主义的
boatrace	赛舟
neuroendocrinology	神经内分泌学
algometrical	痛觉测验计的
uses	States
viatica	viaticum
smearcase	农家鲜干酪
balefire	焚化尸体的柴堆
fatimid	法蒂玛王朝君主
pleasure	快乐
linksland	海边沙丘地带
null	无效力
plasmal	体液素
stymy	从中作乱
viscidity	粘性
chop	商标
lending	出租物
hidrosis	发汗
labour	工作
frailly	不坚实
irregular	不规则
exhaustive	详尽的
sincere	真实的
puddingheaded	愚钝
degradedly	degradedness
limited	狭窄的
corrodibility	可腐蚀性
disruption	中断
rabble	用拨火棍搅动
platform	平台
dissociable	可分离的
zedzap	支持重传
caprylic	羊脂酸
carromata	畜力二轮车
demophobic	群众恐惧症
unreduced	未减少
inexistent	不存在
transformative	变形
dollop	块
resinoid	象树脂的
reserve	预约
adventurous	喜欢冒险
indecorous	不合礼节的
anna	安娜
arica	阿里卡
hurdling	跳栏赛跑
whitehanded	清白
movies	电影
jis	Japanese
footfall	脚步声
forestall	之前
lati	lat的复数
halt	使停止
sparkish	俊俏
misdemean	做不规矩事
sublime	异常的
caricaturist	讽刺画家
unfading	可靠的
hiding	隐匿
endorsee	承受背书票据者
diversely	各色各样地
featherwit	愚者
fetial	外交的
flatter	过分夸赞
envelop	信封
extra	额外的人临时演员
ungrateful	不领情的
medieval	仿中世纪的
undiscussed	未讨论过的
yahoo	美国Yahoo公司
exclusive	独占的
arm	臂状物
carefully	小心
space	一段时间
violence	暴力
constatation	真相
trike	三轮车
reinflame	使再次极度激动
tumultuously	骚乱地
drysalter	药品染料商
aftermentioned	后述的
favonian	西风
unlikelihood	未必有
unsure	不肯定的
sacred	庄严
panorama	全景画
privation	丧失
electrostatic	静电学的
unrwa	Nations
tricktrack	=trictrac
impeachment	弹劾
swarthy	浅黑
excruciation	拷问
segregate	隔离
lauraceous	月桂科属
banian	榕树
akademi	学术团体
boondagger	强悍的女人
touriste	旅游者腹泻症
snaky	蛇一般的
succinctly	简洁
excitement	刺激
wring	绞
pba	Administration
spasmodic	间歇性的
barbette	炮座
slimmer	减肥者
emblaze	颂扬
unhappy	不幸
immission	引入
negligent	疏忽的
drayman	运货马车车夫
emulously	好竞争地
cuvierian	居维叶分类法的
yabber	谈话
phrenetic	狂热
campus	大学教育
finnesko	挪威鹿皮靴
periphonic	全向声系统的
enemy	敌方的
semiprofessional	半职业性的
courageously	勇敢
sampling	取样
quintuplet	五件一套
iffy	有问题的
rateable	按比例
cavefish	洞穴鱼
congregationalist	公理会
monologuize	=monologize
lapstreak	=lapstrake
dietarian	吃规定饮食者
horoscope	诞生时的星位
glowing	容光焕发的
image	肖像
starched	拘泥刻板
volkspele	南非白人民间舞
decillion	decillion
benignly	仁慈地
princesse	公主装的
philogynous	喜欢女子的人
sceptical	怀疑的
grandioso	雄伟
soutache	饰带
commerciogenic	有市场吸引力的
limnological	湖沼学
spatiotemporal	时空
inedited	未经编辑
inched	英寸的
thermomagnetic	热磁
contempt	藐视法庭
owl	猫头鹰
hose	水龙带
stick	棒
fearless	勇敢的
xystus	古希腊室内运动场
functionality	泛函性
abuse	滥用
issueless	无子女的
tenorist	男高音歌手
dentinasal	齿鼻音的
medivac	=medevac
trooper	伞兵
tubectomy	输卵管切除术
possessed	疯狂的
mulatta	=mulattress
gfwc	Clubs妇女俱乐部总联合会
wither	感到羞愧
frank	免费邮寄特权
sublanguage	次语言
parabomb	带伞空投容器
scrapheap	废料堆
roughhewn	草率的
monadic	单孢体
boatload	一条船的货物
deathplace	临终之
bethel	圣地
squeezability	威吓
wilsonian	威尔逊的
jauntily	意洋洋
hydrocyanic	氰氢
sere	干枯
field	野生
seminiferous	产生精液
eternal	永远的
ato	安第斯共同市场
adolescence	青春期
apocryphal	假冒
fenestrated	有孔
constable	巡官
nesting	嵌套
undersong	隐匿之意义
breezy	活泼的
imposturous	欺骗的
nakedize	成为裸体
fame	名声
col	上校
vile	坏透的
trumpery	中看不中用的东西
closet	关入私室密谈
inconstantly	易变地
supernatural	神奇的
helminthology	肠虫学
svelte	苗条的
introit	圣餐式前所唱的赞美歌
scran	食物
vitally	紧要
gibberish	乱语
reversedly	反转
unclasp	打开
orientalism	东方民族特征
enigmatize	使不可解
unversed	无知
fumatory	烟薰室
claptrap	应景的
fractious	易怒的
fake	伪装
sorehead	落魄者
electroacoustic	电声
sextuple	由六个部分构成的
trigon	三角琴
modernday	现代
