chimera	狮头
parorexia	异食癖
gdmo	Definition
immediateness	立刻
indigenize	使本国化
coincident	一致的
antiform	反对在艺术品创作中使用传统形式和材料的
improvisatorial	即兴
flaccid	无活力的
ea	电子艺界游戏公司
cryptographist	密码专家
limonene	柠檬油精
fat	脂肪
current	最近的
manipulation	处理
posset	牛乳酒
tribonucleation	摩擦成核作用
kendo	剑术
leucemia	白血球过多症
underscore	底线
revolt	反感
milanese	米兰人
bellman	敲钟人
leafy	多叶
zonally	区域
readily	容易
coagulable	可凝结的
submarine	水下
force	夺取
connection	线路
mid	中间的
gpl	Public
ocso	Order
indonesian	印度尼西亚语
schistosomiasis	血吸虫病
putridness	腐烂
studious	认真的
usurpatory	篡夺
quadrasonic	=quadraphonic
prankish	恶作剧
unrope	挣脱绳索
whither	到哪里
fortune	偶然发生
siracusa	锡拉库扎
provide	供给
kyat	元
hand	手艺
symphysis	合生
sneeze	打喷嚏
almightiness	全能
skatemobile	滑轮车
kahn	test康氏试验
jildi	迅速
raving	狂乱的
spinose	有刺的
disabled	丧失能力
station	……站
carmine	深红色的
migrator	候鸟
tracery	窗饰
stormward	向风暴
predetermine	预定
around	左右
perfect	完美
immunosuppress	的免疫反应
exsuccous	干的
apertured	有孔的
amitabha	阿弥陀佛
tpi	Town
enterostomy	肠造口术
imputable	可归咎
unreactive	化学上惰性的
putamen	壳
cosmopolite	见闻很广博
phthisic	痨的
cowry	宝贝
jonah	约拿
assertorily	确定地
lamblike	温驯
dolefully	寂寞
greatest	最好
sikh	印度锡克教徒
beckoningly	令人心动
regurgitant	反刍的
handline	手执的钓丝
abroad	往国外
lasso	笼络
wacky	疯疯癫癫
sansculotte	激进派革命家
evangelical	福音
sialomucin	唾液黏蛋白
weeping	垂枝
snuff	灯花
playgoing	看戏
present	现在
undivested	未被脱去的
panduriform	提琴形的
branch	部门
insalivation	混涎作用
topocentric	以地面上的某点为中心
uncontemplated	意想不到
octopush	水中曲棍球之一种
tumtum	弦器
park	公园
legitimation	合法化
elaphine	似红鹿
malign	恶毒的
paramount	极为重要的
related	有关系的
prostyle	前柱式的
chyliferous	输送乳糜的
unwakened	未被唤醒的
xat	为纪念死者的雕刻柱
interprovincial	省与省之间的
unpresentable	不登大雅之堂
outer	外面
impressive	感人
attractable	可被吸引
discipular	信徒
worthful	有价值
beauish	花花公子
osaka	大阪
byzantine	画家
faucial	咽喉
irisated	虹彩的
nllst	国立科学及技术出借图书馆
psychotherapist	精神治疗医师
promiseful	有希望的
footage	以尺计算长度
mediate	调停
undisposed	无倾向
insensitive	感觉迟钝的
sedgeland	莎草
calkin	鞋底铁掌
feuillant	费洋社
heteroatom	杂原子
urticariogenic	致荨麻疹的
snide	假珠宝
monatomic	单原子的
flub	搞错
spiel	喋喋不休地高谈阔论
muonic	μ子的
recover	复原
untrue	不忠实
piratical	海盗
aquiferous	蓄水的
ladderlike	梯状的
testing	与试验有关的
gwine	的现在分词
metalingual	=metalinguistic
elevator	升降舵
panne	平绒
monozygotic	单精合子
viscounty	身份
flotative	可漂浮
parsimony	过度节俭
gossamer	蛛丝
cyclopic	巨大
quavery	颤声
integrable	可积的
poise	犹豫
steak	牛排
rubral	脑红核的
hydrosulfurous	连二亚硫酸的
enquiring	寻问的
chanson	歌谣
backscratcher	长柄扒
fair	晴朗的
menstruation	有月经
paleography	古文书学
plantation	人造林
abetment	教唆
bugs	发疯
peristome	开口部
vacuometer	低空计
proviso	附文
distinction	区别
buccolingual	颊舌的
ardently	热烈
azc	Council美国犹太复国主义者理事会
christocentric	以基督教义为中心
monometallist	单本位制论者
efflorescent	起霜
gallimaufry	搀杂
pyxidium	盖果
lasher	堰下的水溏
motorail	铁路运载汽车及其司机、乘客的业务
mature	成熟的
strategy	策略
currently	普遍地
disyllabic	双音节的
hopei	见Hebei
corydon	青年
heterogenesis	异形生殖
lecherous	色情
phonotactics	音位配列学
photodynamics	光力学
uncontemplated	未经周密考虑的
awshucks	羞怯
banquette	射击壕沟
lex	法律体系
modifiable	可更改的
syndic	评审员
feudatorial	世仇的
gook	对韩国人
skirl	发出尖锐声
agazed	受惊吓的
flyunder	下层车道
acrodromous	脉向尖聚集的
mmpi	Personality
heliogabalus	黑利阿加巴卢斯
ordovician	奥陶系
grandstand	正面看台
unwove	unweave的过去式
ease	安心
feudalistic	封建制度
seaflower	海葵
conversationist	健谈者
intrepid	无畏的
depreciate	折旧
fluid	可改变
inbred	天生
bedrabble	使湿透
triangular	三人间的
gabardine	一种宽松的长袍
coprophobic	粪便恐怖的
disfavor	冷待
ipts	International
argentite	辉银矿
exit	太平门
ukiyoe	浮世绘
brechtian	的:
acetanilid	止痛剂
indistributable	不可散布的
vulgate	公认的
firstling	最初成果
dysthymic	精神抑郁
cullet	碎玻璃
photodissociation	光解
scheduler	调度程序
possession	所有
zootheism	动物神教
quaternity	四位一体
urbanise	使文雅
washer	洗碗机
ordinance	传统的风俗习惯
xtra	字母X
point	要点
asbestoidal	似石棉的
synaesthesia	联觉
calorescence	热光
etr	External
migration	移动
gibeonite	做苦工者
pleasure	意志
sacerdotalism	祭司制度
total	达到
dauntless	不屈不挠的
crissa	crissum
endways	向着两端
plowback	=ploughback
nosography	病情学
potentiostatic	恒电势的
yielding	出产
spindly	纺锤形的
nymphlike	nymph
sopor	酣睡
scout	跟踪
tropone	环庚三烯酮
dell	美国德尔公司
neutral	中性
sulfureous	硫磺一般
reproduce	使……在脑海中重现
abuzz	嗡嗡
fiftyfold	五十倍
cavern	放于山洞中
encyclopaedic	如百科辞典
amphitheatric	圆剧场的
acidosis	酸毒症
pallium	大披肩
belgic	人
mile	较大的距离
extortionate	敲诈
unabiding	不持久
mainstay	支柱
globule	小球
unoffended	未被冒犯的
maidenhead	处女膜
squilgee	=squeegee
stratigraphy	地层中的岩石组成
chromatopsia	部分色盲
freeloader	揩油的人
shortening	缩针
perceptual	有知觉的
canaliform	状似运河或管子
pleochromatism	=pleochroism
syphilitic	梅毒病人
student	研究者
bluster	吓唬
ebullition	迸发
apolaustic	放纵
compulsive	强制的
maracca	=maraca
subordinating	连接主句和从句的
rushy	多灯心草
undoubtedly	无庸置疑
serried	密集
thermoplastic	热塑性的
flanker	侧面堡垒
articulator	发音矫正器
plainstones	板石
surrounding	周围的
polymorphic	多态
abiogenesis	自然发生
organogeny	=organogenesis
lucullian	奢侈
scarification	松土
editorial	编辑上的
magnisonant	高调
poignant	尖锐
phonic	声音
ritzy	讲究
acellular	非细胞组成的
mordacious	锐利
ringing	干脆
incendiary	煽动
rubelliform	似风疹的
vanadate	钒酸盐
refutable	可驳倒
annotate	评注
kidderminster	的都市
hindustani	印度斯坦
flea	低廉的旅馆
plicate	有皱襞的
nill	不愿
orientate	向东
mongolia	蒙古
fibrinuria	纤维素尿
fifa	Association
championship	锦标赛
spinate	有刺
sewing	缝纫
mainboard	主板
suberect	几乎笔直向上长的
drive	驱赶
aweary	疲倦的
abbreviatory	省略的
nonenzymatic	非酶的
reasoningly	推论地
striola	细线条
patulous	张开的
unorderly	杂乱
undro	Relief
proletariate	无产阶级
anima	生命
hypo	海波
cystiform	囊状的
transvenous	经静脉
babylonia	巴比伦尼亚
thunderous	打雷
parlous	狡猾
buteshire	比特郡
towards	向
prehistoric	陈旧的
chipper	爽快
spendthrifty	=spendthrift
condescension	硬要人家领情的态度
floatable	可航行
nock	作凹痕于
environmentology	环境问题研究
riverboat	内河船
animate	生气勃勃的
phare	=pharos
unclinch	松开
separate	分别
unpeel	削……的皮
tallyho	四匹马拉的马车
upriver	向水源的
wheezily	气喘
jekyll	哲基尔医生
montane	山区
tease	欺负
complete	使完善
unbred	粗鲁
interestingly	有趣
immunoreactive	免疫反应性
cruiserweight	轻重量级拳击手
morally	精神上
unfitting	不适当的
permanently	不变
nonideal	非理想的
antivirus	抗病毒液
crape	黑绉绸
dolichocranic	长颅的
sandglass	沙漏
lollipop	棒棒糖
flexography	苯胺印刷
exogenous	外因的
otiose	怠惰的
magnetooptical	磁场对光线的影响
cep	Error
trivialize	使平凡
balaustine	野石榴
petrosal	岩石般的
entelechy	生命的原理
succinctly	简洁地
proviso	限制性条款
impertinently	不礼貌
barred	隔绝的
apocrine	泌离
devilkin	小鬼
rataplan	击鼓
lie	位于
shall	会
peachick	孔雀的雏鸟
flunk	考试不及格
aggressively	侵略
uredinium	夏孢子堆
viole	的复数
connect	连接
dockmaster	码头负责人
diffusedness	散布
smsa	大城市及其郊区
consonance	调和
inoculation	接种
imperturbed	神色自若的
pst	Time
blae	深蓝色
fullmouthed	声音响亮的
shrunken	缩小的
antemeridiem	午前
fubsy	矮胖
gonogenesis	配体发生
teleologic	目的论
soul	心灵
sciomancy	鬼魂占卜
salat	礼拜
mouthwash	嗽口水
defectology	缺损学
monachism	出家生活
oblivion	遗忘
elasticity	弹性
hob	铁架
edi	电子数据交换
balzacian	巴尔扎克
jimp	苗条的
notion	小饰物
spirality	螺旋形
inosculate	使连接
cobbly	畸岖
nlaa	Aid
heterogeneous	异类
fmi	International
epitope	抗原决定基
kurgan	坟墩
panivorous	食面包的
mongolism	先天愚型病
descriptive	描述
piracy	盗版
neutral	齿轮的空档
restively	难以驾御地
sherlock	私家侦探
moralistic	说教
conquest	征服
radiochromatogram	放射色谱图
suckle	哺乳
minischool	专科实验学校
abbot	修道士的总称
adscription	归属
opposeless	无可反驳
mlg	Low
lophodont	脊齿型的
gwtw	the
cockish	傲慢的
scent	循着遗臭追踪
tumid	肿大
eton	伊顿
japer	开玩笑的人
conclusion	缔结
crisscross	十字形
euphotic	透光层的
usafe	Europe
simple	无经验的
lunatic	极端愚蠢的
subindex	次标
depart	不按照
petty	小
kilpatrick	基尔帕特里克
prehension	理解
infirmarian	看护病人者
surge	澎湃
partner	做伙伴
ratbite	fever鼠咬热
loudly	响亮地
archival	关于档案
sarcomere	肌小节
dependability	可信任
incertitude	不肯定
kgps	per
monetization	当作货币
profluent	涌流
netsuke	悬锤
assimilatory	同化
testing	试验
pitiably	可怜
seismometry	测震学
naysay	拒绝
indicial	表示的
sizable	大小相当
airbus	空中巴士
dippy	脑筋不正常的
spa	矿泉疗养
brcs	Society英国红十字会
datagram'	NULL)
clique	私党
antalgic	镇痛的
stilly	静静
place	放置
colacobiosis	寄生
jerquer	水上稽查员
entomologic	昆虫学
quip	说托辞
cornucopia	满装花果象征丰饶的羊角
postharvest	收割期后
essie	埃西
tuscarora	塔斯卡洛拉人
echopraxis	模仿动作
annette	安妮特
filature	螺丝机
esl	second
scoticise	=Scoticize
tray	盘
finlandization	芬兰化
homogenization	匀化
haida	海达族人
atomic	微粒子
fatuous	发呆的
atherosclerotic	动脉粥样硬化的
tif	标记位图文件格式
scorbutic	患坏血病的
fran	弗兰
exsanguine	失血的
cuspy	整洁的
jubilant	喜洋洋的
imine	亚胺
banter	善意的与人开玩笑
civil	有礼貌的
printing	印刷术
tactual	触觉
adieux	告别
penile	影响阴茎的
careen	倾
gina	吉娜
timing	定时
trisection	三分
etesian	每年发生的
hefa	Education
pentomino	五格拼板
criminal	犯罪者
slavish	专横的
nop	除非另有规定
rics	Chartered
weight	重累
martyrologist	殉教者传记作者
pathetically	可怜
majestical	庄严
putsch	起义
inflictable	可科
mephitis	有害臭气
sputter	飞溅出
stereography	立体平画法
yawing	盘旋
uncustomed	未经海关通过
creditable	可信
grandeur	伟大
sweety	糖果
estrepe	做不必要的破坏
incapable	无能力
mbfr	Reductions
candlepower	烛光
cribrose	有小孔的
exsection	根除
suspensive	暂停
epipteric	翼上的
jcb	作业控制块
stand	架子
bosh	胡说
oftentimes	时常地
shakeable	=shakable
kibe	冻疮
straight	整齐的
offering	祭品
ecotone	群落交错区
patroon	在纽约州和新泽西州的大庄园主
generalization	一般化
nundinal	市集
swift	敏捷
abbot	修道院
polysaccharid	聚糖
immanency	内在
florid	炫耀
profitably	有益
imp	加强
someway	以某种方法
solifluxion	泥流
clottish	愚蠢的
button	扣紧
polygala	=milkwort
subterminal	接近端点
debarkation	下船
crombec	非洲短尾小莺
dyeline	重氮法复印品
vibropack	振动子换流器
yarak	良好飞行状态
umt	Universal
felonious	极恶的
lemming	旅鼠
succous	体液
palk	Strait保克海峡
oleiferous	产油
morale	士气
rarebit	欧洲种的兔子
drudgery	苦差事
lapidification	石化
species	圣餐物
contractive	收缩
nubile	适婚
pleurisy	胸膜炎
permanency	永存
hypochondriacal	过分担心自己健康的
multipartite	多国参加
mononucleosis	单核细胞增多症
conservatory	温室
bats	神经不正常
citrous	柑橘属植物的
pemmican	要旨
leak	漏出物
expiable	可赎的
enterology	肠病学
airliner	定期班机
juvenscence	年轻
offenceful	有罪
sessional	开会
put	表达
fib	小谎
kelleg	应急锚
crinite	有发状尾的
heterogeny	无生源说
eclectically	折衷地
osp	Optical
westbound	向西进行的
ensilage	保藏于地窖
saccharometer	糖溶液比重计
futz	闲荡
atrocity	暴行
forced	被迫
diaphanous	精致的
barometric	大气压力
unpitiful	无恻隐之心的
mileage	英里里程
rancidly	令人作呕地
tetranitromethane	四硝基甲烷
scotice	=scottice
essential	要素
disabuse	释疑
mayan	玛雅语的
scoffingly	带冷笑
wave	摇动
exponential	指数的
sensitive	敏感的
excelsior	精益求精
rio	Object
woolpack	羊毛打包布
overdaring	鲁莽
filibuster	海盗
predictable	可预言
overripe	衰败
hyacinthine	风信子色的
oneiric	梦的
acoustic	有关声音
edacity	贪婪
rimal	细长之口的
boondocks	偏僻地区
irrespective	不考虑
irreproducible	不能再现
muzzy	头脑发昏
stemma	家系
disintoxicate	为……解酒
superduty	超级耐高温
riot	放荡
halfheartedly	不认真地
shebang	陋屋
wgmc	Germanic
juggle	诓骗
leprosy	腐败
falteringly	口吃
clinging	有粘性
engagement	诺言
prescience	先见
reecho	使回响
gibberellin	赤霉素
cadential	节奏的
roucou	=annatto
harmonization	一致
tony	时髦的
winnow	飞行
decayed	烂了
mbini	姆比尼
ssfdc	Disk
lactamase	内酰胺酶
misanthropic	憎恶世人
briefing	简报
zen	禅
incalculability	无数
misappropriate	盗用
yirr	狂吠
phototheodolite	摄影经纬仪
diphonemic	双音位
snorty	令人讨厌的
explicative	阐明的
biogasification	生物气制造
uat	Union
antipathy	憎恶
fluoroscopist	使用者
closet	关起门来的
keelage	停泊税
polygamous	一夫多妻
cautelous	小心
wrong	错误的
yielder	让步者
ruelle	窄小的街道
invert	颠倒的事物
telegrapher	电报员
autoeroticism	自我淫荡
microvascular	微脉管的
oxhide	牛皮
chaeta	刺
bombinate	发嗡嗡声
yowl	号叫
teasy	爱戏弄人的
ceresine	地蜡
dart	标枪
attackman	攻手
impervious	密封
brahmapootra	婆罗吸摩鸡
sierran	锯齿山脊
scout	侦察
dm	Data
ulm	乌尔姆
bum	游荡者
idiomatically	惯用
sniffable	可嗅
irc	Internet在线聊天系统
unicursal	一笔画
actionless	不采取行动
harmoniously	和谐地
accostable	易接近的
billiard	台球的
brokenhearted	心碎
septillion	百万的七乘方
smaragd	纯绿柱石
acgb	Great
lignification	木质化
reliction	新生
neotropical	新热带区的
semidiurnal	12小时
phenacetine	乙酰对氨苯乙醚
silvicolous	森林中生长的
boding	先兆的
unmeaningful	无
equipment	装置
afoul	冲突
muonic	μ子
dot	在……上打点
radiate	有射线的
chacma	大狒狒
manx	马恩岛人的
anacoluthia	破格文体
insensitive	对……没有感觉的
strategetic	=strategic
impayable	极好
urography	尿路造影术
snakestone	菊石
thrasonical	自夸
whisk	搅拌
bacchae	酒神Bacchus之女性崇拜者或女祭司
shellback	老水手
iconological	偶像学的
derelict	被抛弃了的
goatskin	山羊皮
hopelessly	绝望
scraping	挖
person	容貌
scaremonger	扰乱社会民心的人
heroin	吗啡
briny	咸的
ungrammatical	非文法
flask	小水瓶
cacography	拼写错误
insupportably	忍耐不住
censorial	监察的
calking	填空隙
flyaway	轻浮的人
perfusion	充满
lusterless	没有光泽的
teazle	起绒机起毛器
niobic	含铌的
tolyl	甲苯基
marinera	马利内勒舞
fluty	似笛声
garnishment	添饰
underhung	轨上的
visakhapatnam	维萨卡帕特南
examinatorial	检查的
libidinous	淫荡的
lacerta	蝎虎星座
crunode	结点
barge	闯入
druggist	药剂师
backslide	倒退
lowish	小声的
niftic	俏皮的
onstage	台上演出的
intracardial	心脏内的
seriatim	逐一
cense	用香熏
interpolated	以内插值替换的
milanese	米兰的
iscariot	出卖耶稣的犹太之姓
wfd	Federation
travertin	石灰华
homopolymer	均聚物
bullpen	大房间
subastral	天空下的
illegal	不合规定的
refractory	难控制
xerosis	干燥病
gracefully	温文
nonchalant	冷淡
meniscoid	凹凸的
saltatory	跳跃
divisional	部门所有
inswept	尖端狭窄的
hopeless	没有希望的
orographical	=orographic
vanguard	先锋
lumping	重大的
exercitorial	包船的
slightly	苗条
factorize	分解为因数
vomit	大量喷出
instability	不稳定
spd	即DIMM印刷板上一块容量为2048bit的EPROM
rascaldom	无赖
maidstone	梅德斯通
tern	三个一组
salometer	=salinometer
liege	君臣关系的
interlocutor	对话者
lean	偏向
jerk	急推
nisi	非绝对的
fission	裂开
mean	想要
abstemiously	适度
offshoot	分支
sheathy	合身的
flowing	平滑的
avengingly	报仇地
gallinaceous	鸡
coziness	畅快
probably	大概
thermoform	加热成形
unbacked	无靠背的
subharmonic	分谐波
diphonemic	双音位的
preemptive	有强制收购权的
paraleipomena	=paralipomena
dysteleologist	生活或自然之漫无目标
bodiless	无体
kiddle	鱼簖
popularizer	大众化的人
explainable	可解说
heimisch	不拘礼节
extended	广大的
bask	晒太阳
paintbrush	画笔
padang	球场
interlacustrine	位于湖泊间
weasel	狡辩
fulgurite	闪电
embody	具体表达
acquiescent	默从的
romanic	拉丁系语言
assess	估定
waveless	无波
pendent	未定的
mobot	移动式机器人
rendering	描写
gambe	=gamb
neimenggu	内蒙古
rightly	端正地
roily	生气的
telescopically	望远镜地
macadam	碎石路
unrelatable	无关联的
warp	使有偏见
cragged	岩多的
cpc	of
hypoplasia	细胞减生
compassable	可达成的
infibulate	扣住
consuetudinary	惯例上
blindstory	无窗之楼
appassionata	热情
mutt	笨蛋
plica	纠发病
vaccine	疫苗
disquiet	使忧虑
piggyback	在背上
another	又一
roguish	流氓的
fishline	钓丝
opponent	对手
mobility	迁移率
agrin	微笑地
service	耐用
collodionize	以火棉胶处理
manteau	斗蓬
cardiotonic	强心
materialist	唯物主义者
hardy	勇敢
fiddle	瞎搞
morphotectonics	构造地貌特征
creepy	皮肤上有足爬似
tungstous	低价钨的
levis	牌牛仔裤
leisure	安逸
sacred	宗教的
odograph	里程表
videography	电视录像制作
bookmaking	编辑
ble	Engineers
gearing	传动装置
mhc	histocompatibility
outcaste	贱民
inshore	近海岸的
serenely	安详地
saudi	沙特阿拉伯人的
barren	贫瘠
seafloor	海底
expressionist	表现派作家
indicate	预示
phonetic	表示语音的
through	直达
reactively	反应性地
dazzling	眼花缭乱
nesslerize	进行比色处理
adversative	意义相反
gambit	以优势的开局棋法
antwerp	安特卫普
useless	无效的
beak	鸟嘴
unusual	不平常
averseness	反对
kenyan	肯尼亚共和国的
hibernant	冬眠的动物
dirtily	下贱地
smooth	安祥
menservants	manservant
signal	信号
unforensic	不适于公开辩论的
seaworthiness	适航行
wtc	Center
infuse	沏或泡
yosemite	=Yosemite
recommendation	推荐
dictaphone	录音机
unwarrantable	不允许的
unselective	没有选择力
unassimilable	不可吸收的
lassen	Mount=Lassen
iso	国际标准化组织
flapjack	大薄煎饼
thowless	呆滞的
decametre	十米
zeuxis	宙克西斯
livable	可住的
galess	不易生气
sonolyse	=sonolyze
amate	使懊恼
yard	码
deplorably	悲惨
dole	发放救济
seducible	容易受人诱惑
vulture	秃鹰
coop	鸡
xing	美国出品视频播放软件的公司
awake	唤醒
basilisk	蜥蜴状妖怪
talky	说话过多的
block	滑轮
manageable	易管理的
tzarevitch	=czarevitch
dankish	阴湿的
lentic	生活于静水中的
reg	注册表信息文件
exponential	幂数的
carnal	肉欲的
dishwater	洗碟的水
unprohibited	未阻止
radicalization	激进
informant	通知的人
transworld	遍及全球
bicentric	二中心
asafoetida	阿魏
pollard	角被割下的动物
spiritist	关亡人
moskva	=Moscow
narcotic	麻醉
brushed	拉过绒
deforestation	采伐森林
frowardly	顽固地
mesmeric	催眠术的
myotropic	侵袭肌肉的
serranid	鮨
vexation	烦恼
ruling	支配
atherosclerotic	动脉粥样硬化
underpinning	支撑
sixfold	六重的
confect	糖果
puritanize	举止严谨
christabel	克丽斯特贝尔
pococurantism	冷淡
gallantly	勇敢
lover	爱人
labour	费力地前进
lestobiotic	窃食共生
epifauna	底上动物
corporate	全体
compressive	有压缩力的
brunet	深色的
rictal	露齿裂嘴的
nescient	无知的
noumenally	本体
sink	接收器
nonproliferation	防止扩散
confucian	孔子
parasitic	寄生
mitigatory	平静
agroindustrial	农业的和工业的
feticidal	堕胎的
marketstead	=marketplace
microsome	微粒体
mound	积成堆
heater	加热器
integrated	完整的
equality	等式
advocatory	有关拥护者
romanticist	浪漫主义者
orientalist	东方学者
twelvepenny	值12便士的
nailless	没有指甲
fearless	大胆
ribbonfish	细长的带状鱼类之总称
phenylbutazone	苯基丁氮酮
equanimously	镇定地
reputably	好评
frounce	卷缩
coexist	共存
hedonic	享乐
saltpetre	硝酸钠
cavate	挖空岩石而形成
back	早过去的
shrinkproof	防缩
living	生活
narrow	隘路
immediate	紧接的
epicritic	精细觉的
penstock	水道
existent	生存的
resupinate	向上翻转
encyclopedize	按百科全书式排列
fabian	费边式
slouchy	懒散
carshalton	卡苏顿
princelet	=princeling
participation	分享
rabbitry	养兔业
varnish	凡立水
thundering	异乎寻常的
maladaptive	不利于适应的
seminiferous	产生种子
swad	一束
gibing	嘲弄的
supportably	可支持
tangent	离题的
another	另一个
southwardly	往南地
dissolving	毁灭性的
like	相似的
systemic	系统的
maternity	产妇的
gummous	由树胶构成的
goup	粘稠液体
refute	反驳
stilt	高跷
snoop	偷窃
ionic	爱奥尼亚式
damningness	定罪
collyrium	洗眼剂
surd	清音
spermous	精子的
haytian	海
nonmiscibility	不易混合
matted	有席子的
redigest	再消化
tableful	一桌人
fend	挡开
moonshine	空谈
judas	犹大
gulfy	遍布裂口的
headliner	写标题的记者
hackle	梳理
quaere	问题
phyllostome	叶鼻蝠
qos	Quality
calyceal	萼
opportunity	机会
paraprotein	病变蛋白
fibulae	扣针
scourings	擦下的污垢
drome	飞机场
denture	一副假牙
dichlorvos	敌敌畏
function	行使职责
chiaroscuro	明暗的配合
disquisitive	探讨的
jiminy	感动
unpretending	质朴
funny	古怪的
garibaldi	宽大衬衫
papertrain	训练在纸上大小便
prejudiced	怀偏见的
lacombe	拉康姆猪
annulate	由环组成的
mdram	多段DRAM
geta	日本式木屐
cockneydom	伦敦人
legumen	豆
folliculin	经酮
identifiers	标识符
understandable	可懂的
bath	沐浴
hypogenous	下生的
raughty	痛快
sawdust	锯屑
cullion	痞子
practically	简直
tiptop	极好的
evictee	被逐出的人
arillus	一层假种皮
unsuccessful	不成功的
gutty	有勇气的
multicentric	影响多中心
sapient	聪明
branchial	鳃的
lantern	提灯
tooler	阔凿
refrigeration	致冷
delphi	希腊古都
wrapper	书皮
diascope	反射幻灯机
okay	认可
dep	就业和生产率部
pfda	Food
vauntingly	傲慢地
lurch	倾斜
amphiphyte	两栖植物
madden	发狂
vocable	词
lawbreaking	违反法律的
paddywhack	爱尔兰人
sanitation	卫生
polycistronic	多顺反子性
pajamas	宽长裤
gemmer	开采宝石者
mustard	芥子气
farinose	生淀粉
extrados	拱背
colourfast	不掉色的
leafy	叶状的
stag	全是男人的
boatable	小船可通行的
sawan	印度历的5月
laparoscope	腹腔镜
unthought	未深思
aps	高级相片系统
waterfowl	水禽
nonfarm	与农场无关的
runtishly	发育不良
somber	阴森
mucic	黏液的
subaerial	接近地面
erberry	接骨木
annihilable	可消灭
cursely	该被诅咒
sing	唱
responsory	唱和
fencing	栅栏
subeconomic	缺乏经济意义的
redevelop	恢复经济发展
uaw	United
multifoil	繁叶饰
leak	漏洞
palmated	有蹼的
ucla	加利福尼亚大学洛杉矶分校
lambent	闪烁
idiogram	染色体模式图
upstage	自负的
osteometrical	骨测量法的
capriccio	狂想曲
sakti	=Shakti
ornate	装饰
clasp	密切合作
gory	满是血的
animist	万物有灵论者
luminism	光色主义
fluidity	流动性
bizzard	大风雪
supermanly	超人特有
manille	=manilla
padlock	挂锁
immolate	牺牲
infarction	梗塞形成
espantoon	警棍
penitential	苦行赎罪
stuffless	无实质性东西
sequential	结果的
slimsy	不耐穿
unexhausted	未尽
gravidity	怀孕
pithecanthrope	猿人
jawlike	像下巴的
splenectomize	切除……的脾
inalterable	不变的
barbacue	烧烤
expugnable	可突击
teeny	极微
orient	灿烂
pudicity	贞洁
rosily	乐观地
missable	可能打不进穴的
collaborate	通敌
saiga	高鼻羚羊
acceptance	容忍
superchurch	超级教会
jaundiced	敌视
algometrical	痛觉测验计
interspinous	椎间的
evulse	拔出
lucubrate	用功
postbellum	美国南北战争后
goaty	山羊似的
explicitly	明确
print	版
allay	减轻
incautiously	鲁莽地
man	在……就位
oolith	鲕粒
supersaturate	使过度饱和
condolence	吊唁
derisively	嘲笑
struggle	竞争
short	短的
uncatchable	捉摸不住
alluvia	alluvium
exterior	外交的
inchoative	开始
pathlet	小路
nuclein	核素
huckster	小贩
sideward	旁边的
mediator	调停者
bluebottle	矢车菊
decorously	有礼貌
spiffing	出色
laird	领主
plebs	庶民
mariner	水手
double	双精度型
lawmonger	讼棍
semibold	半粗体的
blat	喋喋不休
centerboard	活动船板
girlygirly	娇气十足的
dubitative	半信半疑的
hearsay	道听途说
latish	稍迟
alternately	隔一个地
fastidious	挑剔
yi	彝人
jointure	由妻继承的遗产
usga	美国高尔夫球协会
veritably	真实
irrigate	冲洗伤口
ungular	爪
trench	管沟
arbitrament	裁判
sulfa	磺胺药剂
grainfield	谷物用地
varicosity	精索
bernadette	伯纳黛特
pneumatology	气体学
briticism	英国英语
inertialess	无惯性
speciously	外观好看地
backstairs	厨房门
iniquitously	不正
effluvial	恶臭
scaling	缩放比例
scissorsbill	下等人
habitual	习惯的
downhill	倾斜
inflammation	发炎
rigescent	生硬的
electrolier	电灯架
follow	追求
upslope	上坡
adsum	有
dipsy	深海
unfrock	解除僧职
kite	骗钱
intersect	横断
perfect	使完美
hyperboloidal	北极的
yellows	枯黄病
ferromagnetic	铁磁体
emblematise	=emblematize
pantomorphic	呈所有各种形状的
pacesetting	带头
aboveground	未被埋葬
maltreat	虐待
assuagement	缓和
hydrocracking	氢化裂解
roily	动荡的
predestinarian	命运注定
underside	内面
carronade	大口径短炮
patripotestal	以父系亲属委员会为权威
bob	上下或来回的动
oligosaccharide	低聚糖
jangle	刺耳响
suggestive	暗示
potassic	含钾的
bromize	溴化
jackfruit	木菠萝
hostage	人质
titubate	蹒跚
varvel	奇异之事
cautioner	警告者
erectly	直立
rude	粗鲁
ostend	奥斯坦德
qbe	query
enkindle	使燃烧
anticyclone	高气压
cissoid	凹边
coadjustment	相互调节
sausage	香肠
borneol	龙脑
voluminal	体积
partialness	部分的
triennially	每三年地
succedent	随后的
rubricate	加以红字标题
wartime	战时
unture	不忠实
unjelled	不固定的
ideographic	表意的
vacuous	空洞
unexcited	镇静的
serration	锯齿状突起
loxodromics	斜航法
kabele	=kabele
equability	无变动
koei	日本光荣公司
projectionist	电影放映员
footling	微不足道的
glowing	炽热
lamellirostral	扁嘴类
anthobian	食花的甲虫
ventage	空气孔
sidelight	侧灯
nyc	City
waste	垃圾
iconodulic	崇拜偶像
battlesome	好斗
vasectomize	给……施行输精管切除术
underestimate	看轻
cryptomeria	日本柳杉
pineland	松林地
ratcatcher	捕鼠者
peritricha	周毛菌
republican	共和党人
undro	Disaster
trotter	快跑的马
prefect	长官
benzidine	对二氨基联苯
potentiostat	稳压器
preadapted	预适应的
specifiable	可列举的
motivity	原动力
scrupulously	小心翼翼地
trass	火山土
goddaughter	教女
psychokinesis	意志力
pack	被包装
vb	语言
prizeman	得奖人
regenerate	新生的
sawtimber	锯材
unbroken	未破损的
panorama	全景摄影
alvin	阿尔文
nutritional	滋养
koniology	空气中的灰尘
dyspepsy	胃弱
eggar	=egger
megatron	塔形电子管
manuduction	引导
tolane	二苯乙炔
luciferous	光亮
infiltree	渗透者
haemoid	血样的
amusia	失歌症
cutis	表皮
etymologic	语源学
uncertainty	不可靠
genet	香猫
genially	快活
detrusive	推落的
disgustful	厌腻的
precocity	早成
silt	淤泥
breccia	角蛮岩
praetor	执政官
underpin	巩固
mythicize	解释为神话
cohort	一群
irresponsive	无感应
morphological	语形学
waveless	平静的
hateful	可恨的
perimeter	周界
alight	点着的
toom	空
mailclad	穿盔甲的人
hydrocinnamic	氢化肉桂醛
sciograph	=skiagraph
bummer	无赖
cisc	复杂指令集计算
carbocyclic	碳环形的
staid	沉静的
resinous	树脂质
recense	修正
ricketic	佝偻病的
desiccant	使干燥
flinty	严峻的
christless	不信奉基督
vengeful	复仇心重
cookhouse	船上厨房
cinematize	摄成电影
plumose	有羽毛的
lustful	渴望
forthcome	出现
piccolo	短笛
uncharted	不详的
reform	改过
durra	蜀黍
thalassic	内海
notion	想法
residential	与居住有关的
handle	把柄
synonymical	=synonymous
untuneful	不悦耳的
apologia	辩解文
weird	不可思议的
abortion	流产
sertularian	桧叶螅
impermeable	不渗透性的
wearable	耐磨
suppose	推想
idiomorphism	自形
incunabulum	最初期
rumaki	腊肉春卷
unescorted	没有护卫的
fill	满足
rear	背面
mode	样式
interpretive	作为说明
nightlong	彻夜的
obtestation	恳请
fluvialist	河成论者
red	红
nutty	狂热的
fair	女性的
bitsy	小
sweetheart	爱慕
fractional	部分的
tumefacient	膨胀的
unrepealed	仍有效
fardel	包
ubi	无论在哪里
phylogeny	语系发生
interlibrary	馆际
facilely	轻快地
setup	设置
regional	整个地区的
tetracarpellary	四心皮
clianthus	开穗状花朵的矮树
exeat	外宿许可
sling	投石器
branching	发枝的
fatbrained	脑筋迟钝的
sprawl	爬行
gorilla	大猩猩
harmonical	调和
gruntle	使高兴
intime	=intimate
deadish	钝浊的
notification	告示
twicer	一事作两遍的人
altruist	利他主义者
notitia	记录簿
roomer	房客
och	哦!
monographer	专题论文作者
synaxis	敬拜集会
bloated	傲慢
alcaic	句法
pectinaceous	果胶
malconformation	畸形结构
enforce	强迫
ozonize	以臭氧处理
politer	优雅的
laval	似熔岩般灼热的
rubberware	=rubber
rationalist	理性主义者
ugt	急电
venerer	猎人
signalize	使显眼
leader	领导者
chiromancer	手相家
blouson	松紧带束腰的女衫
hypnogenetically	催眠
alluring	吸引人的
overstrain	使工作过度
synantherous	聚药的
mendacious	虚假的
irredeemable	不能兑现
hound	追捕
aeropulse	脉动式喷射引擎
anfractuosity	错综复杂
pinacoid	轴面
riffle	迅速洗牌
rightly	正当
pestiferous	邪恶
emotive	使感动的
limbless	无翼
manufacturing	制造业的
nonrated	不列等级的
recrement	废物
delaney	德莱尼修正案
snuff	鼻吸气息
piquant	顽皮的
electrosurgery	电外科学
outlook	见解
basan	书面羊皮
copiously	丰富
threat	凶兆
set	事先做好
tootsies	脚趾
praxis	习题
widger	小锄
compellent	强制性的
uncorrectably	不能补救地
radioecology	辐射生态学
brag	吹牛
testae	testa的复数
smatter	肤浅的知识
manchester	曼彻斯特
unrig	取下索具
twinge	一阵一阵痛
eclosion	涌现
trivially	平凡地
assailant	攻击者
decapitator	刽子手
blellum	饶舌的懒鬼
snooze	小睡
grammalogue	其记号
unfilmed	尚未拍成影片的
lacrimal	泪腺的
yautia	箭叶黄体芋
yellowy	淡黄的
particularization	分列
indemnitee	接受赔偿者
darwinian	达尔文的
sociosexual	社会群体内性关系
listener	听众
trismegistus	Trismegistus
pyrometamorphism	n
jointed	有接缝
vicenary	以20为基数的
tantivy	突进
tripod	三脚桌
sleave	解开
fewtrils	无价值的东西
couloir	山腹的峡谷
rebelliousness	造反
megapolis	大城市
amoebocyte	变形细胞
triggerman	刺客
testing	试验的
upcast	上抛
gain	增加
total	整个的
downhill	下坡的
cicely	没药科植物
backwoods	未开垦地
chemotaxis	趋药性
overpot	栽用盆过大
sha	hour
aca	of
unobvious	不明显
inerrably	确实地
aloetic	芦荟制
damagingly	很
biyearly	两年一次地
synostosis	骨性联接
nicrosilal	镍铬硅铸铁
adoptive	收养关系的
sickish	象是要吐的
finite	有限的
mayhap	但愿
countrymen	农民
roding	锚缆
expellent	驱除剂
theoretically	理论地
uncontradicted	不矛盾
sensibly	聪明
elaborate	精心制作
uart	Transmitter
impious	无信仰
decorate	为……做室内装修
cbc	Canadian
microreader	缩影胶片阅读器
callisthenics	柔软体操
eviscerate	除去精华
rheological	流变学
teething	出牙
peroxidase	过氧物酶
congenial	适意
cerebroid	如脑或大脑
insusceptibly	无感觉
prefectural	地方官的
featherbrained	愚蠢的
demurrer	异议
orb	弄圆
courtesy	礼貌
everest	珠穆朗玛峰
leukemogenic	引起白血病
antihero	非英雄主角
jingoish	沙文主义
weasel	黄鼠狼
potpourri	花香
mugho	pine
oneness	统一
handcraft	手工
sustainable	可以忍受
ultracentenarian	一百岁以上的人
unobserved	没有观察到
waterproof	不透水
bilabial	双唇音的
unimpassioned	平静
bronchitic	支气管炎
nonjuring	拒绝立誓效忠
immiserize	使贫困化
impeccable	不会做坏事的
preproduction	生产前的
appulsively	趋向
esb	electrical
hornbook	入门书
thoroughpaced	彻底
humorous	富幽默感
univallate	围有单层防护土墙
inscrutable	难以了解
senary	六
importune	强求
cynologist	狗学家
photophilous	嗜光
intoxicated	喝醉
disposed	有……倾向
natively	生来地
autodestruction	自毁艺术
orache	滨藜属植物
lever	抬起
sinkhole	污水池
malady	疾病
heterogenous	异质的
guest	作客
acrr	Relations
strumae	小节叶
obbligati	肋奏
comby	蜂巢状的
leftover	剩余物
unfatherly	残酷
amendatory	改正的
semiorbicular	半球形
coplanar	共面
pluckily	有勇气
malignancy	恶意
enactive	有制定权
crisis	危象
gangetic	沿恒河
poikilitic	嵌晶结构
jugoslavian	南斯拉夫
paging	内存分页
rama	罗摩(印度教神名
module	模数
libelous	损害名誉的
mask	戴面具
jauntily	活泼地
lankily	过分瘦长地
detergence	洗净
killdeer	小水鸟的一种
injuriously	伤害地
stagnancy	停滞
providing	倘若
undiscussed	未讨论过
negatively	否定
certain	必然
extirpate	毁灭
quay	码头
semibreve	全音符
keyword	关键字
marmorean	冰冷的
hairdye	染发剂
simulant	拟态
lr	铹
conchoidal	贝壳状
jugal	面颊
coadapted	相互适应的
vm	Virtual
lsat	Test
sports	有关运动的
coenozygote	多核合子
triclinium	躺卧餐桌
aperitive	通便药
mannerism	怪癖
chill	扫兴
lordy	老天爷
lardtype	脂肪型猪
suggestible	可建议
idolatry	过度崇拜
boatman	船夫
rival	竞争
virilia	男生殖器
thickset	繁茂的
shock	冲突
soupcon	少许
hypo	硫化硫酸钠
lockdown	一级防范禁闭期
unhidden	不隐藏
bock	一杯啤酒
apocarpous	心皮离生
hummer	蜂鸟
unwitnessed	无证人签字
honda	本田汽车
doyley	小型装饰桌巾
acquisitive	可学到
peck	扔
baconianism	认为莎士比亚戏剧为培根所著的主张
audibility	能听度
tuc	Trades
damnably	可恨
garibaldian	加里波第
unseat	使失去资格
mnemon	记忆单元
mousebird	齿鹑
homophone	同音字
mercia	麦西亚
lipolytic	分解脂肪
spermaceti	鲸脑
strap	用带缚住
underlying	在下面
tauromachy	斗牛
collocutor	谈话者
labour	劳动
tensile	可伸长
polyunsaturate	多不饱和物
cornucopian	丰饶的
tall	高的
horseman	马兵
lateritic	含有红土之特性
obstruct	遮断
ineffaceable	不能除去
lesion	损害
pasteboard	纸板做
proud	妄自尊大
noblest	高贵
johnboat	平底小船
polyphonic	复调
arabian	阿拉伯的
attrit	消耗战
quaintly	优雅
sometime	有一天
whom	pro
kudos	名望
bareback	不用马鞍
nonantagonistic	非对抗性的
herborist	=herbalist
ramify	成网状
bowfin	北美产淡水鱼的一种
triangulate	有三角花样的
tipsily	倾斜地
straightness	笔直
insubordinately	不服从
programming	规划
comecon	for
actorish	不受演技优劣影响
held	hold的过去式和过去分词
euglena	眼虫属
waterlocked	环水
rehearse	使排练
chlorinate	使氯发生作用
quinquelateral	五边
thenar	手掌
polysemous	一词多义的
synovial	滑液
adopter	养父母
fit	恰当的
afterdinner	正餐后的
hitlerian	希特勒政权
maxine	玛克辛
monkeyshine	把戏
paye	Pay
caddy	小盒子
midmorning	上午
steeplebush	绣线菊之类
lark	愚弄
electrofiltre	电滤尘器
signalled	告知
knightly	侠义的
nullifier	取消者
frowardly	顽固
deeryard	鹿群过冬的地方
chiaus	使者
wane	月亏
anglican	英国国教的
diamante	镶人造钻石
disseisin	侵占
sombre	阴沉的
czechoslovak	捷克斯洛伐克人的
programmer	程序规划员
geepound	斯勒格
superintend	主管
private	私有的
psyche	心灵
bulgarian	保加利亚人
intrigant	阴谋者
shammy	麂皮革
ecp	IEEE1284标准并行通讯标准的一种增强模式
over	越过
heavenly	天空
dairen	见
taxi	乘坐出租汽车
trecento	十四世纪
polysyllabic	多音节的
hexarchy	六国联盟
threesome	三人的竞赛
cuticolor	肉色的
tav	希伯莱语的第二十三个字母
globule	水珠
fingernail	手指甲
polynosic	高湿模量粘胶
egalitarian	平等主义
vinaceous	像葡萄
erythropsin	视红质
untenanted	未被租用
lavishly	丰富
incomplete	不完善
civil	市民的
machaira	双刃弯刀
ihp	horsepower
flatly	平平地
peritus	专家
legatine	使者
mounted	裱好的
anticommute	反对易
haycock	圆锥形的干草堆
buttlegging	偷税漏税贩运香烟
discourteous	失礼的
malleate	锻
campstool	轻便折凳
scuttle	急忙撤退
palembang	巨港
ironic	说反话的
rounding	凑整的
vdt	Terminals
overspray	超范围的喷涂
eatery	食堂
chorography	地势图
baking	烘焙
tdn	total
buddie	兄弟
unsuspecting	无疑虑的
smokeproof	防烟
slip	滑倒
abstemiously	有节制地
impavid	大胆的
snappy	爽快的
marianne	玛丽安
worriment	焦虑
egalitarian	平等主义的
gravenhurst	格雷文赫斯特
farcicality	滑稽
encyclopaedic	如百科辞典的
anticrop	破坏作物的
marcus	马库斯
rsgb	Society
immoderately	过度
faradaic	=faradic
strafe	机枪扫射
mpp	Massively
incorporeal	灵魂的
widgie	女流氓
intersubjective	主观间
underwrite	给……保险
homoeologous	部分同源的
extraartistic	艺术范围以外
tarradiddle	谎话
phagocytose	=phagocytize
succous	汁
unlighted	未被照亮的
mitochondrion	线粒体
cummer	教母
wistful	渴望的
drably	无光彩
snood	妇女发网
people	公民
time	期限
necromantic	妖术的
natural	自然界
muddle	使咬字不清晰
kenspeckle	明显的
savable	可储蓄的
communicate	相通
otiose	没有用的
estaminet	小酒吧
trendily	时髦地
skylarker	爱胡闹的人
reliction	新生地
cavecanem	小心恶犬
coaly	含煤
sumption	大前提
attributive	定语的
onward	向前的
paraprotein	异常蛋白
monochroic	一色的
expenses	费用
palpebrate	有眼睑
insusceptible	不为所动的
locality	地点
insinuative	巧妙巴结的
programmable	可编程
himyaritic	希米亚里特文化
mercantilism	商业主义
amplitude	物理学名词
irrespirable	不适于呼吸的
unboundedly	无边际地
spicae	角宿第一星
esthetical	美术
immethodical	无次序的
aiche	Institute
lycian	利西亚人的
wassailer	痛饮者
trounce	痛击
thrustful	积极进取
turtlet	小海龟
proteolytic	解蛋白的
interrogate	审问
peristalith	石柱圈
attachable	可附上
nab	逮捕
wolves	wolf的复数
monocarpic	结一次果
hfs	System
resuscitable	能复活
appellant	上诉人
bedpost	床柱
glottal	声门
incandescency	白炽
possess	支配
archducal	大公爵
unsearched	未搜寻过
monoploid	单倍体
xylophilous	木生的
hayfork	干草叉
ledgy	突出物很多的
intermediate	中间的
axillary	腋生
waste	变消瘦
mappery	地图绘制
ungovernable	难统治的
swellheaded	自大的
extracorporeal	身体外
instinctive	本能的
arability	可耕性
astute	机敏
orbicular	圆
plasmogamy	胞质融合
unbloody	未染上血
ibizan	hound
fuel	供以燃料
acknowiedged	公认
reinstallment	再装置
wide	宽
standpoint	观点
subastral	天空下
demimondaine	花街柳巷的
reappointment	复职
treasonous	叛逆
pyruvate	丙酮酸盐
oestrous	发情的
archontate	古雅典执政官的任期
uptodate	现时的
dupery	欺骗
eam	Apelevtherotiko
extraartistic	与艺术无关
intrusive	插入的
cognitive	认知
emaciation	瘦弱
fiery	暴躁
ultrarightist	极端右翼分子
hell	飞驰
unwrought	未做成
disciplined	遵守纪律的
brushback	头侧球
prothallium	原叶体
dismission	解雇
eventful	重要
overbrilliant	过分光辉灿烂
waywardly	刚愎
forked	叉状
adrate	附加税
nicolette	尼科莱特
usual	通常
loke	死胡同
whosis	=whoosis
abelmosk	黄葵
arrearage	拖延
electro	电镀物品
suspension	中止
excitation	鼓舞
mercurian	水星的
optician	眼镜商
inhabitant	居住者
sluttish	懒惰的
toolmaking	机床维修
wintry	象冬季
catcall	不满之声
animalistic	色情
disappointing	使人失望
shimmy	震颤
icaaaa	of
perfidiously	背信地
scruple	踌躇
dcs	Column
hypoxanthine	次黄嘌呤
beneficent	善行
hypo	瘾君子
chalk	和以白垩
festoon	结彩于
bourride	蒜味蛋黄鱼羹
waste	荒芜
jettison	投弃货物
antemarital	婚前
esophagitis	食道炎
cautelous	警觉
phlebogram	静脉造影照片
wash	虚假的
dashy	时髦
beethovenian	贝多芬风格的
sadistic	虐待狂的
savagely	残酷
beige	米色
semidiurnal	半天的
valet	伺候
sweated	低工资的
spatiotemporal	空间与时间的
mitose	发生有丝分裂
wordmongering	舞文弄墨
preoccupation	当务之急
ric	皇家化学学会
offset	平版印刷
baae	of
crotchet	反复无常
abortive	失败的
sempre	自始至终
minny	=minnow
gain	获利
leastwise	无论如何
rolled	包金箔
lattin	=latten
partizan	党徒
arms	兵种
garibaldian	拥护加里波第
conqueringly	耀武扬威
boresome	烦人
decenary	征收什一税的
transitively	及物地
nonhibernating	不能冬眠的
koutekite	六方砷铜矿
federalization	联邦化
assertor	维护者
exiled	放逐的
bilocular	两室的
incontinuous	间断
prunella	耐用的毛织品之一种
epileptiform	癫痫样
darling	亲爱的
instance	情况
howsoever	不管如何
lepus	天兔座
pettifog	讲歪理
lie	谎言
frightfully	可怕
grubstreet	潦倒文人的
leftover	残留物
xanthopsia	黄视症
unaverage	不寻常
scrap	敲碎
shodden	的过去分词
haplont	单倍性生物
lagnappe	小赠品
commonplace	平常话
rigorous	严峻
pargyline	巴吉林
adh	antidiuretic
contract	订约
forgetfully	健忘地
initial	初始的
absence	缺席
jurisprdence	法学
javelina	一种野猪
bittersweet	苦乐参半
lekythos	=lecythus
impracticably	不可能实施
laboursome	吃力的
beachhead	据点
techniphone	练习弹奏指法的无声钢琴
hotspring	温泉
bullfight	斗牛
fille	姑娘
candor	直率
humoresque	诙谐曲
home	家乡
aja	Americans
umbellule	小伞形花序
chlorotic	变色病
hypospadias	尿道下裂
goosey	鹅
lorn	荒凉
strychnos	马钱子
helpful	有帮助的
distant	间隔
heraldry	纹章
antemarital	婚前的
banausic	物质的
fere	配偶
malignance	有害
aphthoid	像口疮
unchangeable	不变
zealotic	狂热
fetich	迷信
venally	唯利是图
sufficient	足够的
wobble	抖动
bioassay	给……作生物鉴定
allegorically	寓言
hussy	贱妇
lurcher	杂种猎狗
quizzical	古怪
unthought	unthink的过去式及过去分词
companionate	友爱
flow	流动
phoenix	完人
petiolate	有柄
loss	失败
irrationalize	使不合理
pretty	可爱
lactary	牛奶房
flq	Quebec魁北克解放阵线
slate	蓝色
hypertonic	高渗
inimically	抵触
tailwagging	高速大转弯
educible	可引出
borrow	借用
mendacity	谎言
subservient	有帮助的
rigor	精确
inhospitably	冷淡地
subdirectories	子目录
featherlike	像羽毛
babbling	胡说的
unlively	不活跃的
algor	寒冷
mobbism	暴乱行为
tubercula	的复数
kengtung	景栋
aggravating	加重的
cryptaesthesia	=cryptesthesia
drugger	吸毒者
personnel	职员
argumental	好争辩的
plump	圆胖的
planify	系统规划
upriver	上游的
moola	钞票
frondage	叶
erosion	腐蚀
undisguised	无伪装的
phonetist	主张使用语音记号者
applewood	苹果木
estimate	评估
idle	游手好闲
damnable	该死的
cantonal	市区的
unboastful	不自夸的
lamblike	温驯的
unmortgaged	未抵押
marezzo	人造大理石
lipless	无唇的
vadm	Vice
bolt	门闩
primary	原来的
cdnc	计算机辅助设计数字控制
fine	美好
hit	成功
encroachment	侵蚀
feel	觉得
assaultive	喜好攻击
parenteral	肠胃外的
zonked	服过麻醉药
functionary	作用的
vugular	含晶簇的
kimono	和服
middleweight	中量级选手
typification	代表
correct	端正
sluttery	淫荡
candid	无偏见的
resilient	弹回的
penannular	形不成闭环的
potentiostatic	恒电势
tentage	帐篷设备
reoffer	再讨论
toxigenic	产生毒素的
belle	美女
identifiability	可识别性
graining	漆成木纹的方法
chloridize	用氯化物处理
rejuvenate	使恢复精神
captivation	魅力
lav	Vehicle
help	助手
caricature	讽刺描述法
neodoxy	新见解
merca	梅尔卡
vulgate	公认
distasteful	味道不佳
interpage	把……插入书页间
bandersnatch	一种想像中的猛兽
filial	孝顺
wastry	挥霍
yardwand	码尺
hugeness	庞大
puckish	淘气的
crepitant	劈劈拍拍响的
vagal	迷走神经的
missileman	导弹设计者
paranasal	鼻旁的
indent	定货
antilyssic	抗狂犬病
erect	竖立
sonofabitch	=son
tunisian	突尼斯的
drupaceous	可生核果的
silvichemical	林产品
conservancy	管理
basebred	无教养
tenebrous	晦涩
lifegiver	给予活力之人
mane	鬃毛
antipyretic	退热
coil	盘绕
gcse	Certificate
cantabrigian	模仿英国的
hat	戴帽子
glottology	言语学
bodgie	无赖青年
actuation	冲动
rickle	散乱放一起之物
quashy	似沼泽的
environs	市郊
notepad	记事本
swat	全垒打
fatidic	预言性的
inquirer	询问的人
falconet	旧式小炮
valhalla	瓦尔哈拉殿堂
sonsy	丰满
endogamy	同族结婚
clean	清白的
ssrc	Research
rsn	Now
redheaded	急躁的
unendued	未给予的
fibular	腓骨的
mercenary	唯利是图的
novaculite	均密石英岩
baoding	保定
mustang	野马
resipiscence	悔过
guardee	警卫
reignite	再点燃
difficult	难相处的
lxxx	罗马数字
governessy	古板的
weatherability	耐气候性
grasping	抓
noodlework	钻研
snowbush	山白刺美洲茶
streakily	容易生气地
abettal	=abetment
one	同样的
paleohabitat	古动物栖息
prefixion	置于前面的
priceless	极贵重
bathos	虚伪
isolable	可孤立的
transpire	发散
personalise	=personalize
majorcan	马略卡人
execratory	诅咒的
unitar	for
idioplasmatic	种质的
dizen	装饰
intolerant	不宽容的
hasenpfeffer	渍过再炖的五香卤汁兔肉
story	经历
unimpeachably	无可指责地
palynology	孢粉学
intersubjective	主观间的
abloom	开花
glooming	皱眉
hyalographer	玻璃书写术
undyed	未染色的
fitted	按实物尺寸做的
revengefully	燃起报复念头
eastwardly	向东
acgb	Council
tenko	战俘集合
chemosurgery	化学外科治疗
pdsa	"人民"兽医药房
beautifully	漂亮
gairfowl	=great
radioteletype	无线电传打字机
discontinuer	停止
epitaxial	取向附生的
garrulous	多嘴的
thermotensile	热抗张强度
mound	土墩
identic	同一
cataleptiform	似强直性昏厥的
nymphish	少女的
cockneyism	语调等
cern	laboratory
bramble	树莓
cubbyhouse	玩具小屋
triacetate	分子中含有三个醋酸基
crinkle	皱纹
godlike	似神的
infrequent	罕见
separability	可分离性
mure	监禁
unvitiated	未败坏的
gyrose	环形
inchoate	未形成的
plead	借口
temperamentally	气质
degust	尝
sound	噪音
decanal	牧师管辖
syllable	音节
seater	有……座位之交通工具
tipcat	两头尖的短木片
environmentology	环境学
thaumatology	奇迹论
idealistic	空想主义
malentendu	误解
clostridial	梭菌属
trublemaker	常惹麻烦的人
grilse	溯河产卵鲑
burthen	累
cmb	Manhattan
casuistical	诡辩的
judah	犹太所出的后裔
cycler	骑机车者
quadridentate	四齿的
finny	鱼族的
dioscuri	狄俄斯库里
con	反对票
unprojected	未计划的
facial	面部的
introduction	导言
organically	器官上
medallic	奖章似
ovular	卵子的
extrasolar	太阳系以外
superciliary	眉毛
tetanus	破伤风
swimathon	马拉松式的游泳比赛
formic	蚁
fear	恐怖
grubstreet	潦倒文人
phosphatic	磷酸盐的
reverberatory	反响的
runtish	矮小的
withering	使干枯的
mummy	干瘪的人
encouraging	奖励的
flowage	流出
transmountain	穿过山
orthodox	保守的
bullate	肿胀的
coat	外套
blacksmith	铁匠
serotype	按血清型分类
ambagious	迂曲
unlawfully	不正当
asphaltum	沥青
hiding	隐藏之事
ramayana	罗摩传
most	最多
freeform	形式自由
unaspiring	无志气
ckd	完全拆开
soluble	可溶解
paleosol	古土壤
aboveboard	光明正大
lightness	灵活
canicular	酷暑期
polemical	辩论术
defibrillator	去纤颤器
compulsory	义务的
swim	旋转
rigorous	严峻的
feudalistic	封建性
diminishable	可削弱的
glasshouse	玻璃厂
nickelic	含三价镍的
trireme	三层桨座之战船
antifungal	杀真菌的
literarycritical	文学批评的
convocation	毕业同学会
immolate	献出
fernanda	费尔南达
cqd	danger
congregationalist	公理会之教友
armada	舰队
triphyllous	具三叶
unspliced	非绞接的
tetraethyl	四乙基的
hereto	到此为止
ka	知识获取
hugely	非常
merienda	午后点心
fluty	柔软清澈的声音
latency	潜伏物
purlieu	常去的地方
coxal	腰节
antirachitic	治疗佝偻症的
tail	后面来
labile	不安定
around	周围
philippopolis	菲利波波利
tail	排的长队
gastroenteric	胃肠的
underfocus	欠聚焦
daggerboard	活动披水板
aimlessly	漫无目的
changeless	不变
foreignism	外国习俗
complete	全部
seedy	结籽
benedictive	祈求式
roughage	粗粮
springal	小伙子
promulgator	广传者
braze	铜焊
eugeosyncline	优地槽
smudgy	脏污
suspend	吊
commensal	共餐
shortstop	速显液
fulvia	富尔维亚
meshugga	失常的
disubstituted	双取代的
dirty	肮脏
treasonable	背叛的
copeck	俄罗斯小铜板
comfortlessness	孤单
alfisol	淋溶土
quadplex	四倍
madwoman	疯女
wolverhampton	伍尔弗汉普顿
wean	小儿
acheron	黄泉
abidingly	不变
element	元件
occlusive	咬合的
egress	出口
monoacidic	一价的
disilicide	二矽化物
nibble	半位元组
masticate	咀嚼
dejeuner	早餐
west	西
retinoscope	检眼镜
rale	水泡音
prickle	戳
unexaggerated	未渲染的
fungi	真菌类
nov	十一月
nark	作线民
unimolecular	单分子
arenation	热砂浴
mollification	缓和
quaternity	四个一组
sweepstake	彩票
commissurotomy	连合部切开术
unnourishing	无营养的
corrasive	侵蚀
connectedness	连通性
corselet	胸衣
cantilena	轻快的抒情短歌或器乐曲
powerlifter	力量举重运动员
po	便壶
mudfat	肥壮的
painsworthy	值得花力气
nuits	努依红葡萄酒
oxazepam	去甲羟基安定
stockrider	骑马的牧牛或牧羊人
brightsome	明亮
demythologize	除去…………的神话色彩
firmly	稳固
levee	筑防洪堤于
martyr	烈士
chlamydeous	有花被的
lissome	敏捷
inspirational	给予灵感的
corps	团
constantly	不变地
slack	淡季
scrubby	矮小的
apriorism	演绎之推论
beckoning	令人心动的
dungy	令人作呕的
screwy	怪僻的
errand	差使
reprofile	给……新的外表
heel	跟部
donetsk	顿涅茨克
lawing	诉讼
konfyt	水果糖
nativism	先天论
horseman	养马的人
scribal	抄写
juggle	歪曲
gigglish	好咯咯笑的
incarnate	肉色的
hydroelectricity	水力电气
cementite	渗碳体
sixfold	有六部分的
umber	棕土的
enounce	发音清晰地读出
thin	瘦
heller	昔德国之小铜币
capercailzie	北欧产雷鸟之一种
laniate	撕裂
penial	阴茎的
clothbound	布面精装
scapular	肩胛
iaaf	Amateur
coequally	平等地
obediently	顺从地
pilgarlic	可怜虫
sinophile	爱好中国的
supernature	超自然界
preposition	前置词
watkins	沃特金斯
remarkable	值得注意
acrimonious	辛辣的
inwit	良知
raffinose	蜜三糖
dieb	胡狼
lunisolar	由于日月的引力
shirring	褶襞
ahum	低唱
phosphonium	膦
eardrum	耳膜
nonflying	不飞的
tenpenny	十便士
theophany	神的出现
piteous	可怜
dotty	薄弱
euglobulin	真球蛋白
reconvey	再载送
pungent	辛辣
suggestibility	可建议
colorfast	不褪色
tergant	显示出背部
steak	肉排
systemless	无体系
vesiculate	小泡状
unmarked	无记号
oceanographic	有关海洋学的
lay	放置
airer	干燥器
mux	multiplexer
intestinal	肠内的
zemindar	地主
webernesque	具有韦伯恩音乐特点
scunge	借
intertwist	搓合
defeat	失败
recognized	公认
bloodiness	残忍
scyphistoma	螅状幼体
iea	International
adenoids	扁桃腺肥大
capitulary	牧师会
casteless	不属于任何阶级
isopycnosis	等皱缩
inodorous	无气味
housebound	不能离家
apophthegm	箴言
semiglazed	具半光泽
sobering	使冷静
tumble	跌倒
discredit	不信
help	招待
paradoctor	伞降医生
rostella	的复数
compliable	依从
storeroom	库房
mylonite	糜棱岩
samely	千篇一律的
goddamnit	该死!
conjuration	魔法
binocs	=binocle
germiston	杰米斯顿
andradite	钙铁榴石
swede	瑞典人
dona	小姐
hallucinatory	幻觉
unwind	伸直
amaryllidaceous	属石蒜科的
nameless	无名的
chat	聊天
treat	论述
burst	爆裂
roquelaure	男用齐膝外套
wain	北斗七星
clownage	小丑之行为或工作
pone	玉米饼
protonema	原丝体
latvian	拉脱维亚语的
muscleless	无力的
injudicial	浅薄的
sanman	垃圾清洁工
piedmontite	红帘石
accurately	精确地
form	构成
deutoplasm	卵滋养质
andrology	男科学
nicety	准确
desultory	断断续续
bloom	花
huffish	傲慢的
tinfoil	锡箔的
hodoscope	描迹仪
gainless	毫无进展的
achievable	做得成
laconically	简洁地
chyle	乳糜
nearctic	新北区
overcrust	用外壳覆盖
narrow	狭窄
rio	=Rio
ctenidium	栉鳃
hospitalman	海军医务兵
nausea	反胃
trews	紧身格子呢绒裤
quittance	报答
unreserved	坦白
alexbow	弓形破冰扫冰装置
acetyl	醋酸基
diplophase	二倍期
ravenous	渴望的
rakata	腊卡塔火山(即喀拉喀托火山
hyperspecialization	=overspecialization
platelet	小板
frightfully	非常地
placidly	平稳地
wishfully	渴望地
scs	Conservation
shank	胫
rack	使痛苦
discriminatory	有差别的
bratwurst	德国式小香肠
artiste	技艺家
endlong	全长
adumbral	成荫
skint	身无分文
bonkers	疯狂的
smear	涂片
unphilosophical	非哲学的
salishan	萨利希语组
formulation	作简洁陈述
spiccato	用跳弓弹奏的
cockeye	喝醉
genevan	日内瓦的
blocking	舞台调度
unsanctioned	未通过
geostationary	与地球的相对位置不变
constantsa	康斯坦萨
necrobiosis	渐进性坏死
bronx	布朗克斯
sublapsarian	=infralapsarian
feverish	发烧的
vendible	可销售物
karstification	喀斯特作用
umbilicate	中间凹的
sound	发出声音
irish	爱尔兰
pernoctate	通宵祷告
overrun	蹂躏
bear	负担
wakefully	提高警觉
fifthly	第五
hag	魔女
dematerialize	消失
tardigrade	缓慢的
pastorally	牧歌般
pterylography	鸟羽分布描述
miniature	缩图
idle	不做事
nop	otherwise
emancipationist	解放主义者
upstage	自负
sabrecut	被砍的伤口
chancellor	大臣
phytobenthon	水底植物
valorously	勇敢
moil	骚动
misconception	误解
unrepulsive	不可憎的
irisated	虹彩
visitor	游客
stoup	酒壶
karateka	空手道专家
trough	饲料槽
lunar	月亮的
tower	塔
cavern	洞窟
complaisant	彬彬有礼的
dodecagonal	十二角形
cephalometer	头部测量器
manstealing	诱拐
russian	俄国人的
decoy	诱骗
furnisher	供给者
vicissitudinous	有变化
slurp	啜食
emprise	壮举
onlay	裱贴
lilliputian	小人国居民的
tully	塔利
strained	紧张的
antilabor	反工会的
surat	苏拉特
airport	小型民用机场
fissile	易分裂的
leeangle	L形尖头粗木棒
pop	热门
graveness	认真
ration	定量配给
wildfire	磷火
episcopalian	主教制
glum	阴沉的
mightily	强烈地
reeducation	再教育
mesmeric	催眠术
jerk	性情古怪的人
shoebill	鲸头鹳
weedicide	除草剂
unvoiced	无声
oxidizable	可氧化
ringing	响声
evenminded	平静
careerism	追求名利
telecomputing	远程信息处理
soilless	不用泥土
chemotherapy	化学疗法
narcissistic	自我陶醉
workability	可使用性
republican	共和主义的
dyslogy	贬抑
ligan	=lagan
automatism	自动化
phytopathogen	植物病原体
rooted	确立
brokerage	经纪人之业务
venom	怨恨
mario	马里奥
unfurl	使旗招展
prebind	加固装订
qualmish	似要作呕的
undone	破灭的
fingerprint	手印
wisdom	贤人
giro	一种早期直升飞机
methodology	方法学
cyberculture	电脑化影响
cyclopaedic	渊博
overmark	给……打分过宽
nondrinking	戒酒
taberdar	牛津大学女王学院奖学金学生
fandom	运动迷
homebody	喜欢在家消遣的男人
eviscerate	凸出
nazarite	拿撒勒人
maglemosean	=Maglemosian
prevail	流行
repleviable	可发还
fake	赝造
nonrated	不列等级
lamington	巧克力椰丝方块蛋糕
adjuster	调节器
isogeneic	同基因的
buddy	伙伴
capacitivity	电容率
sadu	圣人
liveried	穿制服的
despotic	专制
spotless	没有污点
rectificative	矫正的
foundation	基础
armorbearer	武士的扈从
preatmospheric	大气形成前
arthrodial	摩动关节的
imperceptibility	细微
meniscoid	新月形
history	历史学
planet	行星
thiophenol	苯硫酚
unscrupulously	无道德原则
dart	飞快的动作
ellipsis	省略符号
unmilked	未挤奶的
rasc	Royal
administration	/网络管理
cryptogamous	隐花
counteropening	相对切口
drearily	厌倦
elicit	抽出
embarment	囚禁
cod	货到付款
gaucho	牧人
drone	低沉地说出
glyptics	宝石雕刻术
brocaded	穿锦缎
capitulary	牧师会会员
spread	摆
gimbalsring	=gimbal
irreproducible	不能繁殖
mohammedan	伊斯兰教徒
theomania	宗教狂
transilient	跳跃的
morphia	吗啡
kindling	点燃
ordinant	指示的
neglect	忽视
dilantin	苯妥英纳
dab	轻擦
average	买进
puffy	气喘吁吁
chapped	裂开
frailty	虚弱
humic	腐殖
immigrant	移来的
surrealistic	超现实主义
mainliner	主干线列车
wood	树木
briskly	活泼
exopathic	外因病
masterman	家长
romance	风流韵事
hackle	锯齿形
aqaba	亚喀巴
usher	展示
barytic	重土的
preterite	过去时态
redeemable	可收回
remoulade	加料的蛋黄酱
unsightly	不悦目的
darshan	有德
extrovertish	外向者
slowish	速度较慢的
rectifiable	可矫正的
unpitiful	无恻隐之心
decreasingly	渐减
insertion	插入
jigsaw	竖锯
unpopular	不流行的
berascal	骂某人是流氓
combatant	战斗的
viyella	维耶勒法兰绒
pie	馅饼
sound	可靠的
leechcraft	医学
falsies	假乳房
profile	剖面
carcinectomy	癌切除术
pleading	辩论
rebound	回弹
harmoniser	=harmonizer
teg	二岁羊
ricin	篦麻毒素
loose	开火
northern	北方
overextend	过分扩展
qp	pawn
gayer	快乐的
torsibility	耐扭力
actionless	静止不动的
chaeta	刚毛
cynocephalous	似犬面的
garage	放入车库
heteromorphy	=heteromorphism
irreclaimable	不能开垦的
drastic	激烈
prograde	与其他天体作同方向运行的
bilbao	毕尔巴鄂
catadioptric	兼反射光及折射光的
spread	酒席
syphiloid	梅毒状
fzs	Zoological
euphuist	用华丽的文体书写的人
hanefiyeh	洗沐喷泉
powerfully	强烈地
countermine	反地道
cocket	海关通行证
jambeau	胫甲
gingerly	小心翼翼地
cerebrate	思考
reinsurance	再保险金额
dominant	占优势
fragile	脆的
imbibition	吸取
gaited	某种步态的
digs	寓所
afore	在前
linewalker	护管道工
puberal	发育期
foldboat	折叠舟
warp	偏见
lez	女同性恋者
mixture	混合剂
eluvium	因风吹积的细砂土
radix	基数
satiation	厌腻
daffydowndilly	=daffodil
aauw	American
magnetofluidmechanic	[用作单的
radiophone	无线电话
jayvee	大学运动队第二队
majlis	议会
bezzant	=bezant
histographically	组织论
gladius	古罗马军队的短剑
shiah	什叶派
creditor	债权人
osfcw	of
compilatory	编辑的
prolongate	延长
habitability	可居住
terbia	氧化铽
prima	第一
quadrille	四人用四十张纸牌玩的牌戏
bronzy	青铜色的
incurvate	向内弯曲的
condensery	炼乳工厂
acoustic	有关声音的
pug	跟踪追寻
unvexed	不受干扰的
underclothed	穿着不暖
overtype'	NULL)
balkan	巴尔干半岛
postorbital	眼窝后部
solaceful	充满慰藉
beanpod	豆荚
acritical	不危险的
dexamethasone	氟美松
mazhabi	马扎比
conquerable	可征服
second	第二人
cardiocirculatory	心脏和循环系统
neonate	婴儿
upsurgence	=upsurge
effacement	抹消
mildness	温和
pucker	折叠
lamenting	悲伤的
unmanly	娇气的
cirrous	a
austerity	苦行
suprapersonal	超私人的
walkaway	轻易完成的事
hackneyed	常见
nationality	部落
capsulary	蒴状
wash	冲积物
tress	一绺头发
dialytic	透膜性的
ocellation	眼点
dantesque	但丁式
flatly	无力气地
ablepharous	没有眼睑
exploder	雷管
interlaced	交织的
share	一份
swallowtail	燕尾状物
wren	鹪鹩
theanthropic	把神性表现于人身的
indoors	在户内
shillingsworth	1先令钱能购买的数量
haloplankton	生长在盐质环境的浮游生物
fishkill	鱼殇
multiuser	多用户
antacid	中和酸性的
limited	狭窄
submicron	亚微细粒的
brambly	荆棘多的
washy	稀薄
caucasian	高加索的
silvicolous	居住在森林中的
yardman	调度员
leave	许可
dormantpartner	股东
glaswegian	市民
brittle	易碎的
praxis	现实
pheidippides	费迪皮迪兹
mythicism	神话的解释
tpi	Planning
inarticulately	难以表达地
logical	合乎逻辑
steady	稳固的
shvartze	=schvartze
ridiculously	可笑
algology	藻类学
twinkling	闪亮的
duchess	公爵夫人
breathless	停止呼吸
mankind	男性
baric	钡
vladimirite	针水砷钙石
dreamily	朦胧地
finical	过分注意
ably	巧妙地
yirr	咆哮
xylem	木质部
silvichemical	从树木中提炼的化学物质
autofocus	自动聚集的
acarpelous	无心皮
timbrel	小手鼓
encouragement	鼓励
shokku	轰动事件
apopetalous	离生花瓣
paperhanger	裱糊工人
huffy	发怒
equal	匹敌
fruitcake	掺有干果的糕饼
boorish	粗鄙
equiprobable	等概率的
hotel	旅馆
genuine	真正
antrustion	中世纪法兰克国王的防卫队
snuffling	假装虔诚的
cashmere	开士米织物
glamor	迷惑
sidewise	横斜的
finalist	参加决赛的选手
multidimensional	多面
humic	从腐殖质中提取
nastily	污秽地
edificatory	启迪
coccidiosis	球虫病
expenditure	支出
skibobbing	连橇运动
commanding	居高临下
ruler	划线的人
puppetoon	木偶片
ablactation	断奶
diapason	和谐
crankily	古怪
fleshy	丰满的
alkoran	可兰经
unsung	未在诗歌中歌颂过的
philippic	猛烈的抨击
kingdom	天国
shnaps	=schnapps
fellowless	没有伙伴
cherubic	天使的
uno	Nations
procural	实现
delighted	快乐
gruesome	令人厌恶
alternate	交替的
usis	United
louden	变响亮
leda	勒达
ingratiate	使迎合
capacity	接受力
railhead	尽头
terminative	结尾的
thiochrome	脱氢硫胺
anemometer	风力计
bedroom	卧室
opiology	鸦片学
sobeit	倘使
citizen	公民
allergy	敏感症
simper	假笑
felted	用毡覆盖
solstitial	至
cordis	心脏的
chiastic	交错法的
tourmalin	电气石
grungy	脏
ingratiatory	讨好
ips	每秒英寸数
worthily	正当
subcontrariety	小反对关系
ledgy	有暗礁的
untasted	未被尝过的
soluble	可溶解的
suffice	使满足
flaxseed	亚麻子
autogenesis	自发发生说
mores	民德
contain	可被……除尽
laingian	兰恩
persona	角色
try	尝试
maronite	马龙派教徒
co	central
wobbly	歪斜
gaycat	新流浪人
established	已制定
addible	可添加的
tilt	翘起
echinodermatous	棘皮类
pussycat	有毛的柔软东西
sjc	Court最高法院
diphthongise	=diphthongize
sociocracy	全民政治
posterolateral	后外侧
razzle	喧闹
triumvirate	三头政治
lactam	乳胺
silviculture	造林术
pediatrician	儿科医师
wfd	World
uruguayan	乌拉圭人
regular	有秩序的
driftwood	无用的人
physoclistous	闭鳔的
kosher	犹太教所规定允许
hyperoxide	过氧化物
lst	Standard
reaggregate	使重新积聚
incognito	隐名埋姓
hopefully	有前途
unsensible	无感觉的
expansionism	膨胀主义
myob	your
polygenesis	多源发生说
rusty	生锈
sneakingly	偷偷
nutate	俯垂
europium	铕
in	在……之内
venally	以权谋私
sprang	spring的过去式
unaffectionate	没有感情
mussulman	伊斯兰教徒的
fixer	毒贩子
pop	流行乐曲
inhabitiveness	爱家
uncontemplated	意想不到的
pettifogger	讼棍
infinitesimal	无穷小
wildfire	古时攻打敌船所用的燃料剂
honorific	敬语
beeper	能发出哔哔声音的仪器
bastardly	庶生
unlike	不同的
unexploded	未爆炸
surveyorship	测量员的地位或职务
antineutrino	反中微子
palace	宫殿
throne	君主
irreplaceable	不能调换
fillet	鱼片
necropolis	大墓地
guano	鱼肥料
victualer	供应食物者
whom	谁
imperfectness	不完善
pulchritudinous	标致的
solstitial	冬至的
viaduct	间道
nobleite	四水硼钙石
recital	独唱会
clemency	仁慈
metalloenzyme	金属酶
hyperphysical	超肉体的
recognizant	认识
frigg	弗丽嘉
vexillar	旗瓣
toft	宅
whereinto	进入哪个地方
tattered	破烂
fie	咄!呸!
spasmodical	痉挛的
wrongly	不正当地
plop	扑通落下
yesman	好好先生
sublime	崇高的
radialized	放射的
witty	诙谐
soberize	使持重
hackneyed	不新奇的
hackbut	一种老式手枪
amidah	犹太教的一种礼拜仪式
ruminatively	沉思默想
horsey	似马
wifely	妻
visuomotor	视觉眼肌运动
pop	发出爆裂声
baton	警棍
actuarial	保险精算的
bestial	残忍
ties	绑
glamorous	富有魅力的
calculated	适合的
plasmodium	变形体
circulative	循环的
bulge	膨胀
westabout	向西
countersea	逆浪
rockbound	被岩石包围的
trowel	用泥铲铲
legitimacy	合法
philanthropist	慈善家
freebooting	强盗行为
anticolonial	反殖民主义
choragus	合唱团之指挥
equilibria	均衡
spun	纺成
lawrentian	劳伦斯的
luluabourg	卢卢阿布尔(扎伊尔中南部城市卡南加
vittoria	维特多利亚
anglesite	硫酸铅矿
antiresonance	反共振
visuosensory	视觉的
solo	单独的
hospitably	招待周到地
wrb	Board
brim	满溢
acidic	酸性
tragicomedy	悲喜剧
seraphic	纯洁
vicara	维卡拉人造毛
civilized	有礼的
barracks	兵营
ommiad	=Omayyad
usga	Golf
sinitic	中国
aspirant	上进
tractably	温顺地
pinworm	一种寄生虫
downfield	在前场
prelexical	词前成分
sarcomere	肌节
bonne	女仆
polymolecular	多分子的
gym	体操
inscrutability	不能预测
enneastylos	正面有九根柱子的建筑
enforce	坚持
aggregative	集合的
unnatural	不自然
deice	除冰
sirtaki	瑟塔基舞
wilkes	威尔克斯地
angulation	有角的部位
figurehead	装饰船头的雕像
epizootiology	动物流行病学
piddle	鬼混
straddle	跨骑
winterly	冬天的
counterproductive	反生产
chillon	夏兰
rhizopodan	似根足虫纲动物
cytotoxic	细胞毒素
muff	失败
promisor	契约者
anglican	英国国教徒
unrazored	未剃过
utilitarian	功利
steerage	士官的二等室
rubdown	磨平
eudiometer	测气管
wide	张大
pelagian	远洋的
solderable	可软焊的
matronly	安祥的
deliberate	商讨
insinuate	使逐步而巧妙地取
australian	澳大利亚人
bulbiferous	生球根
james	詹姆士
setiferous	具刚毛
severity	严重
nondrinking	不喝酒
tif	Format
telegoniometer	遥测角计
transpositive	变换
unliving	无生命的
natsopa	National
harquebuss	火绳枪
shopfront	店面
foretoken	成为……之预兆
pasteurism	巴氏狂犬病预防接种法
drive	推进力
tubicolous	管栖
ghostdom	冥界
recto	纸张的正面
deflationary	物价低廉
gustav	Gustavus
scurvy	坏血病
uropod	尾足
tissular	组织
marcheshvan	=Heshvan
dmso	dimethylsulphoxide
insufflator	吹入器
longan	龙眼
offering	提供
president	会长
cuddlesome	令人想拥抱的
cloudward	朝着云
incestuous	乱伦的
hombre	男人
catenate	连接
thence	从此
shock	使震动
etymological	根据语源学的
equal	平静
kindly	和善
unequalable	比不上
homebuilt	自制的
deadsville	沉闷
splash	溅
corrodent	腐蚀的
spritz	细的喷流
actinomycotic	放射菌病
refusable	可拒绝
ostraca	ostracon
unfading	永不辜负期望的
intercollegiate	学院间的
warmish	稍为温暖的
spongiopiline	海绵毯
nighted	黑暗像夜的
burnable	燃烧
anuclear	无核的
bear	忍受
tortile	扭转
doing	行为
creasy	皱纹多的
untense	使放松
binding	装订
pdq	立刻
amimeche	ofMechanical
apiculus	小尖端
monticulate	有小山冈的
lubricious	不稳定的
stepped	行走
gameland	狩猎区
townee	镇民
unobserved	没有观察到的
antiapartheid	反种族隔离的
treat	请客
dav	Veterans
lithophytic	岩表植物的
downside	下降趋势
nondairy	非乳制的
epode	长短句交替的古代抒情诗体
random	胡乱地
faience	精巧彩色陶器
denazify	解除纳粹制度
kinase	致活酶
gravitation	引力作用
reiterant	反复的
pleximeter	叩诊板
protest	拒付
runless	无得分
belike	恐怕
pop	电子邮件协议
distrait	心不在焉
urethrotomy	尿道切开术
flak	高射炮火
democratic	民主政体
drecky	低劣
semibarbarian	半野蛮的
brinded	有斑纹的
essentic	有表情的
twine	织
sulcate	有槽的
undp	United
parageusia	味觉异常
crimped	起皱褶的
beneficial	有益的
ragamuffin	衣裳褴褛的而又肮脏的人
efflorescent	开花的
votary	信仰者
shuddering	震动
presentative	表象
encouraged	被鼓励的
stand	位于
hand	插手
domo	"笃么"士
neolith	新石器时代的石器
mayoralty	市长职位
weakliness	虚弱
buddhism	佛教
pediform	脚形
reconnaissance	搜索
courthouse	郡政府所在地
tackify	使有黏性
heatproof	抗热
succulently	有兴趣
degradation	退化
crmp	Royal
dumpy	粗短的
grutch	勉强地准许
ultraclean	特净的
diastasis	脱骱
nescient	无学
safekeeping	保护
indeterministic	非命运论者
rhodora	杜鹃之一种
carter	驾驶货车的人
intolerability	无法忍受
actualistic	现实主义
homebred	不懂世故
bastinado	打脚掌
caucasus	高加索山脉
vj	电视综艺节目主持人
brownstone	富有阶级的
gorgonia	柳珊瑚
mind	意见
ursine	熊的
trencher	有关膳食
pacesetting	定步速的
dumb	哑的
campanology	鸣钟术
recrimination	反责
hoot	嘲骂声
demivolt	马前足抬起的半转弯
inertion	迟钝
noway	一点……也不
spiffing	漂亮
intellectual	有智力的
state	政府
saltate	跳舞
unstiffen	使容易弯曲
belated	迟来的
sjambok	粗皮鞭
unmanliness	怯懦
olfactometer	嗅觉测量器
cartage	货车运费
devalorize	使减价
loan	贷款
costean	掘井勘探
elaioplast	造油体
urban	城市
sleeveless	无袖
psg	platoon
centrally	在中央
yeanling	小绵羊
dittograph	重书写
cantonization	区划化
thrasonical	沉重
electric	电
ashur	最初的首都
susceptivity	感受性
rubral	脑红核
censoriously	吹求疵
tricel	三醋酯纤维
panic	没有理由
mariticide	杀夫的人
xerothermic	适于干热环境
globeflower	金梅草属植物
curd	凝块
brachydactyl	短趾
variety	变化
mill	磨坊
condonation	赎罪
labial	嘴唇
svga	Array
triangular	三角形
ingenious	机灵
sneaky	卑鄙的
plaid	格子花呢
abcd	Accelerated
bipod	两脚台
undersong	伴唱歌
occidentally	西方
impoliticly	失策
speciate	形成物种
parvus	小
decline	下垂
washed	洗过
crackbrain	疯子
limonitic	俗褐铁矿的
obligatory	义不容辞
crustaceous	硬皮的
feces	渣滓
levantine	为特定的人举行的招待会
outroar	咆哮声音高于
condemned	被责难
remove	移交
legantine	教宗使节的
upset	倾覆
mizzen	后桅
hydroxy	羟基
distilland	被蒸馏物
garage	修车厂
peculiar	特权
whacking	巨大的
deflation	物价低廉
bottom	尽头
heatstroke	中暑
sclav	斯拉夫人的
sowntown	商业区
sweetback	情夫
dexie	右旋苯异丙胺药片
leasehold	租赁期
schnook	迟钝的人
interstitial	空隙
sneeringly	嘲笑
fount	泉
vociferance	喧嚷
alternant	交互的
amplexicaul	抱茎
wolframium	=tungsten
looie	少尉
raggedness	破烂
cruciate	十字形的
coccidology	介壳虫学
thin	细
wallsend	沃尔森德
socialize	使社会主义化
reversionary	倒退的
sap	笨人
immure	禁闭
absorption	吸收
bulbous	球根状的
metalware	金属器皿
pregnable	可受孕的
sunken	凹陷
labionasal	唇鼻音的
ihp	indicated
slade	Artists
flickering	一闪一闪的
disallowable	可拒绝的
volute	涡螺
counterweight	平衡物
bimillennial	两千周年
ooze	软泥
semiotic	症状的
emulable	可仿效
recollectedness	镇定
nobble	诈骗
cuckold	有不贞妻子的男人
undervalue	低估
fountainous	泉源的
hoggin	含沙碎石
manganese	锰
afc	A
cottier	佃农
wrapper	包装纸
strafe	猛烈炮轰
squitch	匍匐冰草
integrand	被积函数
qbasic	Qbasic语言
paediatric	儿科医学的
shift	移转
canyon	溪谷
omicron	字
passee	已过盛年
loudly	大声地
catholic	天主教
inflictable	可处的
rumina	的复数
anhydration	脱水
faa	Aviation
gamophyllous	叶子相连
catboat	独桅艇
moonshiny	月照似的
pronephros	前肾
pronucleus	生殖核
pythonic	神谕的
ephemeral	短暂的
physician	医师
longtime	长时间
phonomania	杀人狂
zygote	受精卵
flack	对空炮火
nce	New
grisliness	厉害的
besmear	弄脏
evenness	平等
ana	名言集
schoolcraft	学校教的知识
tanglesome	复杂的
marsupial	有袋动物
chromogenic	发色的
excurved	往外弯曲的
ipecac	吐根树
fijian	斐济语的
edifying	有教训意味
favorable	赞许的
agonic	不成角的
gramary	魔法
sensually	官能
polocyte	=polar
eyedropper	点眼药器
trial	审讯
centennial	一百年
aviette	小型滑翔机
barred	隔绝
neophilia	对新事物的强烈兴趣
coincident	巧合
orchis	兰花
fleabane	飞蓬
agname	绰号
longton	Hall朗顿瓷
bowed	弯如弓的
promptive	推动
maldives	马尔代夫
chipper	使高兴起来
pedaguese	=pedagese
veritas	真实
header	首领
pantological	人类全部知识
neighborite	氟镁钠石
clasp	紧握
unmotherly	不像母亲的
tumultuate	使骚乱
antagonise	使敌对
effulge	照耀
pettifoggery	欺瞒
ciphony	密码电话学
examinationism	主张考试制度者
proclinate	向前的
reentrant	再进去
resume	再用
sponsorial	保证人的
pouch	使成袋状
skywriting	空中文字
derivation	语源
unspeakable	不能以言语表达
vdr	Recorder
cfc	氟氯化碳
punctuate	加标点
interpenetrate	互相贯通
unacquirable	学不到
iterant	重复的
canvasser	兜揽生意的人
pontifical	主教的
sugar	糖
chromatist	色彩学家
satisfy	满意
sterling	纯银制的
papal	教皇制度的
charity	慈善团体
crocean	克罗齐精神哲学
strati	stratus
aggressively	侵略地
unrazored	未修剪过的
felicitous	可喜的
scuttle	毁坏
flatter	阿谀
autotext	自动图文集
wampish	前后摇摆
jazz	喧吵
trinal	三倍的
susceptive	感受性强的
above	上述的
crusado	有十字架花样的银币
apiarist	养蜂家
sheepman	牧羊业者
pecuniarily	在金钱上
notionate	倔强
beravement	丧事
diagonal	斜的
phytotoxicity	危害植物的毒性
raft	筏运
lonely	偏僻的
expertly	熟练地
tapper	轻敲者
purulence	流脓
astrometer	天体光度计
geodimeter	光电测距仪
minnie	女人名
hypophoria	下隐斜视
anonymous	匿名的
bleary	朦胧
louie	=looie
pawner	交当人
unplagued	未受折磨
suramin	苏拉明
boilover	爆冷门的结果
body	肉体
kudzu	野葛
malarkey	胡说
recently	最近
blowout	喷出
transpersonal	超越个人
ligamental	韧带
whopping	庞大
color	粉饰
mundic	=pyrites
canulate	管状
mynah	八哥
vigneron	葡萄种植人
deliverly	灵巧
eisa	Industry
icrp	on
teriyaki	红烧
tactful	圆滑
fawny	近浅黄褐色
byzantine	拜占庭式
macrocytosis	大红细胞症
lyra	天琴座
oos	Of
amplectant	攀附
euchre	一种纸牌玩法
tamely	没骨气
appulse	撞击
unionization	结合
hermetic	与外界隔绝
kayak	皮船
service	服务性工作
pathogen	病菌
proruption	突出
anthropological	人类学的
pronominal	代名词
fusion	熔接
hyoid	舌骨
filmmaking	制片
lyophiled	用低压冻干法取得的
limitary	限制的
optically	眼睛地
strip	剥
munitionment	军需品
accessible	易受影响
flare	闪光
strife	斗争
hetero	异性恋的
scummy	浮渣般的
roseate	玫瑰色的
unexacting	容易的
particularism	特殊神宠论
tridigitate	有三趾
unproposed	未提议
theory	原理
interspatial	层际空间的
indispensable	不可缺少之物
pharyngoscopy	咽镜检查
community	团体
having	持有
sexism	男性至上主义
paracusis	听觉倒错
calx	金属灰
wisdom	至理名言
papillary	乳突的
hankerchief	手帕
blinding	使眩目
uxoriously	顺从妻子
sicko	道德败坏的人
fond	喜爱的
sismogram	=seismogram
circe	瑟茜
nontelevised	不看电视
existential	有关存在
stalagmometer	滴重计
katzenjammer	滑稽的模仿
unobjectionable	不会招致反对
aftergrass	割后再生的草
cuddly	令人想拥抱的
conferrence	授予
gadgety	小配件
ararat	阿勒山
neurogram	印迹
rugged	高低不平的
mouse	鼠
rimless	无边
analogically	类推地
inventor	发明家
algous	藻类
sententious	简洁
pinko	左倾分子
undp	联合国开发计划署
matey	友好的
unthanked	未受答谢的
barquentine	三桅船
propagandism	宣传
sawder	恭维
jiggers	注意
semiscientific	半科学的
bronchoscope	气管镜
ependymal	室管膜的
acquired	已获得的
reive	掠夺
uniparental	单性生殖
outsang	的过去式
noncarcinogenic	不促成癌
orient	灿烂的
tmo	money
dardic	达尔德语
pappy	半流质
scotomization	精神"盲点"形成
bomblet	小炸弹
narcolept	发作性睡病患者
physiognomy	相面术
unbiased	没有偏见
belike	或许
schweiz	=Switzerland
elevatory	向上举
circumfusion	围绕
finical	过分讲究的
inharmony	不和谐
unpliant	不柔顺的
depancreatize	截除胰腺
pneumatograph	=pneumograph
silvester	西尔维斯特
atwitter	紧张
wasteweir	退水堰
unburned	未燃的
filtration	过滤
nephrology	肾脏学
californicate	以都市化和工业化毁坏的自然景色
labile	易发生变化
blunderingly	浮躁地
routine	常规
farmy	有农场
mulloway	石首鱼
unyieldingness	不屈服
dad	爹爹
bungaloid	平房式的
monothematic	单主题的
unfriendly	不友善
soppy	湿透
noninstallment	一次付清的
intertidal	高潮线与低潮线之间
hvar	aircraft
castaly	灵感的源泉
inseverably	不可分离地
bleaching	漂白法
septangular	七边形
uncontroverted	无可争辩的
melange	混色纱
absence	缺乏
counterpoise	平均
adream	做梦的
wisdom	智慧
interpolatory	插入的
bale	打包
mussulman	伊斯兰教徒
guiltless	无罪
listen	听从
sacchariferous	含糖的
iaz	inner
infauna	底内动物
beverage	饮料
yokelish	乡下人
pacesetting	领头的
crazyweed	=locoweed
pythogenous	腐生
olg	Old
cashew	腰果
shareable	可分担的
eleemosynary	接受接济
underran	underrun之过去式
glyceraldehyde	甘油醛
militant	积极从事或支持使用武力
falconiform	隼形目的
tupian	图皮语
glaringness	耀眼
lexan	莱克桑
langobardic	伦巴第语
leprophil	亲麻风病者
equalitarian	平均主义者
scraping	吝啬
digastric	二腹
quacksalver	骗子
rough	粗略
icu	unit
interpunction	标点符号
vegetative	植物的
querist	质问者
artificial	非原产地的
gaffer	老人
unharmful	无害
polycarpous	多心皮的
yokemate	同事
horsey	马
cylinder	圆柱体
null	无效
underslung	装于车轴之弹簧上的
participatory	供人分享
help	款待
remilitarization	重整军备
prenomen	=praenomen
sinless	无罪
colorimeter	色量计
jacinthe	淡橘红色
filemot	褐色的
rasc	皇家陆军补给与运输勤务队
interpandemic	流行病两次暴发之间
aplastic	成长不全
happenstantial	偶然发生的
molucan	摩鹿加人
hemmer	缝边者
acolyte	助手
crazed	疯狂的
insipidness	清淡
pelvimeter	骨盆测量器
nas	Network
technic	手法
groin	腹股沟
cornish	康沃尔人的
bedtiime	就寝时间
recessionary	衰退期的
northwesternmost	最西北
hydrosulfurous	连二亚硫酸
birdy	如鸟
gouge	用圆凿子削除
aslope	成斜坡的
malleable	可锻的
unclassical	非经典
olympiad	奥林匹克世界运动大会
assessor	估税员
tapotement	轻叩式按摩法
peremptoriness	强制
receivable	可接受
zoophytology	植形动物学
desuetude	废止
starveling	饿瘦了的人
overfull	过多的
gadgety	小配件的
unpaired	无对手的
abridge	削减
commoner	有共用权者
rattling	活泼
dint	凹痕
microphyll	小型叶
ourari	=curare
inositol	肌糖
astonied	大吃一惊的
pulmotor	人工呼吸器
oneirology	梦学
cellulase	木纤维质酵素
minatory	威胁的
harmonious	和谐
exserviee	退役的
uscf	States
bowl	滚
poetics	诗法
yodization	=yotization
sting	针刺
orotund	响朗
bedload	泥沙等
radioscopy	放射线透视
planetary	行星的
inaccurate	不准确
abiogeny	自然发生论
philogynous	爱慕女子的
loose	放枪
subcontract	转包合同
slickness	巧妙
autoflare	自动拉平装置
dun	催讨
cracking	破裂
determinant	决定性的
triplication	三倍的东西
heterotrophic	不是自养
floriferous	花盛开
deprecatory	不赞成
compandor	=compander
computative	推算
fireflooding	火驱
influence	感化
aal	ATM
dentistry	牙科
indescribability	不可名状
chordee	勃起性淋病
joint	生节
countershaft	副轴
nationhood	作为一个国家的地位
rhinal	鼻腔的
millennia	millennium的复数
underlay	衬垫物
fertility	多产
vhf	Frequency
prolegomenon	序论
recognise	认可
rendering	表现
distad	向远侧
swink	辛劳
haply	偶然
zigzag	成Z字形
luxate	使骨脱节
impotable	不能饮用
daftly	癫狂地
hormonal	荷尔蒙的
intolerant	偏狭的
cranky	任性
rct	Transport
bemuddle	混淆
leave	生叶
estimate	估计
bobette	博贝特
trousers	长裤
nyc	New
immetrical	无韵律的
wobble	摇晃
briton	大不列颠人
subterminal	几乎在末端
gom	Old
unabiding	短暂
comb	搜索
universal	宇宙的
rattlebrained	愚蠢多嘴
recover	重新获
underproduce	生产供不应求
stethoscope	用听诊器诊断
encyclopaedic	百科全书式的
totalitarianize	使极权主义化
vociferously	吵闹
buic	Backup
ruggedize	使耐用
inaudibly	不可闻
feudally	如封建
colostrum	初乳
lepidopterous	鳞翅类的
untread	折回
thundering	异乎寻常
superscript	写在上边的
unlearned	天然
biogeography	生物地理学
aerobody	轻于空气的飞行器
husky	像谷
munga	食物
transpire	蒸发
charry	炭
slack	疏忽
whirlybird	直升飞机
fire	炮火
reefer	大麻卷烟
exsertile	可突出的
memomotion	慢速摄影
dusky	微暗
lycian	利西亚人
sickly	苍白的
acarpous	无果实
acronical	日落时发生
daee	engineering
benedick	有妻室者
urticaceous	荨麻科植物的
sunfed	Fund
iaf	International
sublime	顶点
sasanian	=Sassanid
osteria	旅店
erective	直立
unexacting	容易
colza	菜种
levogyrate	左旋
overbought	超购
tzarina	沙皇皇后称号
unbelonging	不属于……
buirdly	强健的
encipher	译成密码
spurrier	马刺制造者
particulate	微粒的
cymling	一种白绿色扁圆之南瓜
undependable	不可信赖的
tritiate	使与氚混合
igneous	火成
gladsome	令人高兴
flutter	烦扰
commit	提交
eudipleural	两部对应的
ordinal	仪式书
uncarpeted	未铺地毯的
nacreous	有光彩
handle	买卖
pottage	浓汤
like	相似
carnivore	食肉类
london	伦敦
joggle	啮合
renew	使恢复
osfcw	Solid
invariablenes	恒定
tantalus	酒瓶架的一种
significs	语义学
aridity	干旱
expressly	清楚
sitting	孵卵
songlike	像歌
usmcr	States
productile	可拉长的
iamap	Meteorology
promethean	Prometheus
clubland	俱乐部街
unpliant	不易弯折
moistureproof	防潮的
anepigraphic	没有刻字
thereby	因此
kilchoanite	斜方硅钙石
capillary	毛细管
kbp	王翼象前兵
levity	轻浮
nucleolar	核仁
inhabitant	居民
unroyal	不是王室的
mailer	邮寄广告性印刷品
grandiloquent	夸张
influence	影响
rightly	恰当地
santir	萨恩蒂厄琴
fellow	同伴
incontinence	无节制
kirlian	基尔良的
interlacustrine	位于湖泊间的
untamable	不可驯养的
prediabetic	前驱糖尿病的
knuckleballer	不旋转球投手
oa	办公自动化
readily	欣然
inhumanly	无人情味
died	死亡
os	Operating
turgor	夸张
coercivity	矫顽性
atop	在顶上
ephemeron	蜉蝣
erring	做错事的
compere	主持人
cot	轻便小床
tetraonid	鸡形目禽鸟科
unbeliever	不信仰者
comparativist	=comparatist
fustigate	抨击
airily	轻盈地
antipyrine	安替比林
scum	被浮渣覆盖
hematoblastic	血小板的
nullipore	珊瑚藻
incalculable	不可计算
pokey	迟钝
peart	快活
luebke	Heinrich即Lubke
succumb	屈从
mopey	消沉
constabulary	警察
schlepp	携带
unclos	the
muzzleloading	前膛装填的
experimentalism	Ik9speri`mentElIzEm/
tidal	定时涨落
schoolman	学校教师
retinol	维生素A
climax	顶点
cervices	子宫颈
barren	空洞的
discursively	东拉西扯地
laudableness	值得赞赏
turner	体育协会会员
caricaturist	漫画家
washstand	脸盆架
way	途中
isodynamic	等磁力的
pretty	漂亮
sympathetic	有同情心的
rebec	三弦琴
adjustive	调节的
girth	腰身
wickedly	顽皮
cogently	中肯
postal	邮局的
chronicles	历代记
isotopes	同位素
complexity	复杂的事物
strain	应变
exploder	爆炸物
zootheism	动物崇拜
paladin	查理大帝
vietnamese	越南人的
lithographer	平版工
hydrochloric	盐酸
cinematographic	电影的
liturgiologist	礼拜仪式学家
teetertotter	玩跷跷板
enthral	迷惑
amaranthine	不凋谢
ringent	张开的
disrespect	不尊敬
iphone	Phone软件
space	空间
metalclad	铠装
flap	鼓翼而飞
collimator	瞄准仪
taler	德国的旧银币名
hoop	加箍于
academe	学会
bract	苞叶
millstream	水车用水流
confer	交换意见
dpt	diphtheria
irbm	range
archaize	用古体
soloist	独唱者
tribade	女子同性恋
wise	聪明的
exoteric	通俗
unbalanced	错乱的
monastical	出家的
usefulness	有用
plumate	具羽毛的
sorrowful	悲伤的
yaguarundi	=jaguarundi
mcp	pig
spr	Research心灵研究学会
chunnel	通道
cover	封面
moreen	波纹织物
riba	皇家建筑师协会
bedaze	令不知所措
kinkled	卷曲
rubescent	变红的
merogony	卵块发育
computerise	=computerize
anathematically	厌恶
erythropsin	视紫质
extrahazardous	危险性特别大
homoplasy	同形
tell	泄密
alloimmune	同种免疫的
samely	千篇一律
inturned	性格内向的
indention	凹痕
revulse	使极其厌恶
anhui	安徽
togoland	多哥兰(西非一地区
bloated	浮肿的
pothead	瘾君子
peaked	尖
antiforeign	排外的
cpaffc	中国人民对外友好协会
colossi	阿波罗神之巨像
explanation	辩解
anopia	无眼
spiritist	招魂术者
forcible	有说服力的
foliiform	叶状的
restrictive	限制性的
ricard	茴香调味开胃酒
liquefactive	液化的
spiritualism	唯心论
lone	独立
phelloderm	绿皮层
entomophily	虫媒
hemiglobin	变性血红素
matted	无光泽的
rechoose	再挑选
scabiosa	山萝卜属植物的一种
stadia	视距仪器
uncovered	无盖的
unduplicated	无法模拟的
demisemi	四分之一的
humble	谦逊
ptolemaism	天动说
vaporware	雾件
administrant	管理
ukulele	夏威夷的四弦琴
brandade	奶油烙鱼
gag	禁止
ghastliness	可怕
zymosis	发酵病
chemurgy	农业化工
ophthalmic	眼的
folksy	和气
microstomatous	小嘴
breathless	死的
coyly	羞怯
white	白色
testacean	贝壳类的
resinous	含树脂的
fremd	陌生
nodosity	多结节
diametrically	作为直径
header	报头
amebic	阿米巴的
factum	遗嘱的正式订立
monzonite	二长岩
capris	女用紧身裤
uppercase	大写字母盘
considering	考虑到
sterilize	杀菌
abbreviationist	提倡缩写字的人
throat	口子
recommendation	劝告
spackle	填泥料
injective	单射的
clypeiform	圆盾的
bennet	一种水杨梅
humiliatory	蒙羞
nonpathogenic	非病原的
shoaly	多浅滩
compassable	可绕的
iil	logic
rushing	旺盛的
sublimely	高尚地
vsam	Virtual
ruskinize	实践罗斯金的艺术信条
sedentary	土生的
fibrinous	纤维蛋白的
monstrous	畸形的
dispositioned	有某种性情
str	thermal
proteiform	易变形的
tomism	汤姆叔叔主义
staff	棒
boiler	锅炉
san	Storage
pulsator	搅拌器
divaricator	分叉物
sniffy	自命不凡的
leprosery	=leprosarium
utilitarian	实利的
gemel	双生的
educt	离析物
wonted	惯例的
atavistic	返祖性的
dustman	清洁工
offensively	不愉快地
amoy	厦门
whopper	弥天大谎
contradictious	吹毛求疵的
equipment	才能
rejuvenate	使恢复活力
contaminant	污染物
adsorbate	被吸附物
slidden	slide的过去分词
explanans	词的意义
chaste	有道德
uncultured	落后的
consenter	同意者
jostle	争夺
tetrastich	四行诗
quakerish	像贵格会教派的
cuboid	立方形
bittock	一点儿
explication	说明
chelonian	龟类
neuromuscular	神经肌肉的
causation	发生因果关系
terminative	结束
plated	镀金
terrine	沙锅
thermolabile	不耐热的
stellated	星状的
calipers	测径器
antiballistic	反弹道
koodoo	条纹羚羊
unprophetic	非预言
overperform	偏离剧本表演
hoofed	有蹄的
ashes	尸体
pinnated	翼
pli	pounds
hiaa	Insurance
cres	新月
sympathetic	容易感受的人
anticly	奇怪地
glaucoma	青光眼
stp	Tree
extinguish	偿清
constringe	压缩
belting	制带的材料
needlebook	插针垫
when	就在那个时候
belgravia	其生活
animistic	万物有灵论的
syllabary	音节文字表
desexualize	阉割
raffish	名誉不好的
irresponsive	无反应的
dismoded	过时的
ailurophobia	惧猫症
onionskin	洋葱皮
stage	驿站
sucker	乳儿
oversee	监视
disorganized	无组织的
reclame	沽名钓誉
hyperbolize	用夸张法表达
bibliotics	笔迹鉴定学
trappy	艰险
whiting	白粉
endarterectomy	动脉内膜切除术
obtrude	打扰
decrepit	衰老
extraversive	=extroversive
proser	散文般的
fuze	保险丝
windbreak	防风林
delawyer	不需律师就可进行
tectosilicate	网硅酸盐
auralize	想象……的声音
whitepox	轻型天花
exility	纤细
pronate	将手掌转向下
prosopopoeia	拟人法
whim	奇想
inconveniently	不方便地
rawhide	用生牛皮鞭抽打
downhouse	美国南方的
obvious	明显
recollection	回想
labellum	唇瓣
telecommunication	satellite//5keIFn/
anomic	没有目
transformative	有改革能力
kilobaud	千波特
theater	剧场
unpeaceful	不和平的
sudanese	苏丹的
blandly	温和地
indolent	懒惰
cose	谈心
kumbaloi	beads
gambrel	踝关节
aurify	镀金
dramaturgy	演出法
jaded	疲倦不堪
wins	Windows
remit	免除
parergon	副业
marxist	马克思主义者
kennelmaster	养狗场管理员
antoine	安托万
reduced	减少
phosphoresce	发出磷光
unobjectionable	不惹人讨厌的
godless	不敬神
underprivilege	QndE5prIvIlIdV/
elginshire	埃尔金郡(即默里郡
auric	金的
ferrate	高铁酸盐
relume	重新照亮
fully	至少
unstatutable	不符合法令的
unbiblical	不按照的
subversion	颠覆
pid	比例积分微分
channelize	疏导
deathful	致命的
forced	被迫的
woomera	=womera
conceivable	可能的
aluminiferous	产铝的
word	话
untold	未透露
triphenylamine	三苯胺
virulent	有病毒
oppidan	城里人
fennelflower	黑种草
crus	似小腿或后腿形状的构造
precinct	界限
iatric	医药的
swimathon	长距离游泳比赛
stivy	塞满
routine	日常事务
floriate	用花叶装饰
unbrotherly	不友爱的
pully	具吸引力的
acescent	变酸
smart	敏捷
paint	画
tetraxial	有四个轴
cca	communication
candela	烛光
septemia	=septicaemia
underclothe	给……穿内衣
scanty	俭省的
frcp	the
fiduciary	基于信用的
assign	分配
vitamin	维生素
chainless	无链
pernoctate	熬夜
driveability	驾驶性能
alcor	北斗七星中的第五等星
troat	叫春声
sphenoid	蝶骨
inferrible	可推断
stolid	不易激动的
plute	富豪
flank	军队侧翼
overgarment	罩袍
cocaine	古柯碱
temperamentally	气质地
irritative	刺激性
dutiful	忠实
neolithic	新石器时代的
sonorously	响亮
coeliac	下腹的
ironbound	坚硬的
impairment	损伤
psychosomatic	受心理影响的
parsimonious	吝啬的
levanter	逃赌债者
disembodiment	脱离
repulse	反驳
ecofallow	土地生态休闲法
mirable	令人惊叹的
homonymous	同名的
obstreperous	喧嚣的
poor	贫穷的
flagellated	生有匍匐茎
laze	消磨
ocd	of
antitoxic	抗毒素
gowan	春白菊
excommunicable	可革出教会的
spiky	大钉似
ranine	舌尖以下部份的
vociferously	喊叫
chalybeate	含有铁质
queerly	奇怪地
spear	矛
vagabond	流浪
styracaceous	安息香料的
unwavering	不动摇的
lactescency	乳汁状
aerofoil	风板
autofocus	自动聚集
aconite	从乌头的根提炼出的强心止痛剂
affluent	富裕的
yamato	日本民族
thumbprint	个性特征
lay	世俗的
blame	过失
nephric	肾的
juggle	魔术
cenozoology	当代动物学
junky	吸毒者
fissure	裂缝
frondescent	多叶
headwear	吊索
nice	挑剔
acidimetry	酸量滴定法
fris	Frisian
serious	严肃
valiant	英勇
gory	血污
purin	嘌呤
beneficent	善行的
clasp	扣子
ferrotungsten	铁钨
nous	理性
roomily	广阔
ptfe	ethylene
sweetstuff	糖果
desterilize	解禁以供发行货币之用
intergalactic	银河间的
acellular	非细胞的
cansure	非难
excite	兴奋
reagency	反应力
neutral	无确定性质的
nira	Industrial
outscorn	以轻视制服
endothermal	吸热
cedrol	雪松脑
paraphrase	解释
corruptibility	堕落性
nllst	and
decubitus	卧姿
ungated	无门
residually	剩下地
enveigle	诱惑
occupational	职业的
tahsildar	税务员
adipocellulose	脂纤维素
devoid	全无的
intravital	发生于活体内
vasculitic	脉管炎
exceptionable	要不
concertino	小协奏曲
tacky	缺乏教养或风度
greyhound	灰狗
canorous	音乐般的
areologic	火星科学研究的
aulic	宫廷的
wesley	韦斯利
whistle	吹口哨
extra	额外
lipotropy	亲脂
duplicate	两倍的
frier	煎锅
reoccupy	再次出任
journal	航海日记
trecentist	十四世纪意大利文学家、美术家
osf	St
catacombs	陵寝
meshugga	失常
underpitch	低坡穹窿
irradiant	光辉的
spontaneously	自然
brow	眉毛
pubsy	酒馆的
metapsychical	心灵学
dunnage	日常用品
chime	一套发谐音的钟
stilly	默默地
bravissimo	Ⅰ
biangular	双角
wearily	无聊
schist	片岩
incentre	内切圆心
stormy	暴怒的
recover	恢复
educe	唤起
skyjacking	劫机
prosocial	忠实于既定社会道德准则
inn	旅馆
subgum	素什锦
redirection	重寄
unglue	拆开
temporal	时间的
earplug	耳塞
dysaesthesia	感觉不良
bathless	无浴室
astounding	令人惊骇
petard	攻城炸药箱
odontoid	齿状
veteran	老手
helcosis	溃疡形成
helpmeet	合作者
bedclothes	铺盖
frequency	周率
phosphatidyl	磷脂酰
filaceous	丝质的
quadrate	使适合
soligenous	由地面水流入造成
irrepressible	镇压不住的
foulmouthed	出言不逊的
pasta	意大利面制品
superdreadnought	超无畏级战舰
judaeophil	对犹太人友善
formic	蚁酸
following	其次
ultrabasic	超基性的
nitrification	氮饱和
foreigner	外地人
aggeus	=Haggai
larger	多量
capitulaitonist	投降者
fix	注视
feoff	授予封地
frenzied	狂乱
numbers	民数记
quadruply	四重地
archwise	拱廊似
specky	有瑕疵
fodgel	矮胖
vervet	东南非洲产之一种小猴
clampdown	压制
beslobber	使满身口涎
titillation	搔痒
ndis	Specification
encomiastic	赞颂的
mizz	=miz
diallel	双列
unconscious	无意识
upturned	朝上
undreaded	不被畏惧的
obfuscate	使模糊
lev	列弗
neutral	中立国的
insolvency	无力偿还
zooplankter	浮游动物
gey	可以的
boggy	沼泽多的
excommunicable	应革出教会
retzina	=retsina
xslt	XSL
edacious	贪婪
level	平坦的
eccentrically	反常
goitre	肿物
readout	读出器
photoinduced	光诱导的
break	暂停
upgrade	上升
onion	洋葱
humanity	人类
idahoan	爱达荷州人
wild	野蛮的
walk	行道
retrieval	恢复
extract	吸取
pietistic	虔信派
aero	飞机的
reintroduce	再提出
motley	杂色衣服
lace	缎带
or	或
registrar	登记员
tlo	全损险
alarmism	危言耸听
unselfishly	不自私地
rurales	墨西哥乡村骑警队
rhizotomy	神经根切断术
spool	所绕的数量
habitation	生活环境
deep	深奥的
anetic	弛缓的
undp	Nations
quinin	奎宁
them	她们
vaccine	疫苗的
hydroxytryptamine	=serotonin
iupap	Physics
vibriocidal	杀弧菌
gastraea	原肠动物
etcetera	以及其它
pyramidwise	成角锥形地
precise	精确的
contaminated	污染
cornball	似乡巴佬
chicana	女奇卡诺人
smoothness	平坦
keypunch	用打孔机打孔
bismillah	真主啊!
graphospasm	书写痉挛
gaul	高卢人
consequent	随之发生
egomaniac	极端利己主义者
quillet	搪塞
inescapably	逃不掉
ricebird	禾雀
advisability	明智
communally	社区
sarcastic	讽刺的
matting	席
cave	凹陷
poussette	环舞
hectoliter	百公升
unconvince	使不信服
choreatic	舞蹈症
unequally	不相等地
braze	用黄铜镀或制造
blobberlipped	嘴唇肥厚
infarcted	梗塞
ronggeng	龙根舞
chronicle	编年史
loco	疯子
sapient	聪明的
choking	透不过气来
kernelled	有核仁的
checkbox	检验栏
marblehearted	冷酷无情的
confirm	使巩固
dexterously	敏捷地
mezzo	适中的
latifundia	latifundium的复数
germinant	发芽的
charnel	似停尸房的
obscurity	朦胧
inobservantly	不注意地
ragger	恶作剧者
reputable	著名的
jacksonian	美国第七任总统杰克逊
antherozoid	隐花植物之游动精子
valor	勇猛
methodize	使有条理
cumulative	累积的
hunger	饥饿
dentolingual	齿舌音
newfoundlander	纽芬兰船
elegiac	挽歌
mingily	小气地
hendecasyllabic	十一音节的一行诗
swanskin	天鹅皮
southing	中天
appropriative	专用的
underhung	有突出下颚
lapsible	易变
exserviee	退伍
cilice	粗毛布
visitation	天罚
workalike	软件通用型
ogham	欧甘碑文
siamese	暹罗的
slub	轻捻
servo	伺服
imaginative	虚构的
tribophysics	摩擦物理学
pyroligneous	干馏木材而
peloria	反常整齐花
annunciate	通告
epigene	外成的
asbestus	石棉
impersonalism	非人格主义
philologize	研究语言文献
obstructive	妨碍的
lynch	私刑
teentsy	小小的
protopope	主教士
micromethod	微量法
naturalization	移入
pat	恰好
limited	有限的
lrv	roving
catamite	受鸡奸的男童
microbial	由细菌引起
curatory	管理人或监护人之团体
thecodontian	=thecodont
feel	试探
moronic	鲁钝的
scherzando	诙谐的
nondiscrimination	一视同仁
applicable	可适用
labial	唇的
manx	马恩岛人
indicial	表示
tortoiseshell	龟甲状
tentage	帐篷
counterblast	强硬的抗议
faculty	权力
taleteller	揭人隐私者
gasometric	气体定量分析
dos	磁盘操作系统
aid	帮助者
whomsoever	whoever的宾格
aspheric	非球面的
technically	技术上
rheogoniometry	流变测角法
terminally	末尾
gasthaus	酒店
infertile	贫瘠的
stub	烟蒂
nonrated	非军士级
gravy	肉汤
alphonso	阿方索
imagic	形象的
hindostan	=Hindustan
sylvester	西尔威斯特
bott	肤蝇的幼虫
withdrew	withdraw的过去式
vic	V字队形飞行
stallage	摆摊用
snooty	鄙视别人
encephalic	头的
cpsu	Soviet
clothback	布面书
hecatomb	大屠杀
tragical	悲剧性
bummer	乞讨者
genuflexion	跪拜
stroke	一笔
genitival	属格形的
gosplan	前苏联国家计划委员会
transformation	IFEnIst/
parody	拙劣模仿
stressable	可重读
recheat	召唤猎犬的号声
conclusive	决定性
scribal	抄写的
haemostatic	止血
padre	随军牧师
attestant	证明的
macabre	以死亡为主题
quaestor	刑事推事
m	……月后之同日
amort	濒于死亡的
unsolder	分离
explicitly	明白地
mugwump	酋长
aspuint	侧目
square	四方
hypothalami	hypothalamus
venerable	古老的
sponsor	主办
smart	潇洒
image	形象化的比喻
harmonist	对照研究家
hydrodynamics	流体力学
wreckful	造成失事的
squally	起风暴的
preglacial	冰河期前的
rudderless	无指导者
aerosol	烟雾剂
hydrogasification	临氢气化
snood	用发网束发
adoptionism	嗣子说
iatrogenic	因医生的治疗而引起
selectee	征召员
hatchel	麻梳
pitchman	摊贩
sacrifice	献祭
fluridizer	氟化剂
unglamorous	没有魅力
behindhand	落后
parlour	营业室
laval	像熔岩
seaquake	海震
quercine	栎树的
atmolyze	以微孔分气法分离
cabbage	卷心菜
upcast	向上的
soldierlike	有军人样
catechesis	口授经文教理
schmaltz	伤感主义
bloodshot	充血的
corresponsively	相当地
swash	泼水声
overdress	穿得太讲究
strangulate	勒死
love	爱
deadborn	死产
dietetics	营养学
pterosaur	翼龙
unsullied	清白的
unfirm	松散的
pithecanthropus	爪哇直立猿人
landowner	地主
refundable	可偿还
hippopotamus	河马
volubilate	缠绕的
sequential	结果
jade	碧玉
periodical	周期
deepfreeze	低温冷藏
minable	可开采的
fendillate	多处微裂
mesenchymatous	间叶细胞的
ludditish	勒德主义
weeknight	周日夜晚
contractible	会缩的
toddle	刚学走步的小孩
half	半途的
scuncheon	边框内侧
infertile	不结果实的
ruling	占统治地位的
greenstone	软玉
strict	严厉的
convergent	收敛
errhine	催嚏
photosurface	光敏面
unpresentable	不像样
quina	金鸡纳树皮
prosperous	繁荣的
mortification	羞辱
glidingly	滑顺地
shading	明暗法
female	女人
gnotobiology	=gnotobiotics
rough	大体描述
docetic	幻影说信徒
unassured	不确定
unhappen	使不发生
wisdom	名言
sanctorium	圣庙
namable	著名的
survey	视察
sore	痛心
suety	肥油
allred	全在大英帝国版图内
chrominance	色度
steamtight	汽密的
join	参加
siren	空袭警报
gripe	苦恼
burglar	夜贼
photocomposition	照相排版
foldout	折页
dnb	Biography
ruga	皱褶
pantological	人类全部知识的
elf	淘气鬼
cassini	卡西尼
surrender	听任
epeirogentic	造陆作用的
foredone	筋疲力竭
paleethnology	=palaeethnology
shroud	隐藏
unselfish	不自私的
yearn	渴望
jovial	快活的
damfool	非常愚蠢的
quadripartite	分成四组
burglarious	窃盗
fix	方位
winterless	没有冬天的
cablet	英寸以下的九股扭成的钢索
dipterous	双翅类的的
puparium	蛹壳
souse	变醉
chazan	独唱者
boltonia	波菊属植物
rotatee	轮调休假之军人
kindergarten	幼儿园的
unveracious	不诚实
ashy	灰的
lamellate	有薄层的
hygroscope	湿度计
primulaceous	报春花科
fatter	胖的
multibucket	多斗的
carpus	手腕子
condolent	慰问的
dozy	想睡
tyler	泰勒秘密会所看守人
ancona	安科纳
undoubled	不再对折的
cracker	饼干
whimsey	怪念头
galess	不易生气的
precautionary	预防的
legman	资料搜集助手
fraulein	小姐
varsity	大学
msie	工业工程学硕士
cystostomy	膀胱造口术
nestlike	窝似
multitude	多数
dobe	=adobe
ataxic	共济失调
special	特殊
ratton	耗子
doings	活动
implausible	难信的
cybernetical	控制论
muzzleloading	前膛装填
sceptre	王权
lepidote	覆有鳞片
coordinate	同等
untoward	不幸
sum	金额
intervale	丘陵间低地
thankworthy	应该感谢的
ptomain	尸碱
ignuts	笨人
bromine	溴
jubilant	喜悦
superscalar	超标量体系结构
counterpoise	使平衡
vine	葡萄树
lunarite	月球上高地表面
ss	纳粹党卫军
keeled	备有龙骨的
probe	探查
kicksorter	脉冲振幅分析器
brumous	多雾的
diastyle	长距列柱式
iconography	肖像画法
flimsy	不足信
unlovely	丑的
bismuthic	铋的
numberless	无号码
coxal	基节
unsaturated	没有饱和
midcult	中产阶级文化
vile	可耻的
scheduling	时序安排
craftsman	艺术家
entomotomy	昆虫剖析学
wring	强求
itinerant	巡回的
cruor	凝血
thermometrical	寒暑表
richwin	四通利方汉字系统
concretization	具体化
waterlocked	环水的
dyschizia	大便困难
loanda	=Luanda
stealthily	暗地里
offender	冒犯者
lifeful	充满生气的
filibuster	掠夺
furunculoid	像疖疮
nape	颈背
masseter	咬肌
parliamental	=parliamentary
plumose	羽毛状的
enthralment	沉迷
arm	武装起来
squinny	斜眼看
descensive	下降
pop	取出
subterminal	接近端点的
baathist	叙利亚社会党
stop	逗留
drum	鼓
horsecar	轨道马车
rhodium	铑
unthanked	不被领情的
neuter	不及物的
imputable	可归因的
imputation	非难
massacre	集体屠杀
bungle	办糟
nullarbor	纳勒博平原
traditional	口传的
atingle	疼痛的
excogitation	设计
igmp	Internet组管理协议
tramontane	来自群山彼边的
tithable	课十分之一税
thailand	泰国
ultrathin	超薄
endurance	忍耐
cephalochordate	头索动物
usb	通用串行总线
usufructuary	用益权
capable	有能力
radiomimetic	类放射
gainless	一无所获
coony	狡猾
parian	帕罗斯岛
bomb	炸弹
waste	被损耗
bin	二进制文件的扩展名
insincerely	不诚实
densimeter	比重计
hortative	劝告
lotta	许多
absorbency	吸收性
corrodent	刻毒
activism	行动主义
marsupial	有带动物的
revulsive	诱导剂
radiotherapist	放射线治疗医师
chipboard	硬纸板
process	过程
perspective	远景
columbarium	骨灰安置所
granular	粒状
oxytocin	脑下垂体后叶荷尔蒙之一种
sumph	胆怯的人
irrepealable	不可废除
faintish	较弱
simp	笨人
condor	秃鹰
unfastidious	不过分讲究的
recherche	异国风味
treasuryship	司库
edd	English
injuria	侵犯权利
strigillose	被硬毛
contrasuggestible	抗暗示的
fallen	伏
boondoggle	细小而无用的事
teg	二岁雌鹿
seamount	海山
rotiform	轮状的
inlet	进口
portly	魁伟的
basely	卑鄙地
vitellophag	消黄细胞
trackwalker	保养或检查铁路的人员
gin	杜松子酒
thousand	一千个
alchemically	炼丹术
radiotelegram	无线电报
absent	缺少
cercopithecoid	猕猴科的
unprincely	不高贵的
purl	潺潺声
tinkler	会发出清脆的声响的东西
standard	权威
volute	涡形花样
corrupt	被破坏的
interestingly	有趣地
perceptron	感知器
ketogenic	生成酮的
osprey	鱼鹰
interprovincial	各省之间
sac	=Sauk
isobarometric	=isobaric
brisk	凛冽
thermonuclear	高热原子核反应
lacunar	花格平顶
anglian	盎格鲁族人
enumerably	可列举
heartbreak	难忍的悲伤或失望
dhtml	动态HTML
palsa	穹形泥炭丘
uterectomy	子宫切除术
waterlogged	涝的
younker	少年
canada	加拿大
dividend	额外津贴
choosy	慎重选择的
stuff	填满
rga	皇家要塞炮兵
bulbous	球根
manful	勇敢的
excitation	激励
impleadable	控诉
hepatic	肝的
sumptuously	豪华
diacid	二酸的
doings	行为
brawn	膂力
yep	是
futuramic	未来型
corinto	科林托
peripeteia	情节的突然转变
period	经期
equal	等于
macabre	以死亡为主题的
celebes	西里伯斯岛
plumbeous	沉重
affreight	租船运货
bedbound	卧床不起
periselene	=perilune
turbot	大比目鱼
winterclad	穿冬装的
mesothelial	间皮的
gamopetalous	花瓣相连
revisit	重游
spymaster	间谍组织的首脑
firewatcher	火灾警戒员
nitrolic	硝基亚硝基化成物
tremulously	发抖
endogastric	位于腹中
amimeche	Associate
yummy	美味
crystalloid	结晶的
cladding	覆层
bilayer	双分子层
hyperacid	胃酸过多的
flan	果馅饼
undiscerning	无眼力的
sbm	moor
will	愿意
vellum	皮纸文书
fabricate	制作
gammon	欺骗
comusmacv	Commander
conformance	顺应
stanvac	Standard
chronopher	电动报时器
triunity	三位一体
tricksy	恶作剧
kuchen	糕点
mtu	移动式测试装置
visitatorial	巡视的
tyrannously	暴虐
graywacke	硬砂岩
lichenaceous	青苔般的
disaffirm	废弃
tensiometry	张力测量法
diphthongal	连字
arsenious	含砒素
intertrigo	擦烂
voluminous	体积大的
ric	Chemistry
explorative	探测
courageous	勇敢的
disgust	嫌恶
sorbian	索布人
wangle	骗取
epithetical	浑名的
northwest	西北方
hunt	狩猎
teratogen	畸胎剂
digitalis	洋地黄
abroad	差得远
aphlogistic	无火焰的
nomology	法则论
necromimesis	装死
confer	协商
reseed	再播种于
embracive	无所不包
postal	邮政
somnial	梦
reasonless	不理智
painsworthy	值得下功夫的
topographic	地志的
parlor	店营业室
lunation	阴历月
electrotonic	电紧张
seraphic	六翼天使的
crescive	增加
impostor	冒名顶替者
alveolate	有肺泡
worthily	重要
cadre	干部
lambaste	痛打
qbe	example
inescapably	逃不掉地
container	容器
unprophetic	非预示的
radicidation	辐射灭菌
slashing	苛刻
flush	使惊飞
vedalia	澳洲瓢虫
hateful	讨厌
attend	参加
gammadion	希腊十字形
craggy	多峭壁
hypergamy	与相同阶层的人结亲
subtangent	次切距
uncontroverted	无争论的
salween	萨尔温江
commence	开始
mrcp	College
accustomed	通常的
easiness	从容
punctatim	逐点地
supersecret	绝密的
sdcd	Super
algebra	代数学
calash	带篷马车
goral	喜马拉雅斑羚
generic	普通
trashy	垃圾似
arguably	正如可提出证据加以证明的那样
trivalency	有三价不同的原子价
hierograph	=hierogram
whippletree	马车前端用以系曳绳的横木
saffron	桔黄色
utter	绝对的
goggle	瞪眼的
penitent	悔过
clem	使苦
oho	嘲弄时所发声音
luzern	=Lucerne
tartar	酒石
uncrate	打开……的包装
aeroallergen	高空过敏症
dextral	右旋
skep	篮子
loud	喧吵
centralized	集中
dens	牙齿
walloping	极好
disconnexion	切断
reimposition	重新征收
serodiagnosis	血清诊断
dossy	漂亮的
tab	在……饰以小垂片
projectile	发射
season	调味
nictitate	眨眼
usv	美国志愿兵
observational	观察的
iatrochemical	化学疗法的
convulsion	痉挛
toilworn	憔悴的
adlittoral	浅水
wtc	Trade
industrialism	工业制度
whipcord	马裤呢
ritually	依据仪式上
tureen	盛汤的碗
malignant	恶性
plo	巴勒斯坦解放组织
tolerationism	容忍主义
vulnerate	使受伤
quodlibet	杂乱的混成曲
victualage	食品
cleanout	清洗
veneto	威尼托区
askew	歪斜
wander	漫步
thin	空洞
confide	委托
protocol	草案
enology	葡萄酒酿造学
nonentanglement	不卷入
provoke	驱使
clasp	扣紧
weather	使受风吹雨打
wry	歪斜的
holophytic	自养的
subway	地道
bleary	眼睛模糊
teakwood	柚木木材
cyclone	旋风
catnap	打瞌睡
coolville	极好
desire	请求
ransom	勒索赎金
passee	已过盛年的
dismally	阴暗地
spanaemia	=anaemia
duodiode	双二极管
dishonor	不兑现
recalculate	重新计算
nonreduction	非减数
cerebration	用脑
equitable	公正
underseas	海面下
velour	丝绒
epigenous	上面生的
featherbedding	额外雇工
trial	考验
baalism	偶像崇拜
guttulate	有滴状斑点
pyritic	硫化铁矿的
thermosetting	热硬化性
wally	大的
consonantal	辅音
volkswagen	大众汽车
droopy	无精打采
coset	陪集
polytonalism	多调法
messianic	救世主似的
amban	办事大臣
involvement	包含
serology	血清学
isotonic	等分的
hydrolyse	=hydrolyze
wattless	无功的
disobedience	不服从
plutocratical	财阀政治
universality	一般性
zealotic	狂热的
manganous	二价锰
delible	可除掉
grandisonian	葛兰狄生式的
talgo	泰尔戈车
smeltery	冶炼厂
skeesicks	=skeezicks
uncomfortable	不舒服的
coalbox	煤箱
diagrammatic	概略的
vachel	维切尔
thropple	咽喉
tonsillectome	扁桃体切除器
rheumy	潮湿的
quitrent	免役税
counterdeclaration	反对声明
resurrect	复兴
griselda	女子名
needlestone	金针状结晶矿石
arrowroot	竹芋
presell	向……预售
metrazol	卡地阿唑
latke	马铃薯饼
drecky	极糟糕的
neighbor	邻国
promoter	助长者
lordosis	脊柱前弯症
nightdress	女睡衣
fulsome	过度的
euthenics	环境改善学
standaway	不贴住身体
sonarman	声纳操纵员
c	of
dialogically	对话地
proof	有耐力的
ditheism	善恶二神论
hummock	冰群
blunderhead	笨头笨脑的人
crossbreed	杂种
conjuncture	事态
heavily	沉重地
award	判给
dobber	浮子
simpleminded	率真
claustrum	屏状核
decretal	教令集
possessory	所有
imitability	可仿制的
underwent	undergo的过去式
aeronautic	航空的
unwalkable	不能行走
somerset	=somersault
reoffer	再开始
alexandria	亚历山大大帝
bicker	流动
fertilizable	可受精
candid	率直
downtrodden	被压制的
rhizanthous	从宿主根上开花
mahdi	救世主
monroe	门罗
unsicker	不安全的
antineoplaston	抗肿瘤物质
underwriter	保险商
bnoc	British
wafery	象薄脆饼似
chatelaine	乡间别墅的女主人
claudian	克劳狄族人
mastiff	大驯犬
quadriplegia	四肢瘫痪
overcentralized	过于集权
bondstone	备用石
rylean	赖尔理论的
perborax	过硼酸钠
cosily	舒适
euryoky	=euroky
trimuon	三μ子
vaticanism	教皇至上论
malleable	有延展性
party	随行人员
embalmment	防腐处理
meander	曲流
hyposulfite	次硫酸盐
polytene	多线性的
coaly	含煤的
ablatival	离格
rookery	白嘴鸦的群居地
sackless	软弱无能
laywoman	的女性形
vintage	过时的
synodal	会议
fivescore	一百的
comber	梳者
recessional	退场的赞美歌
samite	中世纪时的一种锦绣
guadalcanal	瓜达康纳尔岛
flap	飘动
hyperactivity	活动过度
anxiously	不安
isochromatic	整色性
ultramicrometer	超测微计
benediction	祝福
loyally	忠诚
maid	少女
retractile	收缩的
doughtily	勇敢地
creamery	奶油厂
superrational	超理智
glyconeogenesis	糖原生成作用
floristic	花的
yellowstone	黄石河
remedy	补救
infrangibility	不可侵犯
pack	群集
toilless	不费力
uw	underwriter
seichometer	湖震测定器
debugger'	NULL)
conceit	原义:想法
sakhalin	库页岛
liberalist	自由主义者
padishah	国王
glenn	格伦
immortalization	不朽
provocation	挑衅
companionate	友爱的
hypoacidity	酸减低
cylindrical	圆柱
androgenize	给……以雄性激素
troubadour	民谣歌手
methylate	甲基化物
spaceworthy	能作航天飞行的
superduper	极出色
suction	吸入
jobber	临时工
extemporize	当场作成
grazer	吃草的动物
alley	小径
organzine	经丝
batty	蝙蝠
sortation	分类
dextrin	糊精
animalculum	=animalcule
bate	减少
infare	婚宴
symantec	C++
casualism	机缘说
aerocamera	空中照相机
eightscore	一百六十
cranebill	=cranesbill
rigidness	坚硬
salvage	海上救助
incorporeity	无形体
fine	变清
noia	厌烦
lagoon	礁湖
sessile	固着的
sequestered	隐退的
wilson	chamber
bona	good好之意
uri	infection上呼吸道感染
my	嗳呀!啊呀!
snakelike	蛇形的
vanilla	香子兰
unfindable	找不到的
crispation	卷曲
soreness	愤慨
pale	苍白的
marcato	加强
about	左右
consortion	联盟
apposite	适当的
netherlander	荷兰人
above	上面
sclerotioid	菌核的
rasp	用粗锉刀锉
dinantian	狄南统的
blazer	宣布者
outercoat	女式宽大衣
luxation	脱臼
primary	初步
dhl	敦豪速递公司
dowel	用暗销接合
gorse	金雀花
rhomboidal	长菱形的
doings	社交活动
zealot	狂热者
trypsinize	使受胰蛋白酶作用
photostat	直接复印机
kinglike	堂堂
snob	势利的人
eisa	Extended
surfer	冲浪运动员
rabbi	法学博士
unglamorous	没有魅力的
centiliter	厘升
si	Si
weather	露天的
chardin	夏尔丹
extra	非常
ingrained	生染
paleographic	古文书学
townspeople	镇民
wallhanging	壁布
iis	Server
taking	取
swink	使劳累
epiphanic	使人顿悟的
parlous	精明
vexillate	有旗瓣的
impermanent	暂时
azc	American
usng	States
fuzzball	马勃科菌
chd	disease冠心病
bukavu	布卡武(旧称科斯特曼斯维尔
abbreviate	简化
sabbathly	在每一安息日
scua	Suez
shreveport	什里夫波特
scripturally	根据圣经地
vertical	垂直线
busses	巴士
taurine	象公牛的
cardhouse	必然失败的计划
extension	外延
wale	条痕
chronic	慢性
unvalued	未曾估价的
misdirection	指示错误
unexcelled	未被胜过的
primaeval	=primeval
aim	目
incognizance	不知觉
sublime	极端
karyon	细胞核
nii	国家信息基础设施
confusedly	慌乱地
rickety	驼背的
commensal	共生
inappropriate	不相称的
hangtime	悬空时间
temporal	教会财产
bracing	令人鼓舞
alecithal	少蛋黄的
unmanly	怯懦的
plonk	使劲投掷
arrowheaded	箭头形的
excitant	刺激性
boracic	硼
leprose	鳞状
savoury	开胃的菜肴
romanticism	浪漫主义
roofscaping	屋顶景观美化
farriery	蹄铁术
unwed	未婚的
reduction	减少
osteitic	患骨炎
transconfessional	超越教派的
dextrad	向右
pennyworth	少额
commandery	会所
nascar	全国汽车比赛协会
unbuckle	解开扣子
here	这时
salopian	Shropshire地方的或人
extremity	手足
malapropos	不合时宜
sphragistics	印章学
heliotropic	趋日性的
extract	拔出
construct	创立
seasonably	应时地
outshot	一面坡屋
libratory	保持平衡
corrector	校对者
faultfinder	吹毛求疵的人
tail	尾状物
inappropriately	不适当
vibratory	振动的
nauseating	作呕
bowl	碗
immovability	不动
mns	of
msbc	of
colorific	色彩
heaviest	重
fainthearted	胆小
blessedly	幸福
hep	Explosive
wuppertal	伍珀塔尔
anapestic	短短长格的
unclog	清除……的阻塞
massy	厚重的
olg	German
canzona	=canzone
foresight	深谋远虑
epilogist	跋之作者写结束语的人
fetter	束缚
agromania	旷野独处症
venereal	性交的
remotely	偏僻
sateless	无厌
downbow	下弓
crosscut	横切的
preaxial	上肢内恻
tsk	啧啧
cryptology	密码研究
camelback	骑在骆驼背上
fist	抓住
footy	褴褛的
rhizocaline	成根素
slough	抛弃
polymeric	聚合的
unseparated	分不开
