disagreement	争论
jilolo	=Gilolo
unimpassioned	没有激情的
cancel	删去
elegiacal	挽歌的
regardless	不管
smatter	充内行
distributing	分配
superior	上好的
infusive	令人兴奋
illness	生病
subtility	狡猾
matricentred	以母亲为中心的
accord	调和
overlook	俯瞰
amerenglish	美国英语
nearctic	新北区的
ridge	犁垄
outerwear	外套
storiette	短篇故事
coldish	微冷的
seta	刚毛
inner	内心
protective	保护的
agamic	无性
blaze	在树皮上刻路标
incisory	切割用的
anomalism	反常
shaef	Expeditionary
baconian	归纳
bribability	易受贿
inappetency	欲望缺失
signory	领土
coeducation	男女同校
valuable	有价值的
galliard	活泼愉快的
patient	患者
crib	食槽
snide	伪造的
amphitheatre	阶梯教室
perinephrium	肾外膜
hoopskirt	有裙撑的裙子
value	评价
nte	全国教师考试
ostracon	=ostrakon
shaef	Forces盟国远征军最高统帅部
greasy	油脂的
hydrocoral	水螅珊瑚类
unfortunate	不吉利的
repulsive	令人厌恶的
valued	贵重的
absorber	吸收者
misdone	的过去分词
rationalisation	=rationalization
spectacle	观览物
westwardly	向西
ropedancing	走索
bronchogenic	支气管原的
rarefied	稀薄的
candid	公正
inesculent	不可食用
slurp	啧啧吃的声音
twinkling	闪烁的
antivenom	抗蛇毒血清
stockjobbing	股票买卖
firmness	坚定
boff	卖座的戏
crusade	十字军东侵
consummative	使最终得以实现的
particularize	列举
tearing	撕开的
generalizable	可归纳
fleckered	有斑点的
poppied	多罂粟
fense	栅栏
ssrc	社会科学研究委员会
novillero	见习斗牛士
voluminously	庞大地
gummiferous	产树胶的
death	屠杀
determinative	限定
manumit	释放
microinterrupt	微中断
shellheap	midden
poolroom	弹子房
cinerarium	骨灰存放处
appointor	任命者
magma	岩浆
pipy	发尖声的
tantivy	疾速地
aching	痛的
ifo	已识别的飞行物
procephalic	原头的
eyesome	媚人
drafty	通风良好的
imperforated	闭锁的
escap	Commission
schismatic	分裂的
hyperinsulinism	胰岛功能亢进
parasitoid	拟寄生物的
dissociable	可分离
antigalaxy	反星系
controvertible	可辩论的
filiform	纤维状的
comic	滑稽
scurf	皮屑
water	水上的
new	新的
fruitery	果实
teltag	说明标签
walkaway	轻易得到的胜利
tristful	阴沉的
benchman	收音机及电视机修理工
cochromatograph	/
scratch	勾抹掉
integral	整体
filth	污秽
acervate	簇生的
reciprocator	往复机构
destitution	穷困
bather	入浴者
wendic	=Wendish
chersonese	半岛
humic	腐殖的
linguiform	舌状的
pyelogram	肾盂造影照片
protestor	反对者
quag	沼
scission	切断
score	刻痕
diehard	顽固分子
villainy	坏事
untamed	难控驭
prescient	预知的
czar	沙皇
centre	中央
scapple	=scabble
bondslave	奴隶
kirgizia	=Kirghizia
epigamic	诱惑性
inbreeding	近亲交配
weaken	变弱
arsis	上拍
rowdyish	吵闹的
exemplary	可做模范的
sepalous	有萼片
precoital	性交前
presumptive	假定的
projectile	射弹
radiology	X光线科
eponymous	齐名的
soil	变脏
silvern	银一般的
abweber	=maxwell
tinker	做焊锅匠
servantgirl	小保姆
timocracy	金权政治
caressive	亲柔
anemophilous	风媒的
dryness	干燥
canaanite	迦南人
ponce	Ponce
giddy	轻率的
jumby	幽灵
endosteal	位于骨内的
rayonnant	辐射式的的
clansman	族人
authoritative	命令
interindividual	个人与个人之间
aeriferous	装气的
reemphasize	重新强调
mayvin	=maven
trialogue	三方谈
overmountain	位于山上的
versatile	万能的
nuclear	中心
chilliness	寒冷
sortilege	抽签占卜
incb	Board
concomitancy	伴随
nav	net
modernbuilt	现代化结构
disappointedly	失望地
develop	逐步展开洗印
bonne	女佣
gauntry	木桶架
caird	挑担铜匠
gratuity	赠物
bid	命令
cormorant	贪婪的
undisturbed	安静的
caoutchouc	生橡胶
redoubted	可敬
plumb	探测
half	相当的
moonshiny	空想的
bracteal	苞的
pitted	有凹痕的
bristled	有刚毛
obstinate	顽固
quadrate	方形的
polyamine	多胺
indication	指示
angiomatous	血管瘤的
spiritualise	使成精神上
protostellar	原恒星
pork	猪肉
shirr	宽紧线
hangnail	手指头的倒拉刺
dreamful	常易梦见
smooth	消除
quadrisonic	=quadraphonic
tauri	Taurus
extern	外来的
adenine	腺嘌呤
befuddle	使酒醉昏迷
inconsecutive	前后不连贯
adulterer	奸夫
quadrantal	象限
triable	可以试验的
kneesie	到碰膝盖地步的亲昵关系
mystery	神秘的事物
calescent	变热的
vugular	晶簇性的
heterocyclic	杂环
negotiate	越过
rantipole	泼妇
playfully	开玩笑地
aramean	=Aramaean
moisturize	变潮湿
intravital	活体
oogenesis	卵子发生
unwind	放松
humped	有肉峰
tromba	小喇叭
nitwit	傻子
runnel	细流
glob	一滴
semeiotics	=semiotics
fnma	Association联邦国民抵押协会
quadplex	有四部分的
synthetical	合成的
spile	打桩
hoarsely	刺耳
readvance	再前进
unfasten	放松
medieval	原始
amalgamator	合并者
hotfoot	火急
parabomb	伞投炸弹
overcentralized	过分集中
culture	文明
subchairman	代主席
homologous	同源的
adhesion	支持
muck	捣乱
jenghiz	Khan
imo	In
cinquecentist	16世纪意大利文艺家
madcap	狂妄的人
contaminator	弄脏者
ergogram	肌功波
cachot	地牢
exuberant	繁茂
galley	长方活字盘
explode	推翻
preexilian	公元586年以前
nonpersistent	非持续
pleading	恳求
rehospitalization	再进医院
eclipse	月蚀
quadrumvir	四人团体中的一员
momently	暂时地
screaming	尖叫的
cutoff	切掉
ppe	哲学、政治学、经济学统称
republican	共和国
paynim	异教
prof	教授
practolol	心得宁
portion	一分
stellular	星点花样的
infidel	异端的
monospermous	单种子的
conclude	断定
eurystomatous	阔嘴
gangetic	恒河的
varietist	与常人不同的人
ethylic	乙基属
alfa	字
usaid	Development
tanto	这样
treasonable	不忠
flocking	棉屑
roisterous	作威作福的
godwinian	戈德温的
maneb	代森锰
hiplength	盖住臀部的
shroff	兑换银钱的人
mixing	混合
cultivation	中耕
testify	证实
provoke	挑拨
happening	事件
smackhead	吸海洛因者
dtv	video
magyar	匈牙利人的
bitewing	咬翼片
flexible	柔韧性
bristletail	蛀虫
coldslaw	=coleslaw
steward	乘务员
suggestion	意见
carbonization	干馏
jeanne	珍妮
unduplicated	无副本的无法匹敌的
whole	未打破
bowed	有弓
underground	地面下的
waterlogged	涝
cottus	科托斯
woman	女性的
wakeless	未受打扰的
incognito	隐名埋姓地
futhark	北欧古字母
excitant	使兴奋
flatten	变单调
impracticably	不可能实施地
dextrose	葡萄糖
catatonic	紧张性精神症
placegetter	获名次者
unmold	把……从模子里取出
bhut	恶魔
minster	大教堂
tortile	弯曲的
scrappy	斗志旺盛
speaker	扬声器
sneeringly	嘲笑地
robe	制服
scua	Canal
doodlebug	超小型赛车
aacs	Communications
horological	钟表术的
abortive	中断的
mattoid	半疯子
intermontane	山间的
epidural	硬膜上
relume	重新点燃起
modernistic	现代派
nameless	不可名状的
actuarial	保险精算师的
am	M
decubital	褥疮
snafu	大混乱
trail	拖拉
gasman	煤气装配工人
ruffian	恶棍
equipotential	等电位的
oversee	俯瞰
biostatistics	生物统计学
evaporative	蒸发的
curmudgeonly	不和悦
ringside	拳击场
hobbler	无照领港员
unspent	仍有效
retrusion	牙齿的后移状态
authentically	真正地
bachian	巴赫
lifeboat	救生艇
gynophore	雌蕊柄
unfishable	不适合钓鱼
borough	区
outlier	外露层
takeoff	起飞的
leach	滤去
impenitence	顽固
toccata	托卡塔
toon	马兰香椿
pycnogonid	海蜘蛛
strobilus	=strobile
sneezes	打喷嚏
standfast	坚定的立场
pentacid	五价
tungusian	=Tungusic
adopted	被收养
claudicant	跛脚的
every	全部的
typewriting	打字
reassure	再保证
revolving	旋转
sinker	下沉的人
mainboard	主机板
megavoltage	兆伏级
relativize	相对论应用于
teardrop	泪状物
airconditioned	备有空气调节装置的
firer	烧火工人
amoral	超道德的
qualificative	修饰的
reclusion	隐居遁世
germination	发生
loadhigh'	NULL)
whereunto	为什么
hendecasyllabic	包含有十一音节的
tirelessly	不知疲倦
lanceted	有尖拱的
postpartum	产后
irreducible	不能复归的
mail	给……穿盔甲
granulation	粗糙
spar	争论
phantasmagoria	幻灯的一种
chirk	高兴
curate	副牧师
childproof	对孩童安全
chirpily	快活
malnourished	营养失调的
gneissic	有片麻岩石性质的
humous	腐殖土的
cuboid	立方
desiccated	粉状的
cockeyed	斗鸡眼的
estron	埃斯特纶
whetter	刺激物
weewee	撒尿
mediator	中保
venturesomeness	冒险
eleatic	埃里亚人
trichinopoli	特里其雪茄烟
ginny	有杜松子酒味的
jackleg	没成熟
federal	联合
mecopteran	蝎蛉
diminishable	可减少的
disputation	驳斥
loiteringly	懒散地
lias	青石灰岩
chirp	唧唧声
medley	混杂的人群
legalism	律法尊重主义者
fetus	胎儿
effuse	流出
eventful	充满大事的
hurdle	栏
indisposed	不舒服的
melungeon	默伦琴人
celadon	青瓷色
uaa	阿拉伯航空
nlrb	Board
adventurous	敢做敢为
boswellize	来写
sequelae	后遗症
cospar	Space
cavate	形成山洞
title	权利
nga	National
puckery	弄皱
revile	斥责
tolerationism	宗教信仰自由主义
endlessly	不断
dredging	捕捞
monde	时髦社交界
exclusive	孤高
faintness	衰弱
grotesque	奇形怪状的
fissility	分裂性
ulcerously	患溃疡
schottische	舞的一种
idly	懒惰地
midwifery	产科学
singularity	奇异
trying	令人厌烦的
tocsin	警钟
anorak	带兜帽的夹克
trumpery	没有价值的东西
faker	捏造者
spanking	打屁股
unloose	释放
rampant	猛烈
coverall	包罗万象的
bleak	黯淡的
forcible	暴力的
leukoplakia	黏膜白斑病
kinkajou	蜜熊
worth	相当……价值
unapparent	模糊的
belabor	不断辱骂和嘲弄
appalling	令人震惊的
scotopia	暗视力
ocherous	赭石的
heptagonal	七角
flexibility	适应性
fred	佛瑞德
hotter	热烈
slowish	速度稍慢的
yegg	强盗
sippet	作配菜用的小块烤面包
flustration	喝醉
misbegot	私生的
cartology	地图学
inculpate	控告
picnicky	行乐的
usher	传达员
whoever	pro
jurist	法理学家
barcarolle	威尼斯的船歌
thataway	朝那个方向
unadvantageous	不利的
rainbow	五彩缤纷的
colonialism	殖民主义
flocking	羊毛屑
hinterland	内地贸易区
unhinge	取下……的铰链
culicine	库蚊
holiness	神圣
mediate	仲裁
unfixed	放松了
substrate	感光底层
drive	驾车
carrefour	道路交叉点
correct	惩戒
crispy	精神爽快的
entirely	完全地
grained	除去毛
sunwise	和太阳在天空上移动同方向
altostratus	高层云
hypnophobia	睡眠恐怖
horizontal	地平线的
alphabetically	按字母顺序
applewife	卖苹果之女人
bicomponent	双组分
misconstrue	误解
scoline	司可林
ulotrichous	鬈发的
honest	诚实的
coeternal	永远共存的
rumpot	酒徒
misophobia	不洁恐怖
feel	有某种感觉
singlestick	单棍
scurrility	刻薄
base	基于……
comic	滑稽的
tremolite	透闪石
instead	改为
meliorable	可改善
underpin	支撑
finitist	有极限论的
pithiness	简洁
luminary	知识渊博的人
bradshaw	火车时刻表
modificand	被修饰词
materfamilias	母亲
nosogeography	疾病地理学
neuration	脉序
reforest	重新造林
telephonist	接线生
kastelorrizon	卡斯特劳利松岛
admonishment	警告
subclavian	锁骨下动脉
helvetian	赫尔维蒂人
flyable	可驾驶
decorously	高雅
muggee	遭背后袭击及抢劫者
pare	消灭
badman	罪犯
inviolable	神圣的
road	大道
windowy	窗多
warrant	根据
raa	Royal
aristocratism	贵族主义
substratosphere	亚同温层
psychodynamic	精神动力的
dinah	女子名
ruddered	有方向舵的
aurelian	蛹
partizan	党人
missourian	密苏里州
stodginess	难消化
unicolour	单色
ost	Office
specifiable	可列举
cssr	捷克斯洛伐克社会主义共和国
nummular	圆形
feverous	发烧的
tripping	流畅
pertness	傲慢
determinate	确定的
noncellular	无细胞的
tacamahac	胶杨
preplacement	雇用前的
ethnographer	民族志学者
redheaded	红头
membership	成员人数
plainness	平坦
obediently	忠顺地
undimmed	明亮
poke	捅
redone	的过去分词
thaneship	=thanage
zooflagellate	动鞭毛虫
stamineal	雄蕊的
denudation	剥蚀
interscan	内扫描
inimitable	独特的
lapsuslinguae	口误
frank	率直
uri	respiratory
circulative	流通的
classy	漂亮的
mamillated	乳头状
suffrutescent	半灌木状的
circumgalactic	环星系旋转
neoimpressionism	新印象画派
sideline	边界线
gangly	身材瘦长
farce	填塞
nihilistic	无政府主义的
asphyxial	昏厥
sty	住在猪圈里
illuminating	照亮的
zinc	锌
profitable	有利可图
lander	住在陆地上的人
teleology	有目
sumptuously	奢侈地
egp	Gateway
havdalah	=Habdalah
wizened	枯萎的
mortal	极端
anabiosis	回生
call	叫声
washland	泛滥
pukkah	份量充足的
oxbow	U字形弯曲
lickspittle	奉承者
seditionary	骚乱煽动分子
caspian	里海的
homing	自导引
cardiant	心脏兴奋剂
micronization	微粉化
lubber	粗笨的
decompensate	代谢失调
criminality	犯罪
kalpa	劫
sensualism	好色
motorship	柴油机船
machera	=machaira
pinnigrade	用鳍
carrottop	红发的人
slangster	使用俚语者
lose	浪费
candytuft	屈曲花属植物
incumbency	义务
reflation	通货再膨胀
generalship	才干
derris	鱼藤
ferropseudobrookite	月铁板钛矿
gastric	胃
pennyroyal	薄荷油
trochee	长短格
stigma	气门
resinoid	树脂状物质
zesty	兴致很高的
fuzz	绒毛
ridge	成脊状延伸
dominical	主
discredit	无信用
misdescribe	错误地描写
handbreadth	一手宽
disyllabic	双音节
habu	响尾蛇属毒蛇
worth	值的看中的
glave	剑
luteofulvous	橙褐色
ferruginous	铁锈
dortour	=dorter
communicant	领圣餐者
quadriform	包含四种形态的
preferential	先取的
fated	命中注定
wittig	reaction
nuclear	核子
crackjaw	发音困难的
pleiotropic	多效性
inwrap	包囊
orins	Nuclear
sloat	舞台布景升降机
puzzlist	出谜人
wheelhorse	忠实的工作者
cirrostratus	卷层云
asphaltene	沥青质
fulbright	富布莱特法案基金
conjecture	推测
towards	对面
apprehensively	担心
polynesian	玻利尼西亚人的
filar	丝的
unconsciously	不知不觉
associative	联想的
genf	=Geneva
cartilaginous	软骨质
execrate	憎恨
serried	重叠罗列的
nutso	痴狂
autolithograph	用直接平版印私版印刷法
indignant	愤慨的
bruxism	磨牙症
demagnify	缩小
docile	温顺
inscient	无知
multiracial	多民族和睦相处
iceni	爱西尼人
promptive	敦促
muderer	凶手
dolefully	悲哀地
solanaceous	茄属
illiberally	小气
instructress	女教师
audio	音频的
peanut	花生
ctd	Trade
crumple	垮台
portwide	全港的
superdense	超密
medical	内科
squirish	乡绅的
ahg	antihemophilic
catecheticel	问答式教法的
octonarian	八韵脚
anginal	心绞痛的
crumby	柔软
albescent	变白的
band	波段
accurst	讨厌的
foursquare	坚定
mph	hour
ridger	起垄犁
skatebarrow	板鳃亚纲鱼的卵囊
trichiniasis	=trichinosis
dirigible	飞船
kookiness	发狂
spinthariscope	闪烁镜
gramineous	禾本科
coaming	舱口栏板
consequential	相因而生
radiation	放射
bios	Basic
hera	宙斯神的妻
intimacy	亲昵行为
shadowgraph	将影子投射影幕上的技术
bellipotent	战力强大
tael	银两
multipartite	多国参加的
vascar	Average
rebel	造反的
flop	失败
moral	道德
fend	照料
petala	petalon
vermiculation	蠕虫爬迹形的装饰
culpably	该罚
sublimate	使高尚
reinforce	加强
valentinus	即Valentine
vasovagal	血管迷走神经
descant	详论
garp	全球大气研究方案
endometria	endometrium的复数
liberally	公平
riser	起义者
ddn	数字数据服务
incumbrance	累赘
pore	毛孔
tottery	蹒跚
tristeza	柑橘腐根病
laetare	Sunday
euryphagous	广食性的
headlong	头向前地
knub	肿块
wicked	恶劣
putrefactive	腐败的
modulate	调制
flounder	踌躇
belabor	就……作过分的冗长的讨论或分析等
efficacious	有效
cuboid	三次方的
strigous	覆盖着糙伏毛
impish	顽童似的
disturbedly	不安
smooth	使光滑
amaranthine	不凋谢的
spend	用尽
procellous	狂暴
verbicidal	歪曲词义的
smart	灵巧
unintelligent	愚钝
untidy	不简练的
gastroduodenal	胃与十二指肠
awesome	可怕
backwoodsman	住在边远地区的人
contorniate	边缘内有槽的
heathenry	异教徒
bilobate	二裂片
widthwise	与宽同方向地
apheliotropic	背光性的
hushaby	乖乖睡!
feel	触摸
chirp	尖声地说
thunderbolt	意外的灾难
causal	原因
mcluhanite	麦克卢恩的
irregular	无规律的
peat	泥煤
biserial	双列
azure	蔚蓝的
ayudhya	=Ayutthaya
venerable	值得尊敬的
constant	不变的
infradian	超昼夜
univalent	单价
richly	富饶
scowl	暴风雨前的阴沉晦暗
usb	Bus
crystalline	水晶的
rectify	矫正
topaz	透明的浅黄褐色
pneumaturia	气尿
goad	刺激
guilty	心虚
rower	划手
laith	不想的
rurally	乡下地
quickassets	速动资产
falteringly	支吾地
baggagemaster	行李负责人
logicals	逻辑值
necklet	小首饰
gotham	愚人村
seric	中国人的
auditoria	礼堂
activable	能被活化
atlas	地图集
ambition	雄心
biograph	初期之电影放映机或录音机
halachist	哈拉卡的作者
infielder	内野手
cronus	克罗诺斯
jol	荒芜碎裂的石灰岩高地
amadan	阿玛松
daf	Force
zoologist	动物学家
cerebration	思考
buzkashi	kashi
mushroomy	蘑菇的
ostensible	可公开
brassin	芸苔素
hemocytoblastic	血胚细胞
brittle	易碎
pillhead	服药成瘾者
alumni	男校友
froghopper	吹泡虫
trey	三点的牌
polygyny	一夫多妻
floscule	小花
cagy	谨慎的
interlude	戏剧或歌剧两幕间
squish	咯吱声
eldest	最年长的
axillar	腋羽
nutgall	五倍子
endocrinopathy	内分泌病
ruche	褶饰
microstructure	显微结构
utilisable	=utilizable
prefactor	前因子
ennyyee	倦怠的女人
yestermorn	昨天早上
vietnamese	越南人
defensive	防御用
ase	American
double	快步走
preindicate	预示
animated	动的
spiky	尖刻
unliving	无生命
distaste	嫌恶
unsight	不检查的
domicile	住宅
elegiac	哀歌体
leaflike	像叶子
speak	说明事实
aphthongal	不读音字母
greaseproof	不透油的
kickster	一味追求刺激的人
banjax	揍
thuggish	杀人
turnkey	狱吏
zhuhai	珠海
subduce	除去
teleswitch	遥控键
annullable	可废止的
lanolated	有羊毛脂的
arrogation	诈称
vesical	膀胱
dissolving	消溶
frosted	被霜覆盖
fiend	邪神
equinoctial	春分或秋分
whist	安静的
channel	信道
cheshvan	=Heshvan
flowery	象花一样
adjuratory	誓言的
ultimateness	终结
monofuel	单元燃料
conspiratory	阴谋者
dropping	空投
troublemaking	捣乱的行为
retardance	阻止
spadille	最大王牌
hexastyle	前有六根柱子的
reflex	映象
marvel	觉得惊奇
ridley	鳞龟属
bailable	可交保的
mganga	巫医
spirituel	活泼的
blindfold	n
mismanage	处置失当
elate	使兴高采烈
applicatively	可适用
ramification	分枝
season	适用
marriageable	达到结婚年龄的
prepuce	阴茎包皮
abo	土著居民
lockram	亚麻制品
nullification	无效
trifacial	=trigeminal
olfactive	=olfactory
autoecious	寄生的
impregnate	怀孕的
hoofpad	蹄垫
enchantment	着迷
trivalvular	=trivalve
eater	吃……的动物
executive	执行者
neuraxon	轴突
underneath	在……的下面
loop	环
gremmie	新手
folliculin	卵巢滤泡激素
pinon	矮松果
complicity	同谋
watershoot	徒长枝
intertropical	热带
flask	细颈瓶
dihydro	有二个氢原子的
yapese	雅浦人
excitability	兴奋性
neotype	新型
skinch	对……吝啬
unef	United
persuasively	口才好
tornadic	龙卷风
corporator	法人团体的一员
fourfold	四倍的
creatin	肌肉素
horsemint	美洲薄荷
brownware	原始陶器
overgreat	过于重大的
ravage	蹂躏
aviculture	鸟类饲养
fecund	丰饶
atheneum	图书馆
colander	漏锅
sarcomagenic	致肉瘤
leisure	闲暇
seventy	七十
fertilize	使肥沃
capably	能干
motiveless	无目
jilt	任意抛弃
perinatology	围产期学
baroswitch	以气压来控制的开关
splanchnic	内脏的
dernier	最后
ashore	在岸上地
clitellum	生殖带
superfamily	总科
fall	采伐量
protectingly	加以保护
charitably	慷慨
peacebreaking	肇事
lilied	纯洁
mutinous	暴动
bestially	野兽地
imperviable	不接受
acritical	无极期的
lox	熏鲑鱼
deemphasize	使不重要
unthoughtful	未深思的
oven	烤炉
scurry	急赶
squat	蹲坐
enactment	制定
ascensive	上升
chatterer	饶舌的人
attorney	代理人
malaguena	西班牙
telome	顶枝
extractor	拔取的人
reinforce	增加……的数量
siscowet	湖鳟
spiflicate	使混乱
sliminess	滑溜
rousseauesque	具有卢梭风格
synkaryon	合子核
painstaking	艰苦
umt	Training
iliamna	伊里亚姆纳湖
coxal	基节的
wharf	卸上码头
body	大量
separatory	使分离的
complicit	串通一气
breezily	微风
psychics	心灵学
furious	热烈兴奋
convulsion	动乱
siphonostele	管状中柱
cap	相幅载波
peckish	唠叨的
behove	理所当然
drugget	粗毛毯
proportional	成比例的
scrambler	爬行者
tornado	具有巨大破坏性的人
pterosaurian	翼指龙的
hapless	不幸
pathetic	可怜的
una	Nations
uproariously	吵闹
lamish	有点瘸的
thermoelement	温差电偶
equably	稳定
illuminable	可被照明
update	使现代化
lixivium	浸出液
bayman	靠伐月桂为生者
pleiotropic	多向性
rambling	漫步
crassitude	愚钝
lucullan	奢侈
m	字母M
solidi	的复数
dysteleological	无目的论
throe	剧痛
inflexible	不屈挠
fernery	蕨类栽培
conplane	处于同一平面的
ventricle	脑室
ineradicable	根深蒂固的
gallium	镓
gradatim	逐步
embark	着手
sideroblast	成高铁红细胞
complimental	恭维的
shark	敲诈
sided	有边的
supplicatory	恳求
nonfissionable	不能产生核子分裂的
copihue	智利喇叭花
monofile	单文件
widf	Democratic
reification	具体化
crappy	没价值的
illiterati	无知识的人
stressable	可用重音读的
trivial	微不足道
grail	大盘
darkminded	黑心的
sdcd	Compact
rhemish	version
underexposure	曝光不足
fratricide	杀害兄弟者
readjourn	再次中止
problem	问题
safely	确实地
declamatory	雄辩家式
trichinous	患旋毛虫病的
linguister	翻译员
dismay	使惊慌
cobelligerent	战时盟国
inshoot	内曲线球
scenic	布景
precarious	不稳定的
uninquiring	缺乏好奇心的
calamondin	加利蒙地亚橘
drivetrain	=driveline
tailorable	可裁制成衣
mattamore	地下室
caesural	休止的
conplane	处于同一平面
pushing	急切
invert	使转化
rearmost	最后的
birdy	多鸟
transportable	可运输
kibbock	干酪
lankiness	又瘦又高
cochlea	耳蜗
yancey	燕西
unbuttered	没有黄油
bagpiper	风笛手
ns	nanosecond毫微秒
medium	半生熟的
ingenious	具有创造才能
organosilicon	有机硅
wisp	小物体
spermatogenous	产生精子
entablature	柱顶线盘
tinny	含锡的
forepassed	过去
driver	传动器
showground	展览场地
allantoid	尿膜
angor	极为痛苦
unpatterned	未成形
islamitic	=Islamic
extinguish	熄灭
myrrh	没药树
reniform	肾脏形的
overgarment	大衣
lr	symb
sieur	先生
tintinnabular	铃的
inadmissible	不许可
allopathic	对抗疗法
maraca	沙球
cotta	短袖束腰外衣
cataclysm	大洪水
notable	值得注意的
depraved	堕落
needful	需要的
amends	赔礼
bacardi	巴卡第
italian	意大利
unpersuaded	未被说服
landor	兰道
maladroit	不灵巧的
aiguille	钻头
emphatic	语势强
pallor	苍白
spree	纵乐
cowry	贝壳
diazomethane	重氮甲烷
bursectomize	给……施黏液囊切除术
typograph	活版印制
reservist	预备役军人
ionic	离子的
pollinizer	=pollenizer
interpolated	以内插值替换
dino	意大利人
transporter	运输机
acerbic	酸的
wrong	失常
mediocrity	平庸之才
adullamite	退出一派另行组派的人
conciliate	调和
extraviolet	紫外线
nastily	不洁
testing	测试
tcp	Control
fox	狡猾的人
sonochemical	声化学的
alchemize	使变质
dispatch	急件
helminthoid	蠕虫状
moonstruck	神经错乱的
commonland	公共用地
gurnet	鲂鱼
eternise	=eternize
tessera	纪念品
dosimetry	放射量测定
bmw	Bavarian
ureter	尿管
fossilology	化石学
cloistral	孤独的
morphinism	吗啡瘾
amboceptor	介体
therewith	以其
marplot	捣乱破坏他人计划者
spawny	似鱼卵
bichrome	双色的
qse	and
gam	鲸鱼群
strassburg	=Strasbourg
chickabiddy	小鸡
analogic	类推
diffusedly	普及
federal	北部联邦同盟盟员
wisely	聪明地
cariole	雪橇
coniform	圆锥形的
narrowfisted	吝啬
fizz	嘶嘶声
vicenary	20
faltering	犹豫的
exclusively	排外
cameleer	赶骆驼的人
fagmaster	有低年级生侍候的学生
hexyl	己基
hyposulfurous	次硫酸的
debarkation	登陆
evangel	佳音
histological	组织学
ascorbic	维生素C
bestead	帮助
zing	生命力
dependent	依靠
rickets	软骨病
making	发展
polymorphonuclear	分叶核的
xylography	木版印刷法
scalene	不等边三角形
oblivion	湮没
iab	Board
clammer	蚌蛤捕拾者
schoolmaster	校长
intermigration	互相迁徒
superliner	超级邮船
absence	不在
gleg	敏捷而反应快
trailerable	可放在拖车上载运
plutocratical	财阀政治的
kieselguhr	硅藻土
triturator	粉碎机
marked	显著
traveled	旅客使用
sparkling	闪闪发光
affluent	富裕
cue	球杆
bulldyke	=bulldike
nigerien	尼日尔
capitate	头状花序的
sia	新加坡航空公司
grumbling	喃喃鸣不平
dissociation	分裂
thrombus	血栓
hasty	匆忙的
centrosymmetric	中心对称
succussatory	振荡
phrenetic	发狂
plank	立刻付款
trespass	侵入
diuretic	利尿剂
waveringly	摇动地
rosellen	罗塞伦
rosy	蔷薇色
cered	裹尸布
hexagram	六线形
cpsu	the
estrade	台子
mac	Command
stopper	制止者
transit	中天
ratbaggery	古怪行为
companionate	伙伴的
catchpenny	不值钱
knightage	骑士名录
pineapple	菠萝
mertensian	默顿斯拟态
hempen	大麻的
nonutility	实用的
ketogenesis	生酮作用
frisson	颤抖
vision	视觉
tractive	曳引
gun	枪
laggardly	行动缓慢
indeliberateness	无心
carpogenic	结果实
tray	盘子
parodos	合唱队登场
raiment	衣服
backwater	停滞不进的状态或地方
tannish	浅棕色的
landholding	土地所有
citriculture	柑橘栽培
polyurethane	聚亚安酯
drastic	激烈的
booking	登记
assorted	多样混合
congest	充塞
connotative	隐含的
alkalify	使成碱性
medlar	欧楂
boondoggle	做细小而无用的事
fiercely	厉害
mannerly	有礼貌的
compunctious	悔的
contravention	违反
assyrian	亚述的
sneezy	有喷嚏的
semipalmated	具半蹼
fender	防卫物
mb	MegaByte
saloonkeeper	酒馆的主人
radiograph	射线照片
applescript	电脑开发的程序性语言
mumble	喃喃而语
brainwave	脑波
slav	斯拉夫人的
steerage	驾驶
indemnification	补偿物
cabalistic	神妙
shirt	衬衫
tinny	似锡
squirely	适合乡绅身份
emiction	尿
ground	范围
naughty	下流
antilabor	危害工人利益的
producer	制片人
page	记录
overhasty	过急的
epidermis	上皮
latifoliate	阔叶
myopathy	肌病
spoony	愚蠢的
surfeit	恶心
gallicanism	高卢主义
biparental	来自双亲的
semiconducting	半导体的
cambridge	剑桥
synonym	同义字
potentiostat	恒电势器
dystrophia	发育不全
cake	块
exlex	法律以外的
guimpe	在背心裙下穿的一种衬衫
protreptic	规劝
underemployed	大材小用的人
thitherto	直到那时
fenestration	开窗法
nin	外祖母
poculiform	杯形
oakling	小栎树
animalise	=animalize
deuterium	氘
herb	香草
soroptimist	国际职业妇女会之会员
systemic	身体组织
lincolnite	林肯政策支持者
embryonated	具胚
antitubercular	抗结核的
exoteric	一般人所能理解
vacillatingly	犹豫地
signori	signore的复数形式
choreatic	舞蹈症的
atmosphere	大气
magistracy	长官的职位
unblest	受诅咒的
autosum	自动求和
hydrid	氢化物
pietistic	假装虔诚的
orthovoltage	中电压
reparative	赔偿的
hydrographic	与水道测量有关的
photocell	光电池
toadstool	羊肚菌
auc	the
approbatory	赞赏
extender	添加物
theocratic	神权政治
typhus	斑疹伤寒症
haunting	常浮现于脑海中
cunit	100立方英尺
greenback	美钞
kelantan	吉兰丹州
lagger	惯犯
tentatively	暂时地
docile	温顺的
mesomorphic	具有由中胚叶发达之筋骨
furring	钉板条
faubourg	近郊
indeterminate	不确定
engraving	雕刻术
scandent	附着的
cutthroat	残酷
jmb	Joint
dehydrogenize	使脱氢
medium	中间
undercellar	下层地下室
lenticel	皮孔
unsubmissive	不服从的
stoutness	坚固
everlasting	无止境的
fartlek	法特莱克训练法
conciliationism	调解政策
cosmologist	宇宙论者
hummocky	多圆丘
epizootiology	兽疫学
oceanic	海洋产出的
neuropath	神经病患者
shadowy	有阴影的
snift	=sniff
daniel	男子名
vaunting	傲慢
floppy	邋遢
knockabout	粗造的
averse	反对
branching	分歧的
featherbed	任闲职的
amidate	化为醯胺
rsgb	of
damned	该死的
vanishingly	难以察觉
oaten	燕麦
exosmic	外渗
enate	母系
generator	发电机
rantankerous	不怀好意
revolera	举斗篷过头顶的挥舞
unsuspected	未被怀疑
buccal	口腔的
paillasse	草铺
jell	果子冻
whine	牢骚
mitt	露指手套
gagwriter	笑料设计人
deft	敏捷熟练的
feldspathic	含长石的
apertured	有洞
theta	希蜡字母的第八字
swabia	斯瓦比亚
transmountain	穿过山的
duorail	双轨铁路
catchy	易使人上当
bale	捆包
delirifacient	引起精神错乱的
avail	利益
dedicatory	献纳的
superheterodyne	超daIn/
uncorrectably	无法改正地
adream	做梦
sheshbesh	中东巴加门
loco	火车头
nongreen	非绿色的
marly	泥灰质的
monographic	专题论文
exploiter	开拓者
approachability	可接近
moire	波纹丝绸
oblique	倾斜
mural	墙壁上的
akimbo	两手叉腰的
superserviceable	急于帮忙的
futilitarian	悲观的
cuboid	立方体
superfemale	=metafemale
uncharted	未知的
thermal	热量的
scoter	黑海番鸭
random	随便的
inflect	改变
malice	怨恨
backstroke	反手拍球
aetna	=Etna
farewell	别了!
rallicart	四人座的小型二轮马车
lettered	有文化修养的
transmit	传输
leatherneck	海军陆战队员
guest	旅客
dolefully	悲哀
resident	居民
undersanded	掺沙太少
tuitionary	学费
uppsala	乌普萨拉
unhuman	无人类属性
chabouk	一种长鞭
handless	笨手笨脚的
fake	捏造
transworld	遍及全球的
sac	囊
pyic	脓的
cohere	凝结
merman	男性人鱼
gradine	阶梯形座席之一排
tocologist	产科医师
draughty	通风良好
raises	饲养
frequently	常常
applaud	称赞
underwater	在水线以下
core	果核
dichromatism	二色
sodomy	鸡奸
zoology	生态
clypeus	唇基
microvillus	微小突起物
forgiveness	宽恕
osage	奥色治人的
cuticolor	肉色
fractionalism	分裂政策
malassimilation	同化不全
idiomorphic	自形的
metrazol	五甲烯四氮唑
subsequently	后来
toyon	类似枸骨而结红果实的常绿树
filer	文件装钉员
cenobian	修道士的
reeducate	再教育
helicity	螺旋性
heteronomy	他治
allopatrically	在不同地区发生
organon	推理法
palisander	黑黄檀
clouding	暗晦
facs	the
weatherboard	挡风舷
epure	草图
undissolute	不放荡
vibrational	振动的
supportably	可支持地
grundy	拘泥礼节的人
volumeless	不占容积的
wholescale	不加区别的
amaigamate	混合
dipteran	双翅类的
wound	创伤
smooth	平滑的
ethos	社会思潮
angioma	血管瘤
terminating	使终结
counterpunch	回击
vinous	葡萄酒
blitzkrieg	闪电战
uncharted	不详
inexpugnable	不能攻占的
profound	渊博
favorable	良好
biotin	维生素H
other	pro
bay	海湾
unveracious	不讲真话
detainer	非法留滞
lanceolate	矛尖形
circumfuse	围绕
nonfulfillment	不履行
oniongrass	鳞茎臭草
saltchucker	海钓者
zanyism	滑稽表演
formicate	爬动
criterion	准据
sumatra	苏门答腊岛
bantu	班图人
weasel	躲避
ukaea	United
biowarfare	warfare
guide	操纵
experience	阅历
pastellist	粉笔着色画家
maritime	海事
loose	变松
gnaw	咬
banausic	机械式
coordinate	坐标
balmy	止痛的
auditorial	通过听觉
unscrupulous	无道德
lode	复成矿
tricentenary	三百年的
tired	疲倦
gallery	图库
phrenetic	精神病
devalue	减值
augural	卜占
revolted	起来反抗
legalism	拘泥于法律或规定的人
retroflexion	子宫后屈
splenic	脾脏
subflooring	地板下的粗地板
fast	牢固地
bush	矮树丛
unhasty	不慌不忙
folklorish	带民间传说
visit	调查
uprise	上升
cantabank	漫步的歌唱者
clinical	病房用的
inexcusable	不可宽赦的
iterance	重复
kattowitz	=Katowice
complainant	发牢骚的人
artiodactylous	偶蹄动物
windowsill	窗台
floppy	松软的
beige	浅褐色的
stagy	做作的
appear	看来
yucatec	尤卡坦人
charcuterie	猪肉店
barnaby	巴纳比
disaccharose	二醣类
sartorial	缝匠肌
hydrated	含水的
codling	幼鳕
interjaculate	呈弧形射出
balmy	芳香
balky	停止不前的
notably	显著
unconfirmed	未经认可
plessor	敲诊槌
bargaining	议价
upheave	推上去使上升
colorfast	不褪色的
chance	偶然的
foredone	筋疲力竭的
leningrad	列宁格勒
huggermugger	混乱
nonarticulate	不分节的
unnourishing	无营养
asyndetic	使用散珠格的
featured	有……的面貌特征的
motivator	激起行为
warden	看守人
coyly	害羞
fairytale	童话式
harari	哈拉尔族人
msbc	Science
deglutinate	从
moat	城壕
outlet	出口
snifty	傲慢的
tagmeme	序位
directionality	方向性
curse	降祸
develop	进步
exonerative	免除的
egality	平等
crasher	猛击
diriment	使无效的
seed	根据
rattailed	细长的
compossible	可共存的
oxycalcium	氧钙
steal	窃取
misrule	施暴政
demodulator	解调器
hypocytosis	血球过少
primely	最好地
thuriferous	燃烧时散发芳香的
jobbery	假公济私
cutter	刀具
consultive	=consultative
torn	tear的过去分词
centre	集中
nonstriker	不参加罢工的人
shrewish	泼妇一样的
merozoite	裂殖子
dedicatory	奉献的
disillusionary	令人失望
forbye	其他
labyrinthian	错综复杂的
grapey	=grapy
velma	维尔玛
overland	陆路的
qea	康达斯帝国航空公司
cephalometric	头部测量学
unspoiled	未损坏
nasial	鼻根
finity	限定
untuneful	刺耳
sarmentum	长匐茎
caution	警告
forewing	前翅
solan	塘鹅
diligent	细心而继续不断的
notably	特别
reinforce	补充
indiscriminating	无差别
samsara	轮回
azure	天蓝色
disorientation	方向知觉的丧失
pithily	有力地
roughly	概略
tessera	票子
cymogene	粗丁
course	进程
expletory	=expletive
externality	外在性
asturian	阿斯图里亚斯文化
weatherwise	就天气来说
underactor	次要演员
equilibratory	保持平衡的
megadose	大剂量
glycerin	甘油
personify	赋与……以人性
ectal	外侧的
extraofficial	职务以外
drudgingly	苦役般
puritanical	严格
don	先生指导教师
anaculture	细菌混合培养
dreamfully	常易梦见地
nim	窃
crenulated	细圆齿状
gypsite	石膏土
sinuate	波状
gothamite	纽约市民
bluebeard	残酷的丈夫
eventual	万一
tamanoir	大食蚁兽
hypnotist	催眠士
unshroud	暴露
straightforward	dly//
despotically	专制地
torture	曲解
woodbox	=woodbin
felted	黏结起来的
interrelate	相互关连
apl	APL语言
speckless	无斑点
comtesse	女伯爵
uncate	有钩
salomonian	所罗门
birdlime	粘鸟胶
acheron	阴间
inheritrix	女继承人
mizo	米佐人
varvel	对……感惊异
perceivable	可知觉的
quadrilled	方眼的
negrohead	压榨的烟砖
devoice	使清化
grace	优美
ammo	军火
hydrostatical	静水力学的
incondite	粗劣的
pygidium	尾板
weatherly	能驶向上风的
raptured	销魂的
endogamous	同族结婚的
answer	答复说
unhealthy	对健康有害的
nephelitic	霞石
coralline	产生珊瑚
home	在本国
overceiling	超出最高限额的
panchromatic	全色
ladino	拉地诺语
uric	取自尿中的
dress	女服
indulgent	纵容的
miniature	缩影
ryurik	即
octandrious	八雄蕊
pure	纯粹的
stivy	气闷
nonself	异物
flashy	浮华的
jowl	面颊
sudatory	发汗室
rosiness	愉快
pmpo	峰值音乐输出功率
intercity	城市间的
cathedra	主教的座位
polite	客气
garrotte	绞刑
stopover	中途停留
frigging	要命的
start	惊动
reflectoscope	反射灯
umbrageous	多荫
stucco	涂以灰泥
agp	Port
buccal	颊的
swayless	不摇摆
deflocculant	悬浮剂
embryoctony	碎胎术
ireful	忿怒的
account	估计
carper	吹毛求疵者
irak	伊拉克
murrhine	默勒石的
breeder	饲者
convenient	便利
rsv	Revised
unicostate	中脉显明
inequiaxial	不等轴的
deductive	推论
bezazz	活力
roily	生气
triturate	粉碎
awe	敬畏
flex	电线
suction	抽气
weightily	重要地
carnal	肉体的
electriferous	带电的
tapescript	磁带录音稿
kellock	锚
execrate	痛骂
recompense	报偿
swagger	昂首阔步
fast	牢固
embraceor	收买法庭或陪审团的人
exclusively	专有地
plumb	用铅增加重量
threat	威胁
paraphernalia	随身用具
tormentor	使苦痛之人
bookmatches'	NULL)
warrant	辩解
amimeche	A
hematin	血色素
recondensation	浓缩
octette	八重奏
beaux	情郎
drogher	与此类似的船
resolution	分辨率
feticidal	打胎
strumpet	妓女
unimplemented	未实现的
cocurricular	辅助课程的
fleecy	羊毛似的
stressable	可重读的
yield	出产
laboursome	费力的
noteworthy	显著
meanings	含义
squawfish	大型食用淡水鱼
kneesie	碰膝盖
unchangeably	不易
fond	多情
leucin	亮氨基酸
imperceptivity	无感觉
ritualize	使仪式化
mummery	哑剧表演
upfold	使折起
phoneticist	=phonetist
disorder	扰乱
quartziferous	含石英
bimonthly	两月一次的
pruning	剪枝
aspirer	追求者
interceptive	截断的
unsureness	不确定
talonavicular	距的
dogshore	支船柱
fingerling	一指长
sequestered	幽静
activize	激起
conceit	意见
arsenism	慢性砷中毒
godship	神格
cunctation	迟缓
nigrescence	发黑
renew	重申
unconventional	非传统
bruiser	粗壮的人
fist	抓牢
nobody	无人
giving	礼物
untilled	未开垦的
frostbound	冰冻的
khansu	肯聚长袍
declivity	下坡
floriate	用花卉图案装饰
bottomless	难解的
eventful	多事
halves	一学期
fluey	绒毛似
managerialist	经理主义拥护者
foamy	泡沫
magician	魔术师
proctorial	训导长
fallow	未孕的
jestingly	闹着玩地
phaeacian	费阿刻斯人
catv	有线电视
jaggery	粗糖
hoo	呼!
seafox	长尾鲛
laibach	卢布尔雅那
snubby	好轻视人
supergranulation	超米粒组织
positivism	自信
hypervisor	管理程序
fastish	有些放荡的
skintight	紧身
exoderm	外胚层
dyadic	双值的
pgdn	翻下页
lax	松懈
titanic	钛的
mantic	预言性
illumine	使明艳照人
kpc	kiloparsec
dispersal	分散
underappreciated	未受到充分赏识的
impenitent	不悔悟的
premium	奖赏
distensile	会膨胀
capeesh	=coppish
antalkaline	解碱
satisfy	满足
roulette	转迹线
pungent	刺激性
undiscerning	无辨别力的
inexpugnable	不能攻占
mspe	Master
delusterant	去光剂
luniform	月状
eared	有耳的
tumidly	肿胀地
pretense	借口
rampant	狂暴的
glume	颖
chitchat	聊天
pleiotropic	多效性的
investigative	研究
vassalic	封臣
greaser	加油器
temptable	可诱惑
hideous	可怕
benthal	水底
whitepox	乳白痘
sighthole	检查孔
sniffle	抽鼻子
radiography	X光线照相术
expellant	驱逐剂
ccpit	Council
pondweed	水池草
spurt	迸发
endoglobular	血球内的
fissionable	可分裂的
garnett	扯松
angostura	安古斯图腊树皮
alaskan	阿拉斯加人
acoustic	声学
pale	使变苍白
urticariogenic	致荨麻疹
lessee	租户
laevorotation	反时钟旋转
deceiver	欺人者
gnarl	瘤
upborne	被升高
hypothesis	假设
camion	军用卡车
tartarian	鞑靼人的
microcontinent	微大陆
diallel	异雄同雌
halophilous	适盐质环境生长的
lucius	卢修斯
dividend	股息
bootjack	脱靴器
posnjakite	一水蓝铜矾
dissidence	意见不同
tinkerly	笨拙
costean	井探
uss	United
conjury	变戏法
nationalization	同化
hindustani	印度斯坦的
tournament	锦标赛
inferior	下级的
ashen	苍白的
sonority	响亮
benthos	海底的动植物群
incised	雕刻的
hornbook	小孩学习用的文字板
acting	起作用的
distaffer	家庭中之女性
slickness	巧妙的
ramous	多枝
counterbalance	使平衡
incombustible	不燃性的
jittery	战战兢兢的
seat	所在
flavourful	美味
gigmanity	庸夫俗子
materials	原料
pestiferous	邪恶的
chymic	化学
alleviative	缓和剂
offhand	即时地
suspectable	值得怀疑的
garlicky	大蒜似
suddenness	突然
manor	领
lumphead	笨人
hawk	咳嗽
miniscule	草写小字的
impassably	无法通行
heatproof	抗热的
pessimal	最差
gambol	耍闹
peruse	细读
harlotry	淫妇
easterly	从东方来
distortion	失真
overcolour	过份润色
pertly	冒失
wiriness	铁丝状
adult	成年人
diallel	双重的
paediatric	儿科医学
arability	适合耕种
information	信息
depressingly	抑压
inconsonance	不调和
anastomosis	接合
agamic	无性生殖的
railery	善意的嘲笑
nu	纽埃
retrochoir	的后部
wwf	World
opportunist	机会主义者
swash	虚张声势
zoophoric	具有动物形
epipteric	翼上骨
slummer	出入贫民区工作的人
boorish	粗鄙的
slapdab	正好
nearness	接近
lean	歉收的
niff	恶臭
lurch	击败
piping	平静的
controllable	可管理
adytum	内院
pity	可怜
unappealing	无吸引力
riba	Royal
expugnable	可突击的
impendent	迫近的
direct	直系
angled	成角的
ping	子弹飞过空中的声音
collaborative	协作的
leeward	在下风方向
caitiff	卑鄙男人
tumorous	肿瘤性
colorimetric	比色的
simpleness	单纯
lull	使安静
speakerine	电视节目女主持人
snowflake	雪花
convulse	使抽筋
tobacco	抽烟
micelle	微胞
cling	坚持
belabour	不断辱骂和嘲弄
bang	发巨响
bernice	伯妮斯
abundant	丰富的
demagog	群众领导者
subdiaconate	副助祭之职位
batty	古怪
naupathia	恶心
hydrocephalic	脑积水
uncomfortable	不安的
ignoramus	不学无术的人
topocentric	地面点的
moil	混乱
encyc	encyclopedia
unprison	把……从监狱释放出来
belligerent	交战国的
caffeol	咖啡油
monied	=moneyed
fsf	自由软件联盟
blazon	广布
specialist	专家
ecdysis	蜕皮
redden	变红
overdub	原带配音
tumidly	隆起
dutiful	顺从
mercury	墨丘利神
aline	排列
reconcile	使和谐
intermediate	媒介
hyperplastic	数量性肥大
capernaism	迦百农主义
overtime	超时的
whimsey	奇想
rrl	Reference
atmospherically	气压所致
unregistered	未注册
scheelite	白钨矿
talonavicular	距
variegate	使多样化
lenitive	润泽
expend	把绕在杆上
vmd	兽医学博士
nibble	细咬
emptiness	空虚
zooflagellate	动鞭亚纲原生动物
unsanctioned	未认可的
sudanese	苏丹人
lemonish	有柠檬香味的
chiromegaly	巨手畸形
tennantite	砷黝铜矿
vacuum	真空的
hyperphysical	超自然
mystagogue	秘法家
walkable	适于步行
polymorphous	多形的
pyrographer	烙花人
waver	开始退让
perineal	会阴的
affenpinscher	猴绠
confirm	确认
chandelier	树枝形的装饰灯
unintelligible	莫明其妙
oleomargarine	人造黄油
volucrary	鸟类论
xsl	Language
flaring	发光
emunctory	排泄管
equability	平静
talon	爪
religionist	宗教狂热者
chillness	冷淡
apposite	适当
darshan	增禄
horizon	地平线
legalize	公认
rightfully	正直地
incongruent	不一致
bluntly	坦率地
machinability	机械加工性
crisscross	画十字形于
smack	拍打
fretsaw	圆锯
chemosterilize	用化学绝育剂使
oenophile	嗜酒的人
rejectamenta	废弃物
function	作用
alingual	任何语言都说不流利
horizontal	水平的
flockbed	装有毛屑的床
gab	多嘴
libelous	用言语中伤他人的
sesquipedalian	令人厌倦的
ariose	如歌的
winona	威诺娜
pavilion	搭帐蓬
codiscoverer	共同发现者
kindly	爽快
defensibly	可辩护地
eterne	=eternal
subabdominal	腹下
mishandle	胡乱操作
immission	允许进入
corresponding	相应
plo	巴解组织
pons	连接部分
celeb	名流
unbarbered	未理发的
heterogen	异型杂种
irritating	刺激的
kavass	武装警察
untenanted	无人租赁
irrotationality	无旋性
zaratite	翠镍矿
symbol	记号
jabot	胸部装饰
ceaselessly	不断
aspherical	非球面的
farthest	最远
disfranchisement	剥夺公民权
tablet	便笺簿
entire	完整
wire	铁丝网
proteiform	多型的
essentic	有表情
bpi	bytes
disillusionary	令人失望的
patrician	贵族
thrust	强行推进
sniffy	自命不凡
tefillin	经文护符匣
buttony	多钮扣的
complicitous	=complicit
unbesought	未恳求
preludial	序言
tideway	潮路
asi	空速指示器
powerfully	强大地
trigram	三字铭
liege	列日
pragmatist	实用主义者
interoceanic	大洋间的
aaup	University
frgs	Geographical
or	Operations
promotional	奖励
lowland	低地
recreancy	变节
geocarpy	地下结果性
sorosilicate	俦硅酸盐
acetaminophen	醋氨酚
sureness	确实
vasectomize	切除……的输精管
inquiring	爱追根究底的
chitarrone	基塔隆尼琴
laughing	笑
roseate	乐观
vraisemblance	真实性
detrusion	推落
neapolitan	那不勒斯
plan	平面图
extraparliamentary	国会权力以外
reductant	=reducing
flabbiness	软弱
socotra	索科特拉岛
error	过失
regulate	控制
perjured	犯伪证罪
administrative	court//
wastebasket	废纸篓
iupap	Union
puffy	气喘吁吁的
tousy	凌乱的
worry	烦恼
dysphasic	患言语困难的
warrant	授权
nabobess	女财主
nested	嵌套
hamiticize	使含语化
storage	贮藏库
moviedom	电影圈
bivouac	露宿
inebrious	醉
camisa	女用衬衫
iconically	形象地
noumenal	实体的
repentant	有悔改表现的
uncommon	不凡
unseemly	不恰当
extravasation	溢出物
bubble	泡沫
accountably	可辩解
profile	侧面
impartibility	不可分
luxuriously	豪华
triphenylmethyl	三苯甲基
fmi	国际货币基金组织
turnspit	负责旋转烤肉叉的人
charge	指示
tutor	家庭教师
bere	大麦的一种
melissa	梅利莎
integrate	使成整体
neoarsphenamine	九一四
scholastical	=scholastic
quasar	类星体
cyclonic	飓风
dipteran	双翅类
recalcitrant	顽抗
inform	通知
boskage	树丛
ocotillo	马鞭
whet	磨快
flagellated	生有匍匐茎的
exclamative	=exclamatory
liberian	利比里亚人
aluminate	铝酸盐
sunfed	Economic
gearchange	=gear
masterless	无主人控制
playstation	游戏站
folie	疯狂
defier	挑战者
piripiri	红辣椒酱
matin	晨歌的
waste	使荒芜
segregable	可分离
iasi	雅西
summons	召唤
local	慢车
indefensible	无辩护余地的
sanskrit	梵语的
dishearten	使……失去勇气
vocational	职业的
relatum	被关系者
dad	爸爸
specific	特效的
retrofocus	反远距的
internetwork'	NULL)
somnambulate	梦游
gracile	细长
executive	行政的
result	导致
trailing	曳尾
feces	粪
cernet	and
uneventful	平凡的
lassen	Peak
discursiveness	推论
disconnected	分离的
speciology	物种学
untoward	困难的
dippy	昏头昏脑的
aeriferous	装气
limberneck	肉毒棱菌中毒
towhee	红眼雀
ultraviolet	紫外线
diaspore	水铝石
poise	准备好
abrupt	突然
vagabond	漂泊
carnie	游乐场管理员
martialize	使具有尚武精神
temporomandibular	颞下颌的
unitar	Training
repose	建立于
gobang	联珠棋
unlawfully	不正当地
corporately	共同
tularaemia	土拉菌病
ssfdc	State
verjuiced	不高兴
parlous	危险
mistune	使走调
ps	附录
scrouge	挤
corrupt	腐败
jacksonian	杰克逊思想的
spatiography	空间物理学
coterminous	连接的
overcharge	讨价过高
unversed	无经验
bowery	有亭子
emanate	发源
usual	惯例的
mgd	per
hirudinoid	水蛭
ninepence	九便士硬币
homefelt	舒适自在
virulent	有病毒的
gaming	赌博
gagman	笑料的作者
rechargeable	可再充电
ganefo	Emerging
searching	透彻的
nidnod	使点着头打盹
ghazze	=Gaza
lepcha	雷布查人
triandrous	三雄蕊
lumping	很多的
supercolossal	超大
snog	接吻
postal	邮局
economizer	节约装置
feigned	假的
gastronomical	美食学的
misquotation	错误的引用
feoff	封
trample	践踏
handwrought	手工的
scapular	肩
glandular	起腺体功能
falseness	不正确
hidrotic	发汗
trivialness	琐碎
unassailed	未受攻击的
tawie	顺从
imperviously	透不过地
stiletto	钻孔锥
exalt	晋升
collect	由收件人付款
mushroomy	蘑菇
stopper	塞子
plexiglas	树脂玻璃
ariot	长得过于茂盛的:
iridize	以铱覆盖
ring	环形物
telodendrion	终树突
fallacious	靠不住
coppery	铜一样的
gama	grass鸭茅状摩擦禾
wingman	边锋
liegeman	忠实的部下
undermost	最下的
mappable	可用图上标示的
wineshop	酒店
msphe	Master
positive	肯定的
shuffleboard	推圆盘游戏
tradable	可买卖
diacid	二酸
tinge	微染
hii	Health
pedograph	纸上脚印
sputteringly	结结巴巴
fidelity	逼真度
eminence	崇高
hilac	重离子直线加速器
emarcid	凋谢
nervy	肌肉发达的
sig	Special
elliptoid	椭圆状的
overtop	高耸……之上
fisher	食鱼动物
farinose	含粉
interfoliaceous	叶间的
lanigerous	有细毛
reinvigorate	使再振作
hong	商行
short	弱
keeping	遵守
ragamuffinly	流浪的
transcurrent	横推
hideously	可怕地
qse	engineer
deplumation	除去羽毛
papery	象纸
misgive	使怀疑
salve	涂油膏
convergent	会集于一点的
entity	实体
inquiring	咨询
neoplasia	瘤形成
jaundiced	有偏见
producing	生产的
pickapack	=pickaback
coenogenetic	=cenogenetic
coda	终结句
refluence	倒流
selectorate	代表选举团
manhood	成年
alkylate	烷基化物
starting	出发
working	经营的
pnr	no
conformism	因循守旧
remnant	残留
phyllary	总苞片
fibrotic	纤维变性的
resettlement	再定居
unclos	of
crudeness	不成熟
ranging	广泛搜索
presidial	总统的
umbrous	荫处
pyrethroid	拟除虫菊酯
associate	合作人
disorganized	无组织
petrifactive	造成石化
resorptive	再吸收
twentymo	二十开本
attire	服装
wobble	摇摆
postimpressionism	后期印象派的
iocu	Consumers
overplow	对……犁耕过度
sclerodermatitis	硬化性皮炎
slapdash	匆促
stallman	摊贩
homoeothermic	同温的
tremolo	震音
exaggerated	夸张的
ideaistic	思想的
unconformity	不适合
nucleochronology	核子年代学
tankman	坦克兵
popedom	辖区
hypoacid	酸度过低的
scenic	风景照片
inevitably	不可避免
echovirus	人肠道孤病毒
deformalize	简化:
pacemaker	标兵
blossom	花
enunciative	宣言的
thalamium	闺房
faconne	细花纹织物
spinneret	喷丝头
tromba	小号
endearing	可爱
saturnian	土星的
assimilation	同化
megadose	给予……大剂量
butyral	丁缩醛
hilum	脐
pmkd	邮戳盖讫的
iamap	国际气象学和大气物理学协会
tribesman	部落男子
irascibility	脾气暴躁
sniff	发觉
currejong	=kurrajong
thereinbefore	前头
puristic	修辞癖
avertible	可防止的
semidesert	半沙漠
causalgic	灼状神经痛
paraquet	=parakeet
hectic	脸红
festally	愉快
sweated	使用血汗劳工的
unpunctuated	未加标点
busier	比较忙碌
chary	吝啬的
mulch	覆盖
fls	of
pamper	纵容
trepan	诱入圈套
radicalness	极端
cloze	填充测验法的
unneutral	片面的
auspice	预兆
fusimotor	肌梭运动神经的
rework	重写
ymha	Association
impreg	浸渍木
plagiarism	剽窃物
treescape	树木风景
politely	客气
jadish	疲倦
decimal	小数
pachysandra	富贵草属长青地被植物
dossy	好看
guts	狼吞虎咽
virulency	恶意
epidermal	表皮
fossilize	搜集化石标本
sphalerite	闪锌矿
jabez	杰贝兹
unglamorous	乏味的
rockfest	摇滚音乐节
ho	Ho
description	种类
experience	经验
urination	撒尿
limburgite	玻基辉橄岩
spinous	难弄
picture	照片
dissociability	孤癖
eikon	画像
abruptness	突然
mpls	Label
unenlivened	不活跃
great	强烈的
righthearted	正直的
depart	过去
teeny	极微的
earthshine	地球反照
extraterritorial	rI9tR:rI`AlEtI/n权地
maladaptive	显示不适应的
reformatory	改革的
spatiotemporal	时空的
overdaring	过于大胆的
gentile	非摩门教徒的
bluff	直率
dentary	有齿的
busyness	繁忙
converse	颠倒
quemoy	见Jinmen
wbo	Organization世界拳击组织
faltering	支吾
bravo	亡命徒
phloroglucinol	根皮酚
garrya	嘎瑞木
protestor	抗议者
takovite	水铝镍石
dieffenbachia	花叶万年青
superimpose	添加
antifertility	避孕
outer	外部的
brambly	有刺
tristigmatic	三柱头
scarlet	鲜红
skirmisher	散兵
columbine	鸽似的
kami	神
speechless	不能说话
obsession	困扰
atelectatic	肺膨胀不全
calendarian	日历的
korean	朝鲜人
kentledge	压舱用铁块
gripe	柄
carefree	无忧无虑的
vicinity	邻近
vile	卑鄙的
directoire	执政内阁时代式
snafu	使混乱
curtail	缩减
plodding	沉重缓慢
delay	迟滞
mobilise	动员
discourteously	不礼貌
vehicular	用车辆运载的
arenicolous	生活在沙中的
footle	呆话
mandible	下颚
polytechnic	工艺学校
tributary	附庸
dolores	德洛丽丝
neurosyphilis	神经梅毒
assimilable	可同化
cao	首席行政官
cadastral	土地清册
iniquitously	不正地
savoury	开胃的
weatherworn	风雨侵蚀
saltillo	萨尔提略
inventory	总量
rousseauist	的信徒
time	分期的
folkmoot	群众大会
stippling	点画
spectrograph	声谱仪
arhythmical	无节奏的
revolutionize	大事改革
glamor	魔法
apomixis	单性生殖
recantation	改变论调
solubilization	增溶
deadman	临时支撑物
patronizing	要人领情
delusive	欺骗的
tetrahydrofurfuryl	氢糠基
oracle	神使
protrusive	凸出
ungraceful	下流
attap	=atap
her	pro
weasel	告密
kirlian	基尔良
perversion	颠倒
spilehole	小气孔
unspent	没有用完
benthonic	海底
stop	终止
boeotian	迟钝的
ocso	the
flighty	反复无常
toon	红椿
egregious	异乎寻常
unflaggingly	不衰地
deathblow	致命的打击
brusquely	唐突
decidedly	果断地
incorporation	合并
fainthearted	无精神
solvent	溶解
cytophotometry	细胞光度测定法
personalize	使成私人的
flq	de
oculist	眼科医生
irq	interrupt
liquidambar	胶皮糖香液
intranational	一国之内的
sken	凝视
telephony	电话制造
softy	笨人
contour	轮廓
ft	Financial
regrade	重分等级
brontosaurus	雷龙
slimline	细线电缆
transmit	传播
hyperacidity	胃酸过多症
excogitate	研究出
crake	秧鸡
flibbertigibbet	不负责任
ankylose	胶着
derange	使发狂
band	队
genevan	日内瓦人
invaluable	价值无法衡量的
phosphorescent	发出磷光
majestical	宏伟
adulate	谄媚
wsa	Administration
falanga	打脚板刑罚
interceptive	截断
damsite	水库所在地
haloplankton	海洋浮游生物
tacnode	互切点
telurate	碲酸盐
parochiaid	政府给予教会学校的资助
lowest	最低
reinstitution	再建立
crossgrained	纹理不规则的
aye	赞成票
bechuana	贝专纳人
cnd	Campaign
katakana	片假名
slatted	用板条做的
thumbscrew	翼形螺钉
asbestos	石棉
philobiblic	爱好文学
mercantilism	营利主义
catnap	假寐
footstall	柱子的座坐或台座
blazon	宣布
unga	联合国大会
induce	感应
prevent	防止
visitor	来宾
systemless	无规则
overset	打翻
redraft	重新起草
balmy	止痛
autarch	独裁者
wildcard	通配符
precursive	=precursory
lecithin	蛋黄素
boreal	北
shiner	发光体
seizing	抓
lythe	青鳕
notgeld	应急货币
timberhead	船肋骨端头
fairly	相当地
inconsistent	矛盾
somnambulism	催眠梦游症
truckle	脚轮
hippological	马学
homogamous	雌雄同熟
diapsid	具双窝的
snippers	手剪
bestial	野兽
fustiness	霉臭
escapeproof	防漏泄的
showman	马戏团的老板
hygienically	卫生地
slavish	盲从
finis	终结
affrontedness	被冒犯
longevity	寿命
gassy	吹牛
wrong	错误地
pentobarbitone	=pentobarbital
housework	家务事
inessive	指示位置的
tyrannic	专制君主的
twinkling	闪亮
polyethnic	多种族的
azotic	氮的
scathing	严厉
virilocal	以男方家庭为中心的
inextirpable	无法消灭
savoie	=Savoy
maxilla	小颚
doozy	非常出色的人
affected	受到影响的
stoppage	中断
hokey	做作
unconfiding	缄默
capacity	能力
metastasis	转移
pteridophyte	羊齿类
splotchy	沾上污点的
film	薄雾
kepi	法国军用平顶帽
uptime	正常运行时间
endogamous	同系交配的
presentable	象样的
peregrination	游历
hypocotyl	子叶下轴
neuroplasm	神经原形质
dished	中凹的
filterable	可滤过
enrollment	注册
scruple	犹豫
eurygnathous	上颔宽大的
coil	卷
amusedly	好玩
humanist	人文主义者
prescription	药方
etr	外部数据传输速率
entail	使承担
symplesite	砷铁矿
posse	一队
retinue	扈从
deflorate	已开过花
portly	健壮
inconceivably	不可思议
engird	围绕
concubinage	非法同居
drossy	浮渣一样
moderato	中等速度
shift	推卸
muffin	松饼
shoal	沙洲
rabelaisian	粗俗幽默的
nice	拘泥
noneffective	无效
rozener	烈酒
receivership	破产在管
kongo	刚果人
fire	放枪
powder	搽粉于
eventless	平静无事
shamus	私人侦探
nonviolently	非暴力地
hyperverbal	极其罗唆的
rotatory	引起旋转的
chalybeate	含有铁质的
manrope	扶手绳
fmn	mononucleotide
interblend	混合
conflicting	相冲突
paralegal	辅助律师业务的
inertial	不活泼
dystrophia	营养不良
outline	要点
floatable	可漂浮
fettle	情绪
chief	最有价值的部分
systematiser	=systematizer
popularity	普及
cornerways	斜地
emplacement	炮台
academe	研究院
butterball	胖子
unhappy	不快乐
ultramundane	太阳系之外的
godless	无神论者
hallucinatory	引起幻觉的
iatrical	医疗
intercurrent	间发的
unreceptive	反应不快
supranatural	=supernatural
wusih	见Wuxi
mauley	手
rebel	造反
mythomania	说谎狂
feigned	做作的
readdress	使重新着手
sir	爵士
apanage	属
masher	调戏妇女者
buckshee	额外津贴
prizefighter	职业拳击手
fidelismo	古巴革命主义
jump	暴涨
heirdom	继承的财产
derange	使错乱
peritoneal	腹膜的
refrigerate	冷藏
jump	跳跃
translation	调任
botryoid	一束葡萄状
toxoplasmosis	弓浆虫病
campaign	从事活动
hoyt	霍伊特
literati	文人
halfhourly	半小时
rattled	恼火
cataphyll	低出叶
accredited	公认
globularity	球形
clergyman	牧师
squalidity	肮脏
bibliographer	书志学家
best	最
intervene	插入
quilt	棉被
congealment	冻结
dataller	计日工
shoreless	无法上岸
tactually	凭触觉地
volitant	能飞
limpet	坚守岗位的职员
inept	不称职
embraceor	企图以非法手段左右法庭或陪审团的人
disbench	使离座
amr	Audio
nefariously	邪恶地
body	团体
utricular	小囊状的
peroxyacetyl	nitrate
summerhouse	亭子
phyletic	种族的
violin	小提琴手
admensuration	测量
ventilate	使通风
hygienist	卫生学者
magnify	夸大
zarape	=serape
bifid	两裂的
euchre	打败
msa	in
speedometer	速度计
hoodwink	蒙蔽
wry	扭歪
ratable	可估价的
ced	for
constellate	定名为星座
extorsively	勒索地
cnaa	全国学术奖理事会
bactrian	大夏
embus	装入大客车
pony	小型马
mediation	仲裁
injudicial	不聪明的
asonant	无声音的
secretory	分泌腺
orad	向口
corporealize	使形体化
gharial	=gavial
scattershot	漫无目标的
swbw	west
eczema	湿疹
peripherad	向边缘
garnish	装饰
deductive	演绎
headrace	送水渠
disfavor	不悦
jadishness	邪恶
lesbos	莱斯博斯岛(即米蒂利尼岛
precatory	委托
placentiform	胎盘形的
stray	漂泊
autumn	秋天
haystack	干草堆
moslemic	伊斯兰教的
aid	Association
portion	一部分
kingbird	极乐鸟之一种
electriferous	传电的
planometer	测平器
nucleinase	核质酵素
marsquake	火星震
elamitic	埃兰人的
preadamite	亚当以前的
chloralose	氯醛缩葡萄糖
arrisways	对角
precise	准确的
scratch	乱涂
heavyish	略重
cornfield	小麦田
penstock	压力水管
enfeoff	让渡
unmarked	未被注意的
flotage	漂浮
furphy	谎言
deaerate	从中除去气泡
abide	遵守
chump	大木片
defocus	使散开
euphuism	华丽词藻
scowl	怒目而视
narky	易生气的
gauze	薄雾
pseudology	说谎术
acrospire	幼根
semilunar	半月形
woolpack	卷毛衣
cookie	小甜饼
galibi	加勒比人
reunification	再统一
flabbergast	哑然失色
closemouthed	沉默寡言的
hostess	女主人
biotherapy	生物制剂疗法
conformance	一致
concessional	容许的
ragazza	女郎
diatribe	诽谤
supposable	可想象得到
hiaa	美国健康保险协会
slobber	淌口水
sitting	坐着
position	阵地
factoried	多工厂
mohammedan	回教
carburization	渗碳
keyman	关键人物
punner	夯
awesome	引起敬畏
inflectional	屈曲
tournure	腰垫
malleate	将……锤薄
dyschronous	时间不一致
isometrical	等大的
loomage	织物
hempie	爱恶作剧的
headquarter	设总公司于……
semifarming	半农业
stage	戏剧
gentlefolk	上流人士
bottomless	难解
wildcatter	创业不可靠企业者
overpassed	已废除的
tetragynous	四雄蕊
boomslang	非洲树蛇
closing	结束的
parenteral	不经肠的
reversed	翻转
cicada	蝉
somasteroid	体海星纲的
hate	恨
indestructibly	无法破坏地
sniffable	可闻的
pardon	原谅
phanerogamic	显花植物的
hieronymite	以圣哲罗姆名字命名的隐修会会员
prurigo	痒疹
interneuron	=internuncial
sheriff	郡治安官
downright	明白
grub	幼虫
beaver	海狸
seclusive	隐退性的
camping	露营
recreant	懦夫
furtively	偷偷
fondly	盲目轻信地
ced	Committee
flocculus	小叶
biserial	与双列有关的
barycentre	引力中心
freshness	精神饱满
oligophrenia	=mental
appurtenant	隶属
savoury	开胃
coenobitism	修道院之制度
sternness	严厉
crm	Management
marsupialise	=marsupialize
resignation	辞职书
hearth	炉膛
dewiness	露状
arrivederci	再会
airwoman	女飞行员
endsville	首屈一指的
cipherkey	密码索引
motoric	肌肉运动的
festucine	稻草色
slender	微弱
msdn	Developper
swift	迅速
manageress	女经理
stearic	硬脂酸的
ferrite	铁素体
idiocratically	特性地
vial	装入小瓶
woodenness	粗鲁的人
agonist	收缩筋
cerebrotonic	表示大脑紧张型特性
vdi	虚拟设备接口
skinhead	理平头的男人
sephardic	西班牙系犹太人的
deprecatingly	不赞成
set	趋势
flagitious	凶恶
nazareth	拿撒勒
inferable	能推理
chief	首席
maidenlike	娇羞的
chromoplasmic	染色浆
insurrectionary	暴动者
removal	免职
smokeable	=smokable
standard	本位
limicole	水蚓
scansion	韵律节奏的分析
barlow	巴洛刀
renegue	违例出牌
koan	以心传心
rebel	叛逆者
mali	马里
smart	轻快
interested	有成见
kiln	烧窑
hazel	榛子
blithering	唠叨不已
heavyset	体格魁伟的
trickiness	狡滑
stump	绊倒
unfading	永不辜负期望
nota	背板
ratify	批准
zincographic	锌版术的
sunkissed	受阳光照射
ominously	恶兆
jingoish	侵略主义的
hyperostotic	骨肥大的
toneme	调素
mwa	Modern
childbed	分娩
uricase	尿酸酶
ersatz	人造
finlike	鳍状
saudi	沙特阿拉伯国家
mythicize	视为神话
crenate	圆锯齿状的
zamindar	印度地主
interval	距离
undeviating	不离正道
bureaucratese	官腔
gelsenkirchen	盖尔森基兴
roily	搅浑
backbiting	诽谤
sweetish	有点美丽的
francophil	亲法的
iconodule	卫护圣像者
triploid	三倍性
rgs	皇家地理学会
solicitude	热心
fortaleza	福塔雷萨
other	从前
longevous	长寿的
wakashan	瓦卡希语组的
odontoblast	成牙质细胞
guiltily	罪
battlewise	身经百战的
necrophagia	食尸
dissertation	专题
glyconic	格莱坎诗体的
tee	球座
corneous	角质的
bionic	利用仿生学
hyoid	U字形的
hardhearted	无情的
temperately	适度地
abnormity	不规则
withdrawment	=withdrawal
jellify	成凝胶状
wearable	可佩带
yafo	=Jaffa
spin	纺纱
ethnarchy	总督的职位
place	地位
unbalance	失去平衡
amentiferous	具葇荑花序的
denouement	结局
ialc	instrument
possibly	或者
hypersuspicious	极其多疑
parthenopaeus	帕耳忒诺派俄斯
locale	场所
majestical	庄严的
gasometric	气体定量分析学
retroperitoneal	腹膜后的
astigmatism	因偏差而造成的曲解或错判
overconfident	过于自信的
wreath	圈状物
episematic	花纹使同种动物互相认识的
candid	率直的
performing	履行的
expediency	私利
ssafa	Sailors''
parenthetical	插句
aerarian	财政的
sedentary	沉积的
substitute	代用品
activation	活化
disharmonious	不和谐的
lewd	淫荡
detector	侦察器
lapactic	促泻剂
standing	直立的
dictatorially	独裁
hagride	折磨
influence	势力
frowsy	不整洁的
cyclopic	独眼巨人般的
ponderosity	笨重
breakwater	挡水板
womanliness	女性气质
email	电子信函
quicksand	危险而捉摸不定的事物
nick	缺口
xenophobic	恐外
arenicolous	生长在沙中的
cab	出租马车
superduty	超级耐高温的
mib	Information
price	代价
singular	非凡
kemp	冠军
bodkin	大眼粗针
cycloserine	环丝氨酸
chunderous	令人厌恶
impercipient	认识不足
tubular	管状
scratch	打草稿用
spill	摔下
boldfaced	厚颜的
reenlist	再从军
ptyalism	流涎
recoal	重新添煤
sapful	多树液
pram	RAM
nur	Railwaymen全国铁路职工工会
senopia	老年期视力回春
mage	魔术师
disseat	使离座
businessmen	生意人
nonstriker	陪跑员
vitellophage	消黄细胞
final	决定性的
phenanthrene	菲
diffused	普及的
increasing	越来越多
myxomatosis	粘液瘤病变性
cosily	舒适地
alewife	啤酒店女主人
bnd	Bundesnachrichtendienst
justiciary	司法上的
internuncial	联络的
chaff	戏弄
oofy	有钱的
faints	劣质酒精
fucked	受骗
outdoor	户外
foundation	创立
hemichordate	半索动物纲的
wae	Application
sup	体验
bepaint	着色
liberally	大方
classic	第一流
knap	敲击
value	值
blindfold	看不清
heroize	以英雄自居
vesa	视频电子标准协会
migrate	迁徙
afeared	恐惧
flurr	飞起
agonisingly	烦恼
unfrequented	人迹罕到的
unappealable	不可上诉
underproof	不合格的
stoss	迎鼻崖的
unrelenting	不屈不挠
seam	缝合线
jingoish	侵略主义
triplicity	三个一幅
ganoid	硬鳞鱼
budge	移动
unpregnant	不合适
quadrisyllable	四音节字
gastral	胃的
epulary	宴会的
greet	向……致意
prepose	将前置
toothsome	美味
pustular	有小脓疱的
antiauthoritarian	反独裁主义者的
logographer	希腊历史家
inconscient	无意识的
pedestal	支持
kinsmanship	酷似
profound	意义深远
towering	激烈
edge	利刃
candent	灼热的
dipartite	划分
postern	后门的
shorthorn	刚到边远地区的人
lipogram	避讳某字之文
carpal	腕骨
spleuchan	烟袋
clump	土块
bushbeater	寻访人才或探求民情者
import	引入
interdepartmental	各省间的
sneering	嘲笑
hydrostatic	流体静力学
hemimetabolous	不完全变态中
barococo	巴洛可可式
diphyletic	来自二个祖先的
instantaneous	即时
consummate	完成
ecliptic	蚀的
unselfishness	不自私
bundook	步枪
longeval	长命的
countermine	对抗计划
raising	举
rhetorically	讲究修辞地
tracheotomy	气管切开术
lionlike	狮子般
postmortem	死后发生
federative	有外交和国家安全
bookable	可预订的
provenance	起源
latria	专对天主的礼拜
dubious	可疑
semifarming	半养殖业
vtp	Trunking
unjustifiable	无法辩护的
semimanufactures	半成品
poc	call
lank	瘦
amortization	分期偿还
subsidiary	辅助
linguistry	语言知识
retch	恶心
deception	诡计
automobilism	汽车驾驶
pedodontic	儿童牙科的
apolar	非极的
aubergiste	小旅馆主人
cosmologist	宇宙学家
trendy	流行
baccivorous	食浆果的
supremely	无上
lavatory	浴室
unexpiated	未赎回的
disubstituted	二基取代了的
preferable	更可取的
samnite	意大利一古民族人的
infantilism	幼稚症
ruffianly	残暴的
febriferous	造成发烧的
delicate	灵敏
cowish	胆怯的
derma	烤牛香肠
hesitation	犹豫
leavisian	利维斯式
rear	培养
checkerberry	蔓虎刺之一种
aedile	古罗马掌管公共建筑物、道路、供水、社会秩序和文娱活动等的民选行政官
lapidarian	刻在石头上的
nationality	民族
tellable	值得说
cebu	宿务岛
copen	=Copenhagen
druidical	督伊德教徒
horsefaced	脸长而难看的
neoanthropic	智人
peace	和平
semidiurnal	每12小时一次的
yabby	小形螫虾的一种
bx	exchange
surrenderor	让与人
over	额外的东西
apivorous	以蜜蜂为食的
cyclopaedist	为百科全书撰写条目者
costermansville	科斯特曼斯维尔(扎伊尔东部城市布卡武
ammeter	电表
cotonou	科托努
unimposing	没有威信
furunculosis	疖病
scalewing	蛾
smarmy	爱说奉承话的
parlous	不易对付
harrowing	痛心
trunk	干线
cmtc	国民军事训练营
chastiser	惩罚者
roric	带露水
aerially	空想
sheeny	犹太人
aauw	美国大学妇女联合会
brigand	土匪
overhead	在头上
lankiness	过分细长
uricacidemia	尿酸血症
typification	象征
illegitimacy	反常
pretext	托辞
epileptiform	癫痫样的
sulcus	沟
deadwood	碎屑
damnification	损伤
lamish	有点跛
civil	全民
hemoptysis	咯血
esteem	把……看作
counsel	辩护律师
lapidarist	玉石雕刻
inimicable	有害
madcap	轻率
sulfury	硫磺的
icky	讨厌的
avirulent	无致病力
cebuan	宿务
fenitrothion	杀螟松
armoire	大型衣橱
nosh	点心
merryman	小丑
arbour	凉亭
kep	阻止
stenographer	速记员
tibiotarsus	胫跗骨
tableful	一桌东西
colicroot	腹痛根
francicize	使改用法语
sadhu	哲人
carabid	步甲
criminative	使负罪
berkshire	波克夏
foa	Operations
dichroitic	二色性
impenetrability	不可测知
inferior	自卑
set	固执
fijian	斐济人
artificial	假的
unexacting	不严厉
hawk	叫卖
maximal	最大
childproof	能防止孩童瞎摸弄的
practically	实际上
faciolingual	面部与舌的
rigor	严密
lesion	身体上的伤害
ada	艾达
assign	指派
xylotile	换质石棉
lizzie	廉价的破旧汽车
drive	推动、发动
steady	坚定的
cocomat	椰子树皮所编织之物
highjack	劫持
thug	暴徒
rattlepated	愚蠢多嘴的
chappy	家伙
scintigraphy	闪烁扫描法
honied	甜如蜜
finish	完成
withershins	逆时针方向地
fightback	回击
learning	学
vm	虚拟机
strikebreaking	破坏罢工
numerical	用数表示的
snowbrush	毡毛美洲茶
plainsman	平原居民
predomination	优势
pony	付清
hand	掌管
msgm	政府管理学硕士
sabbath	安息日
dumps	抑郁
zoological	动物学的
tuppence	两便士铜币
validate	证实
mashy	=mashie
ease	减弱
accounting	清算帐目
rueful	悔恨的
intergalactic	银河间
myogram	肌动图
ectogenous	外生
irrepressibly	镇压不住地
unbelievably	难以置信
contabescence	衰亡
hardhattism	高压手段
preferable	更优越
fossa	沟
red	红衣服
converse	认识
gainable	可得到的
harmonicon	一种自动风琴
psychiatric	精神病治疗的
whitebait	鲱鱼的幼鱼
deathplace	临终之地
reformulate	再用形式表示
belletristic	文学研究的
justle	拥挤
spermatic	精巢
miserable	可怜
hepta	七
gold	金制的
spaewife	女预言者
knapsack	背包
whereby	为何
carpal	腕骨的
trust	热望
mitten	棒球手套
predestine	预定
great	得意地
plosive	爆破音
emblazon	颂扬
cocky	骄傲的
evonymus	卫矛属植物
deurbanize	使失去都市特色
filicauline	有丝状茎的
upbeat	欢乐的
rejuvenator	使返老还童的人
assentient	同意者
mollusk	软体动物
homochromatic	只有单色
kinsoku	避头尾
septemvir	七执政官之一
circuitously	曲折
orthodox	正统的
probational	缓刑
brazenly	厚脸皮地
plectra	的复数
out	外面的
goldbrick	懒汉
preagricultural	农业社会前的
decorously	有礼貌地
apiarian	蜜蜂的
white	白的
withe	用细枝条捆
syrphid	食蚜蝇
cterm	Protocol
lothario	放荡者
claustrophilia	喜好幽静的癖好
filar	丝
squashy	熟透的
vote	投票决定
innkeeper	旅馆主人
soddish	糟糕的
will	决心
mwalimu	教师
khotanese	和阗语
cobbly	用鹅卵石铺
hellene	希腊人
nondefense	非国防军用的
judaeophobia	对犹太人的恐惧
emprise	侠义行动
gospel	福音
ferreous	铁
best	最佳状态或作品
fatigueless	不知疲劳的
fibbery	无伤大雅的谎话
prosperously	繁荣地
wisely	聪明
conceptive	概念上
trail	拉
tackify	增强……的黏着性
portocaval	=portacaval
pack	塞满
deregulate	解除管制
department	科
spindle	轴
necessitate	成为必要
verily	肯定地
ulexite	钠硼解石
hera	High
passivity	被动性
outspend	花费超过……范围
skee	滑雪
horehound	带有苦味的糖果
classfellow	同班同学
bellyhold	腹舱
sempervirent	常绿
mouser	捕鼠动物
adjacent	接近
pinaster	松树
prosper	繁荣
nectared	有花蜜
interiorly	在内地
foredo	杀
cpc	China
eulogia	颂德文
wakeful	不能入睡的
hitherward	向此处
nida	尼达
unreaped	未收割
worriment	苦恼
reelingly	摇晃地
osteal	骨性
galliard	轻快的三拍子舞蹈
saturniid	天蚕蛾
productile	可延长的
miscalculate	算错
lecithic	有卵黄的
fourth	第四个
oklahoman	俄克拉荷马州
pohai	见
smorzando	渐次消失的
gangster	歹徒
hyperfunction	官能过度
urceolate	坛状
cacique	酋长
paramecin	草履虫素
ang	美国报业公会
threatening	危险的
shelly	多壳的
perivisceral	内脏周
gastroduodenal	胃与十二指肠的
immutability	不变
spinally	沿着脊骨
angerly	愤怒
jesselton	亚庇(马来西亚沙巴州首府哥打基纳巴卢
inextricable	解不开
enlightenment	教化
quaky	战栗的
circumspection	细心
druse	德鲁士
pediculicide	灭虱的
accelerograph	自记加速计加速者
unconquered	未被征服的
miscue	撞歪
faultfinder	找岔子
agreed	同意
undoubled	展开的
meliorative	改善的
aquarium	养鱼池
dishouse	抢夺住宅
pregnable	易受攻击
ciscaucasian	内高加索的
aetiology	病原
correlative	关联的
deplete	耗尽
rushing	急流的
beretta	法冠
inhabitation	居住
hoatching	密集
strictly	确实地
automatograph	自动记录器
murderous	非常危险的的
syneresis	脱水收缩
disembarrassment	使安心
atmosphere	气氛
slimsy	脆弱
padang	运动场
contingency	意外事故
cake	蛋糕
haply	或许
my	我的
danube	多瑙河
oss	software
transflux	流过
martially	好战
vignette	印放为虚光照
disafforestation	砍伐森林
anticorrosive	防蚀
scatback	快速敏捷的持球队员
fake	假
gritstone	天然砥石
liquid	易变卖
pussyfooter	观望者
measureless	无限
hypnopaedic	睡眠中教学
awake	警觉的
vpd	重要产品数据或虚拟打印设备
hasty	匆忙
most	大部分
flesh	长胖
nameless	难以形容的
enroll	使入伍
powerful	有力
abcd	Business
senora	太太
ratherish	稍微
banjo	五弦琴
faint	软弱
cerebratmon	脑髓作用
substitutional	取代的
antitrinitarian	反对
technically	学术上
synovial	分泌滑液
semiquaver	十六分音符
balsamic	香膏质的
parathyroid	副甲状腺
noted	著名的
hierachical	僧侣统治
deicide	害死耶稣的人
unset	未凝固的
dirtily	淫邪地
aeroembolism	气泡栓塞症
os	System
groundless	无根据
flopper	变节者
phytobiology	植物生物学
recentness	最近
evulse	扯掉
hefa	高等教育设施法
palmitate	棕榈酸盐
eristic	争论术
cathecticize	=cathect
strudel	以果实或干酪为馅而烤成的点心
clerisy	知识阶层
hectic	肺病的
affricative	塞擦音的
workaround	工作区
persorption	吸混
pasturage	放牧
riflescope	步枪上的望远镜瞄准器
rim	轮缘
resuscitation	复兴
tranquilization	稳定
fabricant	制造者
identical	同一的
obliger	施惠与人者
follicle	滤泡
shoreless	无限
shadchan	职业媒人
concurrence	合作
millinormal	毫克当量
crackled	有裂痕的
euphoriant	使人欣快的
unrhymed	无韵的
haematogenous	生血
hypophysial	垂体
mirage	雾气
vdc	Corps
connivence	纵容
tea	茶树
ulterior	隐蔽
offensively	讨厌
parenthetic	插句的
adjuvant	辅佐的
trigger	引起
overweening	骄傲
chetnik	二次大战中南斯拉夫塞尔维亚人之游击战士
brix	白利糖度
hustings	选举程序
czech	捷克人的
denticulate	齿状
strathclyde	斯特拉思克莱德区
lignose	木浆硝化甘油炸药
aging	老化
cambric	细薄布
millstone	磨
remarque	带有轮廓略图的印版
erosion	侵蚀
stranskiite	蓝砷铜锌矿
heliotropic	趋日性
harm	伤害
fade	减弱下去
echo	重复
rimrock	悬崖
virogenesis	病毒形成
complementarity	补充
constipate	便秘
athwartship	横过船的
ablaze	闪耀
oppositionist	反对党人
falsify	伪造
dutiful	孝敬
marriage	婚姻
incapsulate	装入胶囊
pool	汇聚成
vociferation	喧嚷
contrecoup	对侧外伤
toxaemic	患血毒症的
filibuster	阻饶议事
rascally	无赖地
medullary	髓质的
nhra	Hot
plagiotropic	斜向
jd	法学博士
autocritical	自我评定
filmgoer	影迷
ciliiform	均匀细密
otherwise	其他方面
petrosal	岩石般
zymosthenic	促进酵素作用的
emanant	发散
distributee	分配遗产受益人
unpropitious	不吉利
choppy	不断改变方向的
overgreat	过于重大
unlanded	不拥有土
swathe	绷带
zenographic	木星表面的
checkbox	检验盒
duettist	二重奏者
thyroidectomize	对……施行甲状腺切除术
rpc	Pioneer
nib	插入
inconclusively	非决定性地
brimmer	满溢的杯
ruling	统治
tormentor	使苦恼之物
speculum	反射镜
encampment	营地
patter	急速拍打声
evolutive	进化的
scotch	镇压
macroscopic	巨观
morphologic	语形学
speechless	酩酊大醉
culturati	文化人
ethnogenesis	人种形成
transplacental	经胎盘
trapeze	吊秋千
dilettantish	半吊子
approbatory	认可的
malediction	坏话
phenakite	=phenacite
similarity	类似处
pump	抽吸
pekinese	北京哈叭狗
essential	实质
cutlet	肉饼
dishonorably	卑劣地
crackable	会裂开
ivan	伊凡
sonorously	响亮地
habitual	惯常的
meretricious	华丽而庸俗的
persulphate	过硫酸盐
confederacy	邦联
overspread	蒙盖
incisal	割的
refutation	驳斥
antidepressive	=antidepressant
nondecreasing	不减少的
staggard	4岁的雄性赤鹿
reknit	再扣牢
hydridic	带一个负电荷的
nib	嘴
gasengine	煤气内燃机
diphyodont	双套牙的
outcast	被逐
entablature	支柱
chemolysis	化学分解
canonically	照宗规地
overcaution	过分小心
hierocratic	僧侣统治的
nonnasally	口腔地
correctly	正确
backfisch	年轻少女
escort	护送
slow	慢的
booter	足球或橄榄球球员
archaistic	古风的
zinnia	鱼尾菊
thyrsoid	聚伞圆锥花序状
unserviceable	不能胜任
lett	列托语
devisee	接受遗赠者
proverbially	如谚语所说
mortal	临终
dockside	码头邻区
uncreolized	未克里奥尔化
sabbatarian	守安息日的
illusory	幻影的
disjunctive	分离性的
crossed	划掉
idolization	偶像化
materialism	唯物主义
lacteous	乳的
synclinal	向斜
during	在……的期间
titanothere	雷兽
fanwise	成扇形
narrowcast	用电缆电视播送
silence	静
bmoc	on
salic	撒利族
feudist	结下世仇的人
overcome	得胜
nonrestraint	无约束
kilograin	千格令
inversely	倒转
domo	功成名就转而追求悠闲生活的职业人士
whiles	有时候
vulturous	兀鹰
relativize	把……视为相对物
nowhence	无论来自何处都不
kay	凯
customary	习惯
portacabin	=Portakabin
exorable	可用恳求打动
walloping	巨大的
watchword	口号
doldrums	赤道无风带
epibiosis	附生生活
viscerogenic	发自体内的
ack	命令正确应答
dumpishness	迟钝
striped	有斑纹的
intelsat	国际通信卫星机构
thresh	推敲
acatalectic	音节数完整
vacuous	空洞的
toque	无边女帽
bigoted	固执
hypotonicity	低渗
cdgps	Common
flavourful	有风趣
engraving	雕版图
daube	炖肉
setline	有一排钩子的长钓鱼线
hypsometrically	测高术
distilment	蒸馏法
fly	敏捷
entopic	正的
microscopic	精微
provascular	原形成层的
magenta	洋红
stealthy	掩人耳目的
organic	建制的
promotee	获晋级者
mistful	=misty
eyestrain	眼睛疲劳
eristical	=eristic
squarish	有点方的
antisudorific	止汗
dispositive	决定性
autochanger	自动换片器
sputter	急忙地讲
shorthanded	人手不足
yod	希伯来文第十个字母
sympathetically	同情
elevated	提高
awanting	缺乏
vivific	使活跃
slowish	速度较慢
selenate	硒酸盐
forebrain	壮年人发达的脑部
devilishly	厉害地
unscripted	不用剧本的
chalcedonic	坚强
elam	埃兰
meagrely	贫弱地
outmaneuver	以机动性胜过
haciendado	庄园或农场等的主人
fashionist	提倡时尚者
fliting	争论
unlistening	不留神听的
guardship	警戒船
redislocation	复脱位
fidelity	诚实
hobbyhorse	木马
uninstructed	未经教导
underproduce	生产不足
rhetorician	修辞学者
m	发票日
pensive	沉思的
eruptive	疹的
leavy	叶茂盛
eam	Ethniko
accessibility	可到达
outspent	的过去式和过去分词
whistle	口哨
elegant	端庄的
aidance	帮助
mindon	精神信息粒子
fetation	怀孕
print	出版
edge	缓缓移动
benzonitrile	氰苯
moneybag	财富
npcf	全国控制污染基金会
bavarian	巴伐利亚的
subrent	转租租金
tomentose	被绒毛的
nutsy	发狂的
consumedly	大大地
slashing	鲜明
fancy	迷恋
prank	胡闹
postiche	仿造品
arbitrageur	从事于套利之人
dearness	高价
nettlefish	海蜇
privilege	特免
resurgam	我将再起
forestall	囤积居奇
prognoses	预后
bayeux	贝叶挂毯
extractible	可提取
essay	尝试
cinerary	放灰的
haste	急忙
superficialize	使表面化
animating	启发的
exogenous	外因
hyposulphurous	连二亚硫酸
dainty	优美
hermoupolis	厄木波利斯
rontgen	X光
writer	作者
dephosphorization	去磷
bloated	发胀的
sniff	吸
shoal	鱼群
galloot	愚笨的人
yawny	令人打呵欠
townie	城市生活
kitling	小猫
decametre	十音步的一行诗
interlocutor	对谈者
binding	粘合物
loppy	无力地下垂的
guiltiness	罪的自觉
decorticate	剥皮
lentigines	痣
perplexed	不知所措
coincidental	符合
penitentiary	监禁的
nonresident	不住在任所
flitch	背叛
insulating	绝缘
thallous	第一铊盐
tendentious	有倾向
cockeye	扭曲的
bifoliate	双叶
monterrey	蒙特雷
byelaw	规则
soloistic	独奏的
extract	精
aetatis	在……岁时的
paperweight	纸镇
auspicate	卜得吉兆而开始做某事
c	世纪
approbate	认可
unaffected	未受影响的
reviewable	可回顾的
show	展览
ring	套住
rehearsal	试演
costive	小气
orbit	盘旋
brittle	脆弱
hexenbesen	丛枝病
shiftless	无能的
turbulence	紊乱
soybean	大豆
roily	被激怒的
asway	摇摆的
turboelectric	用涡轮发电机
fractionary	断片
fmc	Maritime
thievish	有偷窃习惯的
homoplastically	类似地
creeping	爬行
amphisbaena	无足蜥蜴
moderatism	温和主义
rockweed	生于海岸岩石上的海草
scoundrelism	卑鄙
otb	betting
extemporal	无准备的
obconical	倒圆锥形的
lacedaemon	古代斯巴达的别称
yachter	乘快艇者
damnable	可诅咒
benison	祝福
doggie	汪汪
lamona	白毛矮脚鸡
lallan	苏格兰低地
liquorish	讲究吃
strange	前所未知的
ceremonial	仪式
asleep	睡熟的
chevet	伸出的礼拜堂
dayton	代顿
sycophancy	奉承
aggravating	使恶化的
aroid	天南星科
dolichomorphic	部分肢体特别长
udf	Universal
iaupe	国际大学英语教授协会
cinemicrography	显微电影摄影
delegant	将债务转由第三者偿付的债务人
holocoder	全息编码器
chauvinistic	盲目的爱国心
cno	of
futilitarian	悲观主义
derivation	来历
hush	安静
pretorian	监理军事的执政官的
nira	Act
ling	石南之一种
connivance	默许
dreadful	讨厌
core	核心
overthrust	上冲断层
pinto	黑白斑纹的
screak	刺耳的声音
umbrageously	易怒地
retrojection	后投
aclu	Union
tightness	坚固
surplice	白袈裟
reduction	约简
tame	被开垦的
tournois	图尔城铸造的
pathogenic	病原的
transpiration	流逸
migrator	移居者
riverine	河边
tricksy	淘气的
aortitis	主动脉炎
cesspipe	化粪池等的排水管
precipitate	促成
oakley	Oakley
hosiery	袜类
plumbiferous	含铅的
chill	寒战
minor	未成年的
greatest	最好的
iridectomy	虹膜切除术
positive	原级的
ordinary	罪犯的忏悔牧师
insectival	昆虫的
arrant	彻头彻尾
crubeen	脚爪
amphichroic	双变色
mere	仅仅的
definition	定义
filmable	可拍成电影
floridly	华丽
centennial	一百年的
amur	阿穆尔河
bowery	有亭子的
infectious	易传染的
tall	夸大
reassess	再估价
unreported	没有报道
dicty	极好
munificent	宽宏的
ipts	Scale
tocher	嫁妆
boxy	矮胖的
sulphite	亚硫酸盐
sanskritist	梵语学者
grandniece	侄外孙女
impermanent	非永久的
hell	该死!
runproof	不会渗化的
anticlerical	反对教权
desecrate	亵渎
magnetic	磁的
enormous	极恶
disqualification	剥夺资格
laundry	洗熨
filamentary	似丝
nautical	航海
quadrangle	四边形
sark	衬衣
sardis	萨迪斯
russia	俄国
bondage	束缚
indecorously	无礼
marathonian	马拉松战役
pokey	狭小的
medicable	可治疗的
electrodermal	皮电活动
impermissible	不许可
standpoint	立场
ostensive	以事实例证的
civil	文职的
blackwater	黑尿病
tuque	双层编结御寒帽
coasting	沿海贸易
great	非常的
gunport	炮眼
matted	无光泽
debarment	阻止
sunk	凹陷的
swinger	赶时髦的人
nooning	中午
ilk	种类
conscienceless	不知廉耻
roue	享乐者
compages	构造
maidenliness	处女样子
tubercule	小结节
ragged	粗糙的
usia	美国新闻署
lewd	淫荡的
presser	压榨技工
lot	份额
pentagonese	五角大楼行话
language	语言文学
cinerary	骨灰的
madzoon	=matzoon
unsolvable	不能解决
material	物质的
imperceptibility	看不见
procurer	做淫媒者
middlebreaker	开沟破土犁
quadriennial	=quadrennial
shut	关闭
simile	明喻
enigmatize	使成谜
respectively	各个
hardcover	精装的
pusan	釜山
separatism	分离主义
behest	要求
headstrong	任性
lateroversion	侧倾
alternating	交互
trustify	组成托拉斯
basal	基部
proprietory	=proprietary
frigidity	性感缺失
adventurous	喜欢冒险的
contrapuntal	对位的
spoondrift	浪花
coowner	共有者
uncommunicative	拘礼
sylvan	森林之神
flicker	颤动
hypocoristic	昵称
webernesque	具有韦伯恩音乐特点的
defeasible	可废止
germinal	幼芽的
maximum	极大
estuary	江口
phrenetic	发狂的
kenyan	肯尼亚人
curvilinear	由曲线而成
misspoke	念错
bathurst	巴瑟斯特(冈比亚首都班珠尔
southwester	向西南
phonolite	响石
bund	码头
permissibly	获准
subterposition	低下的地位
relieve	解除
apolar	非极
amaryllis	石蒜科孤挺花属植物
myope	近视的人
professedly	在表面上
jocular	诙谐的
tricarboxylic	羧基
voodoo	伏都教的
oxherd	牧牛人
restiform	绳状的
suggestive	启发
maneating	凶悍的
computistical	统计计算
arciform	拱状
taximeter	计程器
footy	褴褛
http	超文本传输协议
cock	使竖起
verify	检验
skelter	急匆匆地跑
reecho	回声
floridion	佛罗里达人
ozonic	含臭氧
triliteral	有三个字母
microfolio	微型文件夹
vanishingly	难以察觉地
porphyropsin	视紫
broiling	酷热的
castiron	不屈的
immortal	不朽的
juglandaceous	胡桃科属
underload	使装载不足
reviewal	校阅
comer	有希望者
algous	藻类的
exhaust	排气
vegetative	有关植物生长
endosmosis	细胞内浸透
subversive	破坏性
excoriation	表皮脱落
pentyl	戊基
spline	开键槽
bramble	悬钩子
deadness	死一样的状态
lazurite	天青石
bear	挤
ligula	唇舌
fervor	热烈
encyst	被包在囊内
gironde	法国革命时期的稳健共和党
enthronize	=enthrone
pyeloscopy	肾盂X线透视检查
other	他人
slablike	板状
protestation	明言
spherulitize	使成球粒
manyatta	村庄
incontestably	无讨论余地地
vertumnus	威耳廷努斯
tousy	权宜
lynch	处以私刑
japonic	日本
joking	开玩笑
cheilitis	唇炎
affrontedly	被冒犯
surfboard	以冲浪板滑水
orate	演说
inbuilt	内藏的
grizzled	头发斑白的
finlike	鳍状的
overrake	的艏部
vile	坏透
tumour	肿瘤
editorialist	主笔
primely	最好
studded	布满颗粒
os	Old
cashdrawer	存放现金的抽屉
plump	变丰满
peak	使达到最高点
shivery	令人悚然
debilitated	疲惫不堪
crackpot	想入非非的
ent	nose
redemptive	挽回的
bharat	=India
thine	pro
rostellate	有小喙
feminacy	女子的性格
quadriplegic	四肢瘫痪
pigeonhearted	胆小
mahogany	其木材
audience	听众
entreprenant	大胆的
angiomatous	血管瘤
study	考虑
kaleyard	菜园
thereof	关于……
strikeover	打字未修正而重新打上
whoop	小块
proteus	希腊海神
rifleman	步枪兵
nondairy	不含奶
semilustrous	半光泽
antiparkinsonian	抗帕金森病的
illusively	错觉
nutsy	发疯的
geocentrical	由地球中心所见或测量的
ferrocyanogen	氰亚铁酸盐的四价基
conformably	一致
concoct	调合
accessory	附属的
electrodeposit	电沉积
perdurability	永恒
girdle	绕
thenceforth	其后
aep	Echo
prelusive	序幕
embarment	阻遏
gallinipper	大蚊子
galliass	三桅军舰
convenient	便利的
excoriation	严厉的责难
clerk	办事员
beachhead	登陆场
comfit	糖果
nausea	晕船
requicken	重新振作
bystreet	横街
mrna	RNA
astronautically	太空航行地
autogenetic	无生源说的
weeklong	持续一星期的
stall	停止
illegibly	暧昧
counterbattery	反炮兵战
ukaea	Authority
dividual	可分割
ticktock	发出滴答声
pit	凹陷
anticatalyst	反催化剂
trying	费劲
irreversibility	不能反逆的性能
fraxinella	白藓
sweatiness	出汗
brigatisti	"
lose	输去
manner	风格
reparative	弥补
folly	讽刺剧
vittle	victual
virgilian	维吉尔
vulturine	贪婪的
muddle	胡乱对付
pardoner	宽恕的人
fetch	取来
gular	在咽
tankman	装甲兵
supergalaxy	超星系
mack	老兄
stead	替代
singaporean	新加坡人的
humorously	滑稽地
grievance	不平
willowy	易弯曲的
downy	柔和的
tilth	耕过的土
warmly	热心地
impedance	阻抗
rich	富饶
cocker	喜好或举办斗鸡的人
chunnel	水底铁路隧道
vindicatory	报复
maidenlike	娇羞
quintan	五日热
vesuvian	突然爆发
experientialism	经验至上lIst/
subsynchronous	次同步
glassful	一杯的容量
lysergide	=lysergic
donnybrook	闹哄哄的殴斗
undissociated	未离解
coagulen	可阿古连
pvc	聚氯乙烯
fetichism	物神崇拜
fearless	大胆的
manuscript	原稿
inadequacy	不充分
blueness	蓝
complete	完成
whipworm	鞭虫
unwilled	无意
polemical	好辩
handshake	握手
simitar	半月形刀
apteral	无翅
fossorial	掘
soviet	代表会议
nodular	小瘤
trisubstituted	三代
superexcellent	卓越
allethrin	丙烯菊酯
vaginate	似鞘的
floppily	懒散
cerebrocentric	大脑中枢的
denudate	裸体
sandor	桑德尔
fogdog	雾堤中的明亮部份
peacock	孔雀
batting	棉絮
pippa	皮帕
oxeye	牛眼菊
tooth	牙齿
armament	武器
irruptive	突入
hisself	pro
tcs	control
unwary	不注意
fanged	有尖牙的
apheliotropism	背阳性
aep	AppleTalk
reserpinized	用利血平治疗
turncock	供水栓
acheron	地狱
wysiwyg	See
hellery	调皮捣蛋行为
auberge	小旅馆
amputate	切除
readableness	易读
detergency	去垢性
ratomorphic	根据实验鼠的行为来解释人的行为的
whitewash	石灰水
gauziness	似薄纱的状态
lizardite	利蛇纹石
staple	大宗生产
summertime	夏季
wfdy	World
detection	察觉
giddy	眼花缭乱的
snorty	心眼小
exterminatory	有根绝作用的
elfin	小精灵
obstetric	产科的
available	可利用的
edc	European
fieldwork	现场工作
monumental	不朽
doofunny	=dofunny
cevitamic	维生素C
endangered	有灭绝危险的
running	不断
repose	座落
raving	语无伦次
laparotomize	为……剖腹
horseless	无马
slapdab	恰好
polytene	多线染色体
noblest	高贵的
salient	跳跃
pneumatic	有气胎的
doghole	仅适于狗住的地方
mocky	犹太佬
courageous	有胆量
quatercentenary	400年
neronian	尼禄
wrt	关于
diarize	记日记
counterespionage	反间谍
byliner	署名作者
pentagram	五角星形
gsm	communication
goest	go的第二人称单数现在式
insensate	没有感觉的
refloatation	打捞
embryocardia	胎样心音
jaques	莎士比亚喜剧
inverter	反用换流器
perfect	理想的
writable	能写成文的
retro	减速火箭
meander	弯曲
notional	表意
semiarid	雨量非常少
maharanee	王公之妻
mhw	water
ditch	沟渠
fissility	易裂性
hypoallergenic	低变应原的
sanguiferous	含血
pratfall	屁股着地的摔倒
metalloid	非金属的
unwatered	已排水
sweetheart	私下签定的
unsoiled	未被破环的
munificence	慷慨给与
zonked	服过麻醉药的
distrainee	财物被扣押者
jsp	Java
raec	Royal
hwyl	雄辩
blessedly	幸福地
overdaring	有勇无谋
apocalyptic	天启的
flsa	Labor
valeric	颉草
outrow	比……划得快
befool	愚弄
tubular	管状的
aerial	高耸
discrete	离散
bleomycin	博来霉素
exultingly	兴高采烈
loner	孤独的人
implacental	无胎盘的
fretted	焦躁
down	软毛
frat	兄弟会
brythonic	布立吞人的
unvoiced	未出声的
primus	普里默斯炉
finality	终结
ialc	仪表进场和着陆图
ingravescent	病越来越重
vicereine	总督夫人
orthoepy	正音学
constantly	经常
inconvincible	难以说服人
stakhanovite	斯达汉诺夫运动的
scotch	苏格兰语
unexacting	不苛求
homemaker	主妇
hanaper	文件筐
clotheshorse	晒衣架
suberect	接近垂直的
oostende	=Ostend
shorthorn	新来的人
camauro	教宗所戴之红帽
mohammedan	伊斯兰教
ppe	Economics
irksome	讨厌
usaid	States
anfractuosity	曲折
decree	政令
potboiler	为混饭吃而粗制滥造的文艺作品
faithful	守信的
carminite	砷铅铁矿
variola	痘症
hymenopteran	膜翅目的
wally	令人喜爱
topmost	最高
cumbrous	讨厌
insect	对付虫子
zincky	含锌的
kroo	克鲁族人的
rubrication	印红色
rouse	激起
mouthful	一口
shop	买东西
madrilena	马德里女人
maximum	最大极限
desiccant	使干燥的
rack	小步跑
woolshed	羊毛剪理捆装场
trivialness	平凡
seven	七
calfdozer	小型推土机
weakly	虚弱
dantesque	但丁式的
pseudomonad	=pseudomonas
zyme	酶
headlong	轻率
masterless	无主的
gabble	喋喋不休地说
transmit	发射
malvinas	=Islas
septette	七人一组
cautious	小心的
absurdness	荒谬
solenodon	沟齿鼠
eurystomatous	阔嘴的
denish	丹麦的
posh	漂亮
incompatibly	矛盾地
hereditarily	遗传地
jutish	朱特人的
benin	贝宁湾
landzone'	NULL)
pastrami	熏牛肉之一种
hemiparetic	轻偏瘫的
rhizomatous	下茎
crush	粉碎
welshy	威尔士人
rapprochement	和睦
bountiful	慷慨
carefree	轻松愉快
carry	被携带
calvinism	加尔文教派
unparliamentary	违反议会法
otherworldly	来世
parenteral	肠胃外
trampolin	蹦床
bailer	汲出积水的人
spectacularity	壮观
jet	墨黑的
generic	非特殊
missish	矜持的
bioassay	生物鉴定
sponge	海绵般吸收
hypobaropathy	高空病
quilter	缝被子的人
ballistic	弹道学的
limbless	无肢
boanerges	传教士
preteen	不满13岁的儿童
demoralization	士气消沉
grassiness	绿色
assaultive	好动武
unrenewable	不可重订
euramerican	欧美的
evidence	证据
dsp	Digital
pulldown	折叠式
assuage	缓和
quadrisyllabic	四音节词的
appellate	受理上诉
ruga	皱纹
allowance	定量供应
directional	方向
fasciated	扁化的
chargehand	工头
acclivous	向上斜的
anoint	涂以油或软膏
scuff	践踏
orbitale	眶最下点
ventose	浮夸的
literality	精确
dns	域名服务器
poignant	剧烈
nautilus	鹦鹉螺
vauntful	自夸
retarded	智力迟钝
rattailed	鼠尾状
commy	共产党员
effractor	窃贼
platter	大浅盘
blameful	应受责备的
edgebone	牛的臀骨肉
microprojection	显微投影
snack	快餐
throwaway	散单
film	轻烟
uplooking	向上看的
pose	摆姿势
fenderless	无防撞物的
tormina	绞痛
argillite	粘板岩
quavery	震音的
picket	警戒哨
retranslate	再译
modiolus	耳蜗轴
adapted	适合的
unclos	Sea
ignoble	不光彩
thankless	不讨好的
urbanize	使都市化
addle	腐坏
gallop	急速进行
cygnet	小天鹅
literarily	学术上地
figuline	瓷器
checked	棋盘状的
cordial	热忱的
recordation	记录
jugglery	杂耍
remarkably	非常地
sup	吸
unsized	不依一定尺寸制造的
matricide	弑母
iaz	zone
resplendent	辉煌
cruces	要点
foremost	最重要的
kroo	克鲁人
helpful	有用的
ferly	奇迹
bicorporal	有两个身体
friendliness	亲密
monolatrist	单拜一神教教徒
sybaritic	奢侈逸乐的
elation	得意洋洋
fenestella	窗状壁龛
subcollege	准大学程度的
anthocarpous	掺花果的
malihini	在夏威夷的外乡人
lamellose	包含薄片层的
overfraught	超载的
pearlescent	光芒四射的
selflessly	无私
membranate	似膜
saucer	茶托
behave	举止
arithmetical	算术上的
insuperable	不能克服
medallic	奖章似的
cowherd	牧牛者
ahimsa	非暴力主义
pedantry	假装学者
orfe	圆腹雅罗鱼
folkloric	如同民间传说的
dioptometer	视力计
semilogarithmic	半对数
verriculate	覆盖竖毛
chassis	底盘
penuche	粗糖
pane	边
clavus	鸡眼
pinealectomize	为……作松果体切除术
senior	高级
furry	有锅垢
tetrachloroethane	`tetrE9klREJ`eWeIn/
barren	无益
sound	吵闹
swimmingly	顺畅
limonitic	由褐铁矿构成
rough	粗略叙述的
radiosymmetrical	辐射对称
interlocutory	对话体
outwash	冰水沉积
expressly	明白
laudable	值得赞美的
lipolytic	引起脂肪分解
fellowship	友谊
course	急行
crabbed	乖戾
internuncio	使者
fluey	有绒毛
polliwog	首次越过赤道的海员
imbecilic	低能的
polygalaceous	远志科
alacrity	爽快
excuse	借口
puff	喘息
flunky	走狗
hollyhock	蜀葵
consistent	相容的
inexhaustibility	无穷尽不知疲倦
univocal	单一意思的
ordinance	训令
oarswoman	女划桨能手
eccrine	分泌腺的
exacerbation	激怒
manifestly	明白地
monocable	单索架空索道
petrous	岩石般的
mystagogic	解释神秘的
adaptor	改编者
manstopping	用以杀伤冲锋士兵的
title	用作书名
caenozoic	新生代的
skyey	天空的
parthia	帕提亚
printing	印花
bowler	玩滚球的人
gangdom	匪徒及其行为
swart	恶性的
pray	祈祷
bulletheaded	顽固
rich	有钱
tarnation	讨厌的
rage	精神错乱
say	讲
experienced	富有经验
oxalacetate	=oxaloacetate
vvip	极重要的要人
epidural	硬膜上的
stall	厩
aftertaste	余韵
overlusty	精力过于充沛的
unnoticed	不引人注意的
inexcusable	不可宽赦
bangtail	赛马用的马
kiltie	苏格兰高地的兵士
lone	孤独的
mourning	悲恸
extraliterary	文学之外的
validity	正确性
hideously	非常讨厌
wayfare	旅行
haddingtonshire	哈丁顿郡(即东洛锡安郡
contaminant	致污物
incog	微行
pozzuolana	火山灰
fleshpots	寻欢作乐的场所
periphery	外围
meliorism	世界改良论
pebble	小鹅卵石
aif	Australian
dreamland	睡觉
pericementum	牙周膜
miscellany	杂物
attache	大使馆专员
regan	里根
untearable	拔不掉
driver	主动轮
durrie	棉毛地毯
interceder	仲裁者
determine	测定
mortar	臼
crosswise	成十字状
integral	部分
frostweed	岩蔷薇
wardenry	市
moistureless	无湿气的
paniculated	圆锥花
residue	渣滓
hemipter	半翅类昆虫
armourial	徽章
floreat	祝它繁荣昌盛
headstream	源头
assuage	镇定
humble	卑下
cpaffc	Association
reverberatory	反射
fungi	似真菌
byzantine	东罗马帝国的
athleticism	崇尚运动
flouncey	=flouncy
bathypelagic	深海区的
crenature	圆锯齿
hypocoristic	表示亲爱
welt	鞭打
supposed	假像的
leukodystrophy	脑白质营养不良
trunnel	大木钉
somewhither	到某处
gmat	Greenwich
hispanidad	西班牙文明至上主义
methyl	木精
hesperides	金苹果园
putrid	非常讨厌
lcf	common
downfall	垮台
inexpedient	不适宜
micr	Ink
snowpack	积雪场
ignore	忽视
scream	尖叫声
beaux	纨绔子弟
vagal	迷走神经
xvii	罗马数字
through	完全
dubitative	半信半疑
pki	Key
recharge	再装填
droning	声音低沉单调的
cheapie	便宜货
encyclopedical	广博的
opiumize	用鸦片麻醉
urceolate	瓮状
score	划线
khuzistan	胡齐斯坦省
aal	ATM适应层
mcs	计算机科学硕士
rhinopharyngocele	鼻咽肿
enolic	烯醇的
arthromere	体节
rascal	卑鄙
indelible	去不掉
stubbornly	倔强地
beaky	像鸟嘴
fichtelgebirge	斐克特高原
progenitive	有生殖力的
opalize	使成乳色
malformed	难看的
basis	基本
delinquent	拖欠债务的
discommender	不赞成者
reink	重新涂墨水于
ballsy	有种的
cryoelectronics	低温电子学
cheerily	兴高采烈地
lexicographic	词典编辑的
underflow	下溢
hcl	living高生活费
hera	Explosive
panivorous	以食面包为生的
ground	土
relative	相对的
somatotopic	躯体特定区
marquesa	女侯爵
writhe	翻腾
gnarl	扭
glacis	缓慢倾斜
duplicity	表里不一
accusingly	责难
appalling	骇人听闻
deepie	立体电影
smart	潇洒的
unqualified	没限制的
ethnomethodology	民族方法学
idiorrhythmism	供独自修行的僧侣居住的僧院
bulletheaded	圆头
raiser	举起者
nigerien	尼日尔的
kathleen	凯思琳
vehicular	用车辆运载
stupefactive	使人麻木的
spread	桌布
disciplined	受过训练的
obiit	逝世
presser	压榨机
slimly	微弱地
placing	出售
dependability	可靠性
polydemic	广居
couchette	有卧铺的车厢
grocery	食品杂货店
realty	不动产
unconspicuous	不引人注目
dimorphic	二态
pareira	由巴西某种树根采取的利尿药
lumbago	腰痛
navigate	航行于
secam	SECAM制式
corresponsive	相当
hexapartite	由六部分构成的
backwards	向后
meshugge	=meshuga
town	市镇
zoot	suit
anuretic	无尿症的
solstitial	夏至的
thrust	刺
wretchedness	可怜
aloof	避开
balsamic	有镇静作用的
shat	拉屎
fiducial	根据信仰
still	仍
square	与……一致
incentre	内心
polyspermous	多种子
hwyl	炽热感情
yeast	酵母
homonymous	双关的
wheelwork	转动装置
zany	小丑
trimurti	三神一体(即创造之神婆罗贺摩
fleckered	有污点的
stand	站
replacing	替代
ace	一流的
downhold	减少
done	完成了
ascribable	可归于……
solarization	反感作用
discriminatory	有辨识力
subgroup	子群
laryngotracheal	喉气管的
avalanchologist	研究雪崩的专家
sulfurate	硫磺的
linguine	扁面条
hesitantly	踌躇
regular	合格
faucial	咽喉的
plagioclimax	偏途演替顶极
wristwatch	手表
tricksy	狡猾
inefficiency	无效率
dinah	黛娜
helper	帮忙者
vliw	long
tutoyer	亲密地向……说话
legatary	遗产的
cover	掩护
granuloma	肉芽瘤
fourgon	行李车
farmerly	像农人般的
cordelier	法资产阶级革命时的激进派党员在科尔得利教堂成立之政治组织
dell	美国最大电脑厂商之一
fancied	被特别爱好
stayer	支持者
nausea	极度的不快
creak	吱吱作响
goad	激励物
convincingly	信服
bluntly	率直地
teleost	硬骨鱼
expeditious	敏捷的
geopolitist	地缘政治学者
documentary	文件
squirish	样子像乡绅
bunting	颊白鸟之类
swad	一簇
tinderbox	火绒箱
biennially	每两年
jeepable	可通行吉普车
mammary	乳腺
tax	指控
disabled	伤残
cst	中央时区
egotism	自尊自大
profound	深刻
biosatellite	生物卫星
unvexed	镇静的
pythogenic	腐生的
dat	Digital
repose	依靠
osmidrosis	臭汗症
csce	欧洲安全和合作会议
dissyllable	二音节的单字
airdrome	机场
balladmonger	劣等诗人
ppt	1
bond	合同
ravc	Royal
periodical	期刊
hearty	亲切的
wiping	擦拭
awash	与水面齐平
roofage	屋面材料
unconvincing	不足以令人相信的
cocklebur	苍耳属植物
geck	戏弄
youthfully	年轻地
ambulatory	回廊
liberatory	同意释放
germiculture	细菌培养
niigata	新滹
zincy	含锌
avitaminosis	维生素缺乏症
coal	加煤
gulfweed	马尾藻
unselected	随意选定的
weave	编排
tacoma	塔科马
second	助手
entomoplily'	NULL)
ourn	=ours
feignedly	假装
redbridge	雷德布里奇
stoical	不以苦乐为意
infernally	可憎地
quickly	很快
pursuit	追击
fettle	状态
eclectic	折衷
modify	更改
furunculoid	像疖疮的
beneficent	慈善的
stainer	上釉工人
dicephalous	双头的
immure	把……嵌在墙上
skep	蜂箱
bronzer	古铜色化妆品
deoxidant	还原剂
penetration	穿过
triphibian	海
gaberones	加贝罗内斯
filaceous	丝状的
bole	树干
coset	傍系
troglodyte	类人猿
asprawl	伸开手足躺卧地
scholastic	经院哲学家
fargoing	范围广泛的
dower	天赋
antiquer	古董收藏家
flier	快车
vitalize	激发
wysiwyg	Is
timidly	胆小地
apopemptic	告别的
futuristic	未来派的
mouse	搜寻
rebato	大衬领
callable	请求即付的
jeremiah	耶利米书
carpus	腕骨
caput	首
paye	发薪时扣除制
depolarize	去偏光
hydrarthrosis	关节积水
piping	尖声
incendiary	燃烧弹
intendance	监督
aquicultural	水栽法
mathematization	数学化
proportionably	可使相称
sisyphean	徒劳
wale	选择
chymosin	凝乳酶
undefendable	不能保卫
ebony	乌木制的
bibiolatrist	圣经崇拜者
tercom	地形匹配
osteomyelitis	骨髓炎
chrp	Common
stale	陈腐的
impropriety	不适当的事物
swansdown	用于做婴儿衣服的柔软的布料
patriarch	族长
hithermost	最靠近的
unholiness	不神圣
buenaventura	布韦那文图拉
ichthyolatry	鱼神崇拜
ineluctability	不可避免
coat	层
skinch	吝惜
lapidify	使变成石头
gin	起重装
tripodal	有三脚
loricate	有甲壳
mastfed	饲养
briber	行贿者
lection	经文
telereference	远程咨询
cuddly	喜爱抚
immensely	广大地
unsalted	新鲜的
dispart	分开
servitude	惩役
sinicism	中国风格
hegemonism	盟主权
square	彻底
genuine	真实
monocarpellary	一心皮
muckworm	守财奴
metallographic	/
undebatable	无可置疑
engrossment	正式缮写的文件
prow	舰首
accidentally	偶然
generosity	慷慨
prescientific	科学以前的
unacknowledged	不被承认的
manganic	锰
thorianite	方钍石
indomitably	不能征服
guenevere	格韦纳维亚
consistorial	监督法院
frater	兄弟
fertility	人口生产
zeugmatography	软组织结构的映像
heliocentricism	太阳中心说
eject	喷射
waveson	失事船的漂流物
undistributed	未分发的
traipse	长途跋涉
dissociably	不调和地
leafless	无叶
stale	变陈旧
shiny	有光泽的
proletarian	无产阶级的
pyaemic	脓血症的
dural	硬脑膜
methodical	有系统
prefatory	序文的
glossopharyngeal	舌咽神经
unpromising	没有希望的
appalling	令人震惊
chocolaty	加巧克力
unheroic	给人印象不深的
parenteral	不经肠
possession	领土
famous	著名的
canicular	天狼星
arsenical	砷的
sarcoidosis	类肉状瘤病
unveracious	不真实的
sacral	祭典的
mole	筑有防波堤的海港
adrift	漂浮着
cowhearted	胆小
infrastructure	基础下部组织
orcadian	群岛
legendary	传说中
exsanguinate	抽血
manilla	吕宋麻
eurovision	欧洲电视网
extinguishable	可绝灭的
muster	召集
acrr	Race
uncustomed	无须付关税的
eraser	擦除器
garishly	华丽地
innocent	无罪的
to	对
puristical	修辞癖的
jaques	贾克斯(一译杰奎斯
archimandrite	大僧院长
gerontomorphosis	特化进化
osfcw	War
rattly	吵闹的
refundment	退款
charging	装料
superphosphate	过磷酸盐
immigratory	迁入的
unskilful	笨拙
aim	瞄准
uncalculating	不审慎的
abcd	Collection
whiz	发出呼啸声
nitroso	亚硝基的
trimotored	有三个引擎
unimpressionable	不易受影响的
plastiqueur	可塑炸弹投掷者
awag	摇动的
scv	Veterans
photoflood	照相泛光灯
tolstoian	托尔斯泰
photoelectron	光电子
am	上午
noumenal	本体的
omnifaceted	全面
triboluminescence	摩擦发光
ineluctable	无法逃避
smoothbore	无膛线炮
archaism	古语
aryan	印欧语
protonate	使质子化
uncharted	未知
reasoned	详尽论述的
surcoat	女用外衣
inspirator	鼓舞者
disarm	回复平常的编制
sharper	骗子
sidewalk	人行道
feeling	仁慈的
lymphography	淋巴系造影术
thrace	色雷斯
reduced	简化
complement	补足
supererogation	职责以外的工作
humification	腐殖化
munition	军需品
ululate	啼
furcation	分歧
ameboid	=amoeboid
hurley	爱尔兰棒球戏
fenestra	似窗的小开口
censoriously	好批评地
ceremonious	讲究仪式的
ergonomist	生物工程学者
usts	美国旅行社
unmeaningful	意义的
antagonistical	反对的
villeurbanne	维勒班
rareripe	早熟的水果
holarctic	全北区
damnum	损失
necessary	必需品
ever	究竟
hide	隐藏
polygamic	=polygamous
anechoic	消声
undertip	给……不足的小费
wrongly	不正当
blanch	遮断阳光
sanguification	血液生成
nondescript	不属任何类型的人
cyanize	把……转化为氰化物
sinew	腱
greenwing	绿翅鸭
crabbed	乖戾的
lunabase	月球上低平面
embracive	全部包围
telebus	电话叫车业务
pigheaded	固执
redpoll	无角的红牛
grilse	幼鲑
floral	花似的
animating	启发
pleurodont	侧生齿动物
assaultable	可袭击
ai	artificial
spleenful	脾气坏
seed	去……籽
successor	接任者
hathpace	高台
transconfessional	超越教派
buckeroo	=buckaroo
termini	目的
washing	洗涤用
maist	=most
skeleton	骨骼
equitably	公正
pewter	白蜡
contextual	前后关系
acetanilide	退热冰
slade	Engravers
gripe	抱住
monarchial	帝王风度的
hhfa	and
murrhine	默勒石
biracial	代表两种人种的
socially	在全社会中
midas	迈达斯
lokal	酒吧
emplane	装上飞机
maoriland	毛利兰
languishing	苦思的
primarily	起初
fraction	片断
jansenism	派的信条
nuclear	核的
abri	防空洞
gingham	有条纹或方格纹的棉布
scant	不足
coulee	小川
refill	替换物
gratifying	令人满足的
anginal	心绞痛
prefab	预制
caressant	宠爱
indigotin	靛蓝
jawbone	赊买
yet	更
pantheon	万神殿
anorak	带风帽的粗呢大衣
uncloister	解除……的禁闭
hospitality	盛情
clachan	小村庄
unbitter	没有仇恨
autonym	本名
squatty	矮胖的
mind	留心
restructure	调整
lymphoma	淋巴瘤
puff	一阵喷烟
expeditiousness	快速
penthrite	季戊炸药
thalidomide	镇静剂
form	排列
comer	来者
plug	塞子
appropriable	可供专用的
grotesque	奇异风格
overnutrition	进食量过多
containershipping	货柜装货
escapist	逃避现实的
imperatorial	威严
conformism	盲目因袭的态度
wakeful	觉醒的
neanderthaloid	有尼安德特人体形特征的
auspice	前兆
squall	暴风雪
behave	行为表现
cylindric	圆柱状的
dative	与格
dwarf	变矮小
supportable	可援助的
proconsul	殖民地总督
hematozoal	血寄生
punishable	该罚
overdetermine	由多种因素决定
raid	Disks
chamotte	耐火黏土
zhengzhou	郑州
civilize	教化
morphophonology	=morphonology
scuttle	急速逃走
consonantal	带辅音性质的
auric	正金
circumglobal	围绕地球旋转
mtu	transmission
phosgene	碳酰氯
tough	强硬的
leakance	电漏
flapdoor	吊门
stygian	地狱的
phenetidin	氨基苯乙醚
funereal	送葬
impassioned	热情洋溢
sherwani	高领长外套
osteitic	骨炎
ineffectually	无益地
remigrant	再移居者
painsworthy	值得花力气的
jugfet	结栅场效应晶体管
claustrophobic	导致幽闭恐怖症
terabit	兆兆位
aerocurve	曲翼
voluminous	丰满的
bearable	可忍受
cohort	军队
ms	手稿
transom	结构中横向构件
walk	步行
eudipleural	两部对应
reposting	新任命
retractile	伸缩自如的
chloralism	三氯乙醛中毒症
aestivation	夏眠
crumble	粉碎
endocrinopathic	内分泌病的
hyperosmolality	高渗透压性血清状态
aching	心痛
pert	计划评价与审查技术
subcelestial	在天下面
omnitude	全体
mesityl	异亚丙基丙酮
spiny	剌状
uncopiable	不能抄写的
sphinges	神秘的人
payor	=payer
invectively	非难地
cristobalite	方石英
rhesis	名句段
symphile	蚁客
digitated	趾状
sclerosis	硬结
rummily	奇妙
gore	刺伤
ahimsa	不杀生
dallas	达拉斯
tendencious	宣传性的
state	正式的
kainogenesis	=cenogenesis
ras	王公
peroration	演讲高谈阔论
sidenote	旁注
piquant	淘气
aggregation	集合
gallbladder	胆囊
finite	有穷
eater	吃……的人
elytrum	翅鞘
squire	侍从
respirability	能呼吸
bung	桶孔
aplastic	无形的
hopping	卖力
lalique	glass有花卉浮雕的装饰性玻璃
hysteric	歇斯底里的
shrewdly	机灵
wobble	使颤动
escapeproof	十分牢靠
degradation	降格
coronate	加冕
weight	重要
pedimental	山花
fescennine	粗俗
humanize	使通人情
slatter	使溢出
conflicting	相矛盾
eunuchize	阉割
faggoty	女性化的
barothermogram	自动压力温度表
vapidly	没有生气
destructive	破坏的
oda	办公文档体系结构
canvas	帆布
charismatic	神赐能力
ferly	奇异景象
musky	麝香似的
hausen	大白鲟
ergograph	示功器
hierarchy	层级
cyclery	自行车行
rathaus	镇议会厅
citywide	全市性
nourishment	食物
lucre	收益
thermogalvanometer	温差电偶电流计
unconvincing	不足以令人相信
aurae	光环
turning	旋转
lak	腊克语
ada	Ada
virement	转帐
unconventional	异常ly//
nanoid	侏儒样
preserver	保存者
spill	使散落
oo	面向对象的
metazoic	=metazoan
construable	可做……解释
reassure	使……恢复信心
bewitch	迷人
piratic	海盗的
concuss	震动
noiseless	寂静
mill	碾磨
streamy	多水流
metapolitics	抽象政治学
impastation	着色浓厚
tidiness	整洁
brocaded	用浮雕法织锦
ventose	浮夸
balkan	巴尔干半岛的
nccj	of
ismaelian	=Ismailian
underemployed	学非所用的
metaxa	迈塔克瑟白兰地酒
laconia	拉哥尼亚
scorcher	大热天
undissembled	真正
shovelful	一铲之量
ancient	远古
feeze	惊慌
squaw	女人
eccentricity	古怪
iterant	复述
intropunitive	内罚型的
canonic	依教规
prankish	戏弄的
rubasse	红水晶
mount	制作……的标本
monachal	僧院
eytie	=Eyetalian
senarius	抑扬格的三音格诗句
wordiness	多嘴
raggee	=ragee
contemptuous	侮辱的
siffleuse	女吹哨手
intreat	乞求
cessative	表示停止的
jeremiah	耶利米
mungarian	匈牙利的
evenly	平坦地
crepe	绉绸
personal	针对个人
sate	过分的给与
iodoprotein	磺蛋白
p	personnel
tannage	鞣皮厂
parvis	前院
boscage	丛林
zionism	犹太复国主义
landification	石化
sunny	照耀的
phytocidal	杀死植物的
staffer	编辑
irishwoman	爱尔兰妇女
goblet	酒杯
endhand	三人牌局中之发牌者
thyiad	梯伊阿得
hyperphagic	贪食的
bale	大捆
recense	校订
buccaneering	掠夺
baccalaureate	在毕业典礼上对毕业班所作的告别讲话
glandiferous	结坚果的
abstriction	缢离作用
confection	蜜饯
deportable	可流放
roadster	跑车
unhesitatingly	不踌躇地
edginess	急躁
console	藉慰
lettic	列托语的
chillily	冷漠
komondor	匈牙利种牧羊犬
modestly	适当
doukhobors	杜科波尔派
antiulcer	治溃疡的
epode	希腊抒情颂诗第三节
oospore	合子
founder	翻沙工
unassimilable	不可吸收
transcendency	卓越
decad	由十个构成的一组
soluble	可溶
paly	苍白
acerate	针状的
unduly	过度地
authorization	认可
aristocratic	贵族政治的
antidepressant	抗抑郁病药
corruptibly	易腐败地
torrify	=torrefy
plush	豪华
schizophrenese	精神分裂症性言语
ammoniacal	氨
iocu	of
cystic	膀胱的
brier	野蔷薇
pettifogging	骗人
separatory	分离性
virescence	绿化
nim	扒
bacteriocin	细菌素
flyaway	轻浮的
fen	沼池
soliflucted	因泥流作用而移动的
carnous	肉的
lamentableners	拙劣
flagellate	鞭状的
parolee	假释犯
leptonic	轻子的
costless	不须花钱
adrenergic	释放肾上腺素的
grueling	严惩
cogent	使人首肯
clerisy	知识分子
circumambient	周围
umbilicate	有肚脐的
invariable	不变
disarray	混乱
rancher	牧场主
scolecite	钙沸石
holly	冬青树
offcast	被抛弃的人或物
diablo	又称恐惧
eupepticity	消化良好的感觉
extramarital	私通的
eupneic	平静呼吸的
quakerish	像贵格会教派
triton	I/O控制芯片集
ethnarchy	总督的身份
block	木块
dispread	向四方张开
rising	上涨的
alienable	可让与
ledge	暗礁
panjandrum	大人
sore	痛的地方
pseudoscorpion	假蝎
serous	含浆液
drizzle	细雨
arrester	避雷器
gigavolt	十亿伏特
sanity	心智健全
shoddy	翻制的
catcall	发嘘声
lamia	女怪
baronial	与男爵有关的
giddify	使头昏眼花
donkeyish	愚蠢的
philhellenic	爱好希腊的
ionogen	电解物
hexaemeric	创世之六天记述
sulcate	有沟
mandrake	曼德拉草根
instant	直接的
offenbach	奥芬巴赫
reedy	脆弱
provisory	有附文的
tuner	调谐电路
golgotha	受难的场所
doyen	老前辈
doltish	愚蠢
odontornithic	齿鸟类
gallophobia	憎恶法国
northwestwardly	西北
afterdamp	爆发后的毒气
cuttlebone	墨鱼骨
wobbly	不稳定
unhinge	使移走
coquet	卖弄风情
flooey	不行
unicef	Fund
baseborn	出身微贱
enumerably	可点数地
indebtedness	亏欠
holosericeous	有丝状短毛的
humiliator	侮辱者
tuesdays	每星期二
demonian	魔鬼似的
uplift	振奋
poll	民意测验
convict	宣告……有罪
bill	清单
midge	侏儒
fiend	魔鬼
xenotropic	向异
pulsant	搏动
competency	能力
raiser	酵母
impressionistic	给人深刻印象的
probabilism	盖然论
foretoken	预示
ovibos	ox
jokey	滑稽
saltish	略带咸味的
urinometer	尿比重计
herbescent	似草的
epistasis	上位
akinete	藻类细胞附生的一种胞子与母细胞壁合为一体
sheila	Sheila
punny	一语双关的
mirthless	沉闷
howl	嚎哭
lease	出租
tragedian	悲剧作家
cortile	内院
inquisite	审讯
sprig	小枝
tinge	风味
torus	圆环面
ucla	Los
mycobiont	地衣共生菌
subtorrid	=subtropical
unplucked	未摘下
excitation	刺激
discipleship	做弟子的身份
endoparasite	内部寄生物
beamingly	喜气地
wider	广阔
monarchical	国王的
partner	伴侣
infallibility	绝对可靠性
hermaphroditism	雌雄同体性
putsch	造反
undouble	松开
surgical	外科病房
steatitic	块滑石
hexaemeric	创世之六日的
unco	不可思议
terezina	=Teresina
enow	足够
antiepileptic	抗
vomerine	犁骨
anticly	奇怪
obscurity	身份低微
yawnful	无聊的使人打哈欠的
draggly	不整洁的
disinhume	挖掘
latteen	=lateen
lipogenous	产生脂肪的
dipterous	双翅类
nonrefundable	不可归还
touch	触及
rooftree	屋顶
syphilous	=syphilitic
commanding	居高临下的
rbs	of
ictus	爆发
countable	可计算
autoalarm	自动报警器
eastabout	向东地
cembalo	拨弦古钢琴
juniper	刺柏属丛木或树木
plumulaceous	关于绒羽的
makable	可建造的
factualistic	求实精神的
allopatric	在不同地区发生的
hate	讨厌
somatoplasm	体细胞浆
contributory	捐助者
anorexia	食欲减退
needleman	缝衣工人
hohum	令人生厌
nouny	多名词
sustainer	主动动机
detection	发现
razee	删节
idiomatically	使用惯用语句
fortunebook	占卜的书
bengaline	孟加拉织品
transplantation	移植
pulverable	能研成粉末的
discontinuance	中止
matchet	=machete
movable	活动的
jaguar	英、法合作研制的超音速攻击机
charmingly	愉悦
leftover	剩余的
crustily	粗鲁
organizer	建立者
ascot	宽领带
linguistic	语言学上
unfirm	不结实的
noonday	正午的
droopy	下垂的
grungy	低劣
prothetelic	先成现象
feel	摸
reformatory	感化的
immoderation	过度
coterie	同行
citywide	全市的
electrosensory	电感的
anastatic	凸版的
staging	分段运输
reduplication	复制器
perinea	perineum的复数
handling	操作的
paleocene	古新世
valiancy	勇猛
deintegro	重新
monofier'	NULL)
dinar	第纳尔
cornuted	有角的
childproof	对孩童安全的
surnominal	别名
electrotypist	电版术
infamatory	诽谤的
wtp	Wireless
priggish	自负
frostline	冰冻线
