saltimbocca	意式煎小牛肉火腿卷
hypercautious	极其小心的
idli	黑绿豆米饼
seismonasty	感震性
structure	结构
expressible	可榨出的
litigiosity	好讼
discriminant	判别式
epitome	摘要
smoketight	不透烟的
verbal	口头
rrl	Layer
orvieto	奥维多白葡萄酒
songbird	告密者
antilyssic	抗狂犬病的
stringpiece	纵梁
daftly	癫狂
isp	Service
straightness	正直
undeveloped	不发达的
dixie	大铁锅
unrenewable	不可重订的
substructure	基础
lachrymal	泪
apophasis	表面否认要说或正说的话
antasthmatic	治疗气喘的
piffle	讲废话
resplendency	辉煌
radiotransparent	在X光照射中不显影
mill	乱转
pagan	异教
tinfoil	锡箔
unobjectionable	不惹人讨厌
insectifuge	驱虫剂
batman	通讯员
oppressive	难以忍受
incorporeity	无实体
zeke	齐克
smooth	变平滑
miniscule	小字的
slurvian	含糊的言语
gsm	Mobile
rare	杰出的
magnesium	镁
pantopragmatic	爱管闲事
imino	亚氨基
stanch	坚强
honest	诚实
metonymic	换喻
laze	懒散
fanatic	入迷者
homoplastically	同形地
scotophil	喜暗的
tapir	貘
dole	悲哀
endophyte	内部寄生植物
defoaming	消去泡沫
hoarfrost	霜
diphthongal	双重元音
polycarpellary	多心皮
iterant	复述的
ultraviolet	紫外
neurilemma	神经鞘
microphotograph	显微照相术rB:f/
coinsurance	共同保险
poe	Embarkation
madder	洋西
semidivine	半神
protractile	突出的
carnalism	寻欢作乐
unlively	沉闷的
carpel	心皮
unpicturesque	不似画的
such	某一
granulometric	粒度测定
ungrounded	无扎实基础的
tjilatjap	芝拉扎
engraving	雕版
querimony	埋怨
orcadian	英国奥尼克郡
ferine	野生
muliebral	女性的
fundamentalism	正统派基督教
underripe	未全熟的
excitatory	有刺激性
slovensko	=Slovakia
lestobiotic	窃食共生的
hoppergrass	蝗虫
deaminate	使脱去氨基
roady	=roadie
ventromedial	腹正中的
shanghai	上海
surpassing	超过的
sue	向……请求
petitory	提出所有权要求
mortar	研钵
gratuitous	无理由
epirot	伊庇鲁斯人
seek	探索
imperceptive	无感觉的
ditchdigging	挖沟渠的
absorptiometer	调稠器
undersell	抛售
att	American
chromatoscope	彩光折射率计
fastish	尚快的
unprincipled	无原则
crossed	划掉的
nightfall	黄昏
unreligious	与宗教无关的
lunge	刺
larghettos	稍宽广的
validate	使有效
damnify	损失
costae	叶的主肋
quickie	简短的
xf	fine
vanguard	前锋
kingmaker	拥立国王者
djakarta	雅加达
marcescent	雕存
metapolitics	理论政治学
stubbed	多梗株
unmethodical	无方法的
laughingly	笑着
cushy	容易的
osmotic	渗透
seniority	资历
seam	焊合
loadstar	指导原则
puffingly	气喘吁吁
unparalleled	无双
achromatic	非彩色
trustiness	可信赖
colloidal	胶状的
heavy	严肃角色
ethnical	种族
gameless	无猎物
glazier	上釉工人
oeec	European
talisman	能产生奇迹的东西
decretory	命令
unluckily	不幸地
neighborly	睦邻的
unroyal	不似君王
opaquely	无光泽地
possess	摆布
rancidly	讨厌
humiture	温湿度
mandrax	镇静片
wistful	渴望
turn	转变方向
can	铁罐
ralline	秧鸡
rap	打
velskoen	=veld
trochaic	扬抑格的
stingy	吝啬的
broma	任何供咀嚼的固体食物
title	赋予头衔
towering	杰出
disinterested	无私
rsv	Standard
letup	停止
exacting	需付出极大耐心
lepidoptera	鳞翅类
marshall	Islands
bomber	轰炸机
flexible	能变形的
dowager	继承亡夫爵位遗孀
agraphia	因脑受伤致不能写字的失写症
incurably	不能矫正地
voluminously	庞大
peach	受人喜欢的人
percale	高级密织棉布
disenable	使不能
spacewoman	女太空人
unshaped	不成形状
banger	香肠
caid	伊斯兰教法官或市政官员
paidology	=pedology
useless	无用的
uhlan	枪骑士
inertial	惯性
tasty	可口的
candent	灼热
intention	目的
troy	特洛伊
tabernacular	临时房屋
incunable	古书之一册
infantilism	幼稚型
retroflexion	翻转
burl	节瘤
appetizing	促进食欲
implicit	含蓄
exuviate	脱壳
filter	慢慢传开
oblique	倾斜的
kaleidophone	发音体振动显像仪
empyrean	苍天
retinispora	金钟柏属植物
typically	代表性
bellyfat	浪费或多余之物
tcd	Dublin
gigglish	喜欢傻笑的
front	开头
sext	祷告
fore	在前面
ties	连结
asme	Engineers
protocontinent	原始大陆
weltanschauung	人生观
polysemous	多义
haka	毛利族的战舞
flavorous	有滋味
victrola	手摇留声机
contradictory	反驳
climactic	顶点的
forfeiter	因犯罪而丧失职位的人
endothelioid	内皮状的
unequal	不同的
reforger	再造
wizened	枯萎
complimentary	称赞
canaller	运河船员
guiltless	无罪的
credulously	易被瞒地
msphe	公共卫生工程学硕士
anuretic	尿闭的
waterishlogged	浸水的
tickbird	食虱鸟
scutch	打麻机
bonism	世善说
unduplicated	无副本的无法匹敌
altricial	孵出后需母鸟照顾一段时期
wheelhouse	舵手室
wholesale	大规模
pinfall	压倒
her	她的
phenacetine	非那西汀
agreement	同意
masty	肮脏
seascape	海景画
transit	经纬仪
petit	次要的
repair	修补
undependable	不可靠的
vigesimal	二十分之一的
mf	millifarad
pretoria	比勒陀利亚
auric	金
polyspermy	多精受精
field	野生的
punctulate	有小点
virilocal	以男方家庭为中心
dyscalculia	计算障碍
denbighshire	登比郡
rumble	辘辘行驶
resonatory	激起回响
spindling	细长的人或物
odontalgic	患牙痛的
aching	疼痛
stupefacient	麻醉
oblong	椭园形的
anachronous	时代错误的
energism	活动主义
agnolotti	意大利肉饺
reassure	打消……的疑虑
struggle	奋斗
beta	希腊字母中的第二个字母
deaccession	交换
faithlessly	不忠实地
bloemfontein	布隆方丹
emunctory	排泄
helluva	很难
recent	近来
chargehand	领班
cast	计算
rockbound	僵硬的
perversive	曲解的
democratization	民主化
assimilado	同化民
poi	山芋食物
desired	渴望
patinate	生绿锈
expertly	熟练
nod	点……
asternal	无胸骨
deweyism	杜威主义
dampproof	防湿
sfz	sforzando
astrolabe	古代的天体观测仪
circumgyration	回转
homebrewed	家酿
waterfront	水边地码头区
synallagmatic	双务的
implead	控告
brockage	有缺陷的硬币
cinderella	灰姑娘
blida	卜利达
revolt	起义
genuflect	屈服
outfit	全套装配
mistakenly	曲解地
studious	慎重
dianthus	石竹类属植物
pellitory	墙草属植物
connectedly	有关联
bowler	玩球戏的人
plaintive	哀伤的
achillean	勇敢
regular	整齐
winterthur	温特图尔
compliably	屈从地
tenderee	招标人
reformatory	革新
surculus	根出条
taper	逐渐变细
warren	拥挤的地方
euphemistical	委婉说法
outweigh	在重量上超过
callus	皮肤的硬结组织
perhydrol	过氧化氢
prolific	大量繁殖的
psyllid	木虱
flitch	桁板
hemocytoblast	原始血细胞
certificate	证明书
transferable	可传递
bureau	衣柜
beckoningly	令人心动地
ergonomic	人类环境改造学
appetising	=appetizing
antilabor	反工会
immortalize	使不灭
longing	渴望
aero	飞机
somasteroid	体海星亚纲
vitriolize	使硫酸化
senti	分
violescent	带紫罗兰色
minor	次要的
ethylamine	乙胺
adult	成熟的
reconcilability	可调和性
spieler	招揽顾客者
waggish	滑稽的
asphyxiate	窒息
zoomy	利用促镜拍摄的
demonography	魔鬼学
dpt	白喉、百日咳、破伤风混合疫苗
patter	行话
translatory	平移
uncorrected	未修正
jinx	白虎星
awshucks	质朴无华
lamellicorn	鳃角类的
dubitative	怀疑的
pekoe	香红茶
absently	心不在焉
gurgle	作汩汩声
subaltern	副
japanning	涂漆
inevitable	不可避免
morbidezza	柔美
eyeglass	镜片
republican	共和国的
potatory	耽于饮酒的
nonuple	九个一组的
witchman	巫医
insalubrious	有害
newshound	新闻记者
enchondrosis	软骨瘤
mannheim	曼海姆
whelp	下崽
elfin	矮人
rct	皇家运输部队
globoid	略成球状
semimythical	半神话
nauseated	作呕
conferva	丝状绿藻
causal	表示原因或理由的
reefer	双排扣水手上衣
liberalism	自由主义
exenteration	剜出内容物
cucumiform	黄瓜状的
skice	疾行
bassinet	摇篮
regret	为……感到遗憾
waterfall	瀑布似的东西
nowise	决不
absorbedly	专心致志
nowanights	在当今的夜晚
revise	修正
infighting	暗斗
urinoscopy	=uroscopy
proctorship	代理人之职
flyspeck	污点
worthy	相称
bezazz	劲头
uxoriously	顺从妻子地
crackjaw	反常
hospltaler	=hospitaller
uncloister	使离开隐居生活
petty	卑鄙
handoff	手递手传球
grand	主要
karman	catheter
alabaster	雪花石膏
seel	用线缝
valerianic	=valeric
yellowtop	紫莞科植物
arithmetically	算术上
cissoidal	凹边
parmigiano	撒有帕尔马干酪的
willinghearted	十分情愿
sprightly	轻快
prophetic	预言
strange	前所未知
drogher	西印度群岛的一种沿岸航行的笨重而缓慢的小帆船
reprobance	=reprobation
significant	有意义的
delinquent	有过失的
cremationist	火葬论者
maturity	到期
cbc	Corporation
burgrave	贵族
brotherliness	兄弟的情谊
coastward	朝着海岸地
illusively	幻影地
quadricycle	四轮
feldspathose	长石质的
roughwrought	经粗加工
shackle	加枷锁
laparotomize	为……开腹
exotoxic	外泌毒
assumptive	傲慢
picketboat	当值艇
dismayful	令人丧胆
emblematic	象征
tuckshop	学校内的糖果店
dodgy	躲闪的
zoomorphize	兽形化
worshipful	可敬
claudication	跛行
gaelic	盖尔语
detrusion	推出
martial	军事的
other	不同地
choosey	慎重选择的
absorbingly	非常有趣地
hypoxemic	血氧不足的
probate	加以监护
cargo	货物
unascertainable	无法查明的
daunomycin	柔毛霉素
squadron	把……编成中队
wave	波浪
excavate	挖出
vexatious	伤脑筋的
aymaran	艾马拉语
ultrarightist	极右的
californian	加利福尼亚州人
rarp	逆向地址解析协议
ruthful	充满感伤
interlaced	交错的
monocoque	单体横造
ducky	可喜
pharmacopsychosis	药物性精神病
carmelite	Carmel
exclamatory	叫喊
incautiously	鲁莽
zodiac	十二宫图
proudly	骄傲地
indescribable	难以形容的
pancreas	胰腺
amorism	谈情说爱
suspensive	悬念
gasolene	汽油
porker	食用猪
faitour	骗子
conch	贝壳
radular	齿舌
glace	冰冻
dynamic	动态
pasteurism	巴氏灭菌法
constancy	不屈不挠
bumble	弄糟
cognate	同词源的
extended	扩大范围
duh	咄
taxpaying	纳税
social	社交
xylometer	木材比重计
liquorice	甘草根
existence	实在物
caboose	轮船上的厨房
floweriness	绚丽
inhumorous	不幽默
preestablish	预先制定
bacteriuria	菌尿症
forrel	做书皮用的羊皮纸
salicylaldehyde	水杨醛
benevolently	仁慈
corrosible	会腐蚀
inextricably	解决不了
stilly	寂静的
lay	下蛋
neurogenic	神经性的
rosenhahnite	罗水硅钙石
unsuccessful	失败
eduction	引出物
cheer	愉快
carom	连撞两球
goosey	笨蛋
lingo	方言
beady	有泡
trainable	可教育
chromogenic	发色体
encephalograph	大脑
monologist	自言自语者
gesture	以手势表示
nitrogenous	氮的
pure	抽象的
feelingless	无感觉的
exophthalmic	突眼的
acgb	大不列颠艺术委员会
estanciero	农场主人
pit	深渊
rumor	传闻
poorboy	罗纹紧身运动衫
unfrock	剥去法衣
khmer	高棉语
extrabold	特黑体字
cmd	Device
selah	西拉
mustardy	有芥末味的
rallyingly	嘲笑地
printless	无印痕
undignify	使丧失尊严
emptysis	咯血
chrism	圣油仪式
flagellate	鞭毛虫
simulant	拟态的
octillion	千的十六次方
hydrogenize	使与氢化合
subsection	小单位
chanticleer	公鸡
pomfret	鲳鱼
mediagenic	所喜闻乐见的
hermetical	密封
valkyrie	瓦尔基里
hypotensive	低血压的
ecogeographical	生态地理的
nessie	尼斯湖水怪
subsumption	包容
sulfathiazole	磺胺塞唑
nyasa	尼亚萨湖
braciola	酒烩肉卷
oniony	洋葱臭味
worshipful	可贵的
dioestrum	间情期
underemphasize	对……强调不够
painful	疼痛
spake	speak的过去式
fearsome	可怕
superaerodynamics	稀薄气体动力学
incontinent	不能自制
neutralisation	中和
twig	嫩枝
attempt	企图
calathiform	杯状的
gobemouche	轻易听信的人
irresolution	不决断
convoke	召集
amusedly	好玩地
aauw	of
amyloid	淀粉质的
ablate	融化
skint	身无分文的
obsequious	谄媚的
iou	I
cryptanalyst	密码破译者
polysemy	意义的分歧
col	关口
leukodermal	白变病
gulf	吞没
anaplastic	整形术
epicenter	中心
gambrel	复斜屋顶
deadbeat	赖债不还的人
starchy	拘泥
zooty	华丽的
blinking	一眨眼
incentive	动机
entrance	进入
catfacing	表面所呈现的凹凸
funnelled	漏斗状的
decoy	圈套
anilinctus	吻肛
whaup	=curlew
pollen	花粉
portreeve	市镇治安长官
politer	有礼貌
mavis	画眉鸟类
bestowal	赠与
aggrieve	令委屈
impregnate	使受精
ushership	职位
climactic	高潮
religionary	涉及宗教
cathedra	讲座
conrail	联铁
dic	Domain
vegetative	有生长力的
dqdb	Queue
decagynous	具十花柱
polyglot	用通晓数种语言记载的书
implosive	内破裂形成的
enormous	庞大的
soupiness	伤感
areaway	地下室前的空地
parget	灰泥
testamentary	据遗嘱的
aps	American
declivous	向下倾斜的
uncharted	海图上未标明
inseverably	不可切断
college	大学
indubitable	明白的
homophonous	同音
cromerian	克劳默文化
airspace	编队飞行所占用的空间
sloughy	腐肉
laingian	兰恩的
stormy	有暴风雨的
oofy	富有的
flanger	除雪器
square	四方的
rabid	患有狂犬病的
hollywoodize	使好莱坞化
lightwave	光波
rowen	割除后再生之草
jug	监牢
ancilla	女仆人
croupy	格鲁布性的
fuck	杂种
sudorific	发汗的
aero	飞行
unreflecting	不反射的
pithless	无力
sulphonate	磺酸盐
reliquary	圣物箱
torpidness	不活泼
fictile	可塑造性的
hoggery	猪一样的贪娈行为
wabbly	摆动
nous	心灵
iii	3
pigheaded	顽固
jupe	胸衣
angelic	天使
bladdernut	省沽油的荚果
haemolyse	=haemolyze
scr	Car
callithumpian	吹吹打打吵闹杂乱的街头游行的
unequable	不稳定的
psychiatric	精神病治疗
sellable	=salable
featherlight	轻如羽毛的
arthrodia	摩动关节
fascinating	迷人的
outside	出界
vaporous	蒸气多的
crip	瘸子
coralline	珊瑚状构造
reafforestation	重新植林
severalty	各有各事
oracle	神谕
rickshaw	黄包车
apocryphal	假冒的
hick	乡下人
lovell	洛弗尔
overparted	演过多个角色
inconsonance	不协和
edb	ethylene
felonious	恶毒的
indignantly	愤怒地
mother	妈妈
lorn	孤单
assuringly	确实
carpolite	石子
execratively	憎恶地
infector	传染者
compressure	压缩
attune	调音
medially	平均
disposed	有某种健康状态
crossgrained	固执的
humpback	驼背
finical	过分周到的
vop	in
neocosmic	新宇宙的
equality	平等
marlin	青枪鱼
unmeaning	索然无味
jus	法
slack	漏水的
curlicue	花饰
foreworld	洪荒世界
waywardness	不稳定
http	Transfer
misdemean	行为不正
anomalous	不规则
cumin	孜然芹果
explosible	可爆炸
bigoted	顽固的
registered	已登记的
unstatutable	非法定的
tramroad	矿车轨道
bellmouthed	承口的
newsletter	时事通讯
straight	率直
svelte	体态娇美的
ranine	舌尖以下部份
associate	交往
presentence	宣判前
wrong	错误
badmash	恶汉
cyclopedic	百科辞典
discontinuous	间断
liking	爱好
policymaker	决策人
tough	粗暴的
salut	祝你健康
cabasset	十六
exchequer	财物署
eloquently	善辩
trachyte	粗面岩
vile	可憎的
hmas	Australian
pale	尖板条
pelletize	使成颗粒状
governmentese	官话
veto	禁止
supplejack	阿拉巴马句儿茶
homecoming	回国
gradualness	渐次的
surat	印度苏拉特产的劣质棉布
sinful	罪孽深重
sned	修剪
lentiginous	有斑点的
spumone	一种意大利式冰淇淋
defeasible	可废止的
outline	略图
subplot	陪衬情节
amethystine	紫色的
languorously	郁闷
vdt	视频显示终端
fibrillated	=fibrillate
winebag	酒鬼
gaelic	盖尔人的
grits	粗燕麦粉
revival	复苏
oldwomanish	谨小慎微
superficially	浅薄
bardolino	巴多利诺酒
clinquant	金光闪闪的
incumbency	任职
provincial	省
flacon	有塞小瓶
protamin	精蛋白
gourdful	一瓢的量
dextrorotary	=dextrorotatory
cardiometer	心力测量器
micropolis	小型城市
transworld	世界范围的
sparaxis	裂缘莲
redivivus	再现
last	临终的
hall	走廊
intangibly	无形地
infertile	不毛
circumfluent	环流的
weightiness	重要性
summiteer	最高级会议参加者
agro	=aggro
wake	叫醒
wise	慎虑
misogynous	厌恶女人
hemicyclium	半日规
laos	老挝国
stere	立方米
idiosyncratic	特殊
acadian	阿卡迪亚
suricate	沼狸
do	尽力
pulsimeter	脉搏计
winterclad	穿冬装
distensile	会扩张的
anathematically	厌恶地
masty	不易解决的
asynchronism	异步
nebulated	朦胧
felloe	圈轮
pert	辛辣的
quadrate	使一致
designee	被任命者
simulacrum	幻影
sialogogue	=sialagogue
flare	突然烧起来
carrion	似腐肉
emphasis	重点
rsd	Society
baywreath	月桂冠
lawmaking	立法
curitiba	库里提巴
skimmer	撇乳器
waxy	生气
kgb	Komitet
hughie	雨神
dot	圆点
sidearm	侧投球的
protostellar	形成恒星
glittery	闪烁的
synkaryon	结合核
differentiable	可辨的
scenarist	编剧家
sensualism	感觉论
muzzle	钳制言论的手段
foregone	预知
listed	列出的
skimo	n
ashes	骨灰
sec	大臣
distraction	娱乐
leftish	左派的
panther	黑豹
urinant	头朝下
dimidiation	分为两半
setiform	刚毛状的
layoff	临时解雇
fend	力争
intracranial	头颅内
handworked	手工
forward	迅速
suborning	贿赂
redevelop	重点恢复
dodgy	会推托
cissoidal	凹边的
impoverish	使贫穷
irritative	刺激的
georgic	田园诗
featheredged	薄边
succinct	简洁的
extradition	引渡
slingman	投石手
mingily	小气
dab	轻敷
opaque	不透明物
mertensian	无毒拟态
lcp	Personnel
mezzorelievo	半浮雕
sudorific	发汗药
wavelength	波长
salient	突出
despotic	暴虐的
teletype	电报交换机
switchpoint	开关点
decoct	煎
hum	哼
assumingly	傲慢
ebu	European
barring	除非
afar	遥远地
rateable	按比例的
strewment	撒
volte	回
curacoa	柑香酒
unenlightened	无偏见的
dubitable	可疑
neologism	新语
rescinnamine	抗高血压剂
allpowerful	有无上权力的
guardship	守卫船
scud	迅速地移动或奔跑
assumpsit	损害赔偿之诉
apogeotropic	负向
skilful	技术好
biretta	四角帽
inauthentic	不真实的
ninepence	九便士
patchouli	广藿香
headfast	艏系索
subdean	副助理监督
weakly	虚弱地
tex	exchange
trendily	时髦
ruggedly	险峻
unwilled	无意的
start	动身
knuckle	关节
separate	分开的
iata	Transport
pensionable	有资格领退休金
obumbrant	悬垂
wreath	花圈
magdalene	从良的妓女
wolflike	狼似的
andantino	微急的
coextend	共同扩张
poise	平衡
absolute	绝对
parlous	非常
unbitter	没有仇恨的
duskily	微暗地
advices	报道
ingenuously	率直地
gynarchy	女人政治
literature	著作
sweltering	闷热
delomorphic	显形
riddling	筛选
lineskipper	插队的人
urbanise	使都市化
hydroa	水疱
faculative	容许的
ip	Protocol
ast	Army
curtilage	宅地
progestin	孕酮
tinclad	轻装甲炮艇
lunger	肺结核患者
channel	开导
decline	衰落
indirect	迂回
prejudgement	在审判前判决
gollywog	=golliwog
johnsonese	约翰逊式的文体
gerentocratic	管理者的
reversely	相对地
disbelieve	怀疑
nine	九个
remit	宽恕
chipper	高兴起来
dorset	Earl
aminophylline	氨茶碱
flagged	不能再喝
capric	公山羊
carbinol	原醇
transmit	发报
nurserygirl	=nurserymaid
abide	容忍
celibate	禁欲
lagune	礁湖
indolent	不痛
sophisticate	弄复杂
hitchhiker	短篇广告
trope	修辞
neuroleptoanalgesia	=neuroleptanalgesia
icftu	国际自由劳工联盟
ingressive	进得去
kilampere	千安培
neuropteran	脉翅目
cannibalise	=cannibalize
slipslop	枯燥的话
outflung	张开的
infructescence	果序
congregant	聚会者
coseismal	同震曲线的
hirstie	=histie
ovoidal	=ovoid
neurogenic	神经性
mirthful	高兴
surfacely	表面
rampant	跛拱
subbass	最低音栓
cyclization	环化
suspension	悬而未决
dancetty	锯齿形
whitsunday	圣灵降临节
english	英国人的
prolapsus	脱出
healing	有治疗功用
damyankee	北方佬
clinographic	斜射的
tagetes	万寿菊
dps	System
bennett	班尼特
heterotrophe	异养生物
archaeozoic	=Archeozoic
decree	判决
tactician	策士
pompier	救火梯
worsen	恶化
pretrial	审判前的
washy	多水
watchman	看守人
otic	耳的
divine	超人
spuddy	短而粗的
fugue	赋格曲
rubefacient	发红剂
sputter	唾沫飞溅
observable	看得见的
genevese	卡尔文教派之信徒
purism	纯粹主义
lacteal	乳状的
cist	箱形石坟
rumbustiously	难驯
derequisition	解除接管
froward	刚愎
unapproachable	无可匹敌
secondhand	做旧货生意的
hypothetical	爱猜想的
b2b	Business
tensible	可伸长的
undermanned	人员不足
slp	Socialist
remedial	补救的
reaggregate	使再聚集
undeceive	使醒悟
publication	公布
rubefacient	使发红的
oxyphenbutazone	羟基保泰松
abandoner	委付者
rammish	象公羊
unquestionably	无可非议
outback	内地
trashy	没有用的
cinquefoil	梅花形
syllogistically	三段论法式地
continue	连续
riancy	快乐
font	字体
tanintharyi	=Tenasserim
chilli	红辣椒
supervisee	被指导者
kremlin	克里姆林宫
synanthy	联生花性
sanguinopurulent	含脓血的
spacebar	空格键
sirdar	将领
callant	少年们
peaky	尖峰
sepulchral	埋葬
primates	灵长类
puckish	恶作剧
prognathism	凸颚
ball	子弹
sprightliness	快活
phallical	生殖器崇拜的
nonfigurative	非形象
fooster	忙乱
nocturne	夜曲
alway	总是
baor	Army
siding	旁轨
cryogen	致冷剂
childbirth	分娩
obediently	服从
magdalen	妓女收容所
irreducible	不可约分
barterer	交易商
authoritarian	独裁主义
album	集邮本
mortify	苦修
palewise	垂直地
strange	陌生
iotp	Trading
downmost	最下面的
retiary	网状
nwbw	northwest
windbag	饶舌之人
ammocolous	栖砂的
lento	柔和
steadfast	坚定的
episode	有趣的事件
furibund	狂怒的
spode	斯波德式
marquetry	镶嵌细工
cast	投射
eruptive	暴发的
rotavirus	轮状病毒
overpaid	的过去式和过去分词
detectable	可看穿的
exposal	显露
salvationist	救世军
haggard	野鹰
exudate	流出物
hmnzs	Her
chronic	延续很长
stag	不带女伴参加晚会
friskful	有生气的
metacomet	梅塔科米特
voyage	旅行记
intercostal	脉间
diphthongization	二合双元音化
overstock	进货过多
kibed	生冻疮
ial	Algebaic
fake	仿造
bill	帐单
transuranic	超铀
unbarbered	未理发
sf	加强
safranine	番红精
ba	Ba
intercurrent	中间发生
subsidiary	补充
exenterate	去除内容物
cupel	试金用灰皿
czestochowa	琴斯托霍瓦
moustachio	八字须
adjusted	调整过的
chromocentre	核粒
uncoped	无法与之竞争
contrasty	明暗差别强烈
arm	海湾
uv	紫外
yap	无赖
malapportion	不公平的代表权
asynchrony	=asynchronism
integral	积分
direct	指引
ultrathin	超薄的
coolth	漠然
malacophyllous	柔叶的
pontoon	浮筒
oslo	奥斯陆
polyhymnia	圣歌女神
intranquil	不安
changeful	不稳定的
mozzarella	色白味淡
repeatedly	再三地
life	一生
zincoid	锌
burp	饱嗝儿
walsall	沃尔索耳
noddy	傻瓜
front	朝向
extravehicular	太縅lE獾
ungrounded	无稽
beat	打败
doctorand	博士学位候选人
dystopian	反面乌托邦的
nembie	宁比
bes	喜神贝斯
interstrain	杂交
groovy	很帅的
tudor	都铎式建筑式样的
infernal	恶魔
place	位置
tubate	有管的
grazioso	优美的
immutably	不变地
jumpily	跳跃
dress	服装
odophone	香味等级
tunic	束腰外衣
kilter	平衡
zimbabwe	津巴布韦
unapparent	不明显的
tanglesome	复杂
pathography	病史
unsized	未上胶水的
unendowed	不赋有的
formal	合礼仪
extraparliamentary	非国会所能控制
workman	工匠
admix	使混合
nymphaeaceous	莲科植物
ouzel	黑鸫鸟
profoundly	深深地
porifer	海绵
palaver	闲聊
unobstructed	没有障碍
unionise	=unionize
ensate	剑状的
lyrical	充满感情
woefully	使人痛苦
zygoid	合子
nidamental	生卵膜
merci	谢谢
toolhead	刀架
riflebird	风鸟
journey	旅程
amethopterin	氨甲蝶呤
duodecimal	十二为单位
apteral	无翅的
planting	种植
lms	London
euclidian	欧几里
brainworker	脑力劳动者
palpable	明显
rusty	腐蚀了
achillean	阿基里斯
antifungal	杀真菌
woozy	糊涂的
maduro	色深味浓
blastissimo	极强的
pdh	准同步数字系列
jib	踌躇不前
beatle	独立摩登新女性
pulmonic	肺
reaper	收割者
fighter	斗士
increasable	可加大
rachiodont	具喉齿
celature	金属浮雕
unworldly	对钱财不感兴趣
regular	经常的
cheroot	方头雪茄烟
ecology	生态学
jeff	杰夫
outbid	出高于……的价钱
cuboid	立方形的
poofy	脂粉气的
frigidly	冷淡地
tribalism	部落文化
uninterrupted	连续
evadingly	逃避
campanulaceous	吊钟花科
anaphylactic	过敏
radioulnar	桡尺骨的
defective	欠缺
drowsily	懒洋洋地
cutout	剪切块
navarchy	舰队
divertissement	娱乐
faculty	才能
advised	考虑过的
rhinolithiasis	鼻石症
cryptical	神秘
fascistize	使法西斯化
teletypesetter	电报铸字机
kenspeckle	明显
xerophile	旱生植物
heady	鲁莽
ldh	lactate
tiber	台伯河
yahoo	提供Internet上的目录信息检索服务
galess	无胆汁
easting	朝东方
unapparent	不明显
puttier	使用油灰者
adonai	我主
orangy	似橙
waver	摇摆
toothbilled	有齿喙
sepulchral	埋葬的
acceptee	被接受的人
liable	有义务的
tummler	小丑
legwork	外出搜集情况的工作
pesticide	杀虫剂
aeolian	风蚀的
gridder	橄榄球运动员
whitethorn	山楂
acceleratory	加速
tdma	Access
savings	储蓄
ductile	易教导
acrogenous	顶生
sloe	黑刺李
analecta	文选
proconsulship	总督的职位或任期
erasure	抹掉
blockboard	芯块胶合板
momentarily	即刻
peculiar	罕见的
aboveground	活着
oculate	具单眼的
dermoskeleton	外甲
thematic	论题
gsp	Preference一般特惠制
carnal	肉欲
savoury	风味极佳
unacquaintance	不知
attrited	磨坏
scherzando	戏谑
ashore	向岸
citrate	柠檬酸盐
unaccepted	不承担的
chain	一连串
darkle	潜藏在暗中
xix	罗马数字
scarabaeus	甲虫形宝石
erythrophyll	叶红素
papyrotype	纸印平版法
konk	鼻子
tope	豪饮
xylographic	木版印刷的
sociality	交际
rainily	多雨
addressable	可设定地址
ppt	000分之……
moldproof	防霉
knackery	老弱家畜屠宰场
atomization	以原子弹摧毁
ciaa	Athletic
adversarial	敌手
impertinent	无关的
surgical	外科医生的
mump	欺骗
unartistic	非艺术
sublime	庄严
poussie	猫
sheepherding	牧羊
hardhat	需要戴安全帽的
eternal	不灭的
whither	目的
exponential	例子
implicit	暗示
polysynaptic	多突触的
renascent	复活
independent	独立自主
gridiron	烤架
histochemical	组织化学的
pollenosis	枯草热
rident	笑的
raid	Redundant
chid	chide的过去式及过去分词
rook	车
sesquipedalian	令人厌倦
didymous	成对的
voltammeter	伏特安培计
caboshed	面朝前而无颈的
thalassocracy	海权
overwhelm	压倒
codlinsandcream	柳兰
anovulation	停止排卵
aphlogistic	无火焰
premundane	创世前的
spectrogram	光谱图
general	全面的
surrounding	环境
tendril	卷须状之物
honeymoon	度蜜月
simplicity	简易
overbid	过高的出价
undraw	拉开
neaten	整理
forborne	forbear的过去分词
fere	伴侣
ebcdic	扩充的二进制编码的十进制交换码
regain	重新夺
cobblestone	鹅卵石
plantmilk	植物牛奶
compactly	简洁
larghetto	稍缓慢
greasewood	藜科灌木的一种
flaxen	淡黄色的
flyer	飞行员
cortile	中庭
sleave	细丝
finch	雀类
peritectic	转熔
chemoprophylactic	化学品预防的
diethyl	二乙基
flunky	仆人
dotal	嫁妆的
habilitate	取得资格
yakka	艰苦工作
gigman	庸俗的人
awshucks	谦卑
sneeringly	轻蔑
sentiment	情感
byob	your
goddess	女神
anisotropic	各向异性
enunciative	宣言
gambit	话题
contrariant	反对的
tolstoian	托尔斯泰的信徒
spin	纺
toadeating	谄媚
cuvierian	居维叶
liftback	提升式流线型后背车身汽车
quit	离开
bundu	未开发的地方
recalcitrant	反抗的人
putschism	煽动暴动
multigraph	小型旋转式印刷机
poland	波兰
turnspit	转叉狗
patient	耐心
twelfthly	在第十二
collectedly	收集成地
minamata	disease
waistline	腰身部分
logy	迟缓的
preaxial	中轴前
limberneck	腐肉中毒
fiduciary	受托人
though	尽管
authoritative	权威的
twelvemonth	一年
brasilein	=brazilein
specky	有瑕疵的
measly	患麻疹的
avt	tax
glycoside	配醣
electroengineering	电工技术
sensate	可感觉的
cismontane	山脉的这边
incorporative	合并
thriftless	浪费
unknowable	不可知
visuospatial	视觉空间的
tx	Texas
inconvenient	不便
lose	使沉溺于
umw	矿工联合会
jestingly	滑稽
yamato	大和人
cryptographical	密码的
fairing	酬谢礼品
humorous	滑稽的
thermoremanent	热顽磁的
rouille	胡椒味大蒜酱
reliant	信赖
arthroscope	关节内窥镜
crustaceous	外壳的
unexacting	不苛求的
droopy	无精打采的
fool	开玩笑
morbidity	病态
immaculate	完美
cancerization	癌化
nourishing	有营养的
teentsy	很小
manducate	吃
work	作品
prettify	修饰
raised	浮雕
scrap	废弃
opportunity	时机
subcylindrical	近圆柱形的
unexpectable	不可预言
phanerogamic	开花的
urson	鸾猪
kasolite	矽铅铀矿
reemphasize	再度强调
integrase	整合酶
homalographic	=homolographic
southwardly	来自南方
liberalize	自由化
intracerebral	大脑内
ovoid	卵形的
saury	竹刀鱼
literal	照字面上
heathy	石南丛生
gumshoe	偷偷做
rumpless	无尾的
anile	似老妪的
majestic	庄严
fireplug	灭火塞
chlorophyllous	含叶绿素的
muffle	围巾
aujus	带原汁
treasure	珍品
knightlike	骑士风尚的
documentarist	=documentarian
finny	有鳍
sinaean	=Chinese
untogether	混乱的
ethnics	伦理学
unvitiated	未败坏
avowed	公开宣布
wherefore	为此
ciborium	祭坛上的天盖
biosonar	生物声纳
antipathic	反对的
particularist	同上主义者
ruination	毁灭
cant	讲黑话
wbo	World
sheath	鞘
protomorphic	原形态
seam	缝合
subdivisible	可以再分的
partnership	配对
sejant	伸直前脚而坐
aeromechanic	航空技士
evergreen	常绿植物
dexedrine	中枢神经刺激剂
condyloma	湿疣
betrothal	婚约
immutability	永恒性
gab	爱说话
achievable	可有成就的
educable	可培养
johnsonian	约翰逊研究者
necessary	必然的
count	计数
snell	精明
glandular	起腺体功能的
raffish	名誉不好
minuscule	用草写小字写
ovibos	=musk
whatso	不论什么
patronage	赞助
videorecord	录制……的录像
slimmish	稍为苗条的
rule	破折号
drawn	draw的过去分词
destructible	可破坏的
assumed	装的
squirm	蠕动
aquiferous	蓄水
claptrap	讨好的言语或行为
flightily	轻狂地
monomial	单项的
presumably	大概
excurved	往外弯曲
cynocephalous	似狗头的
canular	套管状
haptical	触觉
humoral	体液的
rx	处方
knowable	可知
lure	引诱
bulkily	笨重地
print	印刷业
accessorius	副肌
kindly	温和地
trample	蹂躏
finny	鳍状
piping	尖音
jamaican	牙买加的
jugum	腕锁
pluviose	雨量多的
scope	余地
leave	离开
irides	鸢尾科植物
erasmian	伊拉斯谟作品
noogenic	心理演化的
bulgur	碾碎的干小麦
comparable	比得上的
naupathia	晕船
sthenic	亢进性
disbelieve	疑惑
jerusalem	耶路撒冷
tripey	废物似的
amoebiasis	变形虫病
slipway	船台
bestial	兽性的
strife	竞争
unconventional	/
pilous	有毛的
contemplative	沉思
masturbatory	手淫
superphosphate	过磷酸石灰
repose	使休息
septangle	七角形
uri	upper
replicative	重复
tache	斑点
inartistic	缺乏艺术性的
alibi	托辞
heimisch	不装模作样的
penile	阴茎的
microscopic	精微的
score	帐目
vociferation	大声叫嚷
distressful	不幸
architrave	线脚
senopia	老视减退现象
devoid	全无
irreplaceability	无法调换
capot	独赢
hatchet	短柄斧
subsidise	平息
disconcertedly	不安
glucokinase	葡糖激酶
abiogenetic	无生源说
cough	咳嗽
ephemeris	星历表
vulgarize	使庸俗化
illustrious	杰出
gum	香口胶
hydrous	含水
amazingly	可惊地
rumormonger	造谣者
awny	有芒
airproof	不通气
oxymel	醋蜜剂
average	一般
pigmentary	色素
squantum	烤蛤野餐会
karyotype	染色体组型
striction	紧缩
safekeep	维护
insensitive	对……没有感觉
abnormality	异常性
incursionary	侵犯
lawny	平坦并铺有草皮的
venerable	值得尊敬
hickwall	啄木鸟
inclinable	倾向于……的
pict	皮克特人
whizzo	极好
rogatory	查询
spectroradiometer	分光辐射度计
bromo	助消化药
shamus	警察
blacking	黑色涂料
wow	哄动一时的人物
genie	妖怪
mendable	可更正
unartistic	与艺术无关的
stringless	无弦
gadfly	形似苍蝇
valorously	无畏
smoky	冒烟的
pesky	烦恼的
outskirt	外边
deuteronomist	作者
comfortlessly	孤单地
sunghua	见
tramp	践
unweary	不厌倦的
dohc	双凸轮轴
permissible	可允许
saveloy	干腊肠
xxxix	罗马数字
fastening	结扎者
desolation	忧伤
marina	码头
illatively	根据推论地
absolute	绝对的
dusk	黄昏
zany	滑稽的
baric	含钡
faa	Administration
destructional	由破坏因素造成的:
acoustic	音响学
hidden	隐藏
ejido	合作农场
giddy	轻率
cyclopedic	广泛
taxameter	自动计费计
crepitation	爆裂声
restauration	修缮
husky	嘶哑
driveability	操纵性能
indemnitor	保障者
foretime	过去
encephalograph	X
aid	Identifier
vegete	生气勃勃
weeknights	在周日夜晚
dilate	扩大
editmenu'	NULL)
specula	子宫镜
strict	严谨的
bruiser	彪形大汉
buntline	帆脚之上升索
alpargata	帆布轻便鞋
parthenospore	单性孢子
slimmish	略嫌不足
eudaemonia	因理性而积极生活所带来的幸福
hypomanic	轻度躁狂
substernal	胸骨下的
archaistic	拟古
biedermeier	彼德麦式样
skiver	割皮革的人
paperbacked	平装的
divers	种种的
pantomime	手势
mentalism	心灵主义
conarial	松果体的
vallum	壁垒
and	并
restrain	抑制
reflorescence	第二次开花
horsepox	马天花
unshaded	未遮住
palliatory	减缓的
transpiration	散发
elucidative	解释的
lapin	兔子
equatorial	近赤道
cheliceral	前肢之螯
macedonia	马其顿地区
schumpeterian	熊彼特经济学说主张者
neoplasitc	新造型主义
grimm	Jakob
sss	Selective
intilted	向内倾斜的
hydrometeorological	水文气象学的文气象学
chain	用链条拴住
prodigalise	=prodigalize
thursday	星期四
reversible	可逆
telephoto	用远距镜头照相
inkholder	贮墨筒
atrium	中庭
mshe	Science
goon	愚笨者
gftu	Trade
smokables	烟草
torous	=torose
unembroidered	朴素
scandent	附着
table	餐桌
uniplanar	单面延展的
concoct	编造
floricultural	养花
panegyrical	颂词
cattery	养猫的处所
agilely	敏捷地
imprecision	不严密
led	Light
macao	澳门
humbleness	谦逊
countryside	乡下地方
popster	=pop
stockily	一本正经地
unvexed	不受干扰
edge	侧着移动
tennessean	田纳西州人或居民
diffused	散布
venomousness	有毒
discal	盘状
gate	大门
superterrestrial	天上
braky	多刺丛
factorial	阶乘
erbium	铒
tailfirst	尾在前地
loth	勉强的
sluttery	邋塌
datacasting	数据广播
to	汤加
subdolous	有点诡谲的
manumit	解放
machicolate	开堞眼
frankenstein	毁灭创造者自己之物
raffinate	残油液
whilst	时时
mesotrophic	中滋育
plowland	古代土地面积
equipped	装备
expedite	畅通的
disappointed	失望
neuromotor	神经运动的
eyre	巡回法院
sightworthy	值得参观的
indisposition	不适宜
accumulator	蓄电池
taboo	禁止
waxen	蜡的
fluky	变化无常
sintra	辛特拉
hydraemic	水血症
extra	特大的
tasty	好吃的
language	代码
lopstick	截枝树
lichenology	地衣学
dung	粪
achilles	阿基里斯
asap	Soon
debriefing	任务报告
biparietal	二顶
noncontrastive	不对比的
inhaul	引索
nix	停!
magic	有魔力
sized	有……大小
ultrafine	极其细小
incapacious	无能
dead	熄灭的
suberose	软木质的
amimeche	机械工程师学会准会员
hypergamous	与上层阶层或地位高贵的人联姻
shearling	剪过一次毛的羊
caucus	领导人秘密会议
rhizoma	根茎
sniff	嗅
wilful	任性
cyclostomatous	有圆口
fan	刺激
baltimore	巴尔的摩
yearn	向往
weltschmerz	悲观
epicardial	心外膜的
deficient	不足
slyboots	狡猾的人
fineness	优良
epiphanic	顿时领悟
extractant	提取剂
gioconda	不可思议的
dirge	哀悼歌
telosynapsis	衔接联合
revisionary	修正
feta	羊乳酪
ncsa	国家超级计算应用中心
possibilism	可能主义
underproductive	`QndE9prCdQkv/
enslavedness	被奴役之状态
sempiternity	永久
scherzando	诙谐
spark	求婚
ravine	溪谷
millcake	亚麻籽渣
progress	前进
register	登记簿
hathoric	爱神哈索尔的
handled	有把手
duplicable	可再发生的
laddish	稚气
seaward	朝海的
pergola	绿廊
racon	雷达信号台
reinsure	再保险
browser	吃嫩叶的动物
turdine	鸫的
welter	汹涌
complimentary	夸奖
spirochaeta	=spirochaete
contrarily	相反
fulminous	像迅雷的
coop	拘禁
zymase	酒化酶
encephalitogen	致脑炎物质
sheathe	插入鞘
until	到……为止
macrophyllous	具长叶
chlorite	绿泥石
organically	有机
paranormal	超过正常的
homeric	荷马时代
torpedo	鱼雷
unemployable	不能受雇的
nazim	督军
remember	记
cad	卑鄙的男人
lentiform	透镜
dls	Library
abandon	放弃
nob	大人物
decubital	卧姿的
spenglerian	施本格勒理论
devotement	献身
palace	宫
browse	放牧
failure	疏忽
bally	极
fetoscopy	用胎儿镜观察胎儿
entitle	给……权利
cockalorum	自负的人
lithite	平衡石
slung	sling的过去式及过去分词
sotted	麻木迟钝
leg	走
gaedhelic	哥德里克语
revisionist	修正主义
indulgency	放纵
true	忠实的
minium	朱砂色
amendable	可修正的
tuitional	讲授
shakily	虚弱不堪地
reduction	缩影
fluorinate	在加少量之氟
bloke	小子
soph	=sophomore
germination	萌芽
endoderm	内皮层
tumbrel	农用自卸车
fingersmith	接生婆
engage	使参加
kongo	刚果语
teapoy	三脚几
color	变色
rhapsode	荷马史诗吟诵者
republican	共和主义
flaxbush	新西兰麻
coven	十三女巫大集会
homozygous	同型结合
technicolored	天然色的
feverwort	泽兰属植物
sclerotin	壳硬蛋白
hexahedral	六面体的
amphichroic	两性反应的
comprehensivize	综合化
sod	草地
acridity	狠毒
unbelief	不信仰
were	be的过去式
industrialisation	工业化
nonpasserine	非雀形目
productivity	生产力
saphenous	隐的
homoplastically	类似
bullish	似公牛的
incandescence	炽热
adieu	再见
saturant	使饱和的
hazy	朦胧
precooler	预冻装置
aethereally	飘渺
growthman	主张经济发展政策的人
eudemon	守护神
undemonstrative	含蓄的
mephisto	=Mephistopheles
unipole	单极天线
dendrogram	系统树图
jaundice	黄疸
infertile	不肥沃
logarithmic	对数的
raunchy	肮脏的
hegemonism	支配权
jumbuck	羊
trolleybus	无轨电车
quackster	骗子
commencement	开始
catechetical	问答式的
emblematic	标记
secund	只有一边
wrest	猛扭
entrain	导致带走
sphere	半球
investiture	授职
sordamente	抑制地
parcelgilt	局部镀金
fold	折
baseset	基本集
densimeter	密度计
seiche	湖面波动
smack	滋味
vain	徒然
southing	南向
trammel	阻碍物
gynecology	妇科医学
intermit	中断
sabot	木底皮鞋
stale	陈旧的
lucullan	奢侈的
integrated	综合
oncer	只做一次的人
sore	痛处
lateral	侧部
pillory	上颈手枷
aplasia	发育不全
subaltern	中尉
anthropophuistic	神人同性论的
toothed	有……齿的
extraction	取出
workpoint	工分
steak	鱼片
waspish	易怒的
indigene	土著
umiak	木架蒙皮船
magniloquence	夸大
bottlekhana	伙食房
impetuous	猛烈的
linked	显示连环遗传的
ineffaceable	不能除去的
vendee	买方
ripsnorter	突出的人
insectology	昆虫学
unfearing	大无畏
ophiology	蛇学
drizzle	下毛毛雨
arrowy	笔直
keten	=ketene
ashman	清垃圾的工人
cruciate	十字状
portwide	全港
drum	作鼓声
maracaibo	马拉开波湖
terni	特尔尼
threeman	三人共同管理
interpolation	插补
voyageur	加拿大的船夫或樵夫
upcurl	蜷曲
filth	猥亵
rostrum	演讲坛
verneuk	骗
joel	约耳书
commend	吸引
backwardly	落后地
glossopharyngeal	舌与咽的
hizen	肥前陶器
surinamer	苏里南人
choreography	舞台舞蹈
multinomial	多项
villeggiatura	乡村生活
confirmedly	根深蒂固地
lientery	滑肠
lineshaft	天轴
conventionally	照老例
iconographic	肖像的
arachnoid	蛛网膜
rapparee	土匪
formularise	=formularize
preconvention	大会前的
vaccinal	疫苗
docking	入坞
moviedom	影坛
rosaniline	由苯胺制得的红色染料
peytral	=poitrel
greenstone	绿岩
zeolitize	沸石化处理
ampullaceous	瓶状的
noctambulism	梦中步行
special	专门
delphic	暧昧
gibber	把莫名其妙的事叽叽喳喳地讲
sogat	of
transpire	使蒸发
nodular	小瘤的
pectinaceous	含果胶的
supervisee	被监督者
sunlike	非常明亮的
overpowering	压倒性的
urinogenital	=urogenital
evisceration	取出内脏
aardvark	土豚
orthognathous	直颌的
unreceptive	不会接受
unskilful	不熟练的
unceremonious	随便
lurch	困境
corned	弄成细粒的
seizor	占有者
descendant	后裔
suttee	妻子的殉夫
rattleheaded	头脑空虚的
monostele	单体中柱
elusive	易忘的
tearless	不流泪的
invective	恶言漫骂
empoison	污染
improper	不正确的
depart	过去的
virescence	绿色
aquaria	见aquarium
triptych	三幅一联
affranchise	恢复自由
monographist	专题论文作家
coi	Central
endurable	能忍耐
weave	编法
foliicolous	寄生在叶上
infinite	无限的东西
astringency	收敛性
unacquaintance	不相识
unattended	无人出席的
totter	摇摇欲坠
gumbo	坚硬黏土
trifle	嘲弄
palliard	放荡之徒
penitential	后悔
arrearage	延滞
downsizing	缩小化
hebrewwise	希伯来式
evolvement	演变
dural	硬脊膜的
zeroize	拨回零点
encyclopedical	百科全书的
signalize	向……发信号
unfilmed	尚未拍成影片
parasitology	寄生虫学
gunfire	炮火
spectacled	有眼镜状斑纹
diminutive	指小
shaving	刮
outhouse	厕所
inter	埋葬
whole	纯粹的
chalybeate	铁泉
wrongfully	不正当地
apt	灵敏的
tetraphonic	四声道立体声
mfp	多功能打印机
airy	空想
medici	=Medicean
egad	天哪
venturous	大胆
mildew	使发霉
nonprotein	不含蛋白质的
bumkin	=bumpkin
necrophagous	吃腐尸的
plantlet	小植物
mealymouthed	不敢直说的
aperitif	开胃酒
sacerdotal	祭司
oxidate	=oxidize
overrun	泛滥成灾
trochilics	旋转机械运动学
dump	堆存处
teleological	目的论的
irreproachable	无可指责的
reckless	不计后果
enzygotic	同孵性的
pistillate	有雌蕊
intercommunal	社区之间
world	……界
lequear	花格平顶
scoriae	火山的岩烬
uptodate	现时
parc	帕洛阿尔托研究中心
nicish	须慎重对待
latifundista	=latifundist
commence	着手
neutrophile	嗜中性
impledge	抵押
wobble	动摇
ladrone	土匪
superficialness	肤浅
laocoon	拉奥孔雕像
overlive	活得比……长
deprecatingly	不赞成地
wilson	威尔逊
unharming	无害的
pigheaded	愚蠢
drachm	古希腊的重量单位
comparator	比较仪
indistributable	不可分配
consternation	惊惶失措
blues	沮丧
neologism	创造或使用新语
whalecalf	幼鲸
upstream	逆流
shikaree	猎人
show	炫耀
sustainable	养得起的
losing	损失
impedient	阻碍
aperiodic	不定期
minicam	小型摄像机
hick	土头土脑的人
scoot	迅速跑开
shapable	样子好的
nasty	威胁的
allelic	等位基因的
preemployment	雇用前的
solarization	负感作用
aapss	Political
papal	罗马教皇
funny	奇异的
undescribable	难以叙述的
betaine	三甲铵乙内酯
unspeakable	坏透了的
handsbreadth	掌幅大约4英寸
doss	卧处
histopathologic	组织病`lCdVIkEl/
cloy	吃饱
drably	单调乏味地
exhaustion	疲惫
saunter	闲逛
nescience	无知
dartle	连射
cheapness	廉价
peachblossom	桃花
rencontre	遭遇
dilater	扩张肌
unmoving	不感动人的
leggy	腿过长
oversea	海外
suction	抽水泵
ural	乌拉尔山脉
halafian	哈拉夫文化的
conjunctive	连接
debag	脱去……的裤子
insomuch	就此程度而言
refuge	避难
exdividend	除般息
aeromechanic	航空力学的
sensation	耸人听闻的
kumgang	金刚山
therm	千卡
proscription	剥夺人权
sklodowskite	硅镁铀矿
dumb	不说话
wud	发疯的
counsellor	律师
cuffy	黑人
hydrophile	亲水
swelldom	时髦的人
passably	也还过得去地
forgetfully	健忘
handicap	妨碍
edward	爱德华
boy	男孩
flutter	拍
beribboned	有饰缎带
esthetics	美学
exoatmosphere	外大气层
pseudoclassic	伪古典的
invidiously	不公平地
opaque	不透明
uat	de
lonely	人迹罕至
bemud	使迷糊
orthogon	矩形
decant	移入其他容器
demonstrate	证明
nosogenetic	致病原因的
keyman	最重要人物
imaginably	可想象地
scepticism	怀疑主义
pebble	小圆石
flaccid	无活力
ninebark	九层皮
apiary	养蜂场
msbc	房屋建筑学硕士
feeling	富于同情心的
unrhymed	不押韵
diffusible	扩散性
subhuman	类人
style	时尚
rtl	电阻晶体管逻辑
improvvisatore	=improvisator
cleverly	聪明
igmp	Protocol
hhfa	Home
samnite	意大利一古民族人
smartness	现代风格
scholiast	注释者
tintinnabular	铃声的
relict	残余体
feldspathose	长石质
gigsman	轻便快艇水手
bested	在……境遇的
raffle	抽彩
heavenly	神圣
msgm	Management
po	夜壶
ectogenic	体外发育的
nonresistant	不抵抗主义者
double	双重的
facility	熟练
dastard	懦夫
belated	误期
brisk	敏锐
vii	7
gummous	似树胶
feldspathic	象长石的
meliorable	可改良
thinnish	有点薄
detent	掣子
vehicular	作为媒介
genealogical	家系
xeromorphous	旱生型
hepatopancreas	肝胰腺
criminal	罪恶的
meagerly	贫乏
wisecrack	说俏皮话
socially	善于交际地
chivaree	笑闹音乐
victual	贮藏
charitably	慷慨地
transferee	受让人
parabombs	空袭用的炸弹
nurbs	曲线曲面的非均匀有理B样条
half	半学年
prudently	慎重地
tartarean	地狱的
lion	狮子
triole	三连音符
consubstantiate	圣体共在论/
degree	程度
niggle	拘泥小节
working	抽搐的
misunderstand	误会
blubber	哭泣
faint	衰弱的
flapjack	小粉盒
consequentiality	自大
verrucose	多疣肿的
rub	擦
spreadable	容易被涂开
unshod	赤脚的
neighbour	邻居
lichee	荔枝
piligerous	被毛
digitated	有趾
spasmodical	间歇性
unlearnt	unlearn的过去式及过去分词
bibliopegistic	/
conclusive	最后
hematozoal	血内寄生的
suspensible	可中止的
seat	座
mapam	以色列统一工人党
downside	底侧的
bumptious	盲目自夸
proprietress	女业主
heterokaryotic	异核体
glance	扫视
maunder	徘徊
zincky	似锌的
snuffy	讨厌的
assimilatory	同化力
diamagnetism	反磁性
molluscoid	软体动物似的
sigillographer	印记学家
honorable	可敬的
knightlike	正义的
halation	晕光
socle	脚柱
placentate	=placental
collaborate	合作
unshaped	不成形状的
result	结果
subjugation	征服
unremitting	不懈的
eunuch	宦官
spoonerism	斯本内现象
hijack	揩油
audacious	卤莽
asid	American
brushy	毛茸茸的
undergird	加强
micr	Recognition
acuate	锐利的
earthstar	量显地星
m	/存款单
whipping	鞭打
typesetting	排字的
ovenwood	木柴
collaborative	协力完成
unaccented	无重音
jointed	有接缝的
a	帐上
unhandily	笨拙
fewtrils	小事
nontoxic	无毒的
nutsy	发疯
rimous	有裂缝的
optometrist	验光师
unsuitability	不适合
colourless	无色
county	郡
vascar	Computer
flatly	水平地
ballistic	弹道的
oread	俄瑞阿得
fontal	泉
spiry	尖端的
monostomous	具单盘
mandrel	心轴
euhemerism	神话即历史论的论点
feebleminded	意志薄弱
foundry	翻砂
material	实质性的
gox	oxygen气态氧
eec	欧洲经济共同体
unadvised	欠思虑的
osteoplasty	骨成形术
antiform	反传统形式的
francophobe	讨厌法国的
discernable	可认识的
tachygraphy	速记术
formicivorous	食蚂蚁
matted	纠缠
idlesse	空闲
anaplastic	还原成形术
basque	巴斯克人的
unaccepted	未被接纳
spyglass	以开发Mosaic浏览器闻名
primogenitary	长嗣继承
indisposed	不合适
hectic	发热
unfatherly	残酷的
immalleable	不能适应的
unsex	使失去性功能
mohammedan	穆罕默德
identic	完全相同
blaspheme	咒骂
siphonophore	管水母目动物
bugs	发疯的
technocracy	专家政治论
crustless	无硬皮的
clean	清洁
reject	驳回
transmission	传送
joycean	拥护或喜欢乔伊斯的人
herbage	草
overpunch	补孔修改
barbaric	肆无忌惮的
pikeperch	鰤鲈
misjudgement	判断错误
hippological	马学的
trappy	艰险的
grifter	骗子
zoroaster	拜火教的创始人
interpenetrate	渗透
sm	Sadism
voluntary	非官办
jug	水壶
unspilt	未溢出
hyperosmia	嗅觉过敏
hetero	非同性恋者
fissive	分裂生殖的
cant	斜面
scabwort	土木香
veil	蒙上面纱
canary	淡黄色
withering	摧毁的
photodecomposition	光解
inimically	有敌意
icehouse	冰库
subservient	屈从的
aapss	美国政治和社会科学研究院
brassiere	奶罩
bally	可厌
hutch	把……装箱
inferable	能推理的
sawder	奉承
barnacles	鼻钳似的刑具
alpine	高山
platycephaly	扁头
leftist	左翼的
peloponnesian	伯罗奔尼撒人
rebarbarize	使重新变野蛮
ruling	裁决
elastic	弹性
greatly	非常
fichu	三角形披肩
atwirl	快速旋转的
imprest	预付
flavopurpurin	黄红紫素
dotted	有点的
apogamic	无配子生殖
passenger	旅客
nick	挑毛病
typefounder	铸字工人
equality	等同性
superposition	重叠
confraternity	帮会
bisynchronous	双同步
aeriferous	送气的
barracuda	鱼
lossmaking	老是亏损
price	价钱
ruffianly	恶棍般的
airt	方向
square	结算
disproval	反证
afterlight	后见之明
embryophyte	有胚植物
galley	狭长船
etcher	腐蚀铜版制作者
porky	猪肉
photovaristor	光敏电阻
barrage	弹幕射击
oleomargarin	人造奶油
fullhearted	充满感情的
deplethoric	体液缺乏
hamiticize	使含米特人化
unimpressible	难受影响的
yielder	提供产品的人
tailorable	可裁制成衣的
antiheroine	非正统派女主角
phototaxy	趋光性
athambia	冷静
rieka	=Rijeka
gleaning	拾落穗
ruefully	可怜地
staggerbush	马氏南烛
arrant	声名狼藉的
chipper	切东西的人或工具
mitral	僧帽状
overlusty	过分强健的
unworthy	不足道的
supermanly	超人的
consent	同意
deneutralize	非中立化
newspaperdom	新闻界
pentagraph	相连的5
distinction	级别
canalside	在运河边上的
putschist	反叛者
pretor	执政官
halala	哈拉拉
quarter	季度
niggerize	轻蔑地对待
blackguardly	流氓的
disoriented	无判断力的
delawarean	特拉华州的
uba	Airways
curse	咒语
drifting	漂流
saving	补偿
amok	狂乱地
interface	界面
jugate	具翅轭的
misbeseem	=misbecome
positive	绝对
promptness	敏捷
icebound	冰封
petn	tentranitrate
flocky	毛茸茸
oleomargarin	人造奶酪
constantly	经常地
eccrinology	分泌学
inflammable	易燃的
uniparous	单梗的
difficult	艰难
peenie	阴茎
engraver	雕工
crassly	粗鲁
fascisti	法西斯党
alchemistically	炼金术地
vociferous	大声叫
daughterly	女儿的
rachitis	脊柱炎
expand	详述
bioavailability	生物药效率
fiduciary	被信托者
actinal	口侧
undercut	雕出
needler	揶揄别人者
transude	渗出
cozily	安乐
unreduced	未弱化
sabrina	塞布丽娜
epigraphist	碑铭研究家
tricarpellate	三心皮
informally	非正式
afl	American
deuce	平分
cymous	聚伞状的
its	它的
spathe	佛焰苞
obtuse	钝的
level	夷平
apteryx	新西兰人
oratorize	高谈阔论
groovy	槽的
achievable	可完成的
fearless	不怕的
laminose	压成薄板
psychosomatic	精神身体相关的
duster	打扫灰尘的人
hypaethral	户外的
unseat	使从马上摔下
fissirostral	宽而深裂
vacillation	踌躇
mortal	致命的
bpc	Pharmaceutical
thankful	感激的
slipslop	懒散
pontes	连接部分
mafic	铁镁质
touchable	可触的
semihyaline	半透明的
msbc	Construction
movement	动作
bibliographical	著书目录
haemophilic	血友病的
venial	可宽恕
siphonaceous	虹吸管状
interpretable	可判断
incompatibly	矛盾
vlcc	very
federal	联邦
fermentative	有发酵力
metestrus	=metoestrus
noctuid	夜蛾科
caliology	鸟巢学
maura	莫拉
yielding	让步
pugnacious	好斗
businesslike	公事公办
hoot	表不满或轻蔑的叫嚣
improper	不适当
volation	飞行能力
mahlerian	马勒
iconological	肖像学的
ceinture	束带
achaia	=Achaea
longanimity	忍受
cardioverter	复律器
proseman	散文作家
sunbrowned	被太阳晒黑的
galvanic	以流电所产的
ghettoize	使成为少数民族居住区
capsulotomy	被膜切开术
polychroism	多色性
distance	经过
ethnic	人种的
photons	光量子
blundering	浮躁的
consummate	使达到极点
tale	谣言
slojd	工艺教育
unambivalent	鲜明
negationist	虚无主义者
spiccato	用跳弓弹奏
lazaret	传染病院
facta	辩驳书
catty	阴险
cdt	中央时区
struthioid	=struthious
mccarthyite	麦卡锡主义者
telegenic	适于电视广播的
paddlefish	白鲟
celesta	发出如钟的声音的一种有键的小乐器
counterplan	对抗方案
left	左倾
schmo	笨人
infrasonic	使用次声的
bald	单调的
maracaibo	马拉开波湾(即委内瑞拉湾
instance	获得例证
uno	United
npa	Publishers''
overmatter	留在下期刊载的稿件
lattermost	最后
ichor	脓水
backwrap	背部装拉链的套衫
hexylic	己基的
odious	可憎
dsp	Signal
tumble	摔倒
screever	告地状者
mex	墨西哥人
count	数
smallshot	小人物
advertizing	广告的
factor	要素
barrage	拦河坝
minimal	最小限度的
intramural	内部
sarin	甲氟膦酸异丙酯
rampancy	繁茂
being	人
liberatory	同意释放的
nav	asset
ghibelline	皇帝党员的
rocking	摇摆
horsepond	洗马池
bleak	黯淡
psychomotor	精神运动
varangian	瓦兰吉人的
sinological	汉学
percurrent	到顶
lugger	小帆船
epicotyledonary	子叶上的
inhomogenous	非齐次的
wont	常常
pesterous	纠缠不休
rac	Club
xanthippe	粘西比
sulphonamide	硫胺类药剂
spicily	痛快地
heptastich	七行诗
elemi	榄香
superterrestrial	世外
vulcanism	岩石火成论者
unqualified	绝对
refer	谈及
eyeleteer	打眼锥
asteroid	星状
doctrinist	主义的信奉者
cubic	立方体
triaxial	三维的
origin	原点
unreconstructible	不能重建
yiddish	依地语
vacationer	休假者
orange	橙色
cad	无赖
enwreathe	绕以花圈
colonnaded	有柱廊
bespoken	预订
sickly	多病的
quirkish	双关语的
teratocarcinoma	畸胎癌
triform	在种不同形式合成的
ravine	沟壑
unveil	除去……的面纱
osee	=Hosea
sendmail	发送邮件
picescent	乌黑
safflower	红花染料
vasoinhibitor	血管抑制药
sanctification	神圣化
elucidative	说明
prior	优先
unconfiding	不轻信别人的
various	不同
plena	plenum
undomesticated	不习惯家庭生活的
tectonite	构造岩
replacement	置换
outroad	出击
delusion	错觉
conceit	幻想
clime	气候
congregation	集会
banker	银行家
washed	洗过的
scilly	=Scilly
voluntary	志愿
upsweep	向上弯曲
garmenture	衣着
deify	神化
declarer	宣言者
rawheel	未经艰苦考验的稚嫩新手
tenia	软组织带
consequently	从而
discompose	不安
zealotic	热心的
teazle	起绒草的干果球
tusker	有长牙的动物
setup	机构
artless	朴实
lot	一堆
dumpage	垃圾
misaligned	线向不正的
foxed	有褐斑
topically	总论
drowning	溺死
ingrained	根深蒂固
exes	费用
fallol	矫饰
lebanese	黎巴嫩
poetic	诗歌
sandal	凉鞋
underproof	不合格
overweighted	超载
looby	傻的人
artless	朴实的
moonish	如月的
linenfold	折布式
sandy	含沙
idoneous	适用的
nonneoplastic	非肿瘤引起
vain	虚荣
pert	and
fez	土耳其毡帽
unliquidated	未清算
electropositive	阳电
briskness	敏捷
smuttiness	淫秽
prepossessing	引人注意的
indeliberate	无心
aigrette	冠毛
mmm	嗯
significant	重大的
voluminously	很多
titanate	钛酸盐
hydremic	水血症的
ordinary	平凡
verus	确实
tarsia	嵌木细工
upstate	州的北部
immensely	庞大
mlw	water
unaffectionate	缺乏爱
unconditional	绝对的
turaco	=touraco
possession	占有
scalpriform	凿形
noctuid	夜蛾科的
refuse	废物
esol	of
ghazi	勇士
necessitarianism	必然论
cataphatic	用肯定方法所
elizabethan	伊丽莎白王朝的人
willowware	饰有垂柳图案的陶瓷餐具
capaneus	卡帕纽斯
malone	Malone
diadelphous	两体雄蕊的
appoggiatura	花音
autoecious	异苞同株
fathead	愚钝者
cucurbitaceous	葫芦科的
slabber	唾涎
trick	诀窍
electrodermal	皮电活动的
investiture	覆盖物
subservient	有用的
kook	傻瓜
papillate	乳突的
respective	分别的
poetize	作诗
grayer	灰色的
ester	酯
skateboard	溜冰板
perforative	能穿孔
tribulate	给……磨难
monadelphous	单体雄蕊的
organometallic	有机金属的
plasma	等离子区
dexamphetamine	右旋安非他明
chronologer	年代学者
lodgeable	可寄宿的
reliquary	遗骨匣
danthonia	扁芒草属植物
verbose	详细
vile	可憎
castellan	城堡主
debark	登陆
spirituelle	愉快的
institutional	制度上
unreceptive	接受能力不强
spatter	溅污
wave	示意
repousse	金属细工的
dantean	但丁
hottish	热乎乎的
marchioness	女侯爵
amos	中的一卷
clc	Labour
raving	疯话
fluky	侥幸
sound	健全的
supercontinent	超大陆
entertaining	愉快的
petechial	瘀斑的
joning	骂人取笑游戏
pool	采掘
towpath	牵道
doited	昏头
progesterone	孕酮
owi	War
classify	分等
rimester	作诗者
ajc	澳大利亚赛马俱乐部
icrp	国际辐射防护委员会
goody	好呀!
lending	出借
strait	艰难
imbed	埋藏
kitchensink	刻划现代生活不光明的一面的
unfrequent	不常发生
mime	模仿
flocculi	谱斑
engagement	雇拥
studious	勤学
disappointedly	失望
tacit	默许
spasmodic	痉挛
former	从前的
tap	敲打出
magnificence	富丽堂皇
ganaderia	牧场
capacitance	容量
pomology	果树栽培
lcf	最小公因子
xml	Markup
widf	Women''s
lulu	卓越的人
holily	神圣
involuntarily	不知不觉地
salvable	可救
diphyletic	来自二个祖先
fcis	of
isochromatic	等色的
thinnish	较瘦的
reimportation	再输入
numnah	鞍垫
discifloral	盘状花
escuage	兵役
tutor	助教
refutable	可驳倒的
valorisation	=valorization
rollicking	嬉戏耍闹作乐
devolute	转移
ciphering	计算
trifoliolate	有三小叶的
quadripartite	由四部组成
affiance	使订婚
chekhovian	契可夫
magnesian	氧化镁
altar	祈祷祭拜的地方
sanative	有益于健康
nauseate	产生恶感
frith	河口
cone	圆锥体
misesteem	对……不尊重
complicit	串通一气的
pumpman	唧筒工
disposed	有某种健康状态的
circumlunar	绕月球运动
dprk	朝鲜民主主义人民共和国
knit	编织
bestial	兽性
mecklenburg	梅克伦堡州
amitrole	杀草强
triamcinolone	氟羟强的松龙
repossess	收回
sociable	喜欢群居
sabbatise	=Sabbatize
ripsaw	粗齿锯
rewardless	无报酬的
sabotage	怠工
brimstony	似地狱
zinky	锌制
annexure	附录
resorption	再吞
simpleminded	纯朴的
improvisatory	即席
sidesplitting	令人捧腹大笑
eva	女子名
toadeating	奉承
smd	Music
vii	罗马数字
muliebral	女性
conformability	一致性
wolframite	钨锰铁矿
educator	教育家
lanthanide	原子序数
platonize	信奉柏拉图哲学
montpellier	蒙彼利埃
impetuous	冲动
vop	o
propyl	丙基
greenyard	走失牲畜待领场
emancipate	解放
diction	措辞
leal	诚实的
leafy	多叶的
eastwardly	向东的
voluntary	自发的
advance	提前
euphonize	美化语调
ogle	眉目传情
symmetric	相称性的
hurried	匆忙
quadricorn	四角动物
farrago	混杂物
pfc	first
sophisticate	精于……之道的人
praetorian	执政官
swat	特种战争装甲运输车
excessively	过分地
gimmicky	巧妙手法的
andiron	柴架
striate	有细槽的
ventromedial	腹正中
unwrung	不感到苦恼
wherethrough	经此
mlf	force
everlasting	永恒
chassid	=Hasid
fetch	到达
bathhouse	更衣室
bang	重击
son	孩子
anxiously	忧虑地
zygosis	接合
coronach	葬歌
semidomestic	半驯养的
liquefier	液化器
sodomist	口交者
furthermost	最远的
goodbye	再见
hydroscope	深水望远镜
overleaf	在次页
epeirogenic	造陆作用
newsmonger	爱传播新闻的人
infelicific	招致不幸
eec	Exhaust
underivative	非模仿他人的
reprobative	责备的
sputnik	人造地球卫星
mulatto	白黑混血儿的
amalgamator	混汞机
soccage	农役租佃
epigrammatist	警句家
diffused	扩散
ductile	柔软的
unequaled	无比
kitling	顽皮
secularity	世俗主义
fibrocystic	纤维囊性的
scutellum	小盾板
fortuitous	幸运
rewake	再次意识
megadalton	兆道尔顿
psalterion	=psaltery
parlourmaid	客厅女侍
electriferous	传电
invalid	残废
gimme	=give
exponible	可说明的命题
fumble	摸索
anus	肛门
carroty	胡萝卜色
fly	飞翔
gastrostomy	胃造口术
salicornia	海蓬子属植物
manganin	锰镍铜合金
viscoidal	有黏性的
toxaphene	毒杀芬
massotherapy	按摩疗法
shaky	虚弱的
prelatism	主教制
centuplicate	百分
mesenchymatous	由间叶细胞组成的
gastroesophageal	胃食管的
indolence	好逸恶劳
quaint	离奇有趣
artistically	在艺术上
sincere	真诚的
columbine	鸽的
magnetochemistry	磁化学
conduit	管道
gis	地理信息系统
rhinologist	鼻科医生
sparmate	partner
smooth	平稳
ciaa	Central
longipennate	有长翅
orchestration	管弦乐作曲法
lissome	敏捷的
semiology	记号语言
zootechnics	畜牧学
phenacetin	乙酰对氨苯乙醚
bobbly	跳动
honeyed	多蜜
homy	家庭般
outnumber	比……多
zaqaziq	=Zagazig
monozygotic	单卵
soulful	感情上的
neurohypophysis	脑下垂体后叶
worry	撕咬
joyful	快乐的
aconite	乌头
dodgy	会推托的
aeolic	伊欧里斯的
picket	支柱
indubitable	不容置疑
unsharp	不清晰的
burnable	可燃的
fainaigue	骗人
sceptre	笏
triaxial	三维
tinge	淡色
dauber	拙劣的画匠
clocklike	准时的
intracranial	颅骨内的
quadruply	四倍
politesse	礼节
bluster	咆哮
passerine	雀形目鸟
slip	活络
irisher	爱尔兰人
quibblingly	推诿地
lenitive	缓解疼痛
ornamental	装饰
arisen	兴起的
bashfully	内向地
disorganized	紊乱
slaky	泥泞
incorporator	法人创立者
numazu	沼津
dilaceration	弯曲牙
unco	不知名
virogenic	病毒所致
shoulder	肩部
lapicide	碑文雕刻工
transient	瞬时的
febrific	发烧
draggle	落后
reentry	再进
hieroglyphist	书写象形文字者
uncontrollable	无法控制的
sarcomagenic	致肉瘤的
unburnt	=unburned
chlorinous	含氯的
airfight	空战
breathless	死
dominical	基督的
toothy	露出牙齿的
inactivity	休止状态
hemostasis	止血
glassmaker	玻璃工人
favoringly	顺利
unmanly	无男子气概的
hegemonist	霸权主义者
kutien	见Gutian
belcher	彩色围巾
communally	公有地
muscalure	家蝇引诱剂
apractic	运用不能症的
pockmarked	有痘疮
pincette	小钳子
toynbeean	汤因比的
nephograph	云图拍摄机
sporotrichosis	孢子丝菌病
educable	可教育的
perch	河鲈
tactic	战略
willowy	有弹性的
cacodylic	二甲砷基
unexpectable	不可预言的
deft	灵巧
dolichocranic	长颅
interstage	级际
baldish	无草木的
mercy	怜悯
obituary	死亡的
caterwaul	刺耳的尖叫声
economical	节约
puritan	清教徒
ensanguined	满身染血
distributism	分产主义
aristocratic	贵族化的
walkathon	步行马拉松
punishment	处罚
around	到处
quingentenary	第五百年
palpal	须
botfly	马蝇
presentive	表意
dispossessed	被逐出
character	人物
catacombs	地下墓穴
epitope	抗原决定部位
unabroken	完整
galvanic	流电
ruddle	用红土做记号
retune	重新调整
thingummy	某人
mac	Airlift
diplon	重氢子
acquittance	偿清
melange	杂乱的一群
secretarial	秘书的
camphine	精制松脂
rachilla	小穗轴
enlighten	开导
wakeful	觉醒
trooper	骑警
superexcellent	极好
tectogenesis	构造运动
oestrus	发情
peacockery	虚荣
ideational	观念
calaboose	监狱
superable	可征服
africa	非洲
transmutative	变质的
reinvigorate	使复兴
unitary	单一的
untalented	缺乏才能
honeylipped	甜言蜜语的
sourish	微酸
ter	三次
oxaloacetic	草酰乙酸的
recurrent	再发生
chorology	分布论
swat	Transporter
uncalculating	不审慎
neck	颈壮物
seafront	沿海岸而筑的马路
xi	希腊字母的第14个字母
malicious	怀恶意
mow	扫倒
suitable	相配的
autofocus	自动聚焦装置
coequally	平等
graticulate	把
allay	减少
zoantharia	花珊瑚类
bargeboard	山形墙桁端的盖板
transposal	调换
polka	女用紧身短上衣
oneparty	一党
esne	奴仆
pietistic	虔诚的
remediably	可救济
crapoid	=crappy
fervor	热情
fetch	取物
scurviness	卑鄙
agent	代理
spandy	时髦的
spirit	情绪
verriculate	具毛簇
frenzied	激怒的
organist	风琴弹奏者
jadishly	下贱地
soap	Simple
trusting	信赖的
decidedly	果断
rodman	标尺手
ambit	范围
deep	难懂
inapparent	不明显的
spandy	时髦
epizoology	=epizootiology
dazibao	大字报
perugia	佩鲁贾
con	控制台
intercollegiate	学院间
bonhomie	温和
subvert	推翻
capernaum	迦百农
electrocute	处电刑
rope	围起
piracy	侵犯版权
kohlrabi	大头菜
wakefully	睡不着
beastly	如野兽的
ministerial	部
gastrocamera	胃内照相机
spasmodical	间歇性的
tribunary	保民官
overtaken	overtake的过去分词
cleistogamous	闭花受胎
tgv	巴黎
heelball	鞋油的一种
under	假借
transmembrane	横跨膜的
ba	钡
tax	责备
sedulous	坚韧不拔的
tsingtao	青岛
daughterhood	女儿身份
reliably	可靠性
rogallist	罗加洛回收翼伞驾驶员
carcinology	蟹学
regenerative	更生的
unwavering	坚定的
arraign	提问
desulfurize	去硫
decertify	收回……的证件
fathom	进行探索
separator	分离者
neoconservative	新保守主义者
engineer	轮机员
dr	Refresh
acrostic	离合诗的
consubstantiate	使成同体
merlin	隼
glamourpuss	面貌动人的人
napery	家用亚麻布
honorand	荣获名誉学位之人
msph	Science
wfdy	Democratic
contradictious	爱反对的
object	对象
stippling	点刻法
declaim	高声朗读
hortative	奖励的
schwa	中性元音的名称
indispose	厌恶
gerontine	肝胺
composedly	沉着地
pinup	钉在墙上的
chelyabinsk	车里雅宾斯克
unprincely	不高贵
schmutz	垃圾
uncreated	自存的
suck	吮
filicin	绵马浸质
tabnab	蛋糕
inerrably	确实
ingenuous	直率
typhoidal	类伤寒
placeseeker	追求官位者
brawl	争吵
indirectly	间接
gracious	亲切
makeshift	权宜之计
westbound	西行的
underslept	的过去式和过去分词
factory	商住花园外的代理
chloe	克洛伊
locrian	洛克里斯的
maritsa	马里查河
rascal	下贱
cardiography	心动描记法
espouse	支持
avowed	自认
scs	Service
depersonalization	人格解体
campesino	农场工作人员
oracle	也是主要的网络计算机的倡导者
phototube	光电器
dinner	正餐
aluminize	以铝处理
puy	死火山锥
serous	如水的
pedant	学究式人物
minisub	小型潜艇
farsi	波斯语
amalgam	汞合金
refugo	绝缘用的软木
backstage	在后台
elusory	难以捉摸的
dissembler	伪善者
gambian	冈比亚的
rrl	Remote
certificate	发给证明书
remediably	可治疗
genial	亲切
gaskin	束帆带
site	定……的地点
hearten	振奋
protestatory	表示抗议的
dastard	胆小的人
endemical	=endemic
xql	Query
cinc	Commander
ineradicable	不能根除的
re	铼
emetic	催吐剂
cried	cry
dmd	Digital
photopia	明视觉
vile	可耻
cleanser	使清洁的东西
fastness	牢固
andantino	微急
hangsman	执行绞刑者
resolvability	可分解性
absorberman	管理吸收器的人
smudge	用浓烟熏
unclinch	放开
healable	可治好的
diversionist	阴谋破坏者
ripply	波纹状的
unpicturesque	不似画
asseveration	誓言
usis	States
archaeoastronomy	考古天文学
inorganizable	无法组织
incurable	不能治愈的
fibrinoid	纤维蛋白样
lablab	扁豆属藤类植物
prematurely	早熟
solfeggio	视唱练习
irrationalism	反理性主义
choleraic	类似霍乱的
toolshed	工具房
antespring	预期的春天
enflower	饰以花
phenoxy	含苯氧基
disparagement	轻蔑
miniminded	愚蠢
redistribution	再莍st/9ri:dIstrI`b
sonovox	口声效果装置
cheesecloth	一种粗棉布
aphorist	警句家
stereoscopically	实立体镜
assaying	试金
onward	在前面
vtp	VLAN
metaxenia	果实直感
discrown	罢黜……的王位
newfashioned	新式
adrift	随波逐流地
injun	印第安人
egyptian	埃及
benefic	行善
ectotrophic	外生的
churn	搅拌
fix	凝视
unapprehensive	不怀疑的
bargain	契约
polypragmatical	爱干涉
thin	稀少的
patulous	扩展的
migratory	流浪
valsalva	咽鼓管充气检查法
benedictional	赐福
cussed	固执的
interlanguage	人工辅助语言
denominative	有名称的
hobodom	游民阶层
raised	浮雕的
prostitution	堕落
responsible	有责任的
unslum	拆除
maladaptive	适应不良
covenant	契约
ruskinize	的艺术信条
ankylosis	僵硬
effable	可表达
phillipsite	钙十字沸石
coelenterate	腔肠动物
sermonesque	讲道的
cajolery	诱骗
owing	该付
byr	billion
sublimate	高尚
indigotin	靛青
amandine	含有杏仁
welldoing	做好事的
malnourished	营养不良的
roed	腹内充满卵的
egyptian	埃及的
hyphal	菌丝的
pseudograph	伪书
fulminating	暴发性的
communicative	无隐讳交谈
drafter	起草者
sinhalese	僧伽罗人
tuft	丛生
preludio	前奏曲
gmwu	General
jcr	学生公用室
araneidan	蜘蛛
gain	赚到
amenable	有责任的
lyase	裂解酶
occurent	正在发生的
algebraical	代数
commemoratory	=commemorative
powerpc	IBM和Apple公司联合生产的个人台式机
giggly	吃吃笑的
chicom	中共分子
calf	小牛
dissatisfy	使感觉不满
introit	入祭文
phantomlike	幽灵似地
concupiscent	沉迷情欲的
vdr	Video
phene	苯
gsc	Staff
undelighting	令人不愉快
planetarium	行星仪
mundane	世界
dohc	double
coralline	珊瑚的
drillship	海底钻油船
rider	骑手
phenomenal	显著
overlord	最高统治主
regenerator	再生器
salicaceous	杨柳科的
undecided	不稳定
sportswriting	体育新闻的写作
inharmony	不协调
cno	Naval
unshirted	不穿衬衫
cholla	仙人掌的一种
apterygial	无翼
polluted	玷污
paralytic	瘫痪
brimfull	盈满的
ruler	尺
scramble	使混杂
proser	写平凡琐事的人
kiska	吉斯卡岛
ambidexter	诡诈者
dunkirk	敦克尔克
anality	肛门性欲
habenula	松果体缰
thule	古人相信存在于世界北端的国家
stair	一级
sale	卖出
cathedra	权威人士的地位
vibrato	振动
soli	独奏曲
abject	可怜
motherfucking	讨厌
hectic	肺病
since	自……以后
eventual	终于
hippomanic	有爱马癖的
accra	阿克拉
dinosauric	庞大
twigged	有细枝
miserable	悲惨的
derma	真皮
myxomatosis	多发粘液瘤病
cnd	for
substitute	代替者
cubic	立方
berberis	小檗属植物
compulsorily	强迫
illuminant	发光体
finfooted	蹼足的
favorably	顺利地
electroencephalogram	en5sefElEJ^rB:f/rEJen9sefElE`^rAEJen9sefE`lC^rEf脑电图学缌魍
superindividual	超个体
uncontradictable	不能反驳
armory	军械库
rigescence	僵化
promissory	允诺
covary	共变
limbo	监狱
magic	不可思议的
assumpsit	约定
rhizopod	根足虫
trammel	束缚物
cogitator	深思熟虑的人
virology	滤过性微生物学
compartment	间隔间
cyclopaedic	百科辞典
preharvest	收获期前的
stevedore	搬运工
mugient	哞哞叫的
correlation	相关
maungy	坏脾气
censure	责难
misleading	令人误解的
adding	加
dermatosis	皮肤病
bachian	巴赫的追随者
intercostal	脉间的
fast	忠实
amniotic	有羊膜
tambura	=tamboura
chowmatistic	理财学
phidippides	即Pheidippides
tussah	柞蚕
nondurable	不耐用
twister	缠绕机
spark	电信技师
chapel	礼拜
ssa	Social
mesotrophic	中营养
difference	差动
peduncle	梗
procural	取得
thump	重击
loader	装弹机
unseemly	不恰当的
degras	egras
helpless	没用
previse	预先警告
polymethyl	methacrylate
cyclopaedist	百科全书编者
kaapstad	=Cape
polyclonal	多克隆
outdoor	室外的
monostabillity	单稳态
capacity	地位
stripy	有条纹的
togavirus	外衣病毒
graciously	和蔼
hurrier	匆忙的人
equipotential	有相等潜力的
notabilia	值得注意的事物
damson	西洋李子
yarage	操纵灵活性
rattleheaded	头脑空虚
foots	沉淀物
prey	被掠食者
curvirostral	具曲喙的
hadorwould	将
recrudesce	再发作
diploma	奖状
unabridged	未经删节的
viewsite	风景好的选址
deserved	应得的
stupidly	愚蠢地
cimex	臭虫
tetraspore	四分胞子
ostracize	贝壳放逐法
pilotless	无驾驶员
flapdoodle	胡说
diastolic	心脏舒张
magnisonant	高调的
skeetshoot	作双向飞碟射击
rectify	精馏
radiator	散热器
deliquescent	溶解的
thin	变薄
cribrose	有小孔
chansonnier	歌手
refrigeration	冷藏
praepostor	指导生
myocyte	肌细胞
lappic	拉普兰的
redbrick	新学院
electrocute	触电致死
stillborn	死产
pericardiocentesis	心包穿刺术
snack	小吃
preterlegal	超过法律范围
nok	kin
rifacimento	改写
unskilful	笨拙的
loud	大声
ternate	三个
reprocessed	再经过加工
shield	防护
falchion	略具弯形的大刀
aiff	开发的非压缩声音文件格式。
waldenstrom	瓦尔登斯特伦病
aw	Aruba
motionless	静止的
green	绿色颜料
abolitionist	废除主义者
anorthic	三斜的
come	到达
unleavened	没放酵粉
loppy	无力地下垂
stand	立场
arvo	下午
spoony	多愁善感
presumable	可假定
oligocarpous	几乎没有果实
unsaleable	非卖品
calathos	花瓶式果篮
deanglicize	消除……的英国影响
abyssalbenthic	深海海底的
internalise	使成为主观
amnion	胞衣
levantine	堤
hemocytoblastic	血胚细胞的
aspi	SCSI
infructuous	徒劳
mwa	America
jewelly	戴手饰的
moisturize	使增加水分
oujda	乌杰达
romping	乱蹦乱闹
kakinada	卡基纳达
evangelic	福音的
barology	重力学
scv	南部联盟士兵遗孤组织
nibble	吹毛求疵
photodissociation	光离解
cesspool	化粪池
womanlike	女人似
notarial	公证
choking	憋闷的
preadamite	亚当以前
hypothetical	假定
crablet	幼蟹
snowbreak	防雪林
ghostliness	幽灵
pompon	丝球
gangliform	神经节状
tactual	凭感觉
ululate	呜呜地叫
skint	穷光蛋
himyaritic	希米亚里特语的
tumbler	翻筋斗者
dynel	代纳尔
header	标题
unchangeable	不能改变
formulable	可公式化的
fathom	测深
vltava	伏尔塔瓦河
calk	使不漏水
diamante	镶人造钻石的
amoebiasis	阿米巴病
semischolastic	半学术
spoilsman	以获益为目的而支持政党者
unconformity	不一致
jougs	铁颈项圈
erstwhile	往昔
infusive	有影响力的
histogeny	=histogenesis
editorial	主笔
grisly	令人毛骨悚然的
foxy	狡猾的
gambian	冈比亚
pulperia	杂货店
prooflike	表面光亮似新铸样币的
timbre	音品
orthographer	正字法学者
synthetically	合成地
platitudinous	平凡
einsteinian	爱因斯坦的
aar	阿勒河
shroud	裹尸布
phycomycetous	藻菌的
amenable	应服从的
preincubation	预培养
drink	举杯庆贺
grandiose	堂皇的
insnare	落于陷阱
tradespeople	商人们
http	Hypertext
xylophilous	喜木
somnambulist	梦游者
pitchy	沥青
dichotomize	二分
parsimonious	节俭
mandamus	书面训令
omuta	大牟田
gentoo	巴布亚企鹅
knowledge	认识
endoerythrocytic	红血球内的
undissolute	不放纵
gpt	通用终端
co	office
undimmed	不暗淡
balky	执拗
fissive	分裂的
potshot	乱射
cabrite	蜥蜴
fainty	无力的
insinuating	暗示
outlet	出路
heavenly	天空的
bonami	好朋友
ersatz	合成的
pension	养老金
living	活
goalie	守门员
moonish	反复无常的
inspection	检查
photoelectromotive	光电动的
overkind	过分仁慈
eastward	朝东的
esc	转义字符
hypersexual	纵欲
reconstructive	重建的
cannel	烛煤
whine	哭诉
biovular	二卵生双胞胎特有的
permanganate	高锰酸
gcse	General
remediation	补习
imparticipable	不能共有的
antifreezing	抗凝
rescissible	可废除的
redemptive	用于补偿的
pedigreed	有来历的
alu	Logic
francophil	亲法者
spectrogram	光谱照片
poetics	诗学
leafy	树叶茂盛
warn	发出警告
proclivity	倾向
metallize	用金属处理
grown	长满某物的
postvaccinal	种牛痘后
unpleasantness	不愉快的事
postmenopausal	绝经后的
antisickling	抗镰形细胞形成
thebe	塞柏(博茨瓦纳
glout	蹙额
scrobiculate	具粒陷的
hydrophobe	疏水物
obscene	猥亵
power	功率
interspace	留空隙
tab	行走
ninthly	第九
tarnishproof	保持光泽
orins	Ridge
sec	SEC
thundering	雷一般响亮
preproduction	试生产的
nonassessable	除缴投资额外免除任何费用或责任的的
herbivorous	食草
pucka	份量充足的
mealworm	生于谷类
floriferous	多花
determinist	决定论者
aglisten	光辉耀眼
unmotherly	不像母亲
junco	灯芯草雀
out	出声地
brotherly	亲兄弟般的
theanthropic	具有神人两性
hackneyed	常见的
impugnable	可责难
altar	祭坛
curtal	切短物
declinable	格变化的
pattern	仿造
seam	使留下伤痕
treasure	储藏
voluntary	自愿的
popular	通俗
coral	珊瑚
storytelling	说故事
copernican	哥白尼的
spectrophotofluorometer	荧光分光光度计
tallness	高度
cytotaxonomy	染色体形态之分类法
everything	万事
employment	利用
clarionet	单簧管
nfd	Newfoundland
wftu	Federation
somnolency	梦幻
lumbrical	蚓状肌的
waveringly	摇摆地
chickadee	山雀
unbeknown	未知
woman	妇女
desinence	字尾
exohormone	外激素
ergastic	后含的
crankpin	曲柄梢
andante	缓慢的
chanceless	无机会的
irisated	彩虹色
superconduct	无电阻导电
firstname	名
marriageable	适宜结婚的
ppt	trillion
radio	无线电通信
animating	鼓舞生气
excogitative	发明的
goaty	淫乱
supermundane	非现世的
enthralling	迷人的
raucity	沙哑
remould	改铸
girn	咆哮
rodent	侵蚀性的
nemophila	喜林草属植物
zincate	锌酸盐
octu	Officer
unpaired	不成双的
imperceptible	极细微
girder	钢桁的支架
marxist	马克思主义
disendow	没收基金
switzerite	斯威策矿
satisfy	使相信
profitless	无益
nasion	鼻根
en	在……中
medieval	原始的
disconnexion	分开
ferruginous	含铁
deromanticize	去除……的浪漫色彩
convocation	集会
stopgap	权宜的
erotomania	色情狂
civil	国民
font	洗礼盘
caprine	公山羊的
shorn	shear的过去分词
language	语言表达能力
jocosely	诙谐
vdt	Video
provocation	刺激
magneton	磁子
dairy	奶油
eliminant	消元式
batrachian	蛙类的
scrubwoman	女清洁工
observer	遵守者
ungrounded	无根据的
put	摆
vulgate	公认的文本
preterlegal	不根据法律
cumbrous	成负担
mactation	屠宰
medium	中间的
denish	丹麦人
washin	机翼正扭转
iatric	医疗的
mcg	microgram
marrowy	有力
molet	=mullet
monstrous	怪异的
grits	粗面粉
confusion	混乱
compound	化合物
cadre	骨骼
beadswoman	祈求冥福之女人
canary	金丝雀
unparliamentary	不根据议会法
ishmael	被遗弃的人
hun	匈奴
grindingly	虐待
bellpull	钟的拉索
olent	有香味的
liffey	利菲河
elbowy	用肘推的
sheepish	懦弱的
lick	舔
consociation	联合
fulminatory	爆鸣
heartwood	赤木质
endogenesis	内源
tsinghai	见Qinghai
inadequateness	不适当
disinteresting	无聊的
flecklessly	完美
posteriorly	后来地
thresh	反复做
implied	暗指
derby	赛马会
brutality	残忍
pedestrian	徒步
heavy	繁重的
kook	疯狂的
sideslip	私生子
slavish	专横
indus	印度西北部的河流
swbs	by
carmarthenshire	卡马森郡
endothermic	吸热的
notability	显要人物
easterly	东
spinsterish	似老处女的
enterological	肠病学
elicit	引起
gmwu	Workers''Union普通及市政工人工会
tetrathlon	四项运动
hinduise	=Hinduize
tilth	耕
astutely	敏捷
viatic	旅行
unfilterable	非可过滤
haemophilia	出血不止症
murra	默勒石
ursine	象熊的
hydrotactic	趋水性
huggermugger	杂乱
wisecrack	俏皮话
weave	织法
geodynamic	地球动力学的
pdsa	Dispensary
donnish	象大学宿舍的学监一样
record	档案
plethysmogram	体积描记图
esplanade	散步路
comparison	比较关系
elf	恶作剧的人
safely	安全地
swung	swing的过去式和过去分词
compulsory	必需做的
forgetive	富有想像力的
elaphine	似红鹿的
thy	你
immusical	对音乐不感兴趣的
rubberware	goods
causticity	尖刻
scorzalite	多铁天蓝石
rhinopharyngitis	鼻咽炎
derision	嘲笑
moundsman	棒球投手
metalsmith	金属加工技工
cretinoid	矮呆子样
apt	适当
transcurrent	横贯
savoury	味香的
federal	联邦制的
tabor	敲小鼓
anticlastic	鞍形面
exist	生存
ostensible	虚假的
trample	踩坏
bissau	比绍
deontic	义务的
torque	转矩
charily	小心谨慎地
nujiang	怒江
relative	亲戚
savage	凶猛的
fluorescent	莹光
cosmoid	具有齿鳞质
barathea	巴拉西厄
dnase	=deoxyribonuclease
bars	马上的齿龈
trilemma	三难推理
infelicific	不带来幸福
jurat	市政长官
flippantly	没礼貌
roweite	硼锰钙石
inherent	与生俱来
thyratron	闸流管
tail	成为散乱的行列
anomalous	反常
semiarid	雨量非常少的
casuistics	良心论
vicereine	女总督
pun	双关语
posh	优雅
stp	Pair
jury	临时应急的
consecrated	被视为神圣的
embryonated	含胚的
frontlash	逆反应
pert	爱管闲事
roundline	细圆绳
percipient	理解的
schizophyte	裂植植物
ddk	Kit
gallionic	迦流的
bronchobuster	牧童
intrazonal	在地区内的
caudillismo	专制独裁的理论
slurry	泥浆
popish	教皇制度的
largess	赠送
antiodontalgic	止牙痛剂
inextricably	解不开地
bulbiferous	生球根的
unheroical	不英勇
eric	Information
disconcert	破坏
highness	殿下
motherboard	母板
crackers	精神错乱的
tricolor	三色的
tinner	锡矿工人
enharmonic	等音的
frances	女子名
radc	Army
crudeness	生硬
confect	混合调制
testaceous	红砖色的
ostentatious	卖弄的
speedup	加速
sullenly	不高兴地
assistor	帮助者
humpty	软垫矮座椅
desterilization	解除货币管制
linguiform	舌状
handle	手感
mendable	可更正的
kuru	新几内亚震颤病
protomorphic	原始形式
caip	基于有线电视的IP网通信
staniel	=kestrel
agiotage	汇兑业务
quick	迅速的
worrying	令人担心
dreadnaught	无畏
hlf	Foundation心肺基金会
hircine	山羊般气味的
spirituelle	活泼的
filter	滤波器
yaup	大声喊叫
tripartite	三重
liminary	卷头
founderous	泥泞
radiantly	辉煌地
puzzleheadedness	思想混乱
glum	阴沉
roofless	无家可归
basilisk	一种老式火炮
tacit	默许的
rectangularity	成长方形
respectant	面对面
nummary	货币的
kanu	National
grammatical	合乎文法
unordinary	不普通的
inescapable	不可避免的
landmeasure	面积单位
hiding	痛打
anemometer	风速计
pancarditis	全心炎
bengalese	孟加拉人
eftsoon	又
unbalanced	不均衡
nether	下层社会的
postrider	骑马的邮差
telegraphoscope	电传照相机
taintless	纯洁清白的
mephitis	恶臭
interborough	区与区之间
gain	利润
reddish	略带红色
dehumanize	使成兽性
disinteresting	无聊
pride	骄傲
periclean	伯里克利统治时期的
parametrical	参量
pim	Personal
shock	蓬乱
lallygag	闲逛
departmentalise	9di:pB:t`mentElaIz/
hydromantic	水占术的
sanctum	密室
mentation	心理状态
aca	Chartered
truckle	靠小脚轮移动
parenthetical	附加说明
thrombogen	凝血酶原
tapster	酒吧的酒保
domesticate	使安于土
venturous	大胆的
dhu	12月
unprofitable	没有用
breathless	喘不过气来的
factuality	实在性
gam	腿
sullenly	不高兴
surge	急放
farrandly	壮丽地
fruit	果实
troxidone	三甲双酮
contextual	前后关系的
improbability	未必有之事
reperforator	自动纸带穿孔机
offhanded	立即
traditional	传说的
verjuiced	酸
pontifical	罗马教皇
skin	长皮
chlorophyllous	a
reggeism	theory
backveld	偏僻闭塞的乡村地区
torchy	感伤恋歌式的
abactinal	无触角的
cetaceum	鲸脑
replevy	追回
inobservant	疏忽
ldh	dehydrogenase
keap	拦截
charm	用符咒
uropod	尾肢
tension	不安
dyeing	染色工艺
floc	絮状物
subhuman	类人的
cytotropic	向细胞的
skerry	低小岛
laughing	可笑的
goddam	诅咒
worrying	焦虑的
persistence	坚持
photronic	光电池
slubberdegullion	邋遢懒散的人
balsamic	如香油的
tax	对……征税
capitular	牧师会的
fore	在船头
dicephalous	有两个头的
bedevil	使苦恼
enclitic	附属的
unproposed	未提议的
vaquero	牧童
adultoid	类成虫
restively	倔强
mendable	可改进的
unpleated	无褶的
udt	Data
sharper	削具
divine	神圣
zpg	Zero
laceless	无花边的
wholesomely	卫生地
jugulate	顿挫
hardy	坚硬
peritectic	包晶的
boxtree	黄杨树
plethysmograph	体积描记器
forefeel	预感到
reformatory	少年管教所
epyllion	小型史诗
consultation	咨询
apolitically	非政治
riffle	湍流
sizz	发嘶嘶声
tryout	试验
length	音长
muley	无角的
niceness	美好的事物
prosody	诗体论
ironclad	装甲的
grayer	灰色
palestra	角力场
arginase	精氨酸酶
aerial	空气
bodiless	无体的
avulse	抽出
lentisk	乳香树
genipap	茜草属常绿树
amphipathic	两性分子的
root	扎根
lotic	激流群落
edifying	有益
cretinous	白痴病的
rubidium	铷
sinopite	铁石英
buckshee	免费的
bandspreading	频带扩展
aok	一切正常的
unhesitatingly	不踌躇
sternutatory	催打喷嚏
kite	象风筝一样飞
premaxillary	颌骨前的
saying	话
coha	Hemispheric
pinup	受欢迎
intrepidly	勇猛地
vein	血管
capitalizable	可作资本
trying	令人厌烦
contemporaneity	现代的
negativity	否定性
aeolian	风的
tackle	扭住
diaspora	向国外散居
greenockite	硫镉矿
motherhood	母性
salomonian	所罗门的
microcosmic	微观世界的
pericarp	果皮
quackish	胡吹
amenable	有责任
largo	缓慢的
hayrick	草垛
impressiveness	令人注目
behar	=Bihar
girly	合适少女的
unestablished	尚无成就的
diphthongization	复元音化
homocentric	同心
uncover	揭开
kettle	罐
dispatch	分派
unseconded	无人后援
base	基础
runover	转页部分
physiographic	地形学的
micros	微指令
mesopotamia	美索不达米亚
spinulous	=spinulose
architecturally	建筑上
statedly	壮观地
desire	心愿
menhaden	鲱鱼
inkpot	墨水壶
half	半途
balanced	平稳的
discipular	崇奉者
favorite	特别喜欢的人
grassplot	庭园青草地
pontlevis	吊桥
hieratic	僧侣的
lanuginousness	盖满绒毛
pasture	放牧
cosign	联合署名
gramineous	似草的
woody	木制
rap	使着迷
trypanosome	锥体虫
unwarrantable	无法辩护
jehangir	贾汗季
fremitus	震颤
nizam	土耳其正规军的士兵
heartrending	悲惨的
disbud	摘去嫩芽
candied	糖果
erythorbic	异抗坏血酸
vernally	青春地
azure	碧空
begrudge	羡慕
stonecast	投石的距离
clubroot	棒状硬化根
renominate	再提名
rippling	起涟漪的
doing	做
walking	步行
interscapular	肩胛间
noncarcinogenic	不促成癌的
forenoon	午前
debasement	降低
soberly	冷静地
pecorino	羊乳干酪
flabbiness	无气力
supervisee	被管理者
breviary	缩略
embryotic	未成熟
ialc	chart
pueblo	印第安人村庄
noncampus	不在固定校舍上课的
vri	Imperatrix
sole	鞋底
fully	完全地
hovertrailer	气垫拖运车
supranational	超民族
hen	雌鸟
hg	百克
actuator	激励者
nte	National
sanitarian	保健
relegate	提交
gutter	槽
imperfectible	无法致于完美的
washtub	洗衣盆
stardust	星团
appurtenant	从属物
mill	制造厂
amenity	礼仪
protectory	育幼院
cyberculture	电脑化社会
elves	爱恶作剧的孩子
mortally	凡人般地
exhalant	蒸发管
apivorous	以蜜蜂为食
work	机件
overthrust	逆掩断层
scrappy	杂凑
ultracritical	过于批评的
proteoglycan	蛋白聚糖
verily	实在
tuck	卷起
emmenagogue	通经剂
browbeat	吓唬
syllabification	按音节的发音
heimisch	不装模作样
darbies	手铐
frigging	受诅咒的
grits	粗磨粉
spider	设圈套者
cordial	兴奋性饮料
concourse	场所
ericaceous	杜鹃科的
amain	全速地
pellagrous	玉蜀黍疹
jubilation	庆祝
disfavour	冷待
petropolitics	石油政治
throatily	嘶哑
chillout	供暖不足
unwatched	被忽视
exceptant	以外的
phototransistor	光敏晶体管
semisomnus	半昏迷
unprejudiced	没有成见
scent	嗅觉
supermanly	超人
metasome	新成体
evangelicalism	福音
quit	放弃
apodia	无足
carry	支持
spicebush	西美腊梅
ovl	覆盖文件的扩展名
scrawny	瘦脊的
meliorable	可改进
protestant	新教的
palermo	巴勒莫
styptical	止血的
mottramite	钒铜铅矿
rarefied	纯净
unmanly	无男子气概
needlessly	不必要地
stratal	地层的
bumpety	猛烈地
vulnerary	医治创伤的
fusil	轻型燧发枪
decimal	十进
galess	无胆汁的
parity	奇偶
converse	逆行
nitrous	氮的
spirivalve	有螺状壳
suburbicarian	罗马市郊
mirror	映出
wince	退缩
unspell	解除……的魅力
unweighted	不被认为重要的
electrophoresis	电泳
fixer	把事情暗中完结的人
beata	受赐福之妇女
kosher	犹太教所规定允许的
epixylous	木上生的
surtout	男用外套或大衣
kutaraja	哥打拉夜
supercolossal	极大的
diborane	乙硼烷
staple	把……分类
ecstatically	心醉神迷地
milankovich	米兰柯维奇理论
outstay	逗留得比……久
piauf	皮奥伊州
indefatigably	不屈不挠地
sitebuilder	微软的WWW开发软件包
sheepshead	红鲈
splenic	脾脏的
tipsy	倾斜
simulate	假装
lignicolous	长在树上
spicy	有风味的
sclerotioid	菌核
rheumatoid	患风湿症的
jorum	一大酒杯
embedded	深入的
wassail	为……干杯
contradictory	矛盾因素
anticoagulate	防止……凝血
umlaut	元音变音
handle	运用
paripinnate	偶数羽状
pinnatipartite	羽状深裂的
impressionistic	给人深刻印象
cover	掩饰
stigmatize	诬蔑
praxis	实践
fruition	享用
nomothetic	制定法律
weird	怪异
aboil	激烈的
equally	平等地
mitigation	减轻
gdmo	Guidelines
medley	拼凑
exfiltration	溜出敌军阵地
exosmic	外渗的
tumult	混乱
byob	own
monkeyshine	恶作剧
perverse	不正当
venerably	崇敬
milwaukee	密尔沃基
karachi	卡拉奇
attic	顶楼
homostyly	花柱等长
dynel	其商标名
pustular	脓疱
marginalize	使处于社会边缘
undoubtedly	的确地
vaporous	冒出蒸气
underprop	支撑物
salique	=Salic
pseudoinstruction'	NULL)
neglectful	忽略的
weasel	含糊其词
nonfulfillment	不完成
bedplate	床板
taffeta	平纹皱丝织品
volubilate	缠绕
solubilizer	增溶剂
sound	听力范围
aerocurve	曲翼飞机
aristocratic	贵族政治
merciful	仁慈
soporific	使人昏昏沉沉的东西
shipshape	井然有序
february	二月
maneating	食人的
ribbing	玩笑
holocrine	全浆分泌的
pensione	膳宿公寓
siderocyte	高铁红细胞
costive	小气的
ungrammatical	非文法的
lowerclassman	大学低年级学生
northeasterner	东北人
sbr	Rubber
purport	主旨
resultant	合成
temporarily	临时
endearing	令人钟爱的
aeromotor	飞机用发动机
unfixed	没确定的
intramarginal	边缘内
subhuman	近似人类
kinescope	电视节目录影
semibarbarous	=semibarbaric
syce	马倌
anemography	测风术
younger	较年轻的
enroll	参加
dainty	挑剔的
voguey	风行一时的
fireclay	火泥
linalool	沉香醇
undermeaning	言外之意
orphanage	孤儿身份
bursarial	会计员的
idyllize	使成为牧歌
archeology	考古学
pacemaker	起搏器
chumar	=chamar
lymphatism	淋巴体质
earldom	伯爵的身份
dropscene	收场
wolffish	狼鱼
humanization	教化
illusionless	无错觉
kheth	希伯莱文的第八个字母
resale	转售
phenolic	酚的
billy	尤指警棍
cajun	移居美国路易斯安纳州的法人后裔
constant	坚决
figuline	陶制
owi	Information作战新闻处
southward	向南
vibrometer	=vibrograph
out	使退场
thallus	扁平体
restlessly	慌张地
benthamic	功利主义的
omphalos	中心
informing	增长见闻的
luminize	涂发光物质于
plumpy	丰满
spence	思朋斯
nonelastic	无弹性
ergonomist	工作学者
joyhouse	妓院
unctuously	油腻地
preteen	接近青春期的
economist	节俭的人
interpupillary	瞳孔间
expressionistic	有表现派作风的
element	成分
cryptical	隐藏的
irrespective	不考虑的
jostle	推撞
scorbutic	坏血病患者
acini	acinus的复数
obsequial	葬礼
phosphatic	含磷酸盐的
swimmy	模糊的
undimmed	不模糊的
palaearctic	古北区的
sick	恶心
pilsener	比尔森啤酒
tessellation	棋盘形布置
kinglessness	无国王
pardner	朋友分享者
habitual	惯常
cookery	烹调术
roam	徘徊
orcadian	群岛的
kickback	回扣
rendition	表演
mimeo	=mimeograph
ab	Airborne
dubitant	半信半疑的
graphology	笔迹学
iconography	肖像学
lastness	最终性
jazz	喧吵的
valhalla	英烈祠
demand	需要
rehearse	复述
minicamera	=miniature
squamose	鳞状的
monostable	单稳的
balefire	烽火
riverine	河的
condensable	可压缩的
rendering	表演
recalcitrate	不服从
unaffected	未被感动的
headstone	基石
france	法国
maniacal	发狂
decinormal	分当量
daniela	丹妮拉
pungent	尖锐
steady	扎实
valedictory	告别
hound	带猎犬狩猎
custard	奶油蛋羹
porkbutcher	猪肉商
harrumph	鼻息
sidewise	向一边的
ferment	动乱
lumisome	发光体
brio	生动
bogle	可怕的人
dawdling	闲逛
coralline	珊瑚状动物
hypertonia	高渗性
clampdown	取缔
decipher	解释
chrismation	搽圣油
elope	潜逃
scavenge	以为食
unimplemented	未实现
megalopteran	广翅目昆虫
torpidness	冬眠
nummet	午饭
semicivilized	半开化的
unstudied	不懂的
idoneous	适合的
pigskin	猪皮
running	不断的
skinny	膜状的
enrich	加料于
nannyish	旧式的
faultily	不完美地
bargaining	讨价
cock	堆成锥形
cordwood	锯成4英尺长之木材
joust	斗争
think	预料
keramic	陶器
factice	油膏
lutz	后外钩点冰一周跳
quadrantal	四分仪的
transversal	横向的
stress	重音
buggy	多虫
largess	赏赐
predepression	经济萧条前的
was	be的过去式
scum	浮垢
anthropopathic	拟人的
confinement	产期
claver	闲谈
gloomy	黑暗
biquadrate	四次幂
raises	举起
wheelwright	车轮制造人
blanketyblank	该死
kalsomine	粉刷
impermissible	不允许
directoire	执政内阁时代式的
tubbish	肥胖
darch	doctor
fantabulous	极出色
clinique	门诊部
rswc	up
sackbut	竖琴的一种
straight	诚实的
sst	transport
pericles	伯里克利
sf	San
minty	有薄荷香
buttock	背摔
zoonomy	动物生理学
sod	铺草皮于
creedal	教义的
extrafloral	在花外
gynander	两性体
exception	例外
affectation	假装
innative	天生的
penates	家神
unidentifiable	无法辨认
excitant	兴奋剂
apocarpous	心皮离生的
multiparty	导致多党并存的选举制度的
fellowship	交情
prejudice	侵害
logograph	略字
sizzler	炎热天
hadhramautian	哈达拉毛语
hemothorax	胸腔积血
boughpot	大花瓶
cover	覆盖
asthmatoid	似气喘
seaware	作肥料用的海生植物
lonely	寂寞的
ostracean	牡蛎
solonchak	盐土
shiny	发亮的
languorous	没精打采
habitably	适于居住
ccitt	and
andante	缓慢
gaulish	高卢人
reclaimer	回收程序
investigative	研究的
deltoid	三角肌
tehran	德黑兰
mountain	山脉
villainous	罪恶
drosometer	露量计
doggo	一动也不动地
incendiary	煽动的
hypersurface	超曲面
lav	Armored
halothane	氟烷
exposed	暴露
rhinal	鼻的
teratogenicity	畸形形成性
nary	连……也没有的
eclogue	牧歌
bundu	未开化的乡区
algoid	海藻般的
sunna	伊斯兰教教规
smallsword	轻剑
cretinoid	矮呆病样的
henhearted	懦弱
reform	改革
goaty	好色
unhandily	笨拙地
sungari	River
lip	唇缘
lunge	刺进
generalization	普遍化
polymorphic	多态的
adrenodoxin	皮质铁氧还蛋白
diadelphous	两束花丝
unprofessional	非职业性的
regular	等边
eliot	埃利奥特
epithalamion	=epithalamium
cabernet	红葡萄酒
rifeness	普遍
vedic	吠陀的
adas	Advisory
excogitative	发明
uba	Burma
pail	桶
roseau	罗索
scandalmonger	专事诽谤的人
cardindex	将……记入卡片
uninfluential	没有影响的
inadvertency	不注意
fast	斋戒
worship	崇拜
surety	保证人
soapbark	皂树
lawmonger	恶讼师
tripey	废物似
propound	提议
dexterously	巧妙地
axillary	腋窝的羽翼
lactonize	使变为内酯
causation	原因
apologia	辩解书
out	下台的
temperate	戒酒
gruntle	咕哝
snubbingly	严厉斥责地
ridable	可以骑
clean	清白
autolithograph	^rAfIk/
niaiserie	愚笨
shim	n薄垫片
owi	of
wild	野性的
voiceover	画外音
spigot	套管
nes	elsewhere
goaty	淫乱的
pretrial	事先审理
credibly	可信地
unfearing	大无畏的
inheritance	遗产
flounderingly	挣扎地
determinative	限定的
liane	蔓生植物
sprint	疾跑
oxbridge	牛津与剑桥大学的
sidestream	smoke
sistrum	一种类似哗郎棒的乐器
sombre	阴沉
vane	变化不定的事物
cer	Encoding
starchy	淀粉
excruciate	折磨
ancestral	祖先的
indignantly	愤怒
defer	使延期
pittosporum	海桐花
solicitor	律师
macroscopic	巨观的
electronical	电子的
pashalik	pasha的领
around	四周
lophobranch	总鳃类
procrypsis	隐色
vegete	健康的
pirouette	脚尖旋转
idle	使空闲
hematogenesis	造血作用
pli	per
vendibility	市场价值
tunnage	吨数
psro	standards
cantabrize	效仿英国剑桥或剑桥大学
unroyal	不配为王
amputator	切断器
adcolumn	广告栏
oppilate	使便秘
godetia	高代花
frangipani	从鸡蛋花中提炼出来的香料
singlehanded	单手
pocket	装……在口袋里
variomatic	皮带驱动自动传递的
hives	麻疹
mischievous	为害
preface	为……写序言
undivided	未分开的
freshwater	淡水
molder	使腐朽
gippo	汤
activable	能被活化的
flyable	可驾驶的
furcula	弹器
oast	干烘炉
riffle	迅速翻书
diminishable	可削弱
oui	是的
bilirubin	胆红素
hypercorrect	矫枉过正
organotherapy	器官疗法
quarrel	争吵的原因
haroseth	赫罗塞思
sometimes	有时
ssfdc	Solid
porphyrize	把……研细
nasopharynx	鼻咽
bust	胸像
causality	因果关系
subscapular	肩胛前面的
bergsonian	柏格森主义者
hers	pro
dripless	不滴水
fagot	束薪
politely	斯文
proteolytic	蛋白水解
pyrochemical	高温化学的
favorably	好意
voyage	渡过
villainous	缺德
explanation	解说
tpilisi	=Tbilisi
gramary	魔术
lifesome	有力
undutiful	不孝
unconfessed	未供认的
diffidently	缺乏自信地
eleatic	埃里亚的
meshugaas	愚蠢
garrote	绞死
kiln	干燥炉
humidor	雪茄盒
cinchonidine	金鸡纳啶
overflow	溢出
labiate	唇形
pocket	衣袋
rakish	潇洒的
leisurable	悠闲的
abrasive	研磨剂
overfull	过度
carouser	大喝大闹的人
photonics	光子学
extraventricular	室外的
viscountess	子爵夫人
steam	水汽
polymeride	=polymer
slimsy	不耐穿的
hemoglobinuric	血色蛋白尿的
boll	圆荚
follow	接着
chockstone	山中裂缝中的岩石
myoelectric	肌电的
guianese	圭亚那地区的
nethermore	较深
plump	突然放下
whee	哟
dealership	代理权
oecd	of
armenian	亚美尼亚人的
urubu	黑秃鹫
mylohyoid	下颌舌骨的
recrement	渣滓
detail	详述
armorbearer	替骑士拿盔甲者
waterlog	涝灾
every	每隔……
superfluity	奢侈品
flanker	侧冲
detractress	女诽谤者
troubleproof	不生故障的
dealing	交易
mount	装上
horsey	马的
bani	动员令
perpendicularity	垂直
sheerlegs	人字起重架
oddly	奇特
millinormal	毫规
slip	有活结
commanderia	科姆马迪尔酒(塞浦路斯原骑士团辖区
oquassa	蓝背红点鲑
hydrolytic	产生水解
bear	具有
photomagnetic	光磁
spatulate	竹片状的
fictitious	假装
somber	阴天
birdcall	学鸟叫
fleecy	蓬松
narrow	海峡
etruscologist	伊特鲁里亚文化研究者
checked	选中
uat	联合海空运输公司
viscera	内脏
bumpily	扑通
uncorrupt	不腐败的
eightsome	轻快的八人舞蹈
chine	沿……脊骨剖开
cayuga	卡尤加人
disenable	使丧失资格
headrest	靠头之物
minicamera	camera
sandiver	玻璃沫
chemiluminescnet	化合光的
benzedrine	一种苏醒剂
directrice	女指挥
colcannon	爱尔兰菜肴的一种
nonferrous	非铁的
jocular	诙谐
unconditional	绝对
intraperitoneal	进入腹膜腔内
transparence	透明度
spherular	小球体
extraordinaire	非凡的
turnabout	回旋
weisswurst	小牛肉香肠
factorial	阶乘积
finisher	完工者
antemundane	世界形成以前的
pagan	异教徒
pop	通俗的
ardent	激烈的
semitic	闪族语系的
inure	生效
lease	租借
venomous	有毒腺的
holophrastic	以一个字显示整句意思
resinoid	树脂状
chorten	纪念碑
nin	祖母
unceremoniousness	无礼
threaten	恐吓
breechblock	尾栓
pungent	辛辣的
hereford	赫里福种的食用牛
primitive	原始
divestment	夺取
referrence	参见
gibeonite	卑微的劳动者
philomela	夜莺
cement	接合
tassel	用缨装饰
rheumatism	风湿
discharger	开释人
guanethidine	胍乙啶
thud	砰击声
petty	小器的
uniform	使穿制服
omphalos	脐
esl	as
fingertip	指套
armillary	手镯
become	变得
flannel	法兰绒衣服
pert	别致的
clapometer	掌声测量计
accommodationist	迁就的
insusceptibility	无感受性
daiker	摇摆
parky	寒冷的
fauxbourdon	假布尔东低音
grum	闷闷不乐
hearken	倾听
excrescence	赘生物
knifeboard	磨餐刀板
fiduciary	信托
induce	引起
attractive	吸引人
nellie	内尔
bloke	家伙
keramic	陶器的
toilless	容易的
kidling	小山羊
syphilitic	感染梅毒
comitadji	非正规兵团
histiocytic	组织细胞的
fit	健康的
superseniority	超资深
polyglot	数种语言
nundinal	古罗马市集日
schizogenous	裂殖生殖
petitioner	请求者
alluvion	冲积
deposable	可废除的
homeric	荷马时代的
appellation	称呼
inexpertness	拙劣
despiteously	可恨
spar	争吵
canvass	彻底检查
beneficially	受益
christly	如基督的
barytone	低音铜管乐器
pectinated	栉齿形的
asio	视频流输入输出
coolville	顶呱呱的
mylohyoid	下颌舌骨
behindhand	落后的
eleemosynary	接受接济的
vibriocidal	杀弧菌的
here	这里
homecoming	回老家
wysiwyg	What
rassle	角力
adieu	再会
methodism	教义和礼拜的方式
dm	Dominica
epileptogenic	致癫痫
lestobiotic	靠偷取异种动物为生的
unseriousness	不庄重
snobbish	势利
basaltoid	像玄武岩的
scrophulariaceous	玄参科
rectorship	教区长之职位及任期
destination	目的文件
pregenital	性器官发育前的
prelatic	高级教士
rival	竞争者
shetland	设得兰群岛
oaf	呆子
catechise	问答式教授
placental	有胎盘哺乳动物
aloof	孤零
comparative	相当
unlicked	不象样的
laziness	无精打采
pertly	傲慢
aliped	有翼膜
fleeceable	可以欺诈
buntal	金丝草
fragmental	破片
acquittance	清还证明书
wake	醒来
lactose	乳糖
issuable	可发行的
nucleonics	原子核物理学
receipt	收条
antimask	滑稽戏
eshaustibility	可用尽
subdolous	有点诡谲
consonant	协调一致
palingenesis	转生
touch	触
cupbearer	斟酒人
copasetic	=copacetic
famed	闻名
battue	大屠杀
ephemera	蜉蝣
creasy	皱纹多
auxotrophy	营养缺陷体
polydirectional	多方向
blare	号声
urinalysis	验尿
secondman	助理驾驶员
shampoo	洗发香波
fixing	安装
complimentary	夸奖的
cephalous	有头
blustering	狂风大作的
jumbly	混杂的
dancetty	锯齿形的
screaming	尖叫
wrangle	吵嘴
blaspheme	亵渎
waw	=vav
lawny	草坪的
suitably	相称地
leechcraft	医术
jaunty	洋洋得意
ogle	抛媚眼
opec	Countries
hindustan	印度
lewd	猥亵
rosulate	成玫瑰花形排列的
rhizomorphous	根状的
bolt	逃跑
electricize	充电
cloudling	小云
domesticity	家庭生活
plc	股票上市公司
bemock	讥笑
evolutive	演化
fst	Technology
epigamic	诱惑性的
imperfect	有缺点
yamato	日本人的
moistness	湿
aic	American
crate	柳条箱
eggcup	蛋杯
municipality	自治市
unconstrained	不受拘束
gryphon	半狮半鹫的怪兽
spinoff	将子公司股票分配给母公司股东
eleusinian	Eleusis
intrepidly	勇猛
portfolio	部长职务
contralateral	对侧的
gpl	通用公共许可协议
pluto	冥王星
synodic	相合的
callan	少年们
kirk	教会
pesticidal	杀虫的
wilderness	荒野
secretory	促分泌的
hindooize	=Hinduize
mismatch	使配合不当
renig	=renegue
calefaction	发暖
human	人
duykerbok	=duiker
russia	苏联
juvenescent	变年轻
fredericton	弗雷德里克顿
corkily	喜不自禁
permissively	自由
amfortas	安福塔斯
osteotomy	截骨术
redbug	沙蚤
pashalik	pasha的领地
unfatherly	不像父亲
hidden	隐藏的
multifactor	多种因素的
townhouse	市政厅
damnably	厉害
gibbon	长臂猿
embellish	修饰
ambivert	中向性格者
solicitudinous	担忧的
fenian	芬尼亚主义的
immoderately	无节制的
trust	切望
kewpie	其商标名
powwow	仪式
chatterbox	喋喋不休者
semicoma	轻昏迷
fore	前部
epicritic	精细觉
unharmful	不致伤
amidone	=methadone
hurl	愤慨地说出
madcap	狂妄的
palatably	称心愉快地
whist	安静
knockabout	到处闲荡
asc	state
ideation	构思过程
unbodied	离去躯体的
glace	冰冻的
bringdown	使人失望的事物
isotron	同位素分析器
hideous	骇人听闻
cottonize	使成绵状
unbroken	继续的
disfigure	使变丑
laurel	殊荣
hearsay	传闻
agiotage	证券投机
mustardy	芥末
veteran	退伍军人
gurglet	=goglet
digitate	指状
tillable	适于耕种
recharge	再袭击
troop	群
rabbet	榫头
rigor	严格
intranational	国内
weston	cell韦斯顿标准电池
inesculent	不可食用的
possessory	所有者的
raptorial	猛禽类
mezzo	中间的
exterior	外在的
diemaker	制模工
perigon	三百六十度角
enhancive	增加
ipa	国际语音学协会
barrelful	大量
baroness	男爵夫人
undistinguishable	难区分
allantoid	尿囊样
s3	S3公司
dehydration	脱水
bitterly	悲痛
hardware	部件
serrulate	细锯齿状
remarkably	引人注目
decad	十
representability	可被代表
shaven	shave的过去分词
bored	烦人的
pythonic	预言
doubtfully	怀疑地
ddn	Service
coarsely	质地粗糙
creamcups	一种罂粟科植物
statesmanlike	有政治家之身份的
filasse	植物纤维
nourishing	滋养多
spark	花花公子
micronucleus	小核
reproachless	无可非议
epndb	effective
topographical	形学
tamizdat	塔密兹达
trover	取得
gauzily	薄地
redhibition	买卖无效
msj	of
dpi	dot
qualificative	修饰
demibastion	半棱堡
nitrogenous	氮
exclusive	唯我独尊
mspe	Education
dolce	温柔的
cannular	管的
milkman	送奶工人
centre	中心区
immunoassay	免疫测定
netful	满网
mancunian	曼彻斯特人
sketch	略图
like	如同
wonder	对……感到惊讶
ambulatory	走动的
faldstool	无靠背的椅子
begrudge	舍不得给
export	出口货
irvingite	使徒公教会信徒
geophysicist	地球物理学者
divisional	师的除法
automatous	机器人
immorality	无道义
centennially	每百年一次
fiery	火焰的
laotian	老挝人
bir	Board
domical	圆顶式结构
flannel	法兰绒
catalysis	催化作用
retired	退役
eventful	变故多
proscription	放逐
slighting	忽视的
hdd	硬盘驱动器
callao	卡亚俄
espouse	嫁娶
psychopathia	精神变态
atman	自我
delawarean	特拉华州
surge	振荡
inscrutability	不可思议
flavorful	充满……味道
quarrel	吵架
hypnogenetic	催眠
horsefly	马蝇
neoterism	新字
man	人
prepreg	预浸料坯
palaver	谈话
considered	被尊重的
scopulate	帚形
minicell	微细胞
downcourt	前场篮下方向
wheezy	老生常谈
apodictic	明白
reflex	反省的
sickening	令人作呕的
characterless	平凡
unbacked	未驯服
lrv	vehicle
wingover	跃升转弯半滚倒转
athenian	雅典人
mire	陷入
context	文章的前后关系
atwitter	兴奋的
derby	英国中部的都市
wake	守夜
antidiphtheritic	预防白喉的
indiscretion	轻举妄动
heiress	女性继承人
solemnly	严肃地
adjunction	附加物
unfatherly	严厉的
bacteroid	似细菌
interlude	圣诗等两段之间之间歇
objectivism	客观主义
colorplate	彩色版
pneumorrhagia	肺出血
odour	意味
ruminator	沉思默想的人
ducky	极为愉快的
abridgable	可以删节
overwash	淹没
ethanolamine	氨基乙醇
unreconstructed	旧思想
spreathed	发红
fictionally	编造
obligate	使负义务
overclothes	外衣
etherealize	化成醚
clairaudient	有超人听力的
snobbism	势利
uterine	同母异父的
declutch	使停转
ismailiya	=Ismailia
barilla	苏打灰
capelin	香鱼科的小海鱼
hitlerian	希特勒的
earnest	重要的
rube	土里土气的
chocolaty	如巧克力般
groundling	没鉴赏力的低俗观众
trying	难受的
easement	缓和
myrmecophagous	食蚁的
thowless	呆滞
swoose	天鹅鹅
anchorite	隐者
farrago	混杂
equilibrist	走绳索者
actress	女演员
hawaiian	夏威夷
petty	不重要
hobodom	流浪者生活
ostracise	=ostracize
sphacelus	脱疽
laevulin	菊芋糖
roric	似露水的
ebullient	热情洋溢的
shopper	购物者
expand	发展
medical	药的
schumpeterian	熊彼特
concorde	协和式飞机
calcific	石灰质的
pustulate	生脓疱的
discretional	任意的
lunary	月亮的
anglophobia	反英
retrieval	修补
xenate	氙酸盐
ruler	划线板
episcopature	主教团
isometric	等容积的
executant	执行者
automatic	无意识的
precept	规则
furl	卷起之物
autolithograph	直接平版画
supergravity	超引力
tophus	痛风石
totter	蹒跚的步子
eurithermophile	能在摄能在摄氏零下30度氏零下30度与60度与60度之间存活的之存活
catstep	陡坡上建的窄阶
outcast	被排斥
irrepressibly	镇压不住
bond	联结
kingship	王权
campaign	作战
dissentious	好争论
posterolateral	后外侧的
message	讯息
intimidation	胁迫
ekpwele	=ekuele
tail	限定继承的
dormin	脱落酸
book	卷
engarb	给……穿衣
auriferous	产金的
etic	非位的
disproof	反证
tame	没精打彩的、顺从的
unmoor	解缆
debride	清除
toolroom	工具室
slighting	轻视的
gelandesprung	滑雪者越过障碍物之腾越
hegemonical	=hegemonic
voyageable	能航行
article	清楚说出
bulletin	报告
triptane	三甲基丁烷
depressingly	郁闷地
girlygirly	过于忸怩作态的
cubage	容积
fecundate	使多产
aeolipile	汽转球
equilibrator	保持平衡物
leaden	沉闷的
chromatin	染色质
regild	再镀金于
locksmithing	锁匠工作
convertite	改变信仰者
toothpick	牙签
terminative	结束的
opposeless	难抵抗的
vehemently	激烈地
circusiana	马戏大全
informing	增长见闻
nurture	营养品
fructiferous	结果实的
satanic	邪恶的
msy	yield
ngbandi	恩巴恩迪语(中非共和国和北扎伊尔的一种班图
retrofire	点火发动
microtasking	微任务化
transient	瞬时现象
antifreezing	抗凝的
unminished	=undiminished
eschar	焦痂
benedictory	祝福的
etymology	语源学
biochemistry	生物化学
multocular	多眼的
lactoprotein	乳蛋白质
subinfeudation	分封
infirm	弱
zabaglione	意大利菜肴
troposphere	对流层
witticism	妙语
theocentric	以上帝为中心
ruben	鲁本
gat	狭航道
frizzle	炸得吱吱响
hostie	=air
triethanolamine	三乙醇胺
vaginate	有鞘的
dicastery	由审判官组成的法院
portacaval	门腔静脉
nauseant	呕吐剂
flint	燧石
representor	陈述者
delustre	使退光
jehovist	旧约圣经初六卷
supervenient	伴随产生的
catherine	凯瑟琳
amnicolous	栖沙滩
xcv	95
unclimbable	不可攀登的
postfactor	后因子
spender	挥金如土的人
lixivial	碱汁的
mut	杂种狗
hydrolab	水下实验室
knottiness	困难
subsistent	现存的
ostleress	料理马匹的女人
excurved	弯曲
thromboendarterectomy	血栓动脉内膜切除术
wadding	棉胎
grotto	人工洞室
talmudic	犹太法典的
zoom	突然扩大
dicker	十个
theft	行窃
despondency	失望
unboot	替……脱下长统靴
justification	释罪
mesosome	间体
cogged	齿轮
ribband	防滑材
remedially	矫正地
rope	绳
danish	丹麦的
elegance	高雅
bead	水珠
raid	Array
quingentenary	五百年
breadth	幅
quick	感觉敏锐的部位
dedicatory	献纳
crampon	攀登用鞋底钉
daftness	愚笨
evenness	平坦
rockoon	气球火箭
femininely	娇弱地
unfenced	没有防备的
slumberous	昏昏欲睡的
wrest	费力取
skyphos	双耳大饮杯
pardonably	可原谅
unverbalized	未用言辞表达的
disrespect	失礼
intrepidress	大胆
thionine	劳氏紫
tdma	Multiple
eht	超高压
adulteress	奸妇
grisaille	纯灰色画
uninstall	卸载
inkosi	老爷
analogously	近似
awake	领会
salute	升降旗致敬
cottonopolis	棉都
unwelcome	讨厌
peritectic	转熔的
nummary	货币
shavetail	新任的陆军少尉
televisionless	不看电视的
mudcap	糊炮爆破
intercommunal	社区之间的
interplait	使缠结
aciculate	针状
devotional	献身的
numidian	努米底亚
fatness	油腻
reflect	表现
deformable	可变形的
extramarginal	意识以外
bashful	害羞的
resemblant	摹仿的
archdukedom	大公国
starched	硬挺的
reject	被拒之人
molybdenite	辉钼矿
natruresis	=natriuresis
amr	Modem
langobardic	伦巴第
rutilant	发红色火光
nougat	奶油杏仁糖
refer	查阅
pledge	使发誓
backscattering	反散射
warrant	委任状
scarves	领带
incurrent	流入
selkirkshire	塞尔扣克郡
rumpless	无尾椎的
poll	获得选票
unmatched	不相配的
isostasy	地壳均衡说
infuscated	被弄糊涂
preproduction	生产前
aeolian	风蚀
rotc	后备军官训练队
actiniform	放射形
complaisant	殷勤的
kiaugh	苦恼
fashioned	……式
whacking	惊人
harvardian	哈佛大学的学生
landward	近陆的
flubdubbed	笨拙
flintiness	坚硬
aperiodically	不定期地
quadruplane	四翼飞机
rule	统治
polygamous	一夫多妻的
attack	攻击
tennessean	美国田纳西州
mesh	网眼
brass	厚脸皮
dugout	棒球场边供球员休息的地方
deodorise	=deodorize
paratonic	外来刺激引起的
surrealistically	超现实主义地
asset	资产
accommodationist	迁就
chorography	地方志
dry	干燥的
polyvalent	多价
spinet	古时的小型竖琴
untillable	不能耕种
ecaudate	无尾的
ranter	大叫大嚷的人
set	置
discursively	推论
baldaquin	锦缎
ingroup	内集团
moppy	蓬乱
undiscernible	辨别不出的
gromwell	紫草属植物
palaestra	体育馆
scuzzy	肮脏的
tame	变得驯服
acerb	尖锐
vein	纹理
waterishlogged	浸水
elusive	难懂
skeptical	好怀疑的
coverlet	被单
schizozoite	裂殖子
tumefacient	膨胀
emanatory	放射
mackinaw	方格纹毛毯
microelement	微型元件
scotch	苏格兰人的
recover	痊愈
woodturner	木工车床工人
percentagewise	从百分比看
hydropress	press
ecology	环境适应学
above	上面的
trochoid	轨迹线
wicked	不道德的
jerreed	钝头木标枪
transformative	有改革能力的
zootomy	动物解剖学
panderess	作淫媒的女人
replace	取代
bulbiform	球状的
inflammation	发火
photoinduction	光感应
raggy	=ragged
bas	BASIC程序的扩展名
compactly	细密地
shapable	样子好
volsci	沃尔西人
yesterdayness	近来
appentice	窗前的雨篷
culminating	到绝顶的
inexpressibly	到不能用语言表达的程度
altogether	完全地
disrupt	使分裂
unobvious	不明显的
polysepalous	离萼的
substantialist	本体论者
inbeing	本性
exterritorial	治外法权
solecistic	失礼的
cypriote	塞浦路斯岛人
obelise	加上剑号或疑问号
hematogenous	血性
syrupy	糖浆似
unfavourably	不适宜地
noho	休北区
jaunty	感到自信和自满
banian	印度商人
sforzato	加强的
praedial	属于土
devilishly	厉害
cephalad	向头部地
let	排放
monaker	=monicker
banaban	巴纳巴岛
kbe	the
rhizogenesis	生根
indifferent	无关紧要的
vasovagal	血管迷走神经的
root	根
unresponsive	感受性迟钝的
iocu	Union
meromixis	半混合
abortive	早产的
presiding	主持会议的
syncretic	汇合的
fathom	看穿
latifolious	=latifoliate
orel	奥廖尔
whitleather	leather
magniloquent	使用夸张语言的
stript	strip
coagulable	可凝结
cowk	干呕
famous	出名的
mid	中部
pattie	=patty
derivative	派生词
aurelia	水母
chronicle	编入编年史
submundane	地下的
judiciable	可被审判的
goniotomy	前房角切开术
intrusion	闯入
rhinolalia	鼻音
hypnosis	催眠状态
corporeally	肉体上
sickening	使人昏晕的
chirpy	活泼的
gerontophil	亲老人癖
floweret	小花
airbag	安全气袋
outvie	竞争胜过
tudory	都铎式装饰
optophone	盲人光电阅读装置
featherheaded	蠢的
impoundment	被坝所围住的水
millier	=metric
soberly	冷静
retake	重摄
gray	广告业
czardas	匈牙利的民间舞蹈和音乐
radices	基数
hagborn	巫婆生
glair	涂蛋白于
limberneck	鸡垂颈病
modifier	改造者
hungarian	匈牙利
ophiophagous	食蛇
homophonous	齐唱
suicidology	自杀学
slickness	花言巧语
empathic	感情移入的
photogenic	易上镜头的
dogmatics	教理神学
moulvi	=maulvi
sterile	不育的
foundry	铸造
dissociability	可分离
phenazocine	苯唑星
oke	没问题
bank	一堆倾斜转弯
airily	快活地
unbalance	使能避免
whoosy	=whoosis
declivous	向下倾斜
fiction	编造
humiliatory	丢脸的
filially	孝顺地
rcaf	加拿大皇家空军
detorsion	身体弯曲处的变直
bidialectal	精通两种方言的
grocery	食品
baccivorous	以浆果为食的
asway	摆动
monozygotic	单精合子的
tactful	机智
roisterous	饮酒取乐的
engraphia	记忆痕迹的形成
hfs	Hierarchial
europeanist	欧洲经济共同体第一主义
bronchus	支气管
null	无效力的
solander	索兰德盒
bios	基本输入输出系统
longipennate	有长翅的
theomorphic	有神之形象的
millenarianism	太平盛世
kernelled	有核仁
ecc	Checking
accessibility	易接近
seromuscular	浆膜肌膜
champion	支持
seminivorous	食种子
estaminet	小餐馆
rental	租用
periodically	周期性
geosynclinal	地槽的
isd	Dialing
detent	扳手
coital	性交
vertical	顶点的
polyesterification	缩聚
sempster	=seamster
sybaris	锡巴里斯
otherwise	不同地
gaga	天真
expositorily	以解说的方式
indissociably	不能分离
balaustine	野石榴花
bladesmith	刀匠
minor	二流的
unlock	开……锁
cmh	Medal
lipstick	唇膏
kernel	精髓
overpunch	上部穿孔
antipruritic	防痒
nix	不要!
scorbutic	坏血病的
hcg	chorionic
monocular	单筒
purvey	供应
stanine	9级记分
trespasser	侵犯者
mutagenesis	变异发生
arginaemia	先天性精氨酸代谢失常
bath	浴室
alchemically	炼丹术地
please	使满足
wandsworth	旺兹沃思
dendritic	树枝状的
turner	车床工
misfit	不适合
lengthiness	冗长
procession	行列
theretofore	到那时为止
autotrophic	自给营养
square	使直
shave	刨
resnatron	谐振腔四极管
regretful	后悔
halfbeak	鱼箴科鱼
thunk	铮
aposteriori	归纳
dropsical	水肿的
repeatedly	重复
liturgiology	=liturgics
overclaim	越权的要求
innumeracy	数学盲
snapshoot	快镜拍摄
antislavery	反对奴隶制度
quixotic	狂想家
clart	泥土
tirelessly	不屈不挠
qda	quantity
nur	National
angustifoliate	窄叶的
eudaemonic	幸福学
contributing	起作用
bmoc	campus
thole	桨架
possession	财产
adwoman	从事广告工作的女人
inseverably	不可分离
novel	异常
sycamore	枫树的一种
tarnishproof	保持光泽的
preventorium	防痨疗养院
sneezy	引起喷嚏
plutodemocracy	金权民主主义
cerotype	蜡版之模子
