mao	毛式服装的
osteologic	学
diminutive	小的
synanthropic	生态上与人类关联
magnetogram	磁力图
rasping	锉磨声的
teeny	极小的
choux	chou的复数
continuous	持续
autosomal	正染色体的
underlease	分租
superincumbent	自上而下的
harmonic	和声
redowa	雷多瓦舞曲
rejuvenate	使更新
geologist	地质学者
mural	墙壁上
weightily	重要
articulator	发音之人或物
monarticular	单关节的
meretricious	华丽而庸俗
suine	代黄油
hela	人宫颈癌传代细胞
cobber	合伙人
gadgetize	装置机械
ravioli	馄饨
vendibility	可销售性
abject	卑鄙
huxley	生物学家
rochet	白色法衣
settltment	殖民
atilt	倾斜
unbirthday	非生日那一天
cyclostomate	圆口动物
amboyna	青龙木
hemorrhoids	痔疾
czar	大权独揽的人
waggonette	=wagonette
plodding	单调乏味的
drumbeat	鼓声
ephor	长官
dentine	牙质
attachable	可逮捕
accessory	从犯
adding	增加
demonstrate	示威
soilless	不用泥土的
megacycle	兆周
empiricism	庸医的医术
aubade	黎明曲
dishabilitate	取消……的资格
vox	嗓音
forked	有叉子的
multivocal	暧昧的
hereditable	可遗传的
short	缺乏
silverpoint	银尖笔
sleazy	质地薄
ampersand	的记号名称
basilisk	蛇怪
canonize	推崇
boss	上司
aftercrop	后作
hydric	含氢的
reconvence	再集会
ichthyology	鱼类学
foresaid	前述
simitar	弯刀
dpi	点每英寸
unshift	松开打字机或键盘的字型变换键
gauffer	襞
lacerna	短披风
rush	匆忙地做
presenile	过早衰老的
baccivorous	以浆果为食
sphenopsid	木贼纲植物
physician	内科医师
juglandaceous	胡桃科属的
depositional	沉积的
xanthous	黄色
battue	大量捕杀
huntress	女猎人
tail	限定继承权
radiochemistry	放射能化学
influential	有势力的
lunarscape	月面景色
unlock	解开
schmoll	傻瓜
monumental	纪念碑
puff	吹捧
strategics	兵法
tartarous	酒石
mordacious	刻薄
cladistic	进化枝
adversity	不幸
thin	细的
smithereens	碎屑
bulldike	女相公
slimsy	不结实的
migrate	使移植
myoatrophy	肌萎缩
unconcerned	不相关的
felafel	=falafel
fancy	设想
yell	忍不住笑
oilily	油似
xenotime	磷钇矿
exit	去世
platitudinous	平凡的
rare	珍贵的
cluster	成群
loader	装货设备
booky	=bookish
sermonize	说大道理与人听
gravitas	庄严的举止
trichomonacide	滴虫剂
incapacious	无能的
aldosterone	醛固酮
result	成效
spokesman	代表者
whipsaw	使受双重损失
diastyle	柱间距离等于柱径三倍的
voluntary	故意
multiparty	多党
fascinatedly	出神
tapestry	用挂毯装饰
overflow	充溢
udp	用户数据报文协议
eyeservice	在雇主看着时才干的活
triumphant	洋洋得意
continuable	可持续
backroom	后屋
scullery	碗碟储藏室
petalody	成花瓣形
levallois	文化期的
justification	辩护
rex	雷克斯猫
cockleshell	小划艇
lithospermum	紫草
calligraphy	书法
promote	促进
polysyllabic	多音节
gargoyle	怪兽饰
revanchism	德国复仇主义分子
chloridize	氯化
flannel	法兰绒的
begirt	begird的过去式及过去分词
cerebromalacia	脑软化
condition	情形
crop	产量
dendrite	树枝石
occident	西欧诸国
flowering	以花饰
prediction	预报
unpleasing	不愉快
horological	钟表
equator	赤道似的圈
augean	极脏的
glossematic	语符学的
subversive	颠覆性的
sciagraph	对……作X射线摄影
safeguard	安全措施
language	/
searchless	不可理解的
sutural	针脚的
biannulate	具两个色环
kioto	=Kyoto
paten	金属制平碟
antifederal	反对联邦
galtonian	高尔顿的
enfeoff	授予采邑
unstuffed	不拥挤的
equatorial	近赤道的
propagandistic	宣传家
precipice	悬崖
covey	一群
cardiectomy	心部分切除术
restoral	=restoration
ballistically	弹道学地
invidious	不公平
percuss	叩诊
turbosupercharged	[縫E9tFB:dVE涡轮增压器
eshaustibility	可耗尽
transvenous	经静脉的
submucosa	黏膜下层
erotophobic	憎恶性爱
swap	交换
survey	调查
bigoted	执迷的
bonkers	精神不正常的
credited	信用
ichthyoid	成鱼形的
suberose	似软木的
bodily	亲自地
eyeliner	眼线膏
eligibility	合格
everyone	pro
driftingly	飘动地
planirostral	具扁喙
improper	不适宜
tephroite	锰橄榄石
drooping	下垂的
checkup	检查
overage	过多
steelworker	钢铁工厂的工人
thievish	偷偷摸摸的
fenestration	开窗术
classer	分选羊毛等级的工人
monetarily	从金钱角度
hypochondriasis	疑病
heterogenous	异源的
corniness	乡下味
angiopathy	血管病
devilled	蘸了很多芥末
acquired	已成习惯的
pundit	印度学者
breathlessly	气喘地
tcp	/TCP/IP衛
amplifier	放大器
defaulter	不履行者
guttiferous	产藤黄
trippant	抬起前蹄行走的
vignette	小插图
lifeless	无生气的
licet	那是合法的
decisive	决定性的
enormous	极恶的
extremely	非常地
cartilaginous	软骨质的
annihilative	有消灭能力
carney	哄骗
gaiter	长统橡胶靴
bidialectism	两种方言通
roble	美国西部产的白橡树
moji	门司
renegotiate	重新谈判
plasticity	可塑性
superplasticity	超塑性
azion	人造蛋白质纤维
ferreous	硬如铁的
loathful	可厌
gaborone	哈博罗内
ostensive	清晰显示的
halt	踌躇
unplucked	未扯掉
uncopiable	不能复制
nonrecombinant	非
flatter	奉承
cyanopathy	发绀
coranto	s)
playroom	游戏室
electromer	电子异构体
jetton	筹码
cancered	患癌症的
homer	传信鸽
ozonic	臭氧
sidereal	恒星的
accord	一致
marish	沼泽的
nose	鼻
washing	洗涤的
handle	把手
needleman	裁缝
baldaquin	天盖
habitably	可居住地
allogamy	异花受粉
enzymology	酶学
proof	检验
scenarist	剧本作家
broiling	似烧的
circuit	巡回
revolutionism	从事革命
dead	不流动
naughty	下流的
unstudied	未学过
grinding	磨擦的
voluble	健谈
redescend	从……重新下来
ratite	平胸类鸟的
nancified	女性化的
kitchener	厨师
nouny	具有名词性质
peyote	仙人掌的一种
albacore	青花鱼科的海产鱼
hose	软管
kobold	家神
discretely	分离地
flabbily	无生气
geologic	质上
saying	谚语
villainous	罪恶的
almsgiving	施舍
malihini	来夏威夷的游客
exilic	流亡的
salbutamol	羟甲叔丁肾上腺素
gcse	Secondary
iris	虹
twice	两倍
capriccio	任性
reddest	red最高级
humanness	为人的资格
diaconate	助祭们
crenel	炮门
plagiarism	剽窃
pst	Standard
choice	选择
vexedly	着急地
array	衣服
seducement	诱惑
casteless	没有社会阶级的
docile	容易教
synonymous	同义的
episcope	反射幻灯机
collision	碰撞
eht	high
engineer	工程师
drone	混日子
nationalization	国有化
uncondemned	未受谴责
comprizal	包含
fussily	小题大做
radio	无线电接收装置
imparticipable	不可分享的
ossuary	藏尸骨的罐
dcvo	高级维多利亚女勋爵士
connivent	靠合的
murderer	凶手
haematocyte	血球
odditional	补充的
selaginella	卷柏
multiparty	包括多党
sapful	多树液的
educable	可培养的
extroverted	喜社交
gaper	长蛤
tableau	戏剧性局面
mobster	犯罪集团成员
humoral	温性
homogenization	均质化
scrota	scrotum的复数
constrictor	大蟒
triplicate	三乘的
snack	吃快餐
quick	敏捷
transmontane	来自群山彼边的
enquiring	探听
barabara	用草皮所盖之半地下房屋
brush	拂
plotinism	柏罗丁主义
meany	小气鬼
brachiopoda	腕足门
pillar	柱子
unearned	自然得到
wintery	如冬
obsess	迷住
holding	所有物
ropery	制绳厂
undissolute	生活规矩
squirearchy	地主政治
clownery	粗鲁
vilely	卑劣地
lilliputian	小人国居民
fisk	罗马皇帝王室财库
vengeful	报复
alveolar	小泡
mccoy	本人
fragmental	断片
hexagonal	六角形的
chronoshift	空间转移
rich	富
contractual	契约的
puffery	鼓吹
writer	复写器
demonism	对鬼怪之崇拜
sodomist	兽奸者
scepter	授与王权
bloodguilty	杀人的
asid	of
call	命令
rear	树立
centre	中心
noncarcinogenic	非致癌的
frivolously	轻浮
conodont	牙形石
chomp	格格地咬牙
calm	平息
plaza	广场
myoelectric	肌电
musth	狂暴状态的
literature	文献
erection	建筑物
rectorial	教区长
archaeological	考古学上的
reactionist	反动
duvet	绒毛等制成的棉被
ratherish	约略
iso	Organization
yesman	唯唯诺诺者
redefector	再度背叛
arrenotokous	雄性生殖
said	上述的
drupaceous	核果性
polyacrylamide	聚丙烯酰胺
annihilability	可消灭
crass	非常
sware	swear的过去式
childhood	孩童时期
federate	联邦制度下
prelude	先驱
orthograph	正射投影图
rhizomatic	根茎的
pursual	追踪
bird	人
riprap	用乱石加固
judicator	行事如法官的人
leatherworking	皮革加工
loggy	=logy
gambusia	柳条鱼
centralization	中央集权化
phony	假冒
swagged	挂着帷幕
coi	Information
supersensitive	过敏
waywardness	任性
carnally	肉体地
fold	彻底失败
circannian	以一年为一周期的
gey	相当的
phyletic	种类
multifunctional	多功能的
nondiapausing	非休止中
backhouse	厕所
distressful	使苦恼的
dismayful	令人惊愕的
spectrophotometer	分光光度计
rattlepated	头脑空虚的
rule	标准
journo	记者
indention	定货
nagged	经常遭责怪
eyesome	媚人的
novennial	每九年
cording	的面
shindig	舞会
snafu	天翻地覆、无法可施的状态
sermon	说教
plop	坠落
detoxicate	使解毒
avulsion	撕裂
retiary	网状的
comedic	喜剧的
calliope	蒸气风琴
freeman	自由民
nitrosyl	亚硝酰基的
grain	细粒
trainable	可教育的
disorder	杂乱
saut	跳
makable	可制造的
hurl	丢下
hebephrenia	青春期痴呆
man	男人
fava	蚕豆
barky	似树皮
exhibit	陈列
fibrinosis	纤维素过多症
spoony	痴情的人
isochromatic	整色性的
putsch	暴动
sinological	中国学的
ascap	美国作曲家
philanthropize	仁慈地对待
haplite	=aplite
mercy	宽恕
bother	打扰
nitrous	氮
fiberglas	玻璃丝
botchy	不精致
gorcock	雄赤松鸡
slouchy	没精打采
joint	关节
rectificative	校正
heirless	无继承人
apart	分开的
foresleeve	可取下的前袖
downwind	顺风的
oakley	=Annie
testudo	掩蔽物
gingival	齿龈
aggravation	恼怒
fluorometric	使用荧光计的
beslaver	谄媚
carnal	肉体
lithomarge	密高岭土
difference	差异
prebendary	受俸者
handlers	陶器工人
sadiron	熨斗
sclerous	硬化
leg	胫
oaf	畸形儿
gust	阵风
cloudworld	仙境
schooling	学校教育
biblist	圣经学者
prematurely	过早地
be	是
balanoid	橡实形的
frighten	使惊吓
swish	好看
circumfuse	从四面浇灌
stopgap	权宜之计
gwendolyn	格温多林
corrosible	会腐蚀的
ecliptical	食的
phoneticism	以音标表示
brutalization	兽性
aerodynamicist	空气动力学者
planning	计划编制
sociopathic	反社会的
unsolder	拆焊
lento	徐缓
sultrily	酷热
bymotive	隐蔽的动机
perceval	=Percival
yeast	发酵粉
suspenseful	令人紧张的
inconvincible	难以说服人的
adream	梦想的
gangman	劳动伙伴
tolstoyan	托尔斯泰
amir	埃米尔
shapeless	不成形的
lastacross	最后穿过马路游戏(一种危险的儿童游戏
herman	赫尔曼
latter	较后
novosibirsk	新西伯利亚
hebdomad	一周
nauseating	厌恶
insupportably	忍耐不住地
ideational	观念的
sleave	乱丝
flyable	可以飞行
renavigate	再导航
manacle	束缚
reprehensibly	应受责难
neanderthaloid	类似尼安德特人
cataclasis	岩石碎裂
erotophobic	性爱恐怖
ustc	美国关税委员会
foist	把……强加
strabismic	斜视的
servitude	地役权
homicidal	行凶
tracheate	有气管
uncatchable	不可捕获的
recent	近来的
crackable	会裂开的
flooey	糟
lienteric	不消化性腹泻的
hant	鬼
amaretto	意大利苦杏酒
builder	建筑者
gerontic	年迈的
washing	冲走的东西
badge	证章
highness	高
goniometrical	测角计
radiogenic	由放射能产生的
ccsa	control
brooder	默想的人
verminicide	杀虫剂
immediate	紧接
onward	向前
intraperitoneal	腹膜内的
petropower	石油强国
demonstrator	示威者
rude	猛烈
rsc	Company
downfold	低洼
darhan	达尔汗
figuration	图案装饰法
hardcore	赤裸裸描写性行为的
embow	使成弓形
hypochlorite	次氯酸盐
metamorphic	变质
anatomist	剖析者
ultraright	极右的
borrowing	借款
level	使……水平
subnuclear	亚核的
ectomere	外裂球
future	远景
caulomic	茎的结构
intelligibly	易理解地
cardioid	具有心脏形状的
letup	中止
fatimite	法蒂玛人
pod	生荚
base	本部
ammoniacal	氨性的
leadman	工长
screeve	当马路画家
uda	Universal
upthrow	岩层的隆起
decathlete	十项全能选手
disruptive	分裂性
water	海水
abortive	早产
metallograph	显微照片
slezsko	=Silesia
dehumidify	使干燥
capitalintensive	需投入大量资本以增加生产力
ilo	Organization
burin	冰凿
increasable	可加大的
frostfish	北美产的一种小雪鱼
ncte	National
bessie	贝茜
syphiloid	象梅毒
missourian	密苏里州人
strictness	严格
propitiatory	安抚的
basel	巴塞尔
knee	膝
salient	易见
spotty	多斑点的
weston	standard
illuminant	发光的
incohesive	无凝聚力的
emasculate	阉割了的
lyophiled	冻干
jeffersonian	派的
appetizer	开胃物
chow	中国狗中国人
unimpressible	难受影响
witen	wit的复数现在式
influent	流入
superterrestrial	世外的
sogat	书画刻印及有关行业协会
lessened	减弱的
woodnote	林中鸟鸣叫声
berserker	象狂暴斗士般行动的人
ceramics	制陶术
translucent	半透明
vm	Machine
illusively	错觉地
degeneracy	退化
dualpurpose	肉兼用的
movability	可动性
umbilical	脐带
pied	斑驳
accurst	被咒
sculpture	雕塑
kismet	天命
super	过分的
redeployment	遣调
foreshock	前震
hereinafter	以下
newmown	新割的
subtractive	有负号
fulgurous	闪电似
depsid	缩酚酸
dupable	易于受骗
charivari	瞎闹音乐
frigidity	冷淡
external	外部
unversed	不熟练的
untruthful	不真实
way	路线
dishevel	使蓬乱
miscellany	杂记
haeremai	表示欢迎之辞
gain	开腰槽于
excogitate	设计
satiny	光滑
mesalliance	门不当户不对的婚姻
undetermined	未确定的
democratic	民主主义的
parse	分列
squiteague	=squeteague
laa	antiaircraft
backstroke	用反手击
repeatedly	重复地
irradiative	会发光的
ecuadorian	厄瓜多尔
testatrix	立遗嘱的女人
cleruchial	古希腊将征服土地配给公民之制度
flog	鞭打
regelation	重新结冰
aerographer	高空气象观察员
grette	纸烟
overeducate	使接受过多教育
permissively	许可
radiate	传播
hyperaesthesia	感觉过敏
cockyolly	小鸟儿
fulsome	令人生厌
tacky	有些粘的
channel	频道
trinitarian	信仰三位一体教理的人
connotation	储蓄的东西
print	打印
estimator	评估特有者
sonority	响亮程度
uncdf	Capital
harsh	刺目
loosely	宽松地
ephemeral	朝生暮死的
deanery	院长办公室
tracheal	气管
jereed	钝头木标枪
diamondback	有菱形斑纹
dismissive	表示轻视的
franciscan	Francis的
angleworm	蚯蚓
sometime	在某一时候
elocutionist	演说家
lixivial	灰汁盐的
dishouse	自家里赶出
martial	尚武
spoilbank	废石堆
windflaw	一阵狂风
discrepantly	不一致地
rawness	无经验
ratch	棘齿
wisent	欧洲野牛
dead	废弃了
wiliness	狡猾
osteoplasty	骨整形术
sardanapalian	萨丹纳帕路斯
tipsy	喝醉的
danae	达娜厄
insessorial	习惯于栖止
lorn	荒凉的
linebred	品系繁育的
pennsylvania	宾夕法尼亚州
sutteeism	寡妇殉夫自焚的风俗
blague	吹牛
vergilian	弗吉尔之诗
marrowless	无力
tink	丁零声
plank	睡在板上
piddle	撒尿
epilation	拔毛
verbenaceous	马鞭草科的
swami	专家
wftu	Trade
nonnutritively	没有营养
semiurban	半城市
upas	有毒害的影响
flatways	平面朝上地
equate	使相等
psychoenergetic	利用心力
subsidize	津贴
tangent	接触的
carafe	玻璃水瓶
autumn	渐衰期
altarage	坛上的祭品
sexennial	六周年纪念
crewel	双线
valued	经估价的
here	在尘世间
lour	皱眉头
stylish	漂亮
pshaw	发啐声
drifting	飘动的
branch	分科
lymphous	淋巴
pedology	土壤学
hypergolic	自燃燃料
rareripe	早熟
ambidexter	怀二心
inkling	略微的提示
synechia	黏连
jactation	夸大
girdle	带
unsackable	不可解雇
rancour	深仇
muddle	困惑
serosity	浆液
railhead	军需站
tectonism	构造作用
entomb	成为……的坟墓
lae	莱城
matriarch	女家长
cannabis	大麻
forester	森林人
langostino	=langoustine
trauma	损伤
moronic	鲁钝
voluble	流利
harquebus	火绳枪
chemosensory	化学感应
hermes	重放射性同位素电磁分离器
armoric	阿莫里凯人
thereinbefore	在上文
harsh	荒芜
nervily	神经过敏
bachelorism	独身者之怪癖
jamming	人为干扰
redraw	刷新屏幕
prevail	成功
unpropitious	不吉利的
unclos	United
nicish	细心的
parageusia	味觉倒错
prepubescence	=prepuberty
quarrion	澳洲鸡尾鹦鹉
calkin	蹄铁的折曲端
fraze	磨损或减小直径
prentice	徒弟的
consistent	坚固的
geometrically	用几何学
amu	unit
isochroous	各部分同色
square	正方形的
nlaa	Association
silvicolous	森林中生长
noseless	无鼻子
scrawny	瘦脊
spiteful	恶意的
pyrogenic	高热所产生的
skyey	天空
encyclopedism	百科全书的知识
flitch	咸肉细片
offscouring	垃圾
plessor	叩诊槌
banjoist	五弦琴演奏师
emotively	使感动地
founderous	易使人摔倒的
moxie	胆量
supporter	拥护者
yuzovka	尤佐夫卡(苏联顿涅茨煤田区城市顿涅茨克
mog	撤走
enlighten	授予……知识
crosshatch	画出交叉阴影线
dialogic	问答体的
cavelike	似坑洞
unadvantageous	无益的
ventriloquism	口技
whitley	Council
tympan	衬垫
unimpassioned	平静的
scriptorium	写字间
quartan	每四天的
acouophonia	音响诊断
hippo	河马
gorget	妇女用护肩布
rehouse	供以新住宅
piquant	泼辣
violescent	带紫罗兰色的
iatrochemical	化学疗法
wrecking	失事
aid	援助
recolonization	开拓殖民地
barmaid	酒吧间女
carthaginian	迦太基人
psychopathia	变态人格
jaundiced	患黄疸病
canonicity	正规
employer	老板
proletary	最下层阶级的公民
triennium	三年
inconveniently	不方便
customable	可课税
coquette	卖弄风情之女子
wpm	minute
fasten	拴紧
laird	地主
chechako	=cheechako
odour	气味
inimitably	无法仿效
skillion	棚屋
pubic	阴毛
incestuous	血亲相奸
abreast	并肩地
boskage	灌木丛
mnemonics	记忆术
sequal	结构化查询语言
babblingly	喋喋不休
tutee	受指导者
sputter	气急败坏地说
misbound	装订错误的
told	tell的过去式和过去分词
pentlandite	镍黄铁矿
vehement	猛烈
pectoral	胸
lapidescent	石碑似的
thriftily	繁茂
inherent	固有的
anonychia	无爪症
ulcerously	溃疡性地
kilolitre	千升
feathered	有羽毛的
ejaculator	射出肌
decentralization	排除集中
coastal	海岸
rechabite	绝对禁酒者
quirky	诡诈的
ip	网际协议
visard	面颊
goodly	优美
ornithologic	鸟类学的
harassed	厌烦
tripping	轻快的舞
override	制服
leader	导杆
backbench	后座议员的
parlous	狡猾的
clearsighted	眼力好的
superheterodyne	/
huelga	罢工
weediness	瘦弱
discission	挑开术
magnetotactic	具趋磁性
ramification	衍生物
skill	技能
silvana	西尔瓦娜
sinful	有罪
biscuit	饼干
poxvirus	痘病毒
alfresco	在露天
jammy	粘上果酱的
flexibly	易曲地
muroran	室兰
exterior	外型
legendry	传奇文学
chaldaean	=Chaldean
choriamb	长短短长格
countershock	对抗休克
moonwatcher	月球观察者
prestigious	声望很高的
fast	紧紧
spear	枪
liveware	人件
bepaint	在……上涂漆
symmetrize	使对称
hall	礼堂
pentarchy	五头统治
wally	第一流
browse	浏览
amidogroup	胺基
heliskiing	由直升机送上山顶的高山滑雪
corny	乡下味
alguacil	=alguazil
paint	绘
carry	传送
middleware	中间件
xanthous	黄色人种
stolid	神经麻木
umpy	=umpire
lapm	Protocol
unbrace	解开……索带
serpiginous	匐行的
mansard	有双重斜坡屋顶的房屋
bosom	任何温暖、舒适而熟悉的地方
salientian	无尾目的
hindoo	印度教的
bern	伯尔尼
balliness	=ballsiness
faustina	福斯蒂娜
multiscreen	多银幕放映
dispassionately	冷静
chukchi	楚克其族
gladly	高兴
prejudicious	不利的
brevet	予以名誉晋升
demimondaine	花街柳巷
biome	生物群系
defiant	挑衅的
scum	浮渣
crownling	皇储
scrimpy	缩减
viking	海盗
reasonless	无推理能力
literatus	文学界
gape	打呵欠
teleprinter	电传打字机
ruddered	有方向舵
ard	disease
mukhtar	镇长
ordnance	军火
regionalism	地方主义
corkily	像软木
seamanlike	熟练水手似
ebullience	热情洋溢
abo	当地的
videography	录像片摄制
treponematosis	密螺旋体病
auriform	耳状的
hpgc	gyrocompass
spuggy	家麻雀
multidisciplinary	有关各种学问的
polymelia	多肢畸形
semiscientific	半科学
accepted	一般承认
harsh	苛刻
driftwood	流木
expound	解释
inveracious	虚假
septifragal	室轴开裂的
huttonite	硅钍石
quip	双关语
ginner	轧棉工人
shock	震惊
samsung	韩国三星公司
extorsively	敲诈
navaid	助航系统
replication	复制
exclamation	惊呼
fulminating	暴发性
sweetish	有点甜的
bratty	讨厌
timbered	森林
schizophreniform	精神分裂症样的
demulsification	反乳化作用
scleroiritis	巩膜虹膜炎
dreamer	做梦的人
gastroscope	胃窥镜
demimonde	风月场
hulking	笨重的
curator	馆长
participancy	分享
induce	促使
oceanography	海洋学
blueness	青
spinoff	续集
form	形状
substitution	取代作用
nccw	of
unveracious	不诚实的
assault	袭击
tacirton	躁声闸流管
sungari	Songhua
stellular	小星形
sutural	针脚
conveyable	可移动
climatically	气候上
nullification	使变的无用
conversus	庶务修士
parking	停车
peeper	眼睛
bifacial	有两面的
subtense	弦
noumenally	实在
scotophase	人工夜间
bulgy	凸出的
jocko	猴
anaphylactic	导致过敏的
exemplarily	可为鉴戒
moody	喜怒无常
essentiality	真髓
eradiculose	没有小根的
lacerative	割碎的
pulpit	讲道坛
summersault	=somersault
enigma	不可思议的东西
hungnam	兴南
divisionism	点彩画法
pool	集中
tasmanian	塔斯马尼亚
tcp	包括IP
brigandage	强盗
reg	汽车牌照
chaperon	伴护
talking	表情丰富的
muciferous	分泌黏液
unwinnable	不能赢得的
shunless	回避不了的
consumable	可消费
berserker	狂暴战士
sententious	富于格言的
undershirt	汗衫
accomplishable	可完成的
lighter	点火者
clouding	不清爽
sagaciousness	睿智
indication	指出
introspection	自省
halocline	跃层
nerts	胡说
import	输入
levo	左旋
hermatypic	造礁
sinew	精力
discriminative	ly//
euthermic	发热的
faltering	犹豫
slimming	使苗条
coquilla	nut
liquefy	液化
snoopy	爱窥探
nonreturnable	不能退还
curviform	弯曲
solidification	凝固
phyllome	叶性器官叶丛
marchpane	碎杏仁制成的饼
truckdriver	运货汽车司机
puffbird	喷鴷科鸟
chirp	喳喳声
necrogenic	腐尸的
honan	见Henan
deuce	两点
gadid	鳕科
whippoorwill	北美夜鹰
tumular	古坟
pontifical	大祭司
peridium	包被
vole	大满贯
negativity	消极性
twinight	连续两场比赛
doglike	象狗的
psychrometer	干湿计
uninterrupted	不间断的
trusting	信任
ultramarine	海外的
unsystematic	无系统的
goofus	谷弗斯管
eventual	结局
amimeche	Mech
vsat	Very
idiopathy	原发症
spile	塞
schottische	慢步的
cymbate	船形
freeform	任意的
alphabetically	按字母顺序地
babe	缺乏经验的人
hostess	女服务员
seismoscopic	需求示波仪
suppleness	易弯曲
chummage	同居
sillily	愚蠢
manzello	曼泽洛管
cenobian	寺院
marquise	女侯爵
concertmaster	首席小提琴手
aufwuch	附着生物
unexamined	未经权衡的
autocaption	自动插入题注
emancipative	有助于解放
eolith	原石器
desquamative	脱皮
farcy	家畜慢性致命性放线菌病
crossly	故意为难
pyemic	毒血症
vibraharp	=vibraphone
indeliberate	不是故意
liquefacient	液化的
leporine	野兔
hearty	衷心
incursionary	侵犯的
backroom	秘密完成的
lumbosacral	腰骶
colorado	美国科罗拉多州
glandular	腺
shrubby	灌木一般的
delphic	神谕
inky	漆黑的
trunnion	耳轴
somnial	梦的
aborted	流产的
chloral	三氯乙二醇
subocular	眼下
servo	伺服系统
comecon	Mutual
namable	可指名的
chipper	活泼
nocuousness	有害
heavy	巨大的
indirectly	拐弯抹角
randomly	随便
thuoughput	吞吐量
dissembler	伪君子
verbile	言语意象型
electrical	有关电
pour	灌注
bribe	向……行贿
drencher	大雨
visit	拜访
checkerboard	西洋跳棋盘
mufti	法学家
psychoneurotic	精神神经症
adverbial	状语的
dapple	斑纹
related	讲述
vfat	Allocation
largess	赠品
homosexual	同性恋
kbe	Order
pedestal	基础
tunisian	突尼斯
connivancy	纵容
rockless	无岩石
tylopod	有胼足
flexuous	之字形的
muddily	多泥地
virus	病毒
hedy	赫蒂
chic	别致的
unmentionable	不宜说出口
mirage	海市蜃楼
barbarianize	使变成野蛮人
saltish	略带咸味
jansenism	Jansen
terminal	每学期的
tassel	缨
incontinently	不能自制
feculent	臭的
wearisome	使疲倦
orgy	纵酒狂欢
recusancy	不服从
rcvs	Veterinary
hurtless	无害的
unyoke	解除束缚
virginity	处女性
neuropsychiatry	神经精神医学
guangdong	广东
recision	废弃
urological	泌尿道的
rarer	更珍贵
stiffly	呆板地
requiem	挽歌
screwy	螺旋形的
devouringly	贪食
zonked	吸毒而恍惚的
tad	少量
actinodermatitis	放射皮炎
carping	吹毛求疵的
martial	威武的
skikda	斯基克达
chefdoeuvre	名著
whipgraft	用舌接法接
lamiaceous	属于薄荷科
mastfed	饲养的
pickled	盐渍的
indumentum	毛状外被
kirghizia	吉尔吉斯
casper	为一可爱的小精灵
oecd	Organization
stomatic	气孔
dynel	合成纤维的一种
superexcellent	绝佳的
tribology	摩擦学
extent	临时所有权令
superior	出众
instillation	灌输
slack	马虎
herring	青鱼
wire	拍电报
wrb	War
suzerain	宗主国
hurst	海中砂丘
wrinkly	有皱纹的
insect	虫子一样的
tripalmitin	软脂酸甘油酯
salutary	有益的
fisted	握成拳头的
intravital	作用于活体的
microsegment	小音段
volitive	意志的
matlo	海员
mock	嘲笑
bonesetter	接骨师
exposed	无掩蔽的
mastoid	乳头状
tatary	=Tartary
appear	公开露面
vulcanologist	火山学家
mas	Standardization
depressor	抑制剂
profluent	涌流的
camerlingo	教宗侍从
smarmy	令人厌烦
videotex	可视图文
macrostylous	具长花柱的
runaround	遁词
hostility	恶意
dispraise	指责
propylaeum	入口
cosmonette	女宇航员
mallet	槌棒
tizzy	极度激动狂乱的心情
aggravating	恼人
neuralgic	神经痛
assheadedness	笨蛋
arbo	虫媒
limnetic	淡水的
haemophilic	嗜血的
programmable	可设计的
dic	=dictionary
wogland	外国
bequeath	遗赠
inductile	不能延伸的
georgic	农业的
remelting	再熔化
immusical	不和调
flicker	闪烁
enteron	肠
short	不足
adgb	Great
lipographic	漏写的
conceitedly	自满地
cad	下流人
bilabial	有两唇的
invigorator	强壮剂
briery	多荆棘的
encapsule	装入胶囊
pad	便笺簿
tab	认出
pitiable	卑劣
hubbub	叫嚷声
been	到过
scall	头皮屑
snooker	桌球
pinfall	按倒
wafery	薄
marginal	边际
carrick	=carrack
piperidine	氮杂环己烷
fantabulous	极妙的
voguish	一度流行的
greasy	油脂
sarcenet	有光里子布
nephridium	肾
hydrovane	着水板
consign	委托
shakiness	震动
rhizomatic	像根茎
drover	家畜商人
appendicitis	阑尾炎
ladrone	贼
prelatism	主教统辖制度
soapsuds	肥皂水上的泡沫
collaboration	通敌
divvy	部分
set	装置
elfin	小妖精的
inoxidizable	不能氧化的
stirring	激动人心
palp	触须
meniscocytosis	镰状红细胞性贫血
spoony	笨的
chemulpo	济物浦(南朝鲜港市仁川
circumgalactic	围绕星系
humberside	亨伯赛德郡
professorate	教授之职位或聘期
fenceless	没有围墙的
apprehension	忧惧
homeliness	寻常
hyperbolic	双曲线的
rasbora	波鱼属
dili	帝力
tensile	拉力的
secondly	第二
salangane	海燕
funeral	葬礼
crackly	容易破裂
reupholster	为重装椅面
overbrim	满出
iranian	伊朗的
aniline	苯胺
alluring	迷人
intimity	亲近
nomadize	流浪
alcoholysis	醇解
fifa	Internationale
polynosic	高湿模量粘胶纤维的
inqilab	革命
hircine	山羊
regularise	=regularize
tricarboxylic	羧基的
enclosure	四周有篱笆或围墙的场
rule	管辖
methotrexate	甲氨蝶呤
plantigrade	脚掌着地行走
asymmetric	不对称
obbligato	伴奏
vaccinization	连续接种法
centuplicate	百倍的
graunchy	考验的
fully	足足
godward	向神的
norwalk	agent诺沃克因子
baghdad	巴格达
proximate	最近的
cloistered	住在修道院
fixing	修理
great	大
crustacean	甲壳类
responder	回应者
homothallic	同宗配合
yawny	打呵欠
romanist	罗马法学者
vj	Jockey
favorable	讨人喜欢
hodiernal	现在
unshirkable	无法逃避
indicate	象征
rational	推理的
hohokam	霍霍坎文化的
pluviometer	雨量计
coruscation	焕发
buttstock	枪托
confederacy	联盟
eeler	捕鳗者
bicuspid	有两个尖头
oligophrenia	deficiency
mend	修改
gettable	可以获
vacuolation	空泡组织
unfirm	不稳固的
flagging	下垂
hypoploid	染色体数目较少
whitsuntide	圣神降临周
overinterpretation	不够合理的阐释
push	推动
crumpled	弄皱
corolliform	花冠状
staffelite	绿磷灰石
anecdotalist	=anecdotist
taxonomy	分类学
disqualification	失格
viscerogenic	发自体内
unmerciful	不仁慈
connacht	康诺特省
fire	热情
anisaldehyde	茴香醛
expiate	补偿
time	分期
skyway	航线
eto	European
epsom	赛马
copremic	毒毒血症的
unfluctuating	不起伏的
coalpit	烧焦炭的地方
miliaria	痱子
lettering	字体
flighty	轻狂
soreness	悲伤
strut	高视阔步
demiseason	介于两季之间
fateful	宿命
xeroderma	干皮病
oblatory	供奉物的
sequestered	偏僻的
slumber	睡眠
unbusinesslike	无效能
embodier	收录者
scoff	嘲弄的话
gently	轻轻地
presentive	直示的
dimensionality	维度
wickedly	坏透地
eclectic	折衷派的人
misplacement	误放
wucai	五彩瓷
clodhopping	不礼节的
copulation	性交
nyp	not
iata	Association
conducively	有助地
fibrinoid	纤维蛋白样的
cancrivorous	食蟹的
soubriquet	绰号
seventeen	十七个
photocopier	影印机
amusement	娱乐活动
frankpledge	十户
fortune	运气
prismoid	平截头棱椎体
embezzlement	侵占
devastatingly	讥讽地
jis	Industrial
nervine	神经的
bolshevik	布尔什维克
shoplifting	入店行窃
earstone	=otolith
electrician	电学家
regard	注意
calendric	历法
fibrin	纤维
tabbinet	=tabinet
denaturalise	=denaturalize
jet	黑玉色的
artsy	=arty
tenuous	纤细的
bouquetiere	加蔬菜作配菜的
democratic	民主
waitress	女服务生
redistrict	更改选举区
schistous	片岩质
ducky	极好的
upborne	被举起的
optimism	乐观
inconsistent	矛盾的
patulin	开放青霉素
orsk	奥尔斯克
unpaying	不付款的
pentaborane	戊硼烷
gaggle	一群
unexploded	未爆炸的
acerbic	酸
discontent	不满
androcentrism	大男子主义
amour	奸情
shadowy	多荫的
fricandeau	炖小牛肉
gaucho	高卓人
dekametric	=decametric
chimneynook	壁炉边的暖和处所
lauryl	十二醇
level	水准
damning	咒骂的
popinjay	讲究穿着的人
pussyfoot	轻轻地走
pri	Rate
lectin	外源凝集素
molotov	莫洛托夫(苏联乌拉尔城市彼尔姆
lionhearted	勇猛的
curviform	弯曲的
aliphatic	脂肪质
shinplaster	乱发纸币
glede	鸢
endangered	将要绝种的
soaked	浸湿
ordinal	依次的
entail	遗传给
clarity	透明
fitter	适当的
impermeability	不渗透性
mournful	悲哀的
tell	表明
tame	乏味
mithraic	崇拜密特拉神的
transracial	异族间
inauthentic	不可靠
felsitic	霏细岩的
troublous	纷乱的
afric	非洲
tetrandrous	具四雄蕊的
pituitary	垂体
whist	扑克牌游戏的一种
babbitt	市侩
recuperatory	=recuperative
phenetidin	苯乙定
uninvited	未被邀请的
excitory	易刺激的
lysostaphin	溶葡球菌酶
cern	European
tersely	简洁地
hat	帽子
reexportation	再出口
somniferous	催眠
diphyodont	双套牙
womanize	使柔弱
disengaged	空闲
exhort	劝诫
cranky	怪僻
untidy	不整齐的
fixation	定色
bintree	二叉查找树
pentalpha	=pentagram
transplantation	迁移
fijian	斐济
biodynamical	生物动力的
inductivist	归纳法优越论者
palingenesist	相信灵魂转生说的人
colic	疝痛
laminarin	海带多糖
pinhead	针头
unemployed	失业
funereal	悲哀的
perusal	熟读
bacteriostatic	/
catchy	诡诈
pitch	程度
ably	巧妙
vileness	卑劣
perennial	多年生的
overcrowd	使过度拥挤
chipping	破片
oaec	亚洲经济合作组织
duke	拳头
surroundings	环境
dav	美国残废退伍军人组织
reduction	降低
entrain	拖
unharming	不伤害人的
anathematic	憎恶的
stingo	烈性的啤酒
caliban	丑恶而残忍的人
hylophagous	食木
lsat	Admissions
umpirage	仲裁
wet	湿
rowdydowdy	喧嚷
encrimson	使成鲜红色
noogenic	心理圈
alien	背道而驰
ruwenzori	鲁文佐里山
tonsillitic	扁桃腺炎的
talmi	gold镀金黄铜
cyclodiene	环戊二烯类杀虫剂
uncivilized	无文化
moore	摩尔
ablepsia	失明
bookie	赛马的赌注者
marlene	马琳
sporozoite	孢子体
cssr	Republic
nondirective	不直接提问的
saleratus	小苏打
patrilocal	居住在男方
edgebone	牛的臀骨
unspotted	清白的
toxication	中毒
mismatch	失谐
cretaceous	白垩纪
intersterile	互交不孕的
triploid	三倍性的
upswell	凸起
germaine	杰曼
trigon	三宫之一组
take	接受
cracky	疯狂的
carrycot	手提式婴儿床
codswallop	胡言乱语
winnow	吹开糠皮
arousal	觉醒
supportable	可支持的
condition	环境
irrefutable	不能反驳的
antiodontalgic	止牙痛的
undissembled	公开的
euphonise	=euphonize
hough	割断踝腱使成残废
injunct	吩咐
lamebrain	笨蛋
beastings	初乳
classmate	同班同学
ungular	爪的
indeliberately	无心
overcrowd	容纳过多的人
untalented	缺乏才能的
incapable	无能力的
noetics	智能论
indeliberately	不是故意
stirring	活跃
power	力量
stainer	染色工人
feetfirst	脚先着地
explicit	外在的
quarreler	喜欢埋怨的人
crannied	有裂痕
piccolo	小型的
splenology	脾脏学
rampant	猖獗的
unforgiving	不能原谅的
tethyan	蒂锡斯海的
mopey	没精打采的
participate	分享
capsulary	蒴的
perambulatory	巡视的
comusmacv	MilitaryAssistance
lipless	无唇
groundprox	贴地飞行导航仪
damper	起抑制作用的因素
orometer	山岳高度计
newswire	新闻专线
brunet	浅黑肤色的男人
guide	指导
mould	铸造
respectant	面对面的
constatation	论断
smart	巧妙的
silverly	银一般
sextuple	六倍的
holoplankton	终生浮游生物
committeeman	委员
prednisone	强的松
bathroom	盥洗室
function	仪式
tightfisted	吝啬的
fancy	认为
langouste	龙虾
pet	发脾气
coot	傻瓜
revision	修改
lather	激动
depart	离开
history	来历
saffron	藏红花色
map	其中包含有被连接的程序的某些信息
typology	血型学
smack	风味
cherubic	天使
corps	学生联合会
bosom	内部
drecky	极糟糕
devolution	相传
coxcombical	花花公子的
bravely	勇敢地
impersonally	与个人无关
excuse	申辩
laxity	松驰
powder	火药
atonalism	不成调
unpardoned	未被宽恕
pretorian	监理军事的执政官
painstaker	刻苦的人
mutagen	诱导有机体突变的物质
codlin	未成熟的苹果
hemiparetic	轻偏瘫
volitant	活动
roughen	变粗糙
monamide	一酰胺
farinose	产粉的
dracone	袋
scuff	拖着脚走
contextual	文脉上
fist	拳头
spirogyra	水棉属的绿藻类
magnanimous	宽宏大量的
syncope	昏厥
irenic	和平的
stronghearted	勇敢的
terrain	地形
wormseed	驱虫籽
wallachia	=Walachia
trecento	意大利文艺中的十四世纪
converse	相反的
hoofed	蹄形状的
rhinogenic	由鼻腔引起的
disorientate	使失去方向感
schnorrer	笨蛋
nitramine	=tetryl
fabricius	赘言作家
scaup	斑背潜鸭
illation	演绎
sustentacular	支柱的
endoerythrocytic	红细胞内
warmly	热心
eruct	喷出
cryology	冷冻学
thromboxane	凝血噁烷
sartorial	缝匠肌的
supportless	无支持者
usurpatory	夺取的
colorful	有趣
headstrong	不听命令
distraite	心不在焉的
atechnic	无一技之长者
bellflower	风铃草
quantitive	=quantitative
voluminous	著书多
truncheon	棍子
ammocolous	栖砂
shiism	什叶派教义
vellum	犊皮纸
legend	伟人传
meridian	子午线的
nudicaul	茎上无叶
vigintennial	每20年一次
diametrically	作为直径地
lean	倾斜度
httpd	全球网服务器软件
guiltily	有罪
detrusive	推出的
trippet	敲击装置
hinnie	=hinny
lamblike	小羊似的
secund	只有一边的
comminution	粉碎
favonian	温和的
biestings	生犊后母牛的初乳
bretagne	=Brittany
vinify	酿造
infertility	不毛
flamenco	弗拉门科民歌
manoeuvre	操纵
preparative	准备的
ventriloquous	用腹语
modem	调制解调器
unclench	撬开
flunk	不及格
definable	可定义的
telltale	警告
subsume	包含
reengineer	再设计
faggoting	抽纱法
related	有关系
dhole	凶猛的野犬
schizothymia	分裂样人格
neath	在……之下
centrilobular	小叶中心的
prothallus	原叶体
frogmouth	蛙嘴夜鹰
circumfluent	环流
isocratic	权力平等主义
reembroider	在……上再刺绣
fatigue	使疲劳
wimple	用头巾遮
hendecahedron	十一面体
exacerbate	激怒
habile	熟练
heterocyclic	不同环式
pneumatic	装满空气的
verus	真
undistorted	不偏激的
mystagogic	解释神秘
centrobaric	有重心的
lordly	贵族
uplight	向上的照明器
dray	以运货马车运
labour	分娩
homonymous	同名
incestuous	血亲相奸的
marathonian	马拉松的
cyc	循环
rubberwear	橡胶衣物
phonemicize	把……分解为音位
ganefo	of
unslaked	未安抚
keenly	敏锐地
acquisition	获得物
libertarism	自由意志主义
bourgeoisie	资产阶级
reserve	保存
pneumatic	风力
biquarterly	三个月两次的
fledgeling	初出茅庐者
infundibuliform	漏斗状
whistle	汽笛
kaaba	建于麦加的伊斯兰教寺院内的圣堂
downward	向下的
reave	剥夺
visiting	访问
trope	比喻
worry	困扰
colourpoint	色点猫
glycerol	丙三醇
avoid	消除
grinder	研磨者
square	结清的
pliocene	上新世
billion	十亿
barfly	酒鬼
chill	使冷
unexpanded	未被扩大
itineration	巡回传教
dredging	挖泥
prealtar	圣坛前
poky	狭小的
refill	再充填
thecodont	有槽齿
palatodental	腭齿的
sustainable	可以忍受的
tussive	咳嗽的
nisi	非绝对
irreducible	不能复归
undefendable	不可辩解
are	公亩
nunchakus	双节棍
apulian	阿普利亚区的
hypercomplex	超复数
perversion	曲解
dicky	围嘴
ladderlike	梯状
domicile	住所
anteprandial	饭前的
descriptive	叙述的
shackle	束缚
confabulator	闲谈者
humoresque	滑稽调
fabulize	讲述寓言故事
billing	演员次序
prelithic	石器使用前
preventable	可预防的
hortative	忠告
fillet	把切成片
underworld	黑社会
riot	蔓延
welter	重骑师
spinulescent	带微刺的
washy	浅的
artal	的复数
parcel	打包
hoarding	积蓄
teentsy	很小的
ariel	羚羊类
orientalist	东方通
determinant	决定性
suctorial	有吸盘
decretal	教皇的教书
motherwort	益母草
imaginative	想象
mouser	鬼鬼祟祟搜寻的人
resume	恢复
crystallization	结晶化
trihybrid	三对性杂种
scratcher	抓扒工具
living	居住面积
jarless	稳定的
url	Locator
airbrasive	磨牙的气压机械
vandalic	破坏艺术
afrikanerdom	南非白人人口
carp	鲤鱼
northing	北航
debility	衰弱
gerrymander	不公正操纵
devoted	投入
psat	学业能力倾向初步测验
accomplish	实现
iterate	重述
cosmosphere	宇宙仪
leishmania	利什曼原虫
apostrophize	顿呼
acerb	刻薄的
hygienically	卫生
agentry	代理人业务
moleskin	斜纹厚绒布
pulmonic	肺的
blend	混和
crappy	蹩脚的
recognizee	被保人
anisocercal	不等尾叶
myelin	髓磷脂
improvvisatrice	女即席演讲者
xanthochroous	呈淡黄色
vis	精力
claybank	棕黄色
misaligned	方向偏离的
wirehaired	硬毛的
square	坚定
batangas	八打雁
diffusive	扩及
hexose	己醣
clinometer	测角器
antinational	反国家主义
christmas	圣诞节
oviparous	卵生的
apropos	适当
thataway	按指示
suffice	足够
caledonian	古苏格兰
pruinose	具粉霜的
yeoman	仆人
mcmxc	罗马数字
hotfoot	急行
tcd	都柏林圣三一学院
inalterable	不能变更的
undigested	未经整理的
themselves	它们自己
system	体系
digitorium	无声钢琴
phanerogamous	有花
overfraught	过于充满的
sandpaper	沙纸
intertropical	热带地方之间的
anschluss	两国经济或政治结合
bitartrate	酸式酒石酸盐
innate	先天的
normally	通常
undress	晨衣
distributively	分发地
rebellious	反抗的
unmeaning	无意义的
unnilpentium	105号元素
miacis	小古猫
pertussis	百日咳
wickedly	坏透
hyperkeratotic	角化过的
cacophonize	使声音刺耳或不和谐
virginal	处女
gunyah	澳洲原居民的小屋
redargue	反驳
trunk	躯干的
tradesman	工匠
rinforzando	突然增强
journalistic	新闻工作者的
shortweight	短斤缺两
forethoughtful	慎重地
hemiptera	半翅类
postharvest	用于采收后的
incapacity	无能力
goldbrick	欺诈
epistolary	用书信
incarnadine	染红
radioamplifier	高频放大器
evaluate	评价
paripinnate	偶数羽状的
koksaphyz	青胶蒲公英
antipruritic	止痒
thinness	瘦
thrifty	节约
antiphon	唱和
racecourse	赛马场
leno	纱罗织物
sheave	槽轮
enhydrous	水
laticifer	乳汁细胞
fail	失败
unequivocable	清楚明白
levelheaded	稳健
hortensia	绣球花属植物
monacan	摩纳哥的
psychotropic	作用于精神的
lofi	低保真度的
electrics	电学
current	当前
backpaddle	逆桨
phreak	盗用电话线路
incompatibly	不相容地
ardent	热心
powerful	强大
soligenous	由地面水流入造成的
hmnzs	Majesty''s
grade	分等级
annoit	涂油
preaxial	躯椎前的
cern	particle
brocaded	织成锦缎的
boggle	犹豫
ceruse	铅粉
beckoningly	引诱人
essayistic	小品
moire	波纹的
hulda	赫尔达
hamulate	顶端弯折的
hyperparasite	重寄生物
adatom	吸附原子
snaillike	像蜗牛的
omnipotence	全能
maintainable	主张的
alular	翅瓣
brutify	使残酷
lampless	不点灯
contradictorily	矛盾
fallacious	使人误解的
confiture	蜜饯
luculent	透明的
kitling	如小猫的
fingerbreadth	指宽
silkgrower	蚕农
essay	随笔
adult	成人
revision	修正
glanders	鼻疽病
ectal	表面
uncontainable	压抑不住的
umber	棕色的
bibliolater	书籍崇拜者
thracian	色雷斯
varnish	清漆
tambac	=tombac
wherewith	用那个
wherewith	以其
dopy	呆笨的
notturno	夜曲
nitromethane	硝基甲烷
infective	感染别人的
latent	隐约的指印
cullion	坏蛋
riparian	河岸拥有人
bryozoan	苔藓虫类的
grandiloquent	浮夸的
fishworks	鱼场设备
tininess	极小
serpentry	蛇类
smoketight	烟密
pane	长方块
carhop	汽车餐馆的侍者
strata	stratum
risetime	上升时间
patronage	保护
incursive	侵入
peculiarly	特有地
apyretic	不发热的
terzet	=terzetto
xanthomelanous	有橄榄色皮肤和黑色头发的
indicatory	表示的
exude	渗出
lares	家庭守护神
ariadne	阿里阿德涅
chief	主要的
insidious	阴险的
neutron	中子
washstand	盥洗盆
ganaderia	畜牧场
unfaithfully	不忠实地
isomerism	异性
episcopalism	主教制
riverfront	河边陆地
slash	斜线
corrigibility	易矫正
biochemical	生物化学的
golden	极好
mythological	虚构的
ignitor	=igniter
forward	向前地
belie	掩饰
reinless	无缰绳
harmonic	谐和
realty	房地产
gradualness	逐渐
lanceolated	披针形
reimbursement	付还
bliss	天赐的福
nomenclatorial	术语的
cholinomimetic	类胆碱的
zoophysiology	动物生理学
kvell	扬扬得意:
ophthalmoscope	检眼镜
swift	迅速的
thingummy	某件东西
pediatry	=pediatrics
hematidrosis	血汗症
furze	荆豆属植物
tipster	提供内幕消息的人
shepherd	牧羊狗
criterion	标准
sound	声音
catheter	导尿管
spun	spin的过去式和过去分词
escheatorship	管理充公产业的官员
heterophobia	异性恐惧症
eggbeater	直升飞机
magic	魔术的
reclusive	隐遁
slub	纺
college	书院
pod	蚕茧
magnetooptical	磁场对光线的影响的
autoeroticism	手淫
iberian	伊比利亚岛
cepheus	仙王
restraining	遏制
sugh	=sough
gio	=geo
homopolarity	单极
dna	interNet
cruel	悲惨
npcf	Control
rhyme	押韵
divisional	部门所有的
playday	休息日
sodality	联谊会
ambary	洋麻
finish	终结
perch	就位
imperturbed	神色自若
remarkable	非凡
super	用冷纱布贴
embryogenic	胚胎发生
cranreuch	白霜
trialogue	三人谈
pentameter	有五音步
usaid	International
trudgen	爬泳
rdo	Objects
stockade	用栅栏围住
alba	普罗旺斯晨歌
spiky	大钉似的
tardyon	亚光速粒子
agreed	同意的
coupler	连结者
brachiocephalic	artery头臂动脉
reflectoscope	投射灯
losable	易失的
eluviate	淋溶
consentient	无异议的
petrifaction	石化
unkennel	从洞穴逐出
skiplane	滑橇起落架飞机
extraordinarily	格外
appealingly	哀求
glairy	蛋白状的
subequal	近似相等的
gouge	挖出
frequence	频数
ballproof	防弹
yelp	叫喊着说
reinforcement	增援
autolysate	自溶产物
hilly	陡的
hepatobiliary	肝胆管的
craterization	火山口状骨切除术
cnd	Disarmament
breeks	=breeches
jervis	杰维斯
pegasus	神马
zonian	巴拿马运河区的美国公民
tentative	试验性的
voltairean	伏尔泰风格的
nu	字
iktas	东西
kinda	有几分
sapphiric	像蓝宝石
multihull	多船体
publishable	可发行
inchmeal	逐渐
sericate	如丝的
heavily	沉重
antipathetic	格格不入的
closefisted	小气
clostridial	梭菌
ocker	粗鲁的澳大利亚人
irascibly	脾气暴躁
restauration	修复
oleometer	油比重计
reversion	继承权
front	阵线
datolite	硅钙硼石
preadamite	认为亚当以前便有人类的
matronly	主管
fallacious	靠不住的
frailly	脆弱
arthroplastic	关节造形术
sirvente	讽刺诗歌
abridgment	删节本
direction	收件人地址
overprice	将……标价过高
unwatched	被忽视的
counselee	听取意见者
pseudomonas	假单胞菌
erebus	阳间与阴间当中的黑暗界
obtusely	圆头
effulge	闪闪发亮
readme	自述文件
floriated	具有花卉装饰的
archanthropine	猿人
embosom	把……藏于胸中
electrodeposit	电沉淀物
judicially	依法判决地
ceremoniously	隆重
abscise	脱离
narcotic	催眠的
shelter	掩蔽处
sacred	神圣
cassimere	薄毛呢
unrelatable	无关联
celestially	神
swimming	目眩
aarnet	and
namma	水泉
gesundheit	干杯祝福
future	将来的
skyey	天蓝色
labe	拉贝河
egg	蛋
deft	灵巧的
momental	力矩的
retroengine	制动发动机
inconvenient	不便的
lucubrate	专心著作
isopycnic	恒密的
bestir	使忙碌
circumambience	围绕
pargyline	优降宁
merchant	商人的
pettifogging	讼棍
franciscan	Francis
thunder	轰隆声
incurrent	向内流的
heteronymous	同形异音异议词的
raaf	澳大利亚空军
platitudinous	陈腐的
inductile	不屈的
ironise	=ironize
frse	the
rumpus	喧闹
tootle	嘟嘟地发出
rescissible	可取消的
lop	砍下的部分
fair	清楚
airship	飞船
dysthymia	精神抑郁
prelusive	序曲的
walla	要人
kiln	炉
willing	自愿
fulsome	过分
kernicterus	核黄疽
mfp	Printer
organizer	组织者
damsel	闺女
observability'	NULL)
rejuvenescent	回春
neuropathology	神经病理学
inescapable	逃不掉
theban	底比斯的
typhoeus	百头巨怪
vidicon	摄像机
aor	aorist
overgreat	过大
craped	绉纱
hematinic	补血药
synergetic	协同的
soccer	英式足球
remorseful	悔恨
midterm	期中考试
crackajack	能干
terraneous	生存于陆地上的
tailored	剪裁讲究的
compare	比喻
insubordination	不顺从
corticotrophin	促肾上腺皮质激素
insipidness	没有味道
permissible	可允许的
tripping	平稳地进行
pinocytized	被细胞摄入的
patriarchy	家长统治
idiosyncrasy	特质
rhymer	打油诗人
calcic	含钙
asi	indicator
decline	斜面
arrange	安排
phantasmal	幻影的
crocodilian	鳄鱼
egger	搜集鸡蛋的人
vibratory	振动性
science	理科
fold	笼罩
floatable	可漂浮的
third	第三
cameo	刻有浮雕的宝石或贝壳
omnifaceted	全面的
epicanthic	内眦皮的
intergeneric	属间
subtle	精细
feign	想象
strife	冲突
antiphonal	轮唱赞美诗集
ammonotelism	排氨代谢
unambitious	无奢望的
nonpartizan	超乎党派的
biblioklept	书贼
miscellanist	杂录家
cobbler	补鞋匠
tacharanite	易变硅钙石
jaundiced	敌视的
inextricability	无法解决
monolithic	单块集成电路
bastile	监狱
hyperphysical	超肉体
intimist	描写个人情感
elongate	伸长
looped	成圈的
whangarei	璜加雷
plantation	森林
ccco	Conscientious
tantivy	疾速的
fabled	虚构的
openhanded	豪爽
byelaw	条例
allegorical	讽喻的
technification	技术的采用
carbachol	卡巴可
clint	克林特
fatherfucker	杂种
sdk	软件开发工具包
polygynous	多雌蕊的
aristate	有芒的
versifier	诗人
shredder	撕碎机
faceup	面部朝上
paper	论文
retrospect	回顾
phylloid	叶状枝
antespring	前一个春天
cacophonous	粗腔横调的
graininess	多粒
pepsin	胃液素
rebellious	造反
smear	油迹
inspirational	灵感
dissolvent	有溶解力的
befog	使迷惑
chelifer	恶蚬
neilsbed	针座
anemochorous	由风散布种子
legged	有腿的
caffeic	咖啡的
fluorite	萤石
unhidden	公开的
facticity	真实性
disparaging	毁谤
bioassay	生物测定
golgotha	基督被钉死之地
tic	局部的抽筋
dde	Dynamic
forcipiform	钳状
unwearied	不累的
forename	名
inion	枕骨隆突
third	三分之一
keynesian	符合凯恩斯理论
picaroon	海盗船
limonite	褐铁矿
eyebolt	有眼螺栓
sanely	稳健
mammie	=mammy
zoetic	有生命
mascara	涂染眉毛油
record	被录音
rheumatic	风湿的
novation	以新的代替
jointless	无接缝的
subscriber	签署者
unmediated	未经调停的
nostoc	念珠藻属
scoundrel	卑鄙的
anguiped	有蛇状足的
setdown	申斥
incorporeal	非物质的
flagelliform	细长而柔软的
columbine	鸽
afoot	徒步
flambeau	火把
woodcraft	森林知识
extravagantly	挥霍无度地
crotch	分叉处
uncreated	未创造
scanty	俭省
quodlibetz	在瓷器等物上面所绘的图案
intimidatory	恐吓
fluoroscope	荧光镜
barrelhead	桶盖
eruciform	毛虫状
trabeated	横梁式
wormhole	虫孔
walloping	击败
flounder	比目鱼
riddling	解谜
circulative	循环
slim	纤细
liter	公升
marketer	市场商人
caressive	似爱抚的
winningness	吸引力
wakeless	酣的
flex	弯曲
luciferous	明确
utopian	理想化
wherefrom	从那里
unfitting	不适当
experiential	经验
brush	毛刷
slaver	诱骗女子为娼者
aaup	美国大学教授联合会
bizarre	奇异的
woodcut	木刻印版
lawfully	合法地
apa	points
incognito	化名
mart	市场
stiffly	顽固
overconfident	自负的
snore	鼾声
unlock	放开
electrostatic	静电学
afroism	对于非洲黑人文化的兴趣
whimling	孩子气的人
if	即使
poky	简陋的
chitin	角素
gasolene	挥发油
staff	充当职员
troubleproof	无故障
discriminator	辨别者
marsh	湿地
underplay	扣着大牌不出而出小牌
adipic	脂肪
ante	下赌注
splenization	脾样变
completive	完全的
asio	Audio
lordotic	脊柱前凸
rage	风行
goody	媪
mesocarp	中果皮
bryozoa	苔藓虫门
buckaroo	牧童
xp	Extreme
twister	难事
thridace	莴苣浓汁
pentacid	五价的
radiation	发光
serried	林立
blatantly	看穿了
swarthily	黑黝黝地
mao	oxidase
battue	用驱赶方法狩猎
reductive	还原剂
chromophoric	载色体的
ausgleich	协定
undefended	无论据的
intilted	向内偏斜
amble	缓行
fanwise	如扇形
pirimicarb	抗蚜威
epileptogenic	引起癫痫的
fmcs	and
shrill	尖声
committal	赞助
frypan	=frying
unspeakable	无法形容
histochemical	组织化学
circumpolar	极地附近的
onwards	向前地
embarrassingly	使人难堪地
isoclinic	=isoclinal
decrepitude	老朽
altai	阿尔泰山
erg	尔格
fess	坦白
interlocutress	女问话者
sprig	用小树枝装饰
feudatorial	世仇
leukocytotic	白细胞增多的
beastie	小动物
gemara	犹太教的神学书Talmud
inaptly	笨拙
divestment	剥夺
heteronymously	相关而异名地
surpliced	穿着白色法袍
retardment	减速
hesternal	昨天的
overoccupied	过于拥挤的
acescent	变酸的
iconographic	肖像学的
atilt	摆着冲刺的架势
thickheaded	愚蠢
rugged	有皱纹
morpheus	摩尔莆神
clamshell	蛤壳
realizing	明确无误的
sound	试探
flighty	忽发奇想
discharger	履行者
alkyne	炔
pit	起凹点
rencontre	邂逅
ingoing	迁入
hairif	=cleavers
indicative	预示的
friended	有朋友的
centrifugal	离心
gottwaldov	哥特瓦尔德夫
windage	风力修正量
permeable	有浸透性的
wscf	世界基督教学生同盟
superficiality	表面性的事物
ironwork	铁制部分
cavitron	一种无痛穿孔锥
cementitious	似水泥的
kharkov	哈尔科夫
choler	愤怒
monocarpic	结一次果的
boiler	煮器
millionairess	女百万富翁
usher	作招待员
billingsgate	下流
swash	冲激
nomadism	游牧
propagable	可推广的
catapult	弹弓
pale	界线
until	在……以前
short	不够
engorgement	充血
heliometer	太阳仪
cheskey	捷克语
shuttle	往返汽车
wscf	Student
polydemic	多地区生长
forktailed	尾巴开叉
contraprop	一对互相反转的螺旋桨
dysplasia	异常结构
orthopterous	直翅类
semilanceolate	半矛尖形
phalanger	袋貂
datable	可确定时代的
gigavolt	千兆伏特
inviolate	无污点的
gemutlich	安逸的
candlestick	烛台
concessional	容许
abortively	失败
disparaging	轻视的
rhinopharyngocele	鼻咽瘤
feme	女人
ahd	arteriosclerotic
neuter	不及物
hornbar	横木
treatment	处理
beanshooter	以干豆做子弹之玩具枪
considering	鉴于
sweetly	甜
popgun	玩具枪
shroud	船的横桅索
nonbeliever	没有信仰的人
fluvioglacial	冰水的
unchurched	被逐出教会的
headplate	磁头板
favorably	顺利
ringing	干脆的
scopulate	帚状
lime	黏鸟胶
breezee	吹微风
facilitate	帮助
stellenbosch	调充闲职
fossor	古时候教堂中负责埋葬的职员
rumpot	醉汉
unreaped	没有收获
cornucopian	丰富的
rapc	Royal
nephalist	完全戒酒论者
tractably	驯良
phasedown	逐步减少
radiosodium	放射性钠
enlarger	扩大者
it	信息技术
comeliness	漂亮
sincerely	真诚
eminent	优良的
manes	灵
cretaceous	白垩
worry	挣扎着前进
heft	举起
trickish	欺骗
yock	大笑
fine	优良的
papistical	天主教的
igy	Year
spoonerism	首音互换
solitudinarian	隐士
sexfoil	六叶装饰
fidget	弄
noncontrastive	非对比的
unifier	使一致的人
serbia	塞尔维亚
tamari	酱油
cabezon	大头鱼
facs	American
murderous	造成死亡
relocation	变换布置
rosedrop	玫瑰糖锭
spritz	喷
tetrahydrocannabinol	四氢大麻酚
thousand	许多
vasodilatation	血管舒张
germen	生殖腺
thermoelectron	热电子
butskellism	巴茨凯尔主义
tactually	凭触觉
resistent	=resistant
dentin	象牙质
dunkirk	狼狈地撤退
sportsdom	运动界
antipsychiatry	反传统精神病学
aboveboard	光明正大的
mumu	=muumuu
disenfranchise	剥夺……公民权
carbo	含糖食品
letdown	松劲
unsettle	不安
causable	会惹起
shangrila	理想乐园
nous	精神
subventionize	援助
deliriant	呓语的
inscriptive	题写的
gbf	Foundation
misbelief	错误的信仰
manipulable	可以操作的
dialogist	对话体的作者
morningtide	晨间
odditional	附加的
turbinate	陀螺状的
sponsion	担保
nilpotent	幂零的
unfixed	解脱
lonely	偏僻
docent	讲解员
tern	燕鸥
thyroidotomy	甲状腺切开术
uncoil	解开
invisible	无形的
terrifically	极端
innocent	天真的
guest	款待
libration	天平动
cardioactive	作用于心脏的
polyethnic	多民族的
atomix	http://atomix
base	卑鄙的
meditation	沉思
irreversible	不能取消
wearable	可佩带的
suk	苏克族
projective	投影的
enclitic	附属字
craniology	头盖学
emissive	发射的
override	蹂躏
gaudeamus	尽情狂欢
emancipationist	解放论的人
underpopulated	人口稀少的
unprinted	未付印的
dishwater	洗碗水
lay	世俗
counterpoise	平衡
assignment	任务
helidrome	直升机机场
leaving	离开
shaky	不可靠的
cock	大摇大摆地走
mmx	Multimedia
versicolor	斑驳的
nature	种类
sunwise	向右转
kingfisher	翠鸟
submission	谦恭
cranky	暴躁的
dcvo	Commander
prestissimo	极快的
verbose	冗长
cowichan	sweater科维昌式厚毛衣
aeronaval	海空
neofascism	新法西斯主义
vocabulary	词表
rout	击溃
nawab	英国人
asthenic	衰弱
nistru	=Dniester
betacam	广播级录象机的型号之一
episcopalian	主教派的
reprobative	责备
maidenlike	像处女
phenoxide	酚盐
sparrow	麻雀
dumpishly	忧郁
marrowless	无髓的
cholerine	轻症霍乱
opporunity	时机
victualer	运粮船
parlay	使增值
forest	住在森林中的
adhesive	带粘性的
inspection	视察
herbiferous	生草
reinless	自由
chivvy	耍花招
pyranometer	日射强度计
organohalogen	有机卤素
monologist	独白者
tubicorn	有空角
lipolytic	分解脂肪的
toxophily	对射箭的爱好
beethovenian	贝多芬音乐爱好者
flowage	流动
togated	庄严
carbonari	烧炭党
sponsorship	任务等
show	显示
armory	纹章
serrulate	细锯齿边的
sfax	斯法克斯
overridden	override的过去分词
nonfood	与食物无关的
slantindicular	偏斜的
rayleigh	瑞利
pale	无力
microelectrode	微电极
impledge	当
omit	疏忽
cytopathologist	细胞病理学家
potentiostatic	使用稳压器的
previous	在……以前
guarani	瓜拉尼人
respirability	适合呼吸
toothless	无齿
microsphere	微滴
ergometrine	麦角新碱
cryptical	秘密
cenobitism	修道士生活
dissolute	风流的
alps	阿尔卑斯山
declivitous	相当陡
echelon	梯形
pastern	胶
macrostomia	巨口
silence	使沉默
contention	争夺
heirless	无后嗣
improvisatori	即席
pisiform	豌豆状的
safranin	番红精
examine	调查
greasiness	油腻
aseismatic	耐震
ingliding	内向滑音的
sidle	横行
matra	马特勒
reedy	芦苇丛生的
drainless	取用不竭的
inseparate	不分离
gpm	gallons
ebullience	热情
subheading	副标题
chirpily	活泼
consubstantial	/
depurant	净化器
background	背景
spacecraft	太空船
weariful	使人疲倦
map	例如程序中的组信息和公共符号信息等
rehouse	移往新居
king	做国王
entoblast	内胚层
islam	伊斯兰教
halt	暂停
sucrate	糖合物
jd	Delinquency
inexpansible	不能膨胀
pathogenic	致病的
gamin	流浪儿
condition	条件
wolves	贪婪者
budapest	布达佩斯
sloughy	腐肉的
epaxially	轴上
aureola	光轮
adiathermancy	不透红外线性
fantasize	幻想
indirectly	拐弯抹角地
medal	奖章
ululate	哀鸣
dwc	deadweight
wandering	神志恍惚
conservative	守旧的
sun	阳光
effrontery	厚颜无耻的行为
parotic	耳旁
organization	机构
accomplish	完成
tergant	作拱背状
crop	收获
dvd	Digital
epidermoid	像表皮的
straggling	脱离队伍
anteriority	居先
caesarism	君主政治
spiffing	好看
callipee	=calipee
gni	income国民总收入
retral	在后面的
convivial	欢宴
managing	节约
slantwise	倾斜
springlet	小泉
preferential	先取
marmorean	大理石的
athanasian	Athanasius
emplane	乘飞机
argumental	辩论的
areopagite	古希腊雅典最高法院的法官
newfangled	新制
flagellate	鞭索形
thoughtfully	思虑地
conjunctly	接合
gazebo	眺望台
loathful	可厌的
disbelieving	怀疑的
triplicate	三倍的
unembroidered	简单
laboured	谨慎
forworn	极疲倦
flaxen	亚麻色
tab	小报
replicative	复制
frolicly	玩乐
overeat	吃得过多
left	左边
nebular	星云的
cuneal	楔形的
saturnalia	狂欢喧闹
disimprisonment	释放出狱
supersensible	超知觉的
abstractively	抽象
encampment	营
monophonematic	单音素
embank	筑堤
dreamy	梦想
probative	检验
transmigrant	移居
umbelliferous	有伞状花
mature	充分考虑的
prefab	预制的
cracky	疯狂
bicolor	二色的
halliard	升降索
lacrimator	=lachrymator
huntaway	经训练可牧羊的
metafile	元文件
ninth	第九
kinda	有一点
septennate	七年的任期
recurrent	周期性发生
unsure	没有自信的
cede	放弃
needler	刺激别人者
haut	高级的
elementary	元素
subterminal	几乎在末端的
hierocracy	僧侣统治制度
sophisticator	矫揉造作者
partialness	偏爱
organometallic	有机金属
blet	腐烂
certainty	确实的事情
mercy	仁慈
cytology	细胞学
fork	叉形物
counteragent	反作用剂
acronichal	薄暮的
demon	极残忍的人
holmic	含钬的
ablare	喧哗
openhearted	不隐瞒
leprose	皮屑状的
aquakinetics	婴幼儿深水漂浮训练法
nammet	=nummet
refluent	退潮
productile	可拉长
ashlared	用长方石板砌成的
trilaminar	三层的
pickled	烂醉如泥
flowerless	无花
sympathetectomy	交感神经阻断术
sapsucker	啄木鸟的一种
quickwater	水流湍急处
localize	地方化
fitment	设备
fall	下跌
galiot	荷兰的小型商船
engage	啮合
diomede	=Diomedes
formalism	拘泥形式
aerodonetics	空中滑翔学
myth	虚构的故事
principled	有原则的
disjunct	不相连
swirl	使成漩涡
mortal	非常大的
swellheaded	骄傲
backboned	有骨气的
discourteously	粗鲁
lambkin	好孩子
null	无价值
straight	直接
tetrachloromethane	tetrachloride
inductivism	归纳法优越论
pretext	借口
corydon	牧童
glycine	糖胶
sheila	女郎
copartnership	合伙
bha	butylated
monopteros	圆形外柱廊式建筑
fellow	同伴的
ochreous	赭石
clanism	宗族主义
daily	天天
wicked	坏的
tenia	束发带
aeon	永世
klamath	克拉马斯人
annoyingly	烦人地
sinople	铁石英
basting	疏缝的针脚
supposititious	私生的
teleoperator	遥控机器人
nard	甘松
yabber	闲聊
infernally	恶魔似
taa	Administration
dado	护墙板
digestion	消化力
theologian	神学者
insigne	=insignia
goody	感伤
qairwan	=Kairouan
heteromorphosis	异形化
concessively	让步地
fondly	溺爱地
monostome	具单口的
regrade	重新分类
evergreen	常绿的
presenile	未老先衰
earnings	所
aesthetic	审美的
lingala	林加拉语
canonically	宗规上
telltruth	说真话的人
cms	Church
mattoid	精神病边缘者
endergonic	吸能的
vacancy	清闲
familiarity	精通
convulsant	惊厥剂
backlist	重版书
poe	Entry
radix	根
way	路途
fibrosis	纤维化
overparted	分配担任力不胜任的角色
unrwa	Works
sncf	de
nekoite	新硅钙石
decarbonylate	去除碳基化物
diphenylamine	二苯胺
grobian	粗野而邋遢的人
jewfish	暖海鱼
centner	欧洲商用重量单位名称
disfavor	厌恶
anhydrous	无水
phoenician	腓尼基
filthily	丑恶
twinge	使一阵一阵痛
convertite	从良的妓女
eucharistic	圣餐
accidently	=accidentally
nervosity	神经过敏
barege	巴雷格纱罗
owl	Object
incivism	缺少公民意识
seasoning	调料
ninth	九分之一
undomesticated	不爱做家务
disrate	使降级
fauteuil	安乐椅
aroid	天南星科的
fortitudinous	顽强
granuloma	肉芽肿
ravage	毁坏
meiosis	减数分裂
sukie	=sukey
otohemineurasthenia	单耳听觉不全
reliance	依靠的人或物
inviolable	不可亵渎的
vulcanize	硬化
comecon	Assistance
coupe	分隔车房
medaled	佩带徽章的
anetic	缓和
disaster	灾难
windspout	旋风
balkanize	使割据
fat	胖
meditative	爱思考的
allopathy	对抗疗法
ussuriisk	乌苏里斯克
refixation	再设立
fuzzy	失真的
burnable	燃烧的
tristimulus	三色的
lithe	易弯的
southwesternmost	极西南的
norwegian	挪威
desirable	令人想要的
reversing	回动
petrification	僵化
anaclinal	与四周地层反方向下降的
galveston	加尔维斯敦
faille	罗缎
nolo	=nolo
commemorable	该记住的
bobbly	圆块状
truckle	小轮
upheld	uphold的过去式及过去分词
steep	泡
hypnotic	催眠
unprovided	未作准备的
splayfoot	八字脚
swab	拭抹
snooty	傲慢
veronese	意大利之维罗纳Verona的
lor	天啊!
watchfulness	警觉
distressful	苦难重重的
kaapland	Province
grammarian	文法家
computerite	电脑迷
shat	shit
campo	草原
ftc	Federal
bambara	班巴拉人所用之曼丁哥语
mods	牛津大学B
debarkation	下车
expend	消耗
lulea	律勒欧
delouse	驱除虱子
unequalable	无双的
disbelieve	不信
orthonormal	规格化正交
annulate	有环纹的
mealy	粉状的
rhenish	莱茵河
vibrational	摇摆
carpaccio	生牛肉片
emigrator	移民
privateer	私掠船
umbrage	不快
peck	许多
environmental	周围
salutatory	欢迎词
rear	后方的
destitution	缺乏
unicef	Nations
heteronomous	他治的
cyclohexanone	环己酮
fcis	Fellow
disallowance	不许可
hibernal	冬天的
azt	艾滋病防护药
wild	野生的
challie	印花丝毛料
findable	可发现的
cmos	Semiconductor
hectic	患肺结核
severely	严格
translucent	透明
asterism	星群
circumvention	欺骗
thoroughly	十分
trituration	粉状
broadish	稍宽阔的
reproachfully	责备地
homonuclear	同核的
buccal	口腔
tonnish	=tonish
endogenic	内营力
sebacic	癸二酸的
incooperative	不愿意合作的
herbescent	草本的
reexamination	复试
platitude	陈词滥调
medius	中指
latinist	拉丁语学者
homologize	相应
henna	指甲花染料
defining	定义
voltairean	伏尔泰的
accessary	从犯
churr	颤鸣
metapage	元页
yugoslavic	南斯拉夫
pioneer	先遣兵
felicitous	巧妙的
endnote	尾注
textured	手摸时有感觉的
tractarianism	牛津运动
tentaculiferous	具触手
bosh	空话
ate	Equipment
sandal	便鞋
telluride	碲化物
spenglerian	施本格勒理论的
foreseeingly	有预见
parma	深紫色
watertight	水密
tasty	可口
amphisbaena	两头蛇
girlish	少女的
washrag	面巾
acetylco	A
experienced	经历
cinematographic	电影摄影术
operatize	编成歌剧
stony	无情
epimerase	表异构酶
plasmolysis	原形质分离
athenian	雅典
sale	销路
kerbside	街道边
freehand	徒手画
unanswerable	没有责任
choreiform	舞蹈病样
vagotonia	迷走神经兴奋
logged	劈成木材的
fluxionary	不定
fluxion	转变
feneration	高利贷
nucleoid	病毒核心
contratest	对照试验
tasian	塔萨文化
dogie	迷途小牛
rcvs	of
dispermous	具双种子
tendency	倾向
umbrage	树荫
laryngopharyngeal	咽喉的
unexcelled	未被胜过
greatness	伟大
sheugh	溪谷
ordinant	规定的
sundown	日落
stygian	幽暗
filter	滤光器
bustling	熙熙攘攘的
bastioned	具备棱堡
bellow	怒吼
semifascist	半法西斯主义
defensibly	可保卫地
familiarization	熟悉
impregnate	充满
lowland	低
fructifier	使结果实的人或事物
cymous	聚伞花序的
alme	舞女
noncombat	非战斗的
metric	公制
passerine	雀形目
habiliment	服装
unimpressive	无印象的
evolving	进化的
statesmanlike	有政治家风格
shaikh	酋长
zincographer	锌版技师
melioration	改善
pagoda	宝塔
parton	部分子
conversable	易开口的
nascar	of
astronautical	太空航行学
relativism	相对论
unaccompanied	无伴侣
cow	母牛
comment	评论
glamorous	迷人的
flacon	长颈细口瓶
centripetence	向心作用
mellitum	蜜剂
adenectomy	腺切除术
minnesinger	吟游诗人
narcotic	麻醉药
gavage	填喂法
paravane	扫雷器
sailing	航行的
untraceable	难以捉摸的
ddk	Device
craniotomy	穿颅术
telesoftware	电传软件
haematological	血液病学
municipalist	地方自治主义者
hyraces	hyrax
jostler	扒手
obscurant	蒙昧主义
limitrophe	位于边界上的
rockbird	岩鸟
faggy	女性化
churr	颤鸣声
camisole	女背心
pronouncing	发音
tcd	Trinity
sensibly	敏感地
sticky	粘的
diplomacy	外交
trough	水槽
engrammic	印象
laudability	值得赞美
passant	向前直走姿势
overfleshed	肥育过度
hyperverbal	说话过多
brilliantly	灿烂地
demonology	鬼神学
registered	记名的
restoration	赔偿
fated	受命运支配
cubane	立方烷
teeth	牙齿
hygrostat	湿度调节器
exarch	大主教
radicular	根
bountiful	慷慨的
isologue	同构体
kovsh	长柄船形酒杯
jassid	浮尘子科动物
progress	进行
potash	苛性钾
yankeeize	使美国化
jackaroo	当新手
psf	pounds
wickedly	不愉快
hemic	血性
baroque	巴洛克式的
beau	纨绔子弟
pirogen	=piroshki
counterbalance	使平均
consequential	结果
utp	Unshielded
uncinaria	钩虫
pusillanimous	优柔寡断
conifer	松类
ratifier	批准者
ruritanian	理想王国
wimbledon	温布尔登
lovebird	多情鹦鹉
polyglottism	=polyglotism
intentness	集中的
polymorphonuclear	分叶核
miscellanist	杂文作家
basset	露出
townee	本镇人
gradus	辞典
uphove	upheave的过去式和过去分词
chirk	兴致好
unicode	统一的字符编码标准
flagellate	鞭毛藻
practician	开业者
problem	难题
pectinaceous	含果胶
slicer	切薄片的机器
out	在外
jubilant	喜悦的
coverley	柯弗利
basement	地下室
heortology	宗教节日学
venusian	太白星的
psychosomatry	心对身的
muster	征召
cordis	心脏
fizzle	失败
phidias	菲迪亚斯
robinsonade	式的船只遭难故事
windrow	被风吹集于一处之落叶
squash	壁球
microoperation	微操作
anglify	=Anglicize
androphagous	吃人
upu	万国邮政联盟
underemphasis	强调不够
cigs	of
rubicund	红润的
unspilt	未溢出的
amadavat	莓莺
blendo	混合式
phillips	screwdriver
lippitude	烂眼睑边
scruple	迟疑
supervenient	意外发生
veridical	诚实
emcee	主持人
moonlight	月夜
planform	俯视图
pregnant	重要
templet	模板
seedily	不体面
unimodal	用单峰分布描述的
habilimented	穿着服装的
drolly	幽默地
tomentose	被绒毛
kolinsky	其貂皮
bundestag	国联邦议院
oyez	听
unpleasant	使人不愉快的
bacteriostatic	细菌抑制抵频
zonked	醉酒
waiver	放弃
snide	暗讽
collectivistic	集体主义的
merciless	残忍的
corny	粗野的
handcart	手车
nondrinker	戒酒的人
chlorinous	含氯
rasophore	穿黑色宽袖长袍的教士
spicewood	=spicebush
smokable	可以点燃抽吸
periapsis	近拱点
slurry	浆
inappreciative	不欣赏
immobility	不动
sclc	Southern
pigpen	猪舍似的地方
infidel	不信宗教
purulence	含脓
inconstantly	不稳定
aforehand	事先
pollywog	蝌蚪
atrip	起锚
assuringly	保证
scraggly	锯齿状的
inhumanize	使无情
recite	书面陈述
tubocurarine	筒箭毒碱
comique	丑角
impenetrable	难以渗透的
unplagued	未得灾祸
waggish	爱开玩笑的
par	平均的
humourous	滑稽的
penile	影响阴茎
puerperal	分娩
polysaccharide	多聚糖
laconically	简洁
unsexed	失去性征
unfoiled	未被征服的
sprig	用钉子钉上
tubicorn	有洞角
gruntle	嘀咕
bloomy	有粉衣
trivalent	三价的
untrammeled	无阻碍
relievable	可减轻的
aerocab	供短程飞行用的直升机
fulminatory	雷鸣的
breadless	无食的
detached	分开
fusain	炭画笔
devel	重击
jihad	拥护运动
chine	脊椎骨
inspirer	鼓舞人心的
uniform	制服
rectify	调整
kawasaki	川崎
shopping	购物
disaggregate	使崩溃
ustulate	烤焦
idiorrhythmy	住在自治宗教团体的僧侣
capric	公山羊的
befittingly	适当
pokey	监狱
tutoyer	亲密地对待
magnesic	镁
vex	使烦恼
monadelphous	单体雄蕊
underdrift	=undercurrent
cuneal	楔形
heterochthonous	不是土生
uart	Universal
file	提出
bellmouthed	漏斗口
guttate	有斑点的
reexpand	再扩展
parathyroid	副甲状腺的
remote	细微
spotty	多污点
photoeffect	=photoelectric
beadsman	乞丐
contemptibly	下贱
escadrille	飞行小队
amatively	好色地
monticulate	有火山丘
subservience	裨益
welter	挣扎
stockman	畜牧业者
cyanogenetic	生氰
enthronization	登基
flotilla	小舰队
philatelic	集邮
rectificative	校正的
magnesia	氧化镁
lice	白虱
facsimile	摹写
businesslike	事务性
arrisways	对角地
nongovernment	非政治
eurocapital	欧洲资本的
sublime	庄严的
warlock	魔术师
disubstituted	双取代
leister	以鱼叉刺
macroscopical	肉眼可见的
graphitoid	石墨状
dsrv	submergence
drooping	无力
zaguan	门廊
unitarianism	上帝一位论
latitude	纬度
nigerianize	使尼日利亚化
mirthless	沉闷的
tollgatherer	收费员
borderline	边界线
harmonic	谐和的
macrobiosis	长命
changeful	易变
rotproof	防腐的
tritural	适合于粉化
innutrient	缺乏营养
nsa	Security
pertly	傲慢地
punitive	惩罚性的
trothplight	誓约
dowlas	粗花布
dullish	稍钝
concussion	冲击
thenceforth	从那时
richly	富裕
cultrate	小刀状
bibliology	圣经学
wretchedness	悲惨
digressive	离题的
racer	游蛇属
finagle	欺瞒
loss	遗失
brasier	黄铜匠
obiit	卒
draggle	拖湿
institute	学院
ratproofed	使能防鼠
anthropogeography	人文地理分布学
felicitously	恰当地
magistral	主导
surfeit	过度
verifiable	能作证的
dbcp	dibromochloropropane
tubulin	微管蛋白
armenian	亚美尼亚语
hopelessly	无望地
stood	stand的过去式和过去分词
kemalist	基马尔主义者
special	专用
unwary	不注意的
vrml	Modeling
monomaniac	对一事热狂的人
quinquepartite	分成五部
azygous	非对偶
indubitable	确实
cracker	解密高手
unfluctuating	不波动
straight	诚实
festination	慌张步伐
tousy	蓬松的
dyscalculia	计算困难
softly	柔软
dropscene	最后一场
leaseback	售后回租
uterine	母系的
headful	头所能容纳的量
alienage	外国人的身份
misdiagnosis	错误的诊断
unshroud	从……移去遮蔽物
coruscant	闪
spook	鬼
trickster	骗子
baobab	非洲产的一种巨树
itch	发痒
homoplastically	同形
fiercely	猛烈
amphigory	无意义而滑稽的文章
inviolable	不可侵犯
inordinate	紊乱
inhabitativeness	喜欢永远待在同一住所
schizanthus	蛾蝶花
euryhygric	广湿性
cutwater	船头破浪处
general	全面
xpvm	Graphical
implausibility	不象真实
femininely	女人似地
vestige	遗迹
naming	命名
antismog	防烟雾污染的
milliner	女帽制造及贩卖商
downloadable	可下载
agonic	不成角
enshrine	入庙祀奉
dop	phthalate
possessed	着魔的
pegasus	飞马
handbill	传单
abdicant	逊位
aethereally	非人间
watering	灌溉
deluxe	华丽的
rosy	玫瑰红色
rink	冰球场
char	烧焦
cutcha	贫弱
tenfold	十倍的
iterant	重复
rive	破裂
ytterbous	镱
earthborn	人类的
desensitize	使不敏感
issei	第一代移居北美的日本人
radices	树根
finfooted	有蹼的
prosper	使昌隆
backhoe	锄耕机
xxxiv	罗马数字
transplant	移居者
flowerage	花
corticate	有树皮
humoristic	滑稽的
lunisolar	日与月的
homozygosity	纯质性
overcentralized	过分集中的
bolus	大丸药
unimposing	不庄严的
rct	of
unreel	解开
thickly	浓
gayer	华美的
podium	墩座墙
incontinent	仓促
dynamic	动力
repousse	凸纹面
simtel	很大的软件分布网络
chiseled	凿刻的
swith	当即
filemot	枯叶色
mooring	停泊处
rhythmically	有节奏地
nearshore	近岸水域的
ventail	护面具
interstice	空隙
upthrow	向上的投掷
unspeakable	坏透了
cohesion	凝聚
sternum	胸片
cablet	10
combat	格斗
ruffled	有褶饰边
kennelman	养狗场管理员
overbore	的过去式
exhausted	耗尽
consultant	咨询者
sclc	南方基督教领袖会议
tantivy	快跑
seraphic	纯洁的
canvas	彻底讨论探究
pteropodium	翼足目软体动物的足
instance	要求
ranchman	牧场工人
limpkin	涉禽之一种
chardin	de
sublimate	升华物
feeze	猛冲
dirtily	淫邪
moral	精神
burka	的长袍
radiantly	辉煌
manganic	锰的
nondiapausing	非休止中的
ingest	吸收
p	字母P
eirenic	=irenic
bougainville	布干维尔岛
tremissis	早期西欧金币
bizarre	奇异
aureola	光环
choking	憋闷
duplicate	两重的
jarp	打
ascap	of
legendry	传说集
desaturate	降低的饱和度
automatous	机器人的
exsanguine	贫血症的
unbuttoned	解开钮扣
capacity	才能
abolish	废止
nelda	内尔达
another	另外的
clothe	覆盖
canadianize	加拿大化
sootily	熏得乌黑
novel	长篇故事
readily	乐意
cleavable	劈得开
world	社会
piosity	假虔诚
theatric	戏剧
overage	过老的
vexillar	军旗
fall	堕落
revolutionology	革命学
xeromorph	旱生植物
quickening	活泼
brasier	火盆
presiding	主持会议
indebtedness	债务
pollan	白鲑
delectate	使高兴
pitch	扎营
plumage	翅膀
retia	丛
misgivings	担忧
pagandom	异教徒
dryer	干燥剂
cadmean	卡德摩斯
batrachian	蛙类
unvalued	无价值的
gravelly	碎石构成的
orthographist	正字法学者
domination	统治
retroflex	向后弯曲
charger	袭击者
independently	自立
osteria	客栈
mouthwash	无聊话
ravel	解决
lexicographic	词典
herry	=harry
clottish	笨的
cranage	起重机使用权
handweaving	以手织机编织
ericeticolous	成长在石南丛中的
comportable	合适的
pomposo	华丽地
rigescence	生硬
cycle	自行车
vaginate	有鞘
lord	地主
pancratium	揉合拳击和摔交的古代希腊竞技
headspace	顶端空间
catecheticel	问答式教法
unexpanded	未展开
cursive	草书原稿
lymphatism	淋巴器毒血症
tepidity	微温
mongrel	杂种狗
anteriority	先前
squaw	妻子
intertropical	热带的
included	包括
administrivia	新闻
ferrule	装以金属铁
flabellation	用扇扇凉
lace	扎
diverse	变化多的
vetch	野豌豆
infusive	有影响力
super	特级的
alluring	吸引人
anemometric	测定风力
orchotomy	=orchidotomy
neuroanatomical	神经解剖学的
dicty	时髦的
meditate	想
syphiloid	梅毒状的
specialization	特殊化
aught	任何事物
sublunary	地上的
regressive	回归的
clostridial	梭菌属的
ergotamine	麦角胺
veining	叶脉的形成
cornuted	角状的
argute	机灵
rundale	小块土地占有制
dioecious	雌雄异体
globulous	球形
lavage	洗
gallygaskins	=galligaskins
soar	剧增
deign	赐予
rainily	多雨地
uaa	Arab
profundity	深奥
urbicide	城市毁灭
phloroglucinol	间苯三酚
header	收割台
punctulate	有细孔的
pour	流
fallalery	装饰品
bungler	笨拙者
virement	票据交换
unvalued	无价值
isopycnic	恒密
alarmedly	惊恐
abstinent	有节制的
finagle	使用欺骗诡诈手段
sippet	小片
informant	被调查的人
semon	语义子
blatant	炫耀
subcelestial	尘世的
tercet	三拍子
multiparty	包括多党的
emergent	紧急
debug	除去窃听器
term	条款
osmanthus	木犀属植物
motorable	可行驶汽车
certified	被鉴定的
schizozoite	裂体性孢子
enterozoa	内寄生虫
chondrosarcoma	软骨肉瘤
dithyrambic	狂热
biogeocenose	生物地理群落
handless	赤手空拳的
noegenesis	知识产生的过程
coquetry	撒娇
ultraminiaturize	使超缩微
thoro	彻底的
tamber	音质
hitter	击手
statuesque	雕像般
plangent	凄切的
sporeling	萌芽孢子
rebellious	反叛的
veto	否决权
vitriolic	刻薄
covert	隐蔽的
penetration	渗透
unfettered	被除去脚镣
correctional	改正
parlous	危险的
charmed	着迷的
overflight	飞越领空
alice	艾丽丝
cellularity	细胞性
biassed	=biased
acedia	懒惰
acidproof	耐酸的
mordacious	锐利的
devilish	精力旺盛的
hydrogasification	加氢气化
blind	盲目
annemarie	安玛丽
cabas	女用手提包
depletive	使干涸的
zuleika	朱莱卡
undivested	未被剥夺
polyphonic	有许多声音的
convergent	会聚性的
clamp	夹具
lipographic	漏写
peacherino	漂亮姑娘
anaclasis	长短音换位
antianxiety	防止精神不安
obtusely	钝地
unchangeably	不变
macaroni	通心面
betwixt	在……之间
hesperidium	柑果
ingather	收获
ecclesia	教堂
undomesticated	未驯服
garp	Program
salverform	高脚碟状的
halite	岩盐
anomy	社会的反常状态
naillike	像钉的
mainspring	主要原因
hypomotility	运动不足
bronchoconstriction	[医`strIktE支气管收缩的管狭窄
latrine	公共厕所
spark	闪烁
status	地位
utricular	具胞的
toluol	甲苯
sheeplike	温顺
dodgy	善于骗人的
slip	滑过
orphean	迷人的
exterminative	=exterminatory
inauspicious	不幸的
degender	去除中的性别所指
sorb	山梨树
alameda	林荫散步道路
resource	财力
unjoined	未加入
motory	引起运动
ennyyee	倦怠的
convalescence	逐渐康复
displace	取代
glycerol	甘油
pinkish	略带桃色的
springhead	泉源
metaassembler	元汇编程序
amice	披肩
patronizing	要人领情的
assumingly	傲慢地
agonizingly	苦闷地
glover	手套贩卖商
purpure	紫色的
slumberous	催眠
rhapsodic	狂想曲
idoneousness	适合
manrope	舷梯扶索
corporation	大肚皮
shock	吓人
hemianopia	偏盲
otherwise	不同
salutary	有益
terebinthine	松节油的
hatefully	可憎地
quaternate	以四为一组
aarp	Protocol
level	同高的
retroflexed	翻转
struggle	挣扎
resultant	合成的
permeation	透过
surfacely	表面地
movably	可移动
theism	一神论
carcase	架子
progenitive	有生殖力
commonweal	大众福利
polystylar	=polystyle
iupap	Pure
water	雨水
oarage	划具
cloddish	粗鲁
clearcole	底胶
floridity	鲜丽
deviously	绕道地
impressibility	感受性
whenever	只要
indiscrete	不分开
outer	远离中心的
doss	睡卧
officer	指挥
dls	of
bullpout	pout
develop	发达
switchgrass	柳枝稷
swim	潮流
feu	封地
monophyllous	具一叶的
analecta	论集
capitulaitonist	投降主义的
decumbent	爬在地上
upborne	被升高的
damning	咒骂
pragmatistic	实用主义的
byproduct	副产品
interleaf	插页
eugenic	优生学的
kidron	汲沦谷
dls	Science图书馆学博士
gsc	General
hodiernal	今天
enchantment	妖术
cystectomy	胆囊切除术
orthographer	拼字学者
gallionic	迦流
fiftieth	五十分之一
forgetive	富有想像力
headwear	头饰
duds	行李
wizard	男巫的
twisty	转弯抹角
morrow	次日
empanel	记入名簿上
stapler	订书机
fruitive	能享受
elmer	埃尔默
ghostdom	鬼域
cataphatic	用肯定方法所得的
experimentize	进行实验
meroplankton	季节浮游生物
nary	连……也没有
herbary	草本园
taffy	威尔士人
bluehearts	美洲鬼羽箭
reseau	网格
freeze	冷冻
halavah	碎芝麻蜂蜜糖
selective	选择性的
azury	浅蓝色
puckery	起褶
hologynic	限雌遗传
counterviolence	以暴制暴
rare	非常
longbowman	大弓手
overprint	套印
iconoclasm	对偶像攻击
cynegetic	打猎
ionogen	可离子化的基团
hyperpyrexial	高烧的
aim	对……瞄准
inclip	紧抱
info	信息
snowmaking	人工造雪
zirconium	锆
togavirus	囊膜病毒
immanent	固有
britzka	敞篷四轮马车的一种
northerly	北方的
lysis	病势减退
poll	选举中获得
restive	难控制
seek	寻求
piercing	刺穿
conventicle	非国教徒的非法或秘密聚会
salmi	红烧鸟肉
glucagon	胰增血糖素
palmyra	扇叶树头榈
shh	嘘
gunman	持枪的歹徒
electric	电动
bicentennial	二百年
outerwear	外衣
iconize	把……当偶像崇拜
euphuistical	词藻华丽
short	短路
ruination	灭亡
foolproof	极坚固的
papmeat	软食
napless	磨破了的
rammer	撞锤
cancri	Cancer的所有格
elocutionist	雄辩家
nudicaul	裸茎
resonantly	反响地
utricular	小囊状
concern	涉及
petechial	瘀斑
gunstock	枪托
misarrange	排错
blockage	妨碍
venodilation	静脉扩张
fear	敬畏
pilatory	生发剂
hooverize	节约厉行节约
superficiality	浅薄
soucar	放债人
turn	轮流
ue	Machine
empoison	放毒药
expressman	递送工人
myxoid	黏液样
leaven	使发酵
unendued	未赋予的
entirely	一概
impermanent	非永久
autocontrol	自动控制
sympatholytic	阻滞交感神经
width	宽广
rareness	稀薄
songlet	短诗
eschatocol	结尾条款
drawly	拉长语调
trisulphide	三硫化
aneuria	精力衰竭
godparent	名义双亲
righto	对
durable	耐用
thomasina	托马西娜
oriflamme	旗帜
toluidine	甲苯胺
shield	护罩
epsom	Surrey
runtishness	矮小
existing	现有
agonistic	竞赛
tubulate	为……装管
reductionism	简化法
runtishly	发育不良地
thalia	塔利亚
corny	谷类
parachutist	跳伞人
discard	抛弃
uprising	起义
overpowering	压倒性
textual	原文
kgps	千克秒
libido	性欲
evangelization	基督教化
cyclonology	旋风或飓风之研究
unworthily	可耻
gettysburg	盖茨堡
amendatory	修正
correlative	相关
ssid	ID
surge	放松
inductivity	感应率
theorise	=theorize
leaning	爱好
bovine	牛的
antibody	抗体
demanding	苛求的
mannan	甘露聚糖
fasciated	簇生的
mitigant	缓和
unionist	联合主义者
dormouse	冬眠鼠
impoverishment	贫穷
undoubled	松开
webworm	结网毛虫
shunter	能干的组织者
hubbard	笋瓜
jugal	颧骨的
lookit	听着!
cumulate	累积
beekeeper	养蜂人
zapu	Union津巴布韦非洲人民联盟
superinfection	重复感染
insobriety	头脑不清
vertical	垂直面
dehortative	劝阻
reapply	再运用
lcvp	vehicle
accredited	可信任的
rundlet	隆勒
agglutinative	胶合性
abridgement	删节本
strickle	油石
slam	冲击
involve	潜心于
arhat	阿罗汉
influx	流入
gainfully	有收入
rampart	城墙
kilocycle	千周
tractive	牵引
implausible	难信
sawbuck	锯木架
adrastus	阿德拉斯托斯
rhapsode	史诗吟诵者
toque	羽饰丝绒帽
biplane	双翼飞机
dewalee	排灯节
mummerset	玛迈塞特
undraw	被……拉回
overtime	超时
excruciate	使苦恼
theroid	兽性
geometer	尺蠖
raob	探空仪观测
contrariwise	顽固
gmwu	and
sakel	=Sakellaridis
vergilian	似弗吉尔之诗的
table	嵌合
mutch	帽子之一种
iceman	善于在冰的行走的人
overly	极度地
maculate	有斑点的
sanctified	批准的
bullish	上扬
hieratic	僧侣用
condyloid	髁状的
nysa	=Neisse
millwright	技工
commeasurable	可相比
sunghua	River
shakable	可动摇的
oculomotor	眼球运动的
replicable	能复现的
incorruptibly	不被腐蚀地
sketch	拟定
nanjing	南京
camas	北美产的百合科植物
verifiable	能证实的
aneroid	不利用液体的
indistinction	不清楚
brimful	盈满
moneyman	投资者
unbolted	未上栓的
uncontroverted	无争辩的
irrigator	灌注器
slept	sleep的过去式和过去分词
epiclesis	求降圣灵文
tinned	罐头
dlitt	literature/letters
patrol	巡逻
landgravine	领主夫人
meteyard	评价基准
ase	美国证券交易所
mollescent	易软化
hazing	受辱
course	跑道
preferable	更优越的
clamorously	吵闹
fanged	有毒牙的
aquatel	水上旅馆
downhouse	美国南方
dossier	档案
dypass	通道
colorant	着色剂
untenanted	未被租赁者占用的
pensive	沉思
astrict	束缚
or	或者
patient	病人
venerably	尊敬
acervate	簇生
lagger	落伍者
ectosarcous	原虫外膜
tanniferous	含丹宁酸
odorless	无嗅
simplicidentate	单门齿目
literacy	有读写能力
dirty	下流的
flyby	飞越
decayed	朽了
bassi	低音歌手
pricket	蜡烛扦
stupid	乏味
perfecta	=exacta
underpass	地下道
fateful	致命性
purl	用倒针编织
reticula	网状的
diageotropic	横生
marcasite	白铁矿
evaporator	蒸发器
birthparents	未婚父母
hairlike	毛一般
some	pro
connivent	逐渐集中的
chemiluminescnet	化学发光
fian	<fianna
jow	敲钟
snelskrif	斯耐斯克利夫速记
stunt	惊人表演
groom	马夫
melomane	=melomaniac
terne	镀铅锡铁板
coat	包上
roadbed	路基
snooker	彩色台球
swab	药签
dispersion	散射
vsam	虚拟串行访问方法
ceratodus	澳大利亚肺鱼
legionary	军团的
sandbank	沙洲
gastral	胃
tabularize	把……排成表格式
connubially	夫妇般
curtsy	行屈膝礼
musky	麝香的
jocko	黑猩猩
ungraceful	不优美的
bettor	打赌者
unpaying	无利润的
tigrine	虎
duchy	直辖领
socket	插座
kbe	of
algerine	阿尔及利亚的
conamore	带着爱心
socinian	索齐尼派教徒
moisturize	增加水分
solitarily	独自一人地
auspice	吉兆
missile	发射物
dishonourable	不名誉
cupferron	铜铁灵
parlay	连本带利的赌博
decamethonium	十烷双铵
piscataway	皮斯卡塔韦
beamed	定向
ratheripe	早生的
allegorist	讽喻家
cockamamie	繁琐的
tenor	男高音的
unicameral	一院
catamount	野猫
polynomial	多词学名
muff	接球失败
superlatively	最高
unlessened	未减少
doggo	静静躲藏着地
frowardly	固执地
unnoteworthy	不显著的
revivify	振奋精神
tersely	精练地
physiatrics	物理疗法
gabion	篾筐
profitably	有利地
interstice	裂缝
leasing	谎言
protopope	首席神父
adjacence	毗连
riba	Institute
sinter	泉华
spanking	显著地
grovy	树丛般
catch	抓住
diagonal	对角线
phosphoglucomutase	葡萄糖磷酸变位酶
memorialist	递请愿书的人
tzarevna	=czarevna
dustbinman	环卫工
drossy	铁渣
charactery	用文字表达思想
radc	Royal
tacan	塔康
odorize	给……加臭味
scuzzy	邋遢
trencher	战壕兵
odin	欧丁神
desirability	愿望
strafe	损害
azobenzene	偶氮苯
predictability	可预言
chicago	芝加哥
federative	联合
lapsible	应消失的
sociopolitical	同时涉及社会和政治
barostat	气压调节器
unwatched	未受监视
yearn	想念
bronchogenic	产生于支气管
lubricity	光滑
complyingly	顺从地
awesome	可怕的
movable	变动的
mesh	啮合
covenant	盟约
spyglass	美国spyglass公司
scent	气味
zebra	斑马
bundobust	安排
zillion	无法计算的大数字
combat	搏斗
astroid	星形线
cqd	quick
monogenean	单殖亚纲动物
campimeter	视野计
emporia	大百货店
execution	死刑
ashpit	火炉的灰坑
pragmatism	实用主义
pop	突然伸出
leeway	回旋余
gray	阴沉
faceplate	面板
secta	诉讼
rallyingly	挖苦
hemispheroid	半球体
furcate	叉形
wasteplex	废物再循环联合企业
stadia	视距
flagelliform	鞭状的
haulyard	=halyard
vomit	呕吐物
pregnant	怀孕
flock	羊群
misplug	误插
traditor	叛教者
sincere	真实
potboiler	粗制作品作家
venter	子宫
dry	干的
silvern	银
hammy	火腿味的
untrammeled	自由自在
simplehearted	纯朴真诚
prakrit	古代印度语
mangey	=mangy
base	以……作基础
genealogical	家系的
leh	列城
transthoracic	经胸廓的
setiform	刚毛状
nasty	下流的
lacrymal	流泪
windward	上风的
habitation	住所
lathework	花纹图案
descriptively	叙述
onrush	奔流
dript	滴落
plu	people
extramundane	物质界以外的
alcayde	狱吏
dicastery	审判官法院的开庭地点
voluble	易旋转的
pubsy	酒馆
decury	十人团体
eurystomatous	有可扩展的嘴
lettic	列托语
bundle	捆扎
nonhistone	非组蛋白
acrr	Council
nitery	=nightclub
superintend	管理
blanketyblank	该死的
pure	纯粹
callow	年轻而无经验的
clinicopathologic	[屹床病理
gpm	minute每分钟加仑数
vast	巨大
offering	奉献物
gobbledegook	冗繁而难解的文字或语言
scathe	损害
encephalalgia	头痛
sullenly	阴沉地
playmate	玩伴
crocean	克罗齐
deacidify	使去酸
sixscore	一百二十
misleading	易误解的
deficit	赤字
acores	=Azores
staircase	楼梯
buccal	口
unsubstantial	无实质的
fleckless	完美的
penniferous	有羽的
tawdry	俗丽的
cruzeiro	克鲁赛罗
nonparous	未生过婴儿
visually	真实地
raaf	Force
nervily	强壮
yi	彝语
redhead	红发的人
taintless	无污点
malign	恶毒
lathering	痛打
unserviceable	无益的
nutso	痴狂的
unsmirched	清洁
loom	隐现
hindmost	最后部
hammer	槌
monocular	单眼
simony	买卖圣职的人
rosaria	蔷薇花坛
gi	或
trustfully	信任地
healthful	有益健康
feculent	浑浊
thralldom	束缚
underclothed	穿衣过少
adoringly	崇拜地
glans	阴茎头
dooda	兴奋
otiose	多余
rimous	龟裂
gryke	=grike
inevitable	不可避免的
breugel	family
infectious	有感染力
centrobaric	有重心
erective	直立的
retrain	重新教育
swabby	水兵
defrost	使融化
reexpand	再次膨胀
sailboard	帆板
suspension	悬浮液
punningly	一语双关地
windage	偏差
clastic	可分解
pimply	肿泡
daze	发昏
receipt	收据
prayerless	不做祷告的
disoperation	侵害作用
nitid	发光的
weather	气象
ribosomal	核醣体
fmcs	Federal
postclitic	后附着词
carnify	使成肉质
protractile	突出
edible	可食用
field	田间
consanguineous	密切的
when	什么时候
cppcc	中国人民政治协商会议
normandy	诺曼底
rubbery	有弹力
lingo	隐语
brushy	灌木丛生
alternate	改变
horus	何露斯
lapactic	促泻
biologic	生物
galtonian	高尔顿
zif	Insertion
browsy	浏览性质
victimologist	受害者研究专家
phrensy	=frenzy
xslt	XSL变换
elenctic	辩驳的
dtp	publishing
wifehood	妻的地位
indention	缩排
fit	使合身
aew	空中早期警报
irreconcilable	矛盾的
benthal	海底
seascout	海洋童子军
epilimnion	表水层
fulgid	闪耀
leeway	可允许的误差
fixture	固定设备
soberminded	严肃
durometer	硬度计
unverifiable	无法证实
apt	灵敏
jape	笑话
dsn	Name
exhaustee	财源耗尽者
zigzag	曲折前进
olympic	奥林匹亚
leprous	麻疯病
zirconic	锆
antifertility	抗生育的
gnawing	使苦恼
imperception	无知觉
quarantinable	应受检疫的
implicit	绝对的
annunciatory	预告
appologize	道歉
drear	阴沉的
hornswoggle	瞒
recreationist	行乐的人
lunge	突进
afrikanerdom	南非白人民族主义
photosensitisation	=photosensitization
antifebrile	解热剂
sabrecut	马刀的劈砍
spiel	饶舌
heft	重量
envier	羡慕者
teacherless	无师自通
extractable	可引出的
regressive	回归
octodecimo	十八开
suasive	有说服力
nephrotoxic	足以危害肾脏
kinesis	由外界刺激引起的不随意运动
bonus	红利
bulkily	笨重
official	正式的
landrace	兰德瑞斯猪
okro	=okra
supernova	超新星
mortal	人类
immersible	可浸入的
double	两倍的
unswerving	不歪
immerge	隐没
indisposition	不想
caller	传唤员
acquisition	获
epural	在尾部
feirie	健壮的
spatchcock	杀后立刻烹调
parison	雏型
muddle	鬼混
coony	狡猾的
recapitulatory	概括性的
scotophilic	适暗
jargonel	一种早熟的梨
rectrix	舵羽
manager	管理人员
sternutatory	催嚏剂
two	二
foxglove	毛地黄
tombak	一种铜与锌的合金
bollard	系船柱
lacrymal	泪壶
unsexed	失去性征的
daimler	英国的高级汽车名
hemostat	止血剂
hypercholia	胆汁分泌过多
excavate	挖空
tome	册
sap	挖坑道袭击
laudanum	鸦片酒
antimony	锑
forementioned	前述
alveolate	多小孔
ashiver	颤抖的
executive	经理主管人员
iis	Internet信息服务器
relative	有关系的
tass	Telegraph
run	运行
lento	徐缓的
surpliced	穿白袈裟的
elaphine	红鹿的
circumspective	细心
ultimate	根本
glottis	声门
lassell	拉塞尔坑
picked	精选的
necrophil	嗜尸成癖者
decollete	低颈露肩
bringdown	使感失望
dissolutely	放荡
heteronymous	相关而异名
uncontemplated	意外
beak	喙
coincident	符合的
amicron	超微子
licetus	峭壁平原
phonasthenia	发声无力
acrylic	丙烯酸的
tomfoolery	愚蠢的举动
felspathic	长石的
zulu	祖鲁族人的
bba	bachelor
loadability	载荷率
collet	装筒夹或夹头
haemathermal	温血的
force	强加
shelf	搁板
filicin	失水绵马酸
bariatrician	肥胖治疗专家
caulomic	和茎结构形态相当之结构的
apartness	冷漠
refusable	可拒绝的
clc	Congress加拿大劳工大会
combination	化合物
ankylose	胶住
knop	球形装饰物
enclitic	附属
protrusive	突出
mm	Myanmar
emblematize	成为……的标记
counterreaction	逆反应
ada	Augusta
triboelectric	摩擦电的
handkerchief	手帕
unconfessed	未认罪忏悔的
crustless	无硬皮
uncreased	未起褶痕的
handpick	精选
assimilable	可同化的
singaporean	新加坡的
nefandous	说不出口的
npcf	National
subcontrariety	下反对关系
abbe	僧侣
exuberant	丰富
infirmary	救济院
largando	渐慢和渐强地
dispope	剥夺教皇的尊严
ternary	三重的
eely	易滑脱的
geoponic	农业的
measurable	可测量
spongy	多孔而有弹性的
multilane	多车道的
molluscoid	软体动物似
cote	棚
huntsmanship	狩猎术
pacificator	抚慰者
spittlebug	沫蝉
squire	律师
befuddle	使迷惑
opposed	反对
fibroelastosis	纤维弹性组织增生
dissatisfied	不高兴的
tourane	土伦(越南中部港市岘港
arboraceous	长满树木
chrism	圣油
comportable	适当
substitution	置换
multivitamin	多种维生素的
cameralistic	财政的
tar	焦油
hemichordate	半索海生动物纲
guyanese	圭亚那居民
ordinance	圣餐礼
pyroxenite	辉岩
newish	稍新
bushy	浓密的
undutiful	未尽职
inundation	洪水
multiplicable	可增加的
phenocryst	显斑晶
posturize	作出特定姿势
hera	Rocket
symmetrical	均匀的
cutesy	忸怩作态的
earthling	俗人
rf	Frequency
puzzler	难题
story	事迹
glomerule	团伞花序
antelucan	黎明前
breezy	轻松愉快的
affinal	姻亲的
raticide	灭鼠药
confoundedly	非常地
swage	用型铁弄弯曲n
adversity	灾祸
double	两倍
unequally	不相等
fructosan	聚左旋糖
vauntingly	吹嘘地
inveracious	不真实的
clarionet	木箫
outshoot	突出
academize	使……成为刻板传统
anticarious	抗龋的
diphtherial	白喉的
glucoprotein	醣蛋白
hawk	像鹰一般地袭击
picaresque	以歹徒为题材
lassie	少女
checkrein	马缰
fog	雾
malpighian	马尔皮基
insectival	似昆虫的
variform	有多种形态的
smudge	熏烟
scripturally	根据圣经
edacious	贪吃
loricate	有甲壳的
aphanitism	隐晶岩
ebullient	热情的
unsophisticate	不懂世故凳
kilorad	千拉德
fogy	赶不上时代的人
unfrequented	人迹罕到
oversea	海外的
call	打电话
parallelogram	平行四边形
micawberism	空想的乐天主义
eclipse	食
mincemeat	甜馅
industrious	刻苦
loser	失败者
kgb	苏联国家安全委员会
bandhnu	扎染
pellagra	糙皮病
vigoroso	强
sell	卖
lewd	猥亵的
unshirted	不加装饰的
ranchette	小牧场
iv	intravenous
tropism	向性
oup	University
mordacious	咬痛
suture	缝合处
rechoose	再选择
fifthly	第五地
dichromic	重铬的
pachuco	少年流氓
stile	墙
silkscreen	丝网印刷的
gimpy	瘸的
hottish	热乎乎
pressingly	强求地
angelical	天使般的
illfare	不幸福
palmful	一把
parrotfish	隆头鱼
feudalize	使成封建制度
unsccur	Conference
wacky	古怪的
unwarned	未受警告
material	物质
nomarch	省长
pulsar	脉冲星
prisunic	独价商店
conjecturable	可推测的
aureate	灿烂的
fieldwork	实地调查
vhf	High
unspecific	不具体
hexarchy	六盟国
chromous	含二价铬
gramineous	似草
tousy	蓬松
panplegia	全瘫
waec	Economic
overnutrition	营养过度
shortia	杖草叶岩扇
porky	肥胖
pollster	民意测验专家
billowy	汹涌的
burnable	灼伤的
approximative	近似
jehoshaphat	约沙王
occurent	正在发生
unsavory	难吃的
dumpy	矮胖的
tackle	工具
anticancer	抗癌的
spline	止转楔
postern	后门
funnyman	滑稽演员
abysmal	无底的
ripply	潺潺声
bev	千兆电子伏
sciophyte	阴地植物
ratproofed	作了防鼠处理
revolvably	能被旋转地
isd	国际订户拨号
lactogen	催乳激素
throe	阵痛
lie	展现
rockless	无岩石的
recriminative	反控诉的
intarsiate	木造镶嵌细工
cpi	消费者物价指数
hometown	故乡
exclamation	感叹惊叹
ovular	胚珠的
spherular	小球体的
sophist	博学者
deflection	偏斜
telegraph	打电报
nee	旧姓的
flexuous	波状的
derivative	引出
morbidly	病态地
coarsely	质地粗糙地
sideroscope	铁屑检查器
posted	有地位的
renomination	再任命
working	工作方式
bowdlerize	删改
functionalist	机能主义的
tautog	遍罗
kalmuck	其语言
tumefy	浮华
tgwu	General
kickapoo	基卡普人
violable	易受侵犯
dishonor	不名誉
crapshooter	赌双骰的人
auctioneer	拍卖
bedside	床旁的
miotic	缩瞳剂
ladykin	小妇女
gpd	per
baldish	秃头的
denny	丹尼
shortcoat	给穿第一套童装
corymbous	伞房花序
subversal	=subversion
nonstandard	非标准的
sidetrack	导入侧线
gharry	马车
persuade	说服
personal	人称
astronautical	太空航行学的
strain	扯紧
oilpaper	桐油纸
woodranger	森林警备队队员
euglobulin	优球蛋白
put	固定不动
exploration	踏勘
devotional	祷告
baddy	恶人
unexamined	未经权衡
antimycotic	=antifungal
chronaxie	时值
hematemesis	咯血
besom	长扫帚
smartly	漂亮
consonantal	辅音的
capitalintensive	投资密集的
clonicity	阵挛
neuromotor	神经运动
shaving	刨
terephthalate	对苯二酸盐
knobbly	有节
pillow	枕头
chariot	战车
amalgam	汞齐
superindividual	超个体的
reman	重新补充人员
browser	浏览器
loco	用疯草毒害
overdraft	透支之款项
psephite	砾状岩
crenated	圆锯齿状的
estreat	审判记录之抄本
flabbily	软弱
course	一道菜
inquietly	不安
squirrely	古怪
sole	唯一
grist	谷物
tenorite	黑铜矿
fac	forward
wilding	野生植物
oxalate	草酸盐
conceit	狂妄
gunn	基于耿氏效应的
auckland	奥克兰
palmation	手掌状
overland	陆路
fallen	fall
unhealthy	不健康的
jagged	参差不齐的
disclaimer	拒绝
following	在……之后
calescent	增温的
tdn	可消化的养分总量
mumpish	愠怒
internally	在中心
untrue	不正确
instrumentalism	乐器演奏家
dixie	美国南部
become	变成
velvety	象天鹅绒的
housebreaking	拆屋
ptilopod	脚上有羽毛
lisping	口齿不清的
postpone	使延期
bibliographic	书籍解题的
thin	稀薄的
unsureness	缺乏自信
dermatography	皮肤论
derailment	出轨
washy	乏味的
hop	单脚跳
tolerant	有耐药力
overturn	革命
graven	grave的过去分词
laurustine	一种常绿灌木
headmaster	英国中小学校长
fascine	粗杂材
impuissance	无能
robust	精力充沛
rabbinical	希伯莱语的
asgard	仙宫
acrasin	聚集素
honeymouthed	嘴甜的
stench	臭气
brightness	聪明
excavation	挖掘
educationalist	教育学者
submedian	位于近中央处
gymkana	运动会场
hadhramautian	哈达拉毛的
rosarium	蔷薇花坛
destructively	破坏
inviolate	未受侵犯
mightily	强烈
amuck	疯狂地
cubism	立体派
occasionality	偶然性
infirmity	缺点
super	/
touch	提到
testosterone	睾丸激素
tearing	痛苦的
prehistorian	史前史学家
emulously	竞赛性
parlor	客厅
humidistat	恒湿器
treason	背信
entanglement	纠缠
diastyle	柱间距离等于柱径三倍
wallach	=Walach
categorize	加以类别
xanthium	苔儿属
furnishings	穿戴用品
marginal	边缘的
mandatory	托管
eyelike	眼状的
snide	卑鄙
gemmulation	发芽
lusty	健壮
diapason	全协和音
branchial	鳃状
wean	幼儿
tardyon	慢子
unaffected	真挚的
diorama	西洋景
scorpionis	Scorpio的所有格
larruping	与众不同
aghast	吓呆
lowland	苏格兰低地
cuddlesome	适于拥抱的
literati	文学界
adductor	内收肌
drumble	动作缓慢
xerarch	在干旱地发展
biased	结果偏倚的
chiefless	没有首领的
garlicky	有大蒜气
fane	神殿
blunderbuss	蠢材
quillet	借口
fallol	做作的
sestertium	古代罗马的货币单位
fine	精细
unvaryingly	从无变化地
wheelwork	齿轮装置
niggertoe	巴西果
scissile	易切断
preelection	预选
home	家
honeymouthed	甜言蜜语的
encephalogram	大脑摄影图
pebbly	有卵石花纹
salzgitter	扎耳茨吉特
recolonization	开拓殖民
frequent	频繁
lotion	洗液
cantalever	悬臂
haematite	赤铁矿
espousal	订婚
tailforemost	=tailfirst
shoji	screen
larine	象鸥的
tartrated	含酒石
swagged	挂着帷幕的
dog	类似犬的动物
beneficent	仁慈
vtp	Protocol
unordinary	异常的
carved	有雕刻
basal	构成基部的
disbench	剥夺法学会会员之职
understand	听说
point	加标点于
stretcher	延伸器
earring	耳饰
bta	British
unbenefited	未得到好处
strumae	瘤状突起
calcareously	钙质
unprovided	无支援
whimsical	古怪
lazyish	有点儿懒惰
gawky	迟钝
windward	迎风
digitate	趾状
alleviate	减轻
upland	丘陵地
salicylamide	水杨酰胺
perissodactylate	奇蹄的
individualism	个人主义
achromycin	四环素
vitligo	白斑病
castanet	响板
viviparity	母体发芽
indagator	调查
coastal	沿海
plasticine	代用黏土
stroy	=destroy
pewit	田凫
summarily	概略地
querulously	易怒地
emmenagogue	调经剂
slavism	斯拉夫气质
continual	持续不断的
unrelatable	不相关
scoundrelism	无赖的
trover	取
pulverization	弄成粉
decidedly	断然地
auricle	外耳
rumrunning	酒类走私
irritably	暴躁
incalescent	渐热
rollicksome	嬉戏耍闹作乐
interfinger	相互贯穿
gastronomical	美食法的
unanimous	无异议
yearningly	同情地
bourse	交易所
unload	摆脱……之负担
rehospitalization	再入院治疗
zymometer	发酵计
furcate	分叉的
gastroscope	胃窥器
aluminiferous	产铝
agreed	已经过协议
ethylation	乙醇盐
fastidious	难取悦的
holistic	全盘
peach	桃树
ornamental	装饰的
septuple	七倍
hermeneutic	圣经注解学
colpitis	阴道炎
indicative	预示
longe	练马长绳
thatchy	多茅草
cleruchial	古希腊将征服土地配给公民之制度的
monad	单细胞生物
ideation	构思能力
kosher	使合适
metepa	三膦化氧
seceder	分离者
exchangeable	可交
gap	缝隙
strangury	痛性尿淋沥
wild	狂热的
californian	加州的
noncontrastive	不对比
wosa	System
hog	肥拱起
admitted	被确认无疑的
reirradiate	再照耀
commutate	使方向转换
recommission	再编入服役
industrious	勤勉
incalescent	渐热的
orinasal	鼻化元音
firebox	火室
bulbous	球根的
stannum	锡
contentedly	满足地
inlay	镶嵌
baking	一次烘焙的量
europeanise	=Europeanize
supergranular	超米粒组织
acceleratory	催促
atrabilious	疑心
bronchobuster	驯马师
macroprocessor	宏处理程序
confessant	忏悔者
dinghy	小舢板
waratah	特洛皮
aristotle	亚里斯多德
soaraway	腾飞的
sesamin	芝麻素
carbamyl	氨基甲酰
tetracarpellary	四心皮的
fornicate	弓形
middy	海军校生
logging	伐木搬运业
opaque	迟钝的
tabid	憔瘦的
coquilla	巴西棕坚果
tangent	正切
intragalactic	银河系内的
expectancy	期望
underhand	阴险
sleazy	廉价
unjustifiable	不合道理
dairy	售牛奶
asinine	愚蠢的
tessellation	镶嵌成小方格
dekalitre	公斗
petty	细微的
dissociably	可分离地
unpolitic	=impolitic
sib	有血缘关系
perfect	精通的完成式
prooestrus	发情前期
quarter	季
thrown	throw的过去分词
pide	国际及卫国警察
dazed	眼花
technopolitan	技术社会的
whizz	专家
frigidly	冷淡
cheralite	富钍独居石
aether	醚
euphuism	美丽辞句
umangite	红硒铜矿
lender	贷方
uroscopy	验尿
bellows	风箱
bitnik	比特族
azotise	=azotize
stockbrokerage	证券经纪商的业务
rummy	奇妙的
luthier	拨弦乐器制作匠
abridgable	可以删节的
unlash	松开
expellent	具有驱逐力的
msph	Public
tupian	图皮人
tinglass	铋
scar	伤痕
trailer	乘拖车式活动房屋旅行
kern	紧排
saucier	调味汁厨师
lilacky	淡雪青
porker	肥小猪
photomontage	蒙太奇照片
transigent	妥协的
subdecanal	副院长
crowded	拥挤
make	开始
mover	鼓吹者
voluble	流利的
assistant	助教
bifunctional	具有两种不同功能的
nortriptyline	去甲替林
nimbostratus	乱层云
floorer	铺地板者
second	赞成
masked	伪装
subcompany	附属公司
ctol	takeoff
triphibian	陆
hun	破坏者
characterization	人物之创造
crossroad	歧途
thoracal	=thoracic
baleful	有害的
driftage	流落
pecuniary	应罚款的
empiricism	经验主义
insubordination	反抗
earthlight	地球反照
twentymo	二十开
faint	暗淡的
cry	叫喊
anecdote	轶事
marzine	=Marezine
travelog	旅行见闻讲座
desublimate	使失去升华机制
truculence	残酷
shellless	无硬壳
ellipticity	椭圆率
chromatron	栅控彩色显像管
forktail	尾巴开叉的鸟
pericynthion	=perilune
hexabasic	六盐基的
variety	种种
narc	缉查毒品的刑警
hypnogenetic	催眠的
censurable	该责备的
engraft	使牢记
getaway	逃亡
oneirocritical	解梦
bandy	传播
undershorts	短衬裤
frass	蛀屑
vichyite	拥护维希政府者
dichromatism	二色视
isochromosome	等臂染色体
disprize	低估
taxonomist	分类学者
waylay	抢劫
torsional	扭力的
unfasten	解开
inobservantly	怠慢地
lithonephritis	石性肾炎
amrita	甘露
plagiotropism	斜向性
aleuronic	籽朊粒
gst	time格林尼治恒星时
barf	呕吐
foregut	前肠
sowback	沙丘
hydrographer	水道学者
vera	=very
keratose	角质
snide	不诚实
lending	出租
exequatur	许可证书
bike	脚踏车
bombardon	低音大号
holophote	全反射镜
friesland	弗里斯兰省
hifalutin	=highfalutin
signior	绅士
koan	心印
set	Secure
coagulative	凝结物
longshanks	长腿的人
cool	使镇定
puling	哀鸣
tylopod	趾底有肉垫
delir	经历幻觉
periauger	帆驳船
hook	钩
resistibility	可抵抗性
misaligned	方向偏离
savoury	香喷喷的
behead	使其他河川的水流入自己河中
functional	功能的
twisty	扭曲
kitchenette	小厨房
epndb	noise
medley	杂乱的一团
ecliptical	黄道的
fortitude	坚韧
tabs	制表符
recessive	隐性性状
feat	技艺
pya	分
ralliform	似秧鸡
euchre	欺骗
relative	相关物
spill	暴跌
null	等于零的
frequently	经常
uml	Language
moonscape	月的表面
enigmatical	谜一般
eruct	打嗝
criticism	批判
egomaniacal	极端利己
gagaku	雅乐
cloyless	不会倒胃口
aspartase	天冬氨酸酶
dearness	亲爱
monosymptomatic	单症状的
duff	笨拙的人
heterosporous	具异形孢子
unfelt	不感动的
rattlebrained	头脑空虚
elect	选举
underpowered	动力不足的
lymphangial	淋巴管
perikaryon	核周体
wholesomely	卫生
wealthily	丰富
biunique	单向双系列对应
meshuga	发疯似的
urinose	含尿的
agonising	烦恼的
baronial	宏大
hermitry	遁世
circlet	小圈
dawson	道森
electrical	有关电的
annoying	恼人
vagabondage	流浪者
anarchic	无政府主义的
iht	International
ctd	and
heptasyllable	七音节的字
inductorium	感应圈
baffleplate	障板
batboy	棒球队球童
smoky	烟熏味的
grain	粮食
rebeck	三弦琴
alarmable	会被惊恐的
tigris	底格里斯河
reuptake	再摄取
pithily	简洁
homologous	一致的
plaga	纹
inner	内部的
eternity	不朽
intended	故意
inherent	与生俱来的
biogenic	生物所造成的
hardenable	可硬化的
lacunate	=lacunal
etic	语音学
stager	经验丰富的人
corbie	候鸟
crevasse	崩溃处
thornbush	多刺高灌丛
pandanaceous	露兜树科
chemosmotic	化学渗透作用的
undergo	经历
carl	卡尔
irisher	爱尔兰系的人
gentlehood	名门世家的地位
martial	战争
careful	仔细
victimless	不侵害他人的
menticide	精神扼杀
recast	彻底改动
eyeshot	视野
breakdown	细目分类
cerastium	耳草属
graylag	灰色雁
midsplit	中分
distinguished	著名
suoloco	在本身的位置上
strategically	战略上
estonian	爱沙尼亚语
rhyparographic	对卑贱事物之描写
popish	天主教
groschen	德国的10便镍币
illegitimacy	私生
jippo	=gyppo
bioclimatology	生物气候学
sulfonic	磺酸基
stoneman	石冢
cardinality	集的势
hypoacidity	酸
enunciate	清晰发言
smithsonite	菱锌矿
trot	骑马
countrify	使有乡村风味
sandiness	含沙
eyewink	片刻
dina	迪娜
ingestible	可吸收
summarily	概要地
prosiness	平凡
dipsey	深海的
seed	种子
autnumber	数目超过
encomium	赞辞
dnb	of
aculeated	有刺
mouthbrooder	口育鱼
exfacto	实际上
massacre	大屠杀
topgallant	上桅
multiformity	多样性
fabricable	能加工成形
ddn	Network
swordbearer	执御剑的人
quadrate	长方骨
availability	可用性
unrwa	Relief
devotional	献身
loco	疯草病
grading	等级
pulmonic	有肺
decoct	熬
hematoblastic	血胚细胞
radiological	放射线学的
micah	弥迦书
acrodrome	脉向尖聚集的
glenoid	浅窝
byplay	配角戏
hipshot	股关节脱臼的
constant	持续
usrc	Corps
flameout	燃烧中断
daqing	大庆
awedness	充满敬畏
peddling	忙于琐事的
titleholder	冠军保持者
sncc	National
isostatic	均衡说
pantheress	雌豹
alder	桤木
uncatchable	捉摸不住的
snackery	快餐厅
enow	充分的
newspaperwoman	报社的女从业人员
scribble	滥写
summons	唤出
openwork	透孔织物
aconitic	附子
nllst	Technology
epeirogenesis	=epeirogeny
present	赠品
peel	剥
coronation	加冕礼
audiogram	听力敏度图
hydrophobia	恐水病
censurable	可非难
diplomapiece	会员资格作品
serjeant	陆战队士官之通称
tumbrel	二轮车
outflung	张开
triskele	=triskelion
pstn	public
spitball	小孩弄的唾液湿纸团
bibliographical	书籍解题
nix	不行!
steenbok	小岩羚
slack	松懈
veining	饰以脉纹
glycose	葡糖
ceroplastic	蜡塑术
whereabout	=whereabouts
fog	尘雾
raintight	不漏雨
noncellulosic	非纤维素的
semipostal	高价邮票
ames	test
runologist	如尼文字学家
glabella	印堂
jade	玉制的
councilman	议员
aborted	流产
falderal	廉价的装饰品
passively	顺从
circean	使人着迷的
validly	妥当地
nonpersistent	非持久的
nuciform	核子状的
vigorous	健壮的
coccyx	尾骨
subtle	狡猾的
imprest	预付的
shock	浓密的
citramontane	阿尔卑斯山北侧
windless	平稳
parcel	捆扎
sinople	赭石
exponible	可说明
rembrandtesque	伦勃朗风格的
phthisis	肺结核
mulatto	白黑混血儿
cruller	油煎饼的一种
fungi	似真菌的
contiguously	连续地
factum	自己的行为
chimera	羊身
extant	突出
pndb	noise
disappear	不见
ammoniated	与氨化合了
steam	蒸发
amblyoscope	弱视镜
asyndetic	使用散珠格
gothamite	蠢者
secessionism	分离主义
undersecretariat	副部长
woorali	=curare
exploder	放炮器
leachate	沥出物
hill	丘陵
touzle	=tousle
kibed	生冻疮的
garret	顶楼
humaneness	慈悲
frowst	不通气
asper	阿斯皮尔
phratry	氏族集团
brahmanic	婆罗门的
propagation	繁殖
rattlepated	头脑空虚
weatherstrip	挡风雨条
nietzschean	尼采哲学的研究家
wittiness	临机应变
lapse	失误
soar	昂扬
fittest	适当
bolter	筛面粉的机器
culch	废物
unsolvable	无法解释
inharmonious	不和睦
fixing	固定
belief	信心
suprathreshold	超阈值的
unsc	Security
cyanidation	氰化法
safeguard	捍卫
tutu	由腰部撑开的芭蕾舞用短裙
leakiness	易泄漏秘密
flyaway	海市蜃楼
hardener	硬化剂
running	赛跑
semipro	半职业性选手或运动员
suburbicarian	设在罗马近郊
hottest	热的
neutrino	微中子
pontificate	装作教皇的说话
intersex	阴阳人
whereunder	在其下
chronically	长期
rsj	Rolled
madagascar	马达加斯加岛
balzacian	巴尔扎克专家
colloidal	胶状
hexahedral	具有六面的
tsipouro	齐普罗酒
grimm	参见Grimm
bull	公牛
cyclopedia	百科全书
weatherability	抗风化力
dog	跟踪
sf	有力
cadmean	卡德摩斯式
fretted	腐蚀
semifarming	半畜牧业
equatorial	赤道的
derivable	可推论的
masterful	专横
roseal	玫瑰色
alyssum	香雪球
enterochromaffin	肠嗜铬细胞的
absolutization	绝对化
exoteric	公开
enervation	衰弱
panglossian	过分乐观者
biographically	传记体地
tortious	侵权行为性质
nuthin	=nothing
familarity	精通
unanimous	无异议的
scene	一场
share	参股
peltast	轻盾兵
twinge	感到剧痛
roundeye	欧洲人
contubernal	亲密
historied	有历史
reproduce	繁殖
hetaerae	妓女
corned	盐腌
unbounded	极大
rmt	新马
aquiline	鹰的
visit	游览
squirely	乡绅
semplice	无装饰音的
knapper	破碎器
tamely	温顺
pentamer	五聚物
leadbelly	莱德贝利
edginess	刀口锐利
sorb	吸附
emit	发表
swart	恶性
songsmith	作曲家
suitable	相配
antepaschal	复活节前的
infuriate	狂怒的
administrant	行政官
riotous	暴动的
participialize	使分词化
ferule	戒尺
tilde	加在西班牙语n字上的发音符号
penoncel	=pencel
calvarial	颅盖
acidity	酸过多
safer	safe的比较级
dustup	吵闹
rediscount	再折扣
spread	展开
progenitrix	=progenitress
other	另外的
codex	规则
premature	早熟
interlay	插入中间
pinko	左倾
prosaically	平凡
dumb	哑
frond	植物体
intervolve	卷合
discolored	脱色的
telpher	缆车
sodomite	尸奸者
travelog	旅行记录片
prelapsarian	人类堕落前的
sitting	在任期中的
company	连
mazarine	深兰色的
gluttonous	贪吃的
retrofocus	反远距
oxford	牛津大学
traipse	闲逛
keyswitch	按键开关
episodic	插话式的
confirmable	可以确定的
trashy	无价值
yielding	易弯曲的
merciful	慈悲
conglutination	胶粘
phoenician	腓尼基的
aerocab	计程直升机
orthoclase	正长石
irenical	和平的
saprobial	衡量水生环境有机污染度的
slenderize	使苗条
osteosclerosis	骨硬化
photophilous	喜光的
atheroma	动脉粥样化
scopulate	帚状的
nippy	凛冽的
dreamful	梦多的
wildcatter	投机份子
plainspoken	直言不讳的
draughty	有隙缝风吹入
centerboard	中插板
ratemeter	记数率计
corned	弄成细粒
fragile	易碎
playboy	寻欢作乐的女子
bivariate	二变量
haymow	干草堆
rhyme	韵
monoacid	=monoacidic
invader	侵略者
bigotry	固执
rf	无线电射频
sprite	鬼怪
rsd	都柏林皇家学会
converse	颠倒的
galtonian	高尔顿著作的
antiproton	反质子
ardently	热心
caseophile	嗜干酪者
burst	突然破裂
calls	调用
undiluted	未冲淡的
lamprophonia	声音的响亮和清晰
fortnightly	每两星期一次的
intrastate	州内的
lacertine	蜥蜴
cornishman	康沃尔郡人
ridicule	奚落
scotland	苏格兰
antalgic	镇痛
remigration	再移民
jerk	反射
maravedi	西班牙金币
sigmoid	C形的
admeasure	分配
talc	滑石
msfm	Management
carices	carex的复数
enthralment	奴役
fall	秋天
ppm	minut
contrition	悔悟
xxx	X级片或内容
coactivated	共激活
highgate	海格特墓
carlovingian	加洛林王朝
anticyclonic	反气旋
faineancy	忽略
christie	=Christiania
noseless	无喷嘴
municipality	市政当局
fullery	漂布工场
facial	面部
benactyzine	胃复康
atonement	弥补
monistical	一元论
blur	污点
thwartships	横向
plattensee	=Balaton
jauntily	得意洋洋地
chemosmotic	化学渗透作用
skimo	爱斯基摩人
asce	美国土木工程师协会
choice	爱惜的
boy	孩子气的人
trivially	平凡
pityingly	同情地
radiotherapeutics	=radiotherapy
hindmost	最后面
adventuress	女冒险家
unmeditated	自发
pyroclastic	火成碎屑
plaint	诉苦
hemorrhage	出血
orthodoxy	正统
mouse	耗子
aggressive	侵略性
vulgarise	=vulgarize
diminutive	指小辞
granulate	成为粒状
fool	傻
gnomish	好戏弄的
nympholept	狂乱的人
faithfulness	忠诚
undying	不朽
via	经由
jingling	发叮当声
zoaea	=zoea
imagine	设想
micromesh	微型小网眼尼龙
hipped	着迷
purgatorial	涤罪的
infranics	红外线电子学
azure	蔚蓝
hyperpyretic	高烧
lammergeier	髭兀鹰
greyfish	角鲨
gappy	有缺口
dichogamic	雌雄异熟
reductor	还原器
bourtree	西洋接骨木
peacemaker	调解者
octahedrite	=anatase
pervasion	扩散
pettish	闹情绪的
work	职业
abscess	砂眼
prosaically	散文式
hallucinogen	迷幻剂
whole	完全
adjustability	适应性
shelter	身避处
sunlike	辉煌
cooperate	合作
bedrizzle	用细滴润湿
unbesought	未乞求
hub	网络集线器
tenson	论争诗
pretzel	一种脆饼干
warmly	暖和
chapped	有裂痕
woodcraft	林学
vanuatuan	瓦努阿图的
disenchanting	使不再着迷
responsive	作出响应的
cacodylic	四甲二砷的
dyehouse	染坊
filar	丝状的
civie	=civvy
wink	瞬间
karyotin	染色质
special	特别
multidialectal	种以上方言的
digitated	指状的
sublime	升华
ogreish	恐怖
remigrant	返回迁移昆虫
novelize	编成小说
dinkum	可靠的
mesquit	豆科灌木
firetrap	无太平门的建筑物
udt	Uniform
