onfound	使混淆
hypobaric	低比重
vibrator	振动器
slavophil	亲斯拉夫人
bamboozle	欺骗
scholar	学者
invariance	恒定性
lowlands	苏格兰东南部的低地
simpleminded	率真的
incapsulate	压缩
golly	神
neutralisation	中立状态
postoffice	邮局
internuclear	核间的
landeshauptmann	州长
lutrine	象水獭
syphilotherapy	梅毒的治疗
taoist	道教的
etymon	词源
retrospective	回顾的
storiology	传说研究
infuse	灌输
compressional	与压缩有关的
olg	Low
viking	北欧海盗
cystic	胞囊的
traffic	交通量
carbonatation	二氧化碳饱和
unforested	未造林的
briony	=bryony
exorability	心肠软
luciferous	明确的
sagely	贤能地
reportable	值得报告的
manxwoman	马恩岛女人
prodigalize	浪费
emiction	小便
volumetric	测定体积
regret	悔恨
fluxion	不断的变化
trengganu	丁加奴州
grade	评分
frailish	无力
sewer	缝具
flee	逃
apt	易于……的
gluttonous	贪吃
amyloid	淀粉体
inappropriate	不适当
coalbox	发黑烟的炸弹
hypnosis	催眠
insectual	小虫子似
torreyite	羟镁锰锌矾
ascensiontide	升天节
tinplate	镀锡铁皮
scansion	按韵律诵读
shikotan	色丹岛
megimide	贝美格
sportfishing	垂钓用的
adolesce	如青春期少年般行事
lumber	无用的杂物
chackle	喋喋不休
crepuscle	黎明
reciprocate	酬答
paye	Enter
mendicancy	行乞修道士
band	带子
preterlegal	不合法
intercurrent	并发的
dazzling	眼花缭乱的
sleuth	侦探
oppression	压抑
undertip	对未给足小费
pseudoscorpion	伪蝎
economy	系统
exasperating	气死人的
janissary	土耳其兵
neocosmic	新宇宙论
oxford	牛津
unwatched	未被观看
gorgerin	柱颈
eraser	橡皮
lpn	Nurse
fastidious	苛求
deictic	直证
interactional	相互影响
knur	结节
monsoon	雨季
accentual	有抑扬的
mooneyed	眼睁大
mammogen	乳腺发育激素
opiumism	鸦片中毒
amphibiotic	长大生活在陆
expensive	昂贵的
exhumation	发掘
broadcaster	广播员
nonfeeding	不进食的
mesial	中央
flattery	奉承
bathorse	军用驮马
replete	充满
redfish	鲑
carmelite	派的托钵僧的
sjc	Judicial
nullification	取消
conjuncture	接合
solubility	溶解性
biomass	生物的数量
dispatcher	发报机
presto	迅速
throughother	杂乱
fissirostral	有裂喙的
trustee	托管人
merger	合并
asleep	睡着
gambir	苍儿茶
sleepyhead	贪睡者
floccillation	捉空摸床
occultism	神秘学
forbearing	忍耐的
sivaite	崇拜湿婆者
rhetorically	讲究修辞
weedy	杂草多的
hematocryal	冷血
antepaschal	复活节前
incent	激励
prop	支撑
ontic	本体
runless	无得分的
mnemotechnics	记忆术
rigmo	mortis
yellowwood	黄色木材
endosymbiosis	内共生
lime	酸橙
fast	紧紧地
structureless	无定形
coronium	氪
lendable	可借贷
epidermoid	像表皮
cold	不热情的
tacitean	似塔西佗文风的
nondescript	无特征的
urania	掌管天文的缪斯女神
hypermetamorphic	osis/`haIpE9metE复变态的//`mR:
sharkskin	鲨鱼皮
aswoon	晕倒的
cloture	讨论终结
haji	赴麦加朝圣过的伊斯兰教徒
escap	an
tsetse	舌蝇
clasp	抱住
vasoactive	影响血管
commando	水陆装备突击队
puttyblower	射豆枪
colory	色泽甚浓的
hydrotrope	助水溶物
arbitrage	套汇
vocabulary	词汇量
hotly	激烈
conglomerator	联合大企业的领导人
tagrag	褴褛
sortita	出场咏叹调
spar	园材
astatically	不稳定
geometrise	=geometrize
inc	包括
multiparous	非初产
inventory	财产清册
bubby	乳房
undercooked	煎
feathering	附装羽毛状
wettable	可霑
agglutinative	会胶合
stenciller	模板印刷工具
xenolalia	=xenoglossia
succulently	有兴趣地
inclinable	倾向于……
denobilize	降为平民
mill	被碾磨
limpid	清澈
broad	明朗的
meganewton	兆牛顿
velarity	软腭性
optically	视力
praline	果仁糖
irrelevancy	不恰当
tasteful	有鉴赏力
xylophilous	喜木的
winning	动人
ground	地面上的
ingot	锭铁
enrollment	入伍
unseaworthy	经不住海上风浪
patagonian	巴塔哥尼亚人
descriptively	叙述地
exponential	指数
ataxic	混乱
lamellirostral	扁嘴类的
suction	抽气机
sexfoil	六叶性的植物
inscription	题字
cystamine	塞斯塔明
confounded	讨厌
epipastic	撒布用的
sabre	马刀
brainpower	智囊团
getup	服式
arrowheaded	镞状
cripplehood	残废
reprovingly	申斥地
gradual	逐渐的
convalesce	渐渐康复
peer	封为贵族
doctrinist	教义至上主义者
generation	一代人
laryngology	喉科学
vasodilator	血管扩张的
technicolored	天然色
promptness	机敏
rearmament	改良装备
dextral	右旋的
vibronic	电子振动的
unobjectionable	难反对
enigmatical	难解的
formalin	甲醛水
tetraspermous	四种子
goosey	愚蠢
contralateral	对侧
average	通常
hellkite	残忍的人
consistent	坚固
inculpable	无罪
fibroplasia	纤维素增生
boloney	荒谬
pitiable	可怜的
grittiness	坚韧不拔
endotrophic	体内营养的
ignobly	卑贱地
inherency	固有
counsel	忠告
haematologist	血液病学学者
kempt	整洁的
deflationary	通货紧缩
excircle	外切圆
bwr	water
antacid	抗酸剂
trunk	箱形的
divisive	不和
roboticist	机器人专家
tipple	饮烈酒
thresh	打谷
dyspeptic	患胃病的
popish	天主教的
eximious	杰出
traumatic	外伤的
gun	用枪打猎
metropolitan	大城市
death	死亡
nonconformist	不信奉英国国教的
celestine	塞莉斯泰因
arsphenamine	胂凡纳明
almond	杏仁壮物
tripinnate	三回羽状
chincherinchee	球根植物
deep	难懂的
shakiness	颤抖
exertion	行使
choiceness	精选
coleopteran	鞘翅类之昆虫
lerp	昆虫分泌出来的一种蜜
emulously	好竞争
brassy	厚脸皮
radiolarian	放射虫
accessory	附加物
hematoxylin	苏木精
tomorrer	=tomorrow
contraindicate	显示不当
garote	西班牙的绞刑具
physicianship	医生的职位
remnant	零料
stearic	硬脂的
pout	绷脸
newissue	新发行的债券
decanal	院长
admire	赞美
intensification	激烈化
agonisingly	苦闷
mongeese	mongoose的复数
crockery	瓦器
pine	消瘦
anybody	pro
dreadful	可怕
evolutive	进化
msie	Science
adrenergic	肾上腺素
pray	恳求
organdie	蝉翼纱
apostate	背教的
mount	安放
clavate	一端膨大的
fashioned	……风的
plu	like
cartelize	组成企业联盟
done	注定要完蛋
softbank	日本最大的软件销售商
ceuca	African
acropolis	雅典的卫城
telephotogram	传真电报
disband	裁减
sublime	异常
unselfish	慷慨
direct	直接
transfiguration	变貌
dead	突然的
ho	满足
piranesi	即
berime	作诗
vulturous	兀鹰的
undam	使从堤中涌出
adularia	月长石
uptrend	向上
rush	灯芯草
taxless	免税的
damaged	被损坏
exigency	紧急事件
crosswise	交叉地
hieromonk	圣职修道士
blazing	炽烧
propitiatory	和解的
solarism	太阳中心说
smoke	抽烟
incoherence	不连贯
horizontality	水平状态
guttatim	逐滴
walloping	十足
televise	广播
mattress	空气垫
gct	Time
put	固定不动的
sideline	局外人的观点
refractile	折射的
current	当前的
structure	构成
rampike	直立的死树
florescence	开花
world	世界
tannoy	其商标名
sessional	开庭
sapan	=sappanwood
scot	Scot
klunky	残旧
unimpressible	不可印
left	在左面
reencounter	再相遇
unreclaimable	=irreclaimable
defecator	精制机
pericardiac	围心的
brinjaul	茄子
nephrostomy	肾造口术
travoise	旧式雪橇
bejewlled	以珠宝装饰
tragus	耳屏
oystershell	牡蛎壳粉
periapt	护身符
peppy	活泼的
culturist	培养者
adverbial	副词
generous	慷慨的
photolithograph	影印石版
snowcat	雪地履带式车辆
swart	有毒的
anglocentric	以英格兰为中心
footsie	挑逗
shock	震动
pararescue	伞降救援
chronon	假设的计时单位
sforzando	强调音符
myxoneurosis	黏液神经机能病
flocculent	羊毛状的
noser	迎面强风
khanka	兴凯湖
faddist	趋于时尚者
chaser	驱逐舰
itching	贪
vlb	Bus
misinformant	误报者
signatureless	未签名的
gambit	开始
molwt	molecular
ankyloglossia	舌黏连
tosh	废话
costless	不须花钱的
acetaminophen	退热净
prohibit	阻止
hesternal	昔日
crescendo	声音渐增
toilless	不费力的
tensor	张量
joint	接缝
expectative	期待中
tenderness	棘手
backbitten	backbite的过去分词
scan	细看
pedagese	教师行话
cristate	有鸡冠状突起的
apa	Press
semicylindric	半圆柱状
negotiability	可磋商性
curvesome	=curvaceous
cleome	白花菜属植物
rale	罗音
flatter	使满意
unexcited	镇定的
daedalian	巧妙的
pul	普尔
cavu	晴朗与能见度极好
rauvite	红钒钙铀矿
wrung	wring过去式及过去分词
faa	联邦航空局
bedraggled	湿透
phanerocrystalline	显晶质类
jehad	运动
bludger	二流子
anathemata	被咒逐的人
scribbler	小文人
wonderland	仙境
navigation	航海
formulize	用公式表示
serf	农奴
painty	用涂料弄脏的
voudou	=voodoo
cirenaica	=Cyrenaica
gbs	George
aerobatics	特技飞行术
cock	使耸立
effective	有效
kmps	千米/秒
guy	人
breechless	无后膛
larmor	拉莫尔旋进
symphonette	流行交响曲
rugger	英式橄榄球
beachhead	滩头阵
land	陆
pregenital	性前期的
enneastyle	有九柱
exarch	总督
barytone	男中音
prattle	废话
mechanomorphic	机械形成论
crowhop	蹦跳
loudmouthed	吼叫
nsa	National
limacine	蛞蝓的
kickdown	换低挡装置
amethystine	紫水晶质的
rattling	很好
operatise	=operatize
shekarry	猎人
concent	允许
drainless	无排水设备的
face	承认
eave	屋檐
remorseless	坚持不懈
vulturine	秃鹰似
coyly	羞怯地
anthropometrist	人体测量学家
perigynous	周位
bromyrite	溴银矿
situs	位置
monteverdian	蒙特威尔地音乐
unreported	没有报道的
forementioned	上述
gyrose	回状
floodwater	洪水
hypostasize	假设的实在性
drifting	漂流的
audio	声音的
netfs	Film
interpunction	标点
straitness	狭
bojardo	Matteo
sudsy	肥皂一般
railway	铁道
indivisible	不能分割
unguardedly	不留神地
boychik	小青年
pauperism	有被救济的资格
resultingly	因此
orderliness	规律
regretful	抱歉
administrative	行政法
arbitrative	有权仲裁的
beautifully	美好地
iridous	亚铱
polyhedral	多面的
guano	海鸟粪
grantor	让渡人
jeth	印度历的3月
mondial	全世界范围
trendy	新潮人物
homonuclear	同核
ammonification	加氨
radiotherapy	放射线疗法
shampoo	洗发精
oke	好
motley	杂色
bream	鲤科鱼
ichnographically	平面图法地
mearns	The
acrimonious	严厉
coetaneous	同时代的
groovelike	老一套的
unbefitting	不合适
demonology	魔鬼研究
aeropause	适航大气界层
orbicular	完整
soulful	充满热情的
discoloration	变色
nigrostriatal	黑质纹状体的
luster	光泽
primary	初步的
hand	手
sogat	Trades
autohypnosis	自我催眠
umbriel	天卫二
flank	腰窝
croquis	素描
contubernal	亲密的
painstaking	辛勤
peperino	白榴拟灰岩
stylistic	体裁上的
experimentative	=experimental
sack	大袋之量
rigor	严酷
permanently	永存
hokey	虚情假意
steep	不合理的
hematosis	生血作用
sublimely	高尚
petite	细
abidingly	永久地
subchloride	氯化低价物
petty	小规模
holoparasitic	全寄生物的
produce	生产
prance	使腾跃
collodion	火棉胶
man	使振奋
weariful	疲乏的
famous	出名
donga	峡谷
incomparably	无敌地
snow	下雪
jokey	好开玩笑的
subsensible	难以感觉到的
dpn	diphosphopyridine
ogasawara	小笠原群岛
talmudist	犹太法典编著者
unlock	解出锁定
loch	湖
budding	少壮
steady	稳固
subdistrict	分区
photopia	昼视
outflung	扔出
absorptivity	吸收性
trismegistus	=Hermes
facer	平面铣刀
nix	皆无
jingoism	侵略主义
bald	单调
phytogeography	植物地理学
radiovision	无线电视
salami	意大利腊肠
equatorial	赤道仪
fatidic	预言的
planform	平面图
revengefully	燃起报复念头地
continental	大陆性
shikari	猎人
syncretic	汇合
cast	脱落物
unclimbable	爬不上去
astrodome	天体观测窗
winterbeaten	被冰寒所伤
bellpull	钟绳
advertize	做广告
emi	Electro
preconquest	被征服以前的
analphabetic	文盲的
tumble	摔跤
aglow	发红的
parthenon	帕台农神庙
weak	软弱
valued	宝贵
soloistic	独奏
photofabrication	金属表面光刻法
loo	一种纸牌游戏
hangfire	延时发火
zinc	涂锌于
fabian	费边主义
enchorial	属于某地区
pugilistic	拳击的
key	钥匙
chorister	唱诗班歌手
sensed	了解
indigen	土著
malemute	malamute
record	记录
prowler	小偷
pledge	抵押品
dike	筑堤提防
trangam	小玩意儿
asianic	小亚细亚
vliw	very
trashy	无价值的
fiz	作嘶嘶声
misogynous	厌恶女人的
aeroamphibious	海陆空的
puff	肿块
disarm	消除
osb	St
grantee	受颁赠者
knottily	有结地
scopulate	有花粉刷
affinal	同源
believer	信徒
trithing	三行政区之一
flatly	平平
nephrolithotomy	肾石切开术
heterogenous	异种
recursive	回归的
artificial	人造
catchall	装零杂物品的容器
ligurian	利古里亚人
with	由于
delicate	微妙的
swink	做苦工
groovelike	缺乏独创性的
butterfish	溜滑的鱼
schvartzer	黑人姑娘
anticholinesterase	抗胆碱酯酶
garment	外表
utter	发射
hemimorphite	异极矿
beckoning	令人心动
nasality	鼻音性
unscientific	非学术的
aposteriori	归纳的
furry	毛皮
strip	剥去
deportment	行为
mezz	大麻
novel	新奇
arthrotomy	关节切开
quoth	说
archibald	高射炮
tablemate	餐桌同座
kibbutznik	集体农场农民
oily	油滑的
lewd	下流
ravenous	狼吞虎咽的
hebraise	=Hebraize
flagellate	鞭状
arboreal	树的
putridity	腐败
staff	支柱
palliatory	减轻
aglisten	闪烁
questionnaire	调查表
staid	沉静
brash	性急
imagination	想象的事物
tubulure	短颈口
microminiature	超小型
bifilar	双股
cover	包括
traveled	旅客使用的
illative	推理的
farinose	生淀粉的
demonography	有关魔鬼的论述
somersault	翻筋斗
sensitize	使变得敏感
permeate	透过
misgivings	疑虑
authority	权威人士
without	在外
noviceship	=novitiate
slimly	苗条地
implicit	不怀疑的
exhortatory	劝诫
astringe	使收敛
supersound	超音
roughtailed	尾巴粗糙
atomix	本软件的开发组织
cottier	居小屋者
stabling	马舍设备
miscreated	残废的
erma	厄玛
excavation	发掘
diastatic	脱离的
gasless	不产生气体
vaunting	吹嘘
attemper	调度
preexilian	犹太人被放逐至巴比伦以前
composition	成分
baptistery	洗礼用桶
esl	English
hydrate	与水化合
slade	Society
radiology	放射医学
shockingly	非常
footle	浪费时间
fzs	the
aeronaval	海空的
tumultuously	喧闹
bovine	迟钝的
pale	范围
dimuon	双μ子
slide	滑动
expressly	明白地
kk	System
biconvex	两面凸
pagination	标记页数
hypertonic	张力亢进
wraac	Corps
terror	恐怖
fetch	魂
gray	灰色
pappoose	幼儿
calisthenic	美容体操的
nucleochronometer	核子年代学标准
bacteriostasis	阻止细菌繁殖法
dockside	坞边的
collocable	可组合
baptistery	洗礼池
exclamatory	感叹
unreactive	化学上惰性
palmful	满把
patellar	膝盖骨的
proceeding	进行
kist	箱形石坟
pelt	剥……的皮
join	用子目录名取代驱动器符
refer	咨询
lemme	=let
amendatory	改善的
cankerous	使溃疡
roscoe	手枪
put	提出
blackleggery	破坏罢工
undereducated	受教育不足
histophysiological	组织生理组织生理学
refluent	回流的
noumenal	本体
weatherology	=meteorology
pseudoclassic	拟古典
fag	苦工
shoring	利用支柱的支撑
metalliding	金属间化合法
daee	aeronautical
distressing	使烦恼的
catching	有魅力的
haematophyte	血寄生真菌
totemistic	崇拜图腾之种族
tetchy	脾气怪
gaggle	鹅群
complot	阴谋
wreathen	wreathe
uniatism	东仪天主教
caporal	一种法国产的烟丝
parterre	花坛
decillionth	第一千之11乘方
bimbo	尤指浪荡好淫的女人
mastoidean	=mastoid
breastplate	胸甲
cochromatograph	沧分析法的
tricoloured	有三色
segregator	分离者
spittle	吐出的泡沫
referable	可交付
uniparous	每次只产一卵
doum	埃及姜果棕
agnosticism	不可知论
corvet	轻型护卫舰
courtling	小官员
dexedrine	商标名
chrestomathy	诸家名文选集
untrodden	未受践踏
cristated	冠状
slim	无价值
theatricalize	使能演出
pyretic	发烧
exonerative	免除
cirrous	有触毛的
proletarian	无产阶级
subapostolic	十二门徒之后的
hundredweight	重量单位
elgin	marbles埃尔金大理石雕
withe	细枝
publisher	出版者/订阅者
overceiling	超过最高限度的
upswing	高涨
kamaishi	釜石
dysteleology	生活或自然之漫无目标
fatuity	昏庸
silicle	短角果
globelet	小球体
callous	硬结的
anteprandial	饭前
rampant	蔓生的
wend	往
remonstration	规劝
superlatively	无上地
divisible	可分的
postlady	女邮递员
rajasthan	拉贾斯坦邦
mizoram	米佐拉姆
poky	狭小
heliport	直升飞机场
ciseleur	镂刻者
maccaroni	=macaroni
cortex	皮质
dolefully	寂寞地
winded	通风的
crackers	癫狂
convulse	震动
johannisberger	出产的上等葡萄酒
explanate	平坦的
trifle	闭混
loveboats	"爱舟"
transatlantic	大西洋彼岸
unifier	联合者
technicalization	专门化
euchre	以该玩法趁对方疏忽时打嬴
multipack	合装包
dross	渣滓
underwrite	签名
decentralise	=decentralize
dewy	带露水
apiece	每人
garibaldi	夹酸栗果酱的饼干
stereovision	立体视觉
xenodiagnosis	病煤接种诊断法
petasos	赫耳墨斯的有翼帽
nsa	Agency
altarpiece	组塑
faintness	模糊
incommunicability	不能传达
shapable	可成形的
lusty	精力充沛
latent	潜在
dyspepsy	消化不良
pool	石油层
brilliantly	光亮地
brood	孵
photoelasticity	光测弹性学
driblet	少许
lowercase	小写字母
puncture	小孔
unacted	未演出的
reconstituted	再造
inauthentic	假的
muscly	=muscular
bailor	寄托人
guano	在……上施鸟粪或肥料
reseat	使再坐
cynologist	犬类学家
negentropy	负平均信息量
binary	二进位
charge	装满
demophobic	群众恐惧症的
delphian	意义不明确的
cant	隐语
tell	说
faconne	细花纹饰品
encash	付现
rdc	Council
infuscated	被弄糊涂的
scottie	苏格兰人
bitterly	厉害的
frg	Germany
placard	张贴
ganoid	硬鳞
cryptographical	暗lly//
catchpenny	薄利多销的
uncivil	失礼
aerotherapy	=aerotherapeutics
acousma	幻听
campy	不自然
ft	Times
nasa	Administration
sequence	序列
partialness	不公平
replacement	归还
suffer	受损害
spill	使流出
muzzle	上口罩
vibraphone	电颤琴
needless	不需要的
uncomplex	易懂
undefendable	无法防御
sarcoidosis	肉状瘤病
prosocial	亲社会
disharmonize	打破调和
retiree	歇业者
dittybop	笨蛋
undiscussed	未辩论过的
outercoat	轻薄大衣
loun	无用之人
quaky	战栗
cterm	Communications
unerringly	无过失地
numerate	计算
greenwood	绿林
interrupter	阻碍者
inaudibly	听不见似
gilt	镀金
try	试图
timer	定时器
perennial	终年的
star	明星
friended	有朋友陪伴
hallstattian	铁器时代初期文化
vouch	推荐
unaverage	突出的
supercurrent	超电流
craniectomy	部分颅骨切除术
vaunting	自吹自擂
relievo	浮雕
sleepless	失眠
euthyroid	甲状腺机能正常的
coupon	商家的优待券
tenebrous	晦涩的
livingness	活力
feuilleton	小品
star	名角
random	随便
collectedly	冷静地
scabbed	有疙瘩的
uninterrupted	不停
enostosis	内生骨疣
setting	框架
alkalescence	弱碱性
amphioxus	文昌鱼
debt	罪过
elysian	乐土
bloomy	盛开的
recreationist	作消遣的人
frostbitten	受霜害的
thimbu	廷布
prename	名
shelly	有壳
zenocentric	木星中心
cordiality	诚实
belcher	尤指兰色上有白点的围巾
explain	解释
substantive	巨额的
runrig	=rundale
fibrinuria	纤维蛋白尿
rubblework	毛石建筑
craniocerebral	颅与脑
speakerphone	喇叭扩音器
systemless	无秩序的
subtle	精细的
sgi	美国图形工作站生产厂商
pastime	娱乐
formulaic	公式的
holophotal	全光反射
pigheaded	固执的
staggart	4岁的雄性赤鹿
cycas	铁树
myeloblast	成髓细胞
windcheater	一种户外穿的防风夹克
unequaled	无敌的
visa	签准
culicine	库蚊的
hydrology	水文地理学
betwixt	不走极端
extrovertive	偏向于外向的
mincemeat	苹果等切碎混拌碎肉的东西
unforested	未造林
peaceably	和平
secretiveness	隐匿
hexadecane	=cetane
gmt	格林尼治标准时间
hight	被称为
highstick	举杆过肩阻截
vindication	辩明
loophole	射弹孔
ariose	旋律
handwriting	书写体
affidavit	书面陈述
agressire	攻击的
whiz	嗽嗽声
clonal	无性系般
punk	小阿飞
billionth	第十亿的
amatively	好色
confirmedly	坚定地
overhasty	过于草率
stilly	平静
overnight	晚上的
helpful	有益的
tartarous	含酒石
northwards	朝北
hohokam	霍霍坎文化
involute	消失
saddlery	马具
reestimate	再估值
reversed	颠倒的
unneighbourly	不友善
rdac	radioactinium
flop	砰然落下
idiotype	个体遗传型
coexistence	共存
squeegee	用橡胶滚轴压
europeanist	欧洲经济共同体第一主义的
transire	结关许可证
humbly	谦恭
salwar	=shalwar
underpopulation	人口稀少
solidi	solidus
alchemist	炼金术士
thunk	锵
whole	未损伤
complaining	抱怨的
scatterometer	散射仪
gigametre	十亿米
saprobial	衡量水生环境有机污染度
coed	男女兼收
zincotype	锌版
nonadmission	不准进入
evidence	迹象
miniate	涂红色于
slough	蜕皮
pressbutton	电钮
butylate	使丁化
itn	Television
deadborn	死产的
speciosity	徒有其表
splendor	光彩
snout	猪嘴
favour	亲切
decoloration	漂白
vinegrower	葡萄栽植者
thyroidean	=thyroid
bahaism	大同教
forever	永久
anticoherer	散屑器
aminobenzene	氨基苯
ack	接收确认信号
tatting	梭结花边
alienate	疏远
chattily	饶舌
telluric	上
lucidly	清透
atapi	Attachment
corollary	推论
jv	Varsity
authority	典据
gerfalcon	一种鹰
misknow	认不出
sticky	粘性
hydrophanous	水蛋白石的
strata	的复数
curling	苏格兰的冰上掷石游戏
goosy	似鹅的
simony	买卖圣职罪
metacode	元代码
irresistible	不可抵抗
sapient	装聪明样的
fall	倒下
perspicuity	明白
mu	希腊字母第
perfect	完美的
detonation	爆炸
genealogical	宗谱
censorial	检查官的
sapful	多液汁的
fire	着火
shoreward	朝向陆地
bewigged	戴假发
zipless	短暂而猛烈的
garboil	骚动
dragoness	母龙
catty	阴险的
scuff	使磨损
ministerial	部的
tamber	音色
malthusianism	马尔萨斯人口论
phonogram	表音符号
ribgrass	长叶车前草
tsaritsyn	(苏联伏尔加河下游城市伏尔加格勒
rabbet	榫接
galactopoietic	催乳
gastronomer	考究饮食的人
wakefully	睡不着地
inexactly	不正确
supplicatingly	恳求似地
thermometrical	温度计
rite	典礼
add	增添
female	女子
degerm	消灭……的病菌
asosan	阿苏山
expatiate	详述
freeborn	适于自由民
elegise	=elegize
pinpoint	极微小
exclusion	除外
autocephalous	独立
refractile	有折射力的
evolutive	演变的
scrivener	代笔人
severely	激烈地
satiny	光滑的
sawn	saw的过去分词
inleakage	渗入
bingle	安打
alible	有营养的
noviciate	修道期间
bop	波普
nautical	海军的
waive	放弃
vinegary	有酸味
bioplasma	生物原生质
enthral	迷醉
multivibrator	多频振荡器
seventeeth	十七分之一
smothery	令人透不过气的
gyneolatry	=gynaeolatry
puncturable	可穿刺的
altorilievo	隆雕
muskhogean	马斯科吉语组
ftp	File
usac	United
coordination	调和
trirectangular	三重正交的
pentatonic	五音
telamon	男像柱
refill	补充
adjacent	邻近的
transversal	横断
batten	板条
leptosomatic	瘦弱型的
faucial	喉头音
wakan	灵力
canalage	开掘运河
more	更多
garrulous	啁啾的
dotted	有点
concretion	结石
bricole	投石器
antiutopian	具有反面乌托邦特征的
procambium	前形成层
tawdry	非常华丽
poser	难题
streaked	有条斑纹
conclude	推断
inartificial	非人工的
object	物体
alamode	流行的
spongy	柔软
ethinyl	=ethynyl
sutra	佛经
diluent	稀释药
lizzie	早期的福特汽车
softish	有点软
numismatics	钱币学
chimney	灯罩
unnational	非国有的
hurl	用力或猛烈的投掷
insistently	强求地
idioplasm	种质
furious	狂怒
hapless	倒霉
hoarsely	刺耳地
thanks	谢谢
commensuration	通约
injunct	下令制止
mavis	Mavis
demonism	信仰魔鬼
him	pro
unswear	食言
diocesan	教区主教
olent	有香味
pisciculture	养鱼学
neutralist	中立主义者
luciferous	光辉
bishopric	主教职位
vocoder	声音合成机
acoustical	听觉的
gardez	加德兹
say	假定
medical	药
minimus	微小的
bender	屈服者
funniosity	滑稽
knelt	kneel的过去式和过去分词
bellarmine	贝拉明酒瓶
veronese	维罗纳人的
blindage	掩体
perichondrium	软骨膜
recrystallize	再结晶
stereotype	铅版
fluvioglacial	河冰生成的
veni	saw
evader	逃避者
folksy	有民间风味的
geoprobe	地球探测火箭
ovariole	卵巢管
gunner	炮长
affectionate	亲爱
overroast	把……焙炒过度
musing	沉思的
grindstone	旋转磨石
elegiacal	哀悼的
forget	忘乎所以
shop	店铺
stupid	愚蠢
cladistic	进化枝的
shivery	令人悚然的
ecophysiology	生态生理学
unforgettable	忘不了的
dimetric	四边形
devildom	魔界
apprehension	拘捕
unoffended	不生气的
conger	康吉鳗科康吉鳗
venine	蛇毒素
rapturous	欢天喜地的
breezy	有微风的
asphodel	水仙
bivouac	野营
episcopize	使改信圣公会
netlike	形成网壮的
premonstratensian	普雷蒙特雷修会
transeunt	外在
hame	颈轭
homework	家庭作业
compulsory	必修的
welladay	呜呼!哀哉!
specula	反射镜
ned	Edmund
unhinge	使分开
maghrib	马格里布
hippic	马
elusively	巧妙逃避
stableman	马夫
unhidden	不掩盖的
superincumbent	横在上面
clatter	嘈杂的谈笑声
silence	寂静
thracian	色雷斯人
unroyal	不是王室
overflew	的过去式
penutian	佩纽蒂语群的
cutup	爱炫耀的人
lugubrious	悲哀的
skyey	高耸云霄
burgh	享有特权的区
homicidal	杀气腾腾的
exclusive	高级的
fleshy	肉体的
excitant	刺激物
chronology	年代学
gorge	障碍物
undersleeve	内袖
butty	伙伴
expostulation	劝告
trailerite	乘拖车式活动房屋旅行者
mrna	messenger
foin	刺穿
discernable	可辨别的
halafian	哈拉夫文化
revalorization	重新估算价值
severally	各别地
quinacrine	奎纳克林
pullulation	发芽
nog	支撑
chill	寒冷
aquatic	水
moss	藓
walker	徒步者
knocker	门环
pdp	等离子体显示器
provencal	普罗旺斯人
unvoiced	未出声
extendible	可伸长
torridity	炎热
clutcher	经常参加咖啡聚会的人
confirmand	请求受按手礼
hydrodesulfurization	=hydrodesulphurization
weave	编织
corsican	科西嘉方言
interfere	打扰
copenhagen	哥本哈根
shadowgraph	放射线透视照相
monoxide	一氧化物
cuspy	设计得很有效率的
galleta	牧草
tantivy	狩猎时指示快追的喊声
encyst	把……包在囊内
inclose	附上
northeasternmost	极东北的
antilabor	危害工人利益
square	坚定地
snowball	雪球
hackbut	火绳枪
photostat	复印照片
preconference	预备会议
ripsnorter	喧闹的人
wane	退潮
tuberculate	结核性的
misuse	滥用
sapric	含极腐烂生物的
nyet	没有
parturifacient	催产
uncultured	没有文化
craftily	狡猾地
expend	花费
fsf	Foundation
iraser	红外激射
njorth	分配财富之神
examinatorial	考试
malignant	恶性的
muley	无角
duodenal	十二指肠的
unsullied	清白
forswear	幸运
sanely	稳健地
combustible	易燃
wain	运货马车
isolable	可孤立
serfage	农奴境遇
anoxemia	血缺氧
thoroughpaced	彻底的
heliced	以螺旋装饰的
tack	行动方针
puddinghead	愚人
answer	回答说
sophisticate	老油条
ectochondral	在软骨表面上的
natiform	臀形
nagged	被激怒
chapiter	柱头
event	活动
customization	用户化
aok	一切正常而顺当
nonnuclear	非核的
polyandrist	赞成一妻多夫制的妇女
krantz	悬崖
antique	古物
holocrine	全泌的
zoological	动物学
nae	决不
maidenly	柔和
laughing	可笑
brotherliness	友爱
undefined	未下定义的
exactitude	正确
semidouble	半重瓣的
photodiode	光敏二极管
unshifted	未更换
nonexportation	不可出口
australia	澳大利亚
prang	使……坠毁
spice	香料
gloss	注释
lomentaceous	节荚状的
illuminating	照明
gangsa	甘瑟琴
refreeze	再冰冻
exultant	非常高兴
joisted	为……装托梁
forworn	极疲倦的
solicitudinous	焦虑
advance	预付款
inconvincible	无法使人信服
race	姜根
misprize	轻视
emulsin	苦杏仁酵素
kemalist	基马尔主义
lark	嬉耍
stumble	结结巴巴地说话
expense	费用
salvage	营救
misadventure	运气不佳的遭遇
betted	的过去式和过去分词
adjectivally	作形容词用地
languorously	疲倦
grue	一点
intellectual	知识分子
passe	已过盛年的
habanera	哈巴涅拉
biennially	二年一次地
anticlimactic	虎头蛇尾的
tenebrionid	拟步甲科昆虫
captaincy	captain舰长之地位
steep	浸渍液
evolvement	进化
deexcitation	去激
sickly	令人作呕的
overproduction	生产过剩
khz	kilohertz
redeliver	再投递
nonrecurrent	不复发
hhs	卫生和福利部
fiftyfold	五十倍的
gallization	加水和糖
fearnaught	粗绒大衣呢
erythropoietic	红血球生成的
incity	市内
neoconservative	新保守派
acquittance	解除
ferrule	金属箍
klooch	女人
weltpolitik	国际事务
abdicant	逊位的
blanky	少用
clubman	花花公子
ndis	Standard
astrography	天体照像仪
humify	使湿润
lexigram	图形字
appendiceal	阑尾的
dither	发抖
synergetic	协同作用
spiroid	螺旋形
uncorrected	未调整的
oracy	口语能力
triturable	可研磨成粉末
achromatous	无色的
urbane	彬彬有礼
feel	触
curvaceous	肉体美
lawsoniana	=Lawson
adrift	漂泊
ka	阴灵
infrequent	稀少的
nhra	Association
subsidiary	补充的
variability	可变性
dentilingual	齿舌音的
hognosed	鼻子像猪鼻
spy	侦察
phase	状态
gargoylism	脂质软骨营养障碍
peer	同等的人
stipple	点刻
sequence	顺序
slider	滑雪者
cornetist	小铜喇叭吹奏者
feelingless	无感觉
ailment	不宁
sss	Service
egyptianize	使埃及化
submetallic	亚金属的
leadman	工头
esmtp	SMTP
stockily	矮而粗壮
thermic	由于热造成
guan	冠雉
godwinian	戈德温
radius	界限
cosigner	连署保证
aquavit	白兰地
serbonian	大沼泽的
obscurity	晦涩
inbreed	生产
boater	乘船者
besieged	包围
acidly	心地不良
hardhat	需要戴安全帽
penological	监狱管理学
bareboat	空船的
hydrated	与水结合
xylan	木聚糖
xerostomia	口腔干燥
deficit	不足额
minischool	小型学校
forrel	书套
adsuki	bean
gladiatorial	斗剑者的
hesitatingly	支吾其词地
tiddled	喝醉的
prejudicial	引起偏见
aggressor	攻击者
fourfold	四倍
skete	僧侣团体
impugnation	攻击
stopping	停下来
prothetelic	先成
society	……会
motivic	乐旨的
dearborn	迪尔伯恩马车
homburg	小礼帽
twopenny	低廉
through	彻底
fishpond	海
segregative	不喜欢交际的
xciii	93
florid	红润
preliberation	解放前
runaround	借口
ticktack	跳动声
dialytic	透析的
carshops	车辆修理保养厂
berwickshire	贝里克郡
linage	每页行数
sweetener	甜料
inconsequently	矛盾
transigent	妥协的人
homburg	卷边男毡帽
fibula	腓骨
ribband	带板
pained	痛
gandhiite	甘地的信徒
jib	停止不动
abroach	开口的
echinoid	海胆纲动物
scant	缺乏的
vulnerate	伤害
aerostation	气球驾驶法
transudation	渗透
depigmentation	褪色
secund	偏向一方的
sec	秒
impeditive	妨碍的
diametical	正相反的
loot	掠夺
insusceptible	不易受影响的
profoundly	深深
transpersonal	超越个人的
fungivorous	食真菌的
mappable	可用图上标示
galvanocautery	电烙
pegasus	有翼的马
hempy	爱恶作剧
parcel	小包
kgb	Gosudarstvennoi
proficiency	熟练程度
palaeolith	旧石器
ajc	Australian
lyophiled	冻干的
blastema	原基
bacchic	酒神的
hebetic	青春期
raconteur	善谈者
surfcasting	从岸上向激浪抛钓线钓鱼
maladjustive	引起调节不良的
mastitis	乳腺炎
roquet	击中
immission	注入
kilolumen	千流明
gasoline	汽油
sordamente	抑制
forfex	剪刀
adagissimo	很慢地
southwesternmost	最西南
pilchard	沙丁鱼
ingressive	进入
repertory	仓库
recollected	沉思默想的
encincture	环绕
matrilocal	居住在女方的
narrow	有限
forceps	钳子
shop	商店
enforcement	强制
ungainliness	丑陋
diathermanous	透热
dipsophobia	恐饮症
unsympathizing	不同情的
depressingly	抑压地
acidy	有些酸味的
noncontentious	非争论性的
dogate	共和制总督职位
ignimbrite	熔结凝灰岩
holocene	全新世
congius	一加仑
krooman	克鲁人
wallow	颠簸
layoff	操作停止
ishmaelite	被逐出者
pantheon	罗马万神殿
iteration	反复
thereby	从而
unliquidated	未例外的
glowing	生气勃勃
aerobics	有氧运动法
fancifully	梦想
scurvily	无礼
gravely	严峻地
quadrillionth	千万亿分之一地
surprised	感到惊讶的
ticktacktoe	井字游戏
unworthy	卑劣的家伙
incorruptibly	不被收买地
symptomatic	征候
rachitis	佝偻病
homebred	在家里养大的
isocratic	权力平等主义的
compost	堆肥
mph	miles
crested	有顶饰
transmission	传输
shackle	手铐
regrater	囤积居奇者
pattern	模式
electrogenesis	产电
gladness	喜悦
depurant	净化剂
flitty	脂粉气
complement	补助
arty	装艺术的
wellerism	韦勒比较语
ticking	被套料
physiognomy	地势
wolfish	贪婪
kindle	着火
waspish	腰细的
came	come的过去式
luculent	光亮
advance	前进
spaish	西班牙的
dehiscent	裂开性
cryogeny	=cryogenics
harmaline	哈马灵
yell	叫着说
bulk	大批
pallasite	石铁陨石
flickery	摆动的
unsugared	未加糖
cornea	角膜
feelinglessly	无感情
impellent	推动
premonish	预先告诫
morphometrics	形态测定
discrepantly	矛盾
sanctimonious	假装神圣
overtrain	训练过度
hibernal	寒冷的
sickly	惨淡的
olivenite	橄榄铜矿
dendroid	树木状的
schnitzel	炸肉排
swingeing	有力的
norther	酷寒北风
rarefied	稀薄
periodical	杂志
cinerama	西涅拉玛型立体声宽银幕电影
led	Diode
interested	有成见的
rabbi	法师
puristical	修辞癖
esemplastic	有组织作用
fascisti	黑衫党
vlad	弗拉德
dithyrambic	狂热的
uncreased	未弄皱
doyen	首席
anthobian	以花为食的甲虫
counsel	讨论
tenant	出租
tinnient	发丁零声
hoof	蹄
hyte	疯狂的
aerotrain	悬浮列车
monticulate	有小丘的
jellied	凝成胶状的
mechanical	机械
candu	uranium
withdrawal	退隐
drugola	毒品贿
polypod	多足
forbearing	宽容
doxastic	信念
commons	平民
jubilant	欢呼
calipers	弯脚器
lessened	减弱
democritean	德谟克利特哲学的
cabaletta	卡巴列塔
intragenic	基因内
ssa	Security
uninspired	平凡的
difficult	困难的
hummocky	圆丘般
flank	在……的侧面
fumy	冒烟的
ingather	收集
coedit	合作编辑
reduction	缩小
agreeably	愉快地
naprapath	按摩治疗者
phycology	藻类学
msls	of
toby	人形水罐
level	级别
uric	取自尿中
rebellious	难于对付的
hexameter	六步格
prosper	兴隆
persevering	坚忍
breadless	缺粮的
run	行驶
hawking	利用鹰行猎
heptagonal	七边形的
rasc	Army
worthily	可敬地
reticulated	网状的
claudicant	跛
spurious	假造的
lunarite	月球上高地表面的
exponible	可说明的
circumvolution	盘绕
billabong	洼
preparedness	有准备
safeguard	安全装置
hooter	汽笛
isocephalic	人像头部等高的
viburnum	荚莲属的植物
holmia	钬之氧化物
epididymis	副睾
blacksnake	皮鞭
brooder	沉思者
pentastyle	五柱式的
compo	工伤赔偿
kimchi	朝鲜泡菜
flavourful	味浓的
legalise	=legalize
caravan	沙漠
alaskan	阿拉斯加
positive	确实的
sanctuary	避难所
agrometeorological	农业气象
forget	忘形
greenkeeper	高尔夫球场管理人
jussive	祈使
dissatisfied	不高兴
mrs	炮口基准系统
cinerary	放灰
doggery	狗群
yeastlike	似酵母
fulgurate	发出电光
vastly	广大地
victualage	饮食
transhydrogenase	转氢酶
outboard	外侧
pennatula	pen
egress	外出
janfu	一团糟
lienteric	滑肠的
etymologize	探溯语源
twisty	不直接说明
detorsion	弯曲器官的变直
measle	囊尾蚴
mandible	下颚骨
unchurched	不属于任何教会
inkosi	首领
derogatory	贬损的
linendraper	衬衣类商人
reunify	使重新统一
galactosamine	软骨糖胺
quadraphonic	四声道
careworn	受忧虑折磨的
identic	完全相同的
quarter	四分之一
tenno	日本国天皇
deuteranopic	绿色盲的
discuss	论述
vertebra	脊椎骨
fishes	双鱼宫
airhop	短程空中旅行
countergirl	柜台小姐
saw	see的过去式
preatomic	原子能利用以前的
clear	有条理的
washcloth	面巾
drift	冲洗
schistocyte	裂细胞
cratered	有坑洞
fetation	胚胎发育
roi	Oil
recessive	隐性
suburb	市郊
labialization	唇发音
tlo	only
isapi	Program
martin	燕子
twopenny	头
ghostliness	影子似的
moslemic	伊斯兰文化
unmercenary	不是仅仅为金钱
regardlessly	毫无价值地
coxed	有舵手
transient	短暂
sundowner	暮后小酌
burdensome	难以承担
mild	不含有害物质的的
polyphonic	对位法
flattery	谄媚
epicenter	震中
forsworn	伪誓的
dankly	潮湿
stalemate	僵局
smithy	锻冶匠的工作场所
conjury	魔法
geopolitic	地理政治学的
shoal	浅滩
acalycine	无花萼
consult	考虑
surety	保证
corporation	社团
leeriness	狡猾
wrangell	兰格尔山脉
underpowered	由动力不足的发动机驱动
mugginess	闷热
spoonful	一匙
unpopular	不受欢迎
chemosurgery	化学外科
adventureful	富于惊险事件
colorific	色彩的
erect	盖
acquired	已成习惯
leprosarium	麻疯病院
gfwc	Federation
metropolitan	主要都市
creaming	乳状物之沉淀或上层
fryer	油炸
ruggedly	粗暴地
constabulary	警官队
bossy	浮雕装饰的
fender	挡泥板
hendiadys	重名法
working	抽搐
extrahazardous	特别危险的
foursquare	正方形的
iea	Association国际教育协会
geogenic	地球成因学的
horsecar	运马货车
lengthen	变长
crisis	历史上的紧要关头
aurelian	水母
nucleocapsid	核壳体
damageable	易损害
subcontinent	次大陆
resting	不动的
maelstrom	挪威近海的大漩涡
gownsman	律师
barbarous	粗野的
willa	威拉
jacksonian	美国第七任总统杰克逊的
making	素质
towards	有助于
subeconomic	经济上不合算的
stum	用防腐剂防止发酵过度
nodus	难点
geogenic	球成因学
chirk	快活的
hyalite	玉滴石
plashy	潮湿的
bedfordshire	英格兰南部的州名
thoro	完全的
doggie	小狗
xenia	异粉性
albino	白化病者
evaginable	翻转的
cnaa	Awards
oxisol	氧化土
cokehead	可卡因瘾君子
flamboyance	火焰
bachelordom	单身
institution	制度
bespoken	显示
dystrophication	海水污染
caboodle	群
cotton	棉花
inharmonious	不和睦的
queensware	女王陶
boxhaul	使船顺风势转向
vallation	筑城术
diffused	扩散的
deanship	院长职
reperusal	重新细读
leavy	多叶
irrigate	灌溉
strappado	处以吊刑
iotp	Protocol
gmwu	Municipal
leaven	酵母
colory	色泽甚浓
coziness	舒适
dumpishness	愚笨
enculturate	使适应某种文化
democratic	平民的
sbc	coding
liveborn	活产的
carboniferous	含碳或煤
closter	归隐修道之处
mythologer	=mythologist
divisive	分裂
moosebird	灰噪鸦
face	外观
wwf	Wrestling
calembour	谐音之诙谐语
hematoblastic	血胚细胞的
compendiary	简明的
occidentally	西方文化
wrongfully	不正当
dexiocardia	右位心
constrained	被强迫的
tripinnated	三回羽状的
specular	镜子的
hip	臀
maritime	海员的
dolefulness	寂寞
unhurried	不慌忙的
stage	发展的进程
ln	行
rabblement	暴动
symbolistic	象征性
malay	马来语
treacle	糖蜜
conglutinant	促创口愈合的
ransom	赎回
concentrate	集中
cheep	吱吱地叫
membra	membrum
wearability	穿着性能
imap	Internet消息访问协议
catastrophism	灾变说
refusal	优先取舍权
splash	飞溅
foolish	傻的
gulf	海湾
anubis	豺头人身神
besiege	围攻
savourless	无情趣
myxasthenia	黏液不足
matte	不光滑
becloud	使遮暗
contriver	发明者
allocable	可拨出
butyrate	丁酸盐
out	明显
retarded	发展迟缓的
asyllabic	不成音节
bughouse	发狂的
fluid	流动的
inertion	无行动
maraschino	黑樱桃酒
catalonian	加泰罗尼亚的
voiceprint	声波纹
supplicant	恳求的
bummel	漫步
smolder	郁积
nuclei	的复数形
psychoactive	作用于精神
romaika	现代希腊流行舞
hieland	易受骗的
reship	再上船
billabong	死水
sound	使发声
madly	精神失常地
intellectualize	/
luteofulvous	橙褐色的
unmarriageable	不适于结婚的
ornithological	鸟类学
faciocervical	面部与颈的
tuck	船尾突出部下方
noncellulosic	合成纤维
upright	诚实的
interauthority	当局之间
wakayama	和歌山
thalassochemistry	海洋化学
upstream	向上游
overentreat	以恳求说服
thereof	它
triradiate	向三方射出的
khowar	科瓦语
asocial	自我中心
campy	同性恋的
social	社会的
decagon	十边形
conjugal	夫妇间
muscarine	蝇蕈碱
solidary	团结一致的
kithe	以行动表示
schistoid	片岩状的
insider	知道内情的人
prettyish	可爱的
fetch	带来
roz	=rozzer
aglisten	闪烁的
meniscus	半月板
thaumatrope	西洋镜
prevailing	流行
platinocyanid	铂氰化物
thriftily	兴旺的
copemate	合伙人
opec	Exporting
mmx	多媒体扩展指令集
lamellicorn	鳃鱼的
romanza	抒情短诗
standstill	停顿
fluid	可改变的
wive	嫁
pomade	润发油
catalyse	催化
shindig	骚动
cote	窝
metapsychic	心灵学的
comble	顶点
famed	闻名的
typecast	浇铸
complimental	恭维
unbar	打开
fluky	不可靠的
holophrastic	以一个字显示整句意思的
monopteron	=monopteros
cyanine	青蓝
infusorium	纤毛虫
filmic	象电影的
eupatrid	世袭贵族
enounce	声明
direct	径直的
totty	喝醉
appealing	哀诉似的
dish	盘
seroreaction	血清反应
citizenize	使成为公民
shimmy	晃动
crisp	易碎的
mind	照顾
brink	边缘
urgently	迫切
lovage	一种独活草
forgery	伪造罪
wolf	猎狼
start	惊起
nonacceptance	不答应
meltwater	冰河融化后的水
transubstantiate	trAnsEbstAnFIeIt/
curlycue	花体
teethe	长牙齿
incursion	袭击
bargemaster	驳船的主人
indisputability	无争辩的余
anemone	海葵
brassiness	似黄铜
malentendu	误会
put	怪人
viatka	=Vyatka
notional	想象的
cooptative	增选
shearlegs	人字起重架
clique	阀
ryurik	Rurik
demotics	人与社会学
acclimate	适应
elytrum	翅基
willinghearted	十分情愿的
psia	inch
marked	有记号
hurst	小林
mindexpander	致幻药
canvasser	游说者
regolith	风化层
chitinous	壳质
andersen	安徒生
coastel	水上漂浮旅馆
blind	使失明
illusory	产生幻觉的
milk	乳
literarily	学术上
tew	early
underwater	在水中的
wisehead	=wiseacre
underclothes	内衣
pallidly	苍白无血色
subliminal	下意识的
loss	错过
wctu	Woman''s
albuminoid	蛋白质
rhabdovirus	棒状病毒
stag	只有男性的社交晚会
founder	沉没
attend	照顾
grandfather	始祖
devotedly	忠实
sack	就寝
reason	思考
listee	登记簿上列名者
buckthorn	鼠李科
cantabrigian	模仿剑桥大学
prolegomenon	前言
pinitol	松醇
impertinently	不恰当
thickheaded	笨
granulation	有粒的表面
teeming	丰富
translatology	译学
specialisation	=specialization
tactually	触觉器官
trading	贸易
willowy	苗条
by	Belarus
implead	起诉
unforgettable	令人难忘
stroke	抚摸
heterocrine	多种分泌
coterminous	连接
transpose	调换
palatinate	领
insistency	坚决要求
misconduct	不正当的行为
matamoros	马塔莫罗斯
transplant	被移植物
age	成熟
unfamiliar	新奇的
guidebook	旅行指南
face	正面
stockbreeding	畜牧业
illegalize	使成为非法
glochidia	glochidium的复数
interpellate	质询
logicize	运用逻辑
epeirogentic	造陆作用
wildfire	鬼火
cetacean	鲸
energize	加强
xpvm	Console
ckd	completely
curiosa	淫书
iliac	髂骨的
creatine	肌氨酸
inspectorate	巡视员等之总称
lamergeyer	髭兀鹰
autacoid	自体有效物质
informing	鼓舞的
sheepshank	缩结
rhotacize	使r音化
cabasset	七世纪时的一种钢盔
belfast	贝尔法斯特
unassuming	谦逊
stuggy	矮胖的
anthelmintic	驱虫
clanism	宗族制度
coronach	挽歌
hansel	贺礼
radium	镭
sniff	闻到
unobjectionable	婉转的
cancroid	蟹状
ukaea	Kingdom
mysost	挪威乳清干酪
embryulcia	牵胎法
uncase	暴露
iupap	国际理论和应用物理学联合会
febrific	发烧的
zincotype	锌版画
hydroextractor	离心干燥机
multibarrel	多管的
jehu	卤莽的司机
ophthalmologist	眼科医师
multinest	多重嵌套
spirochaetal	由螺旋体引起
mind	情绪
bating	除……之外
unifilar	单线组成
rafferty	混乱的
dauphiness	王太子的妻子
craig	克雷格
plumbum	铅
ceramics	制陶业
thin	瘦的
cruel	使痛苦
unparalleled	空前
fissipedal	足趾分裂
cherry	樱桃树
fibre	须根
flowerlike	象花
undam	从……撤去堤坝
sacculate	囊状的
sitting	易击中的
angolan	安哥拉
discouragement	劝阻
preoccupant	抢先占据
serinette	八音琴
unvanquishable	不能克服的
draconic	严峻
certify	证明
cognominal	同姓
typhoidal	伤寒
myriapodan	=myriapod
comusmacv	驻越美军司令
keltic	凯尔特族的
ambiguously	含糊不清地
limpingly	勉强地
papaverin	罂粟碱
conception	观念
granular	粒状的
icy	冷淡的
rightable	可补救
asymptotic	渐近线
motley	杂色的
emit	吐露
zoom	嗡嗡声
mammey	=mammee
deianira	得伊阿尼拉
refutably	可反驳地
redemptive	用于补偿
force	暴力
middling	中等
develop	逐步显示出来
schrod	=scrod
fit	准备好的
crosswise	成十字状地
mend	补丁
slatter	溅污
gid	眩倒病
charlatanry	骗子行为
turgid	肿的
enervated	无力
fairness	顺利性
ultrarightist	极右分子的
ritualistic	仪式的
lexic	=lexical
qic	1/4
circumpolar	拱极星
polarizer	偏光器
electrostriction	/
eminence	出众
embow	使成穹形
attaintment	=attainder
videoporn	黄色录像
crocean	克罗齐精神哲学的
setiferous	具刚毛的
sociosexual	社会群体内性关系的
shooting	狩猎场
puckery	缩拢的
subsaturated	不完全饱和
grungy	蹩脚的
creosote	杂芬油
transitoriness	短暂
assessable	可征收
irredeemable	不可救药
temporal	当时的
postcranial	颅下
hodeida	荷台达
vicenary	以20为基数
guardship	哨舰
unattainable	做不到
term	学期
stunner	出色的人
relapse	回复原状
mangily	污秽
uninjured	未蒙损失
watercolor	水彩画
epipastic	撒布粉
tropocollagen	原胶原
lampson	兰普森
anaemic	贫血的
disadvantage	缺点
revest	再赋予
excellent	卓越
precise	准确
cachexia	恶病体质
tetrastichous	四列
gory	血污的
requin	=requiem
decillion	100万的10次乘方
theophoric	的:
interrelated	相关的
unattained	未达到的
girdle	包围
furnishings	设备
aforehand	事先的
boo	嘘!
fidget	坐立不安
excel	胜过他人
nitwitted	笨
assuringly	确实地
shag	蓬松
undisturbed	镇定的
pyemic	毒血症的
saunders	=sanders
kneeboss	膝甲
fashionably	按照流行地
laddie	年青人
floodometer	潮洪水位测量仪
cipolin	云母大理石
maxisingle	慢转唱片
fearful	严重
gandhiite	甘地的
barrater	买卖圣职或官位者
frippery	无用的东西
palpable	明显的
dall	野大白羊
sioux	苏人
unlistening	不留神听
scarify	乱刺
fast	耐久
dressing	敷料
dastardly	卑鄙的
adrenocorticotro	肾上腺9kR:tIkEJ`trCfIk
swank	打扮漂亮
unleased	未租出
urge	迫切要求
himalayan	喜玛拉雅
unsccur	of
else	别的
backbiter	背后诽谤者
tantalise	=tantalize
ailurophile	养猫的行家
hantu	恶鬼
fossilology	古生物学
incalescent	温度渐增
umber	涂红棕色于
dup	开
diverge	脱离
collectanea	选集
spiniform	似脊柱的
trailer	追踪者
cussed	乖僻
coloring	色彩
pushily	一意孤行地
dogginess	象狗
aboriginal	土著的
impressional	印象的
centrifugal	离心的
unicode	采用双字节对字符进行编码
sticking	粘的
bronchogenic	支气管原
speedway	机器脚踏车的竞赛场
etesian	季节风
waltz	华尔兹舞
pressbutton	按钮
marking	记号
naeb	National
malachi	玛拉基书
weenie	细小
proximal	最接近的
gonocyte	生殖母细胞
plutolatry	财富崇拜
generalist	多面手
brim	边
rhomboidal	长斜方形
magnetohydrodynamic	mA^`ni:tE9haIdrEJdaI`nAmIJ9haIdrEJdaI`nAmk/
washy	乏味
durra	高粱
anonychia	先天性无趾和指甲症
allude	间接提到
downspout	水落管
water	水上
spinous	刺状的
microcopy	缩微复制
mangrove	红树林
harmonical	调和的
pretty	恰当
panhandle	行乞
microstomous	小嘴
neurosurgery	神经外科
subliminal	潜在意识
incommutable	不能变换
ballistically	发射
contract	使缩短
rotfl	Rolling
radiolarian	放射目的
dastard	怯懦的
bibliology	书目学
peripheric	=peripheral
warp	弄歪
interfacial	分界面
thoreau	梭罗
whencesoever	无论为什么
indicial	指标
samba	跳桑巴舞
recorder	宏录制器
gruff	粗哑
befittingly	适宜
auditoria	会堂
nestlike	窝似的
dramatic	戏剧性
hygrometric	吸湿性的
snazzy	时髦
acquirability	可
account	说明
divisional	分区的
phallocrat	大丈夫主义者
ne	旧姓的
flump	砰的倒下
random	胡乱
sodamide	amide
railroadiana	铁路文献
downcast	沮丧的
jimberjawed	有突出下颌的
trousseau	嫁妆
nobly	崇高地
hygrostat	测湿计
witchcraft	魔力
at	Austria
apog	apogee
unbalanced	不稳定的
justifier	辩解者
jounce	颠簸
perpendicular	垂线
dominating	独裁
triantelope	澳洲扁体大蜘蛛
satanic	邪恶
electrologist	电蚀医师
malediction	咒
crenulated	细圆齿状的
pageant	庆典
nyp	published
uncivil	不文明
whipster	妄自尊大的小人物
subsistent	存在的
microanalysis	微量分析
sporadical	=sporadic
weak	虚弱的
botryoidal	一束葡萄状的
orotund	洪亮的
popcorn	爆米花
tannish	淡褐色
christadelphian	基督弟兄会会员
mesic	栖于湿
tactical	战术
velodyne	调速发电机
lovelorn	失恋
discriminatorily	有区别
federally	联邦政府地
outwalk	走得比……快
sthenic	兴奋
lighter	驳船
minuteman	独立战争时立即应召的民兵
undivided	专心的
exaggerate	夸大
sackbut	低音喇叭
hemagglutination	/
leisuresuit	便服套装
petalage	花瓣
pinecone	松球
banter	逗弄
strikingly	引人侧目
vasopressor	血管加压
effloresce	风化
homily	说教
quittance	解除
administerial	行政上
streaky	有条纹
token	表意的
papillectomy	乳头切除术
settltment	殖民地
sap	挖坑道
coffee	咖啡树
semifinalist	于初赛获得以在半决赛时出赛的选手
cipolin	意大利产大理石的一种
phrenetic	精神错乱
wishful	想望的
septennial	延续七年
trailing	被拖动
chromidium	核外染色粒
existential	有关存在的
tributary	从属
repulsive	排斥
vamoose	匆匆离开
fractionlet	小碎片
disagreeables	不愉快的事物
unpeace	不安静
restorable	可恢复
tripodal	有三脚的
altogether	总而言之
centennial	百年纪念
continuable	可持续的
berliozian	柏辽兹乐曲的
whine	发牢骚
newfashioned	新式的
mycotoxin	毒枝菌素
filthily	污秽地
shmoo	什穆
useless	无用
reinflation	再膨胀
awry	歪斜
underappreciated	未得到正确评价的
hardhead	矢车菊
maiden	未婚
sublime	壮观
rayah	非伊斯兰教徒的土耳其人
hekla	赫克拉火山
fawning	奉承的
unitar	Nations
cruelly	残酷
pyrocrystalline	火成晶质的
irresistible	不能压制
veranda	阳台
reptiliary	爬行动物馆
untearable	扯不破
crookery	诈骗
febrific	产热的
oceanaut	海底实验室工作人员
lymphogranuloma	`lImfEJ9^`lEJmE/
superacid	太酸的
rule	裁决
provisory	有附文
nodularity	结核状态
neutrophilic	嗜中性
emit	发出
jura	jus的复数
gluey	胶的
rivalize	竞争
emblematic	标记的
telecommute	远距离工作
override	不考虑
jugoslav	南斯拉夫人的
hydromechanics	流体力学
mound	筑堤
authorise	=authorize
cheddite	谢德
opal	蛋白石
physiographical	地形学的
headframe	井架
recumbency	斜靠着
nomenclatorial	命名的
cyclothymic	循环性精神病的
ringworm	癣
mustardy	芥子粉
traditional	口传
fillet	头带
chemist	化学家
inquisitorial	询问人的
untenanted	未被租用的
verily	忠实地
aerodynamicist	气体力学者
adventist	基督再临派成员
idiotype	个体基因型
traumatic	创伤的
affected	做作的
reasonably	适度地
underpinner	支承用的支撑
tauranga	陶兰加
prestissimo	最快速度
nonviolently	非暴力
pocketbook	皮夹
travelogue	旅行见闻讲演
slumberous	催眠的
frigidly	呆板地
jew	犹太教徒
sawback	锯齿山脊
ersatz	人造的
photoactive	光敏
misallocation	错误的分配
hypoglobulia	红血球减少
cinc	chief总司令
distant	疏远的
spender	用钱的人
commandery	骑士团管理地
noumenal	实体
sympathetically	感应着
avowable	可承认的
regionalism	行政区域划分
untidy	不整齐
rubberlike	橡皮状的
handgun	手枪
microcalorie	微卡
knur	硬的突起
monoacidic	一元
porte	土耳其宫廷
capillary	毛状
placage	薄饰面
worthy	值
briseis	布里塞伊斯
paperboard	卡纸
migrant	候鸟
wineskin	葡萄酒囊
unreel	退绕
cered	有蜡膜
petrous	岩石
somatotrophin	生长激素
universal	普遍的
band	结合
regard	关系
unfaltering	坚决的
mwa	美国现代林业人员协会
loverboy	情夫
commodious	宽敞的
tarnal	非常
chou	周
prolusion	序言
some	相当的
magic	魔法
forward	促进
conglutination	粘附
shackle	加桎梏
extinguishable	可熄灭
radioautogram	=autoradiograph
scurrilously	粗野无礼地
thrombokinase	活性司徒氏因子
appetizing	美味可口的
fibrilla	根毛
conche	巧克力搅拌揉捏机
sinuate	弯弯曲曲
lumberjack	木材商的佣工
clearstory	天窗
sunkissed	受阳光照射的
congenetic	同源的
incretion	内分泌物
locofoco	摩擦火柴
tacitly	肃静
outlier	露宿者
hermaean	赫尔密斯方形石柱
nephometer	云量仪
shemite	闪族
catenate	使连续
underproduction	生产不足
row	排
fancy	奇特
skein	一团糟
bland	温和
forwarder	转运公司
pentacle	五角星形
attainder	被剥夺财产和公民权
nixie	nix的阴性形式
ruling	统治的
enring	环绕
fortuitous	偶然的
arsine	三氢砷化
erotism	性的兴奋
pronominal	代名词性质的
practised	老练的
febricide	退烧剂
awash	被浪冲打
carissima	亲爱
rugged	粗糙
objectionable	讨厌
variant	变量
scapolite	方柱石
maidenhood	处女时代
tenebrosity	阴暗
literalise	=literalize
molybdian	=molybdenian
gemmate	有芽
fissile	分裂性的
grunge	难看的东西
sociologise	=sociologize
rcvs	Surgeons
gdi	Interface
subthreshold	阈下的
undershot	下射
councilwoman	议会女议员
woden	沃登
glottal	用声门发声的
hvar	rocket
ley	牧
shelly	多壳
bivallate	围有两层防护土墙
quail	感到恐惧
perissodactylate	奇蹄目的
athirst	渴望的
impress	盖印
exploitative	剥削
curvicostate	具曲脉
shrill	尖声的
misspent	浪费的
allomerism	异质同形
horseshoe	马蹄铁
ultrafax	电视传真电报
title	标题的
braillewriter	=Brailler
vacancy	空虚
deathful	致命
chopfallen	下颚凹陷
guadeloupe	瓜德罗普岛
humilis	淡的
sleight	手法
overperform	超剧本表演
rousseauesque	具有卢梭风格的
remove	班级
palliatory	减轻的
neoglacial	新冰川作用的
maiden	纯洁的
barefoot	赤脚的
mammee	曼密苹果
scent	香味
underproductive	生产供不应求的
byzantinesque	拜占庭风格的
vim	精力
baptism	严峻考验
supervisal	监督
velarize	发软腭音
elementary	自然力的
fin	鱼翅
pythia	皮提亚
cromerian	克劳默人
nomenclatorial	命名
renown	传闻
longhair	知识分子
redhibition	原货退回
postmen	邮差
antecedence	先前
expositive	解释的
thumbtack	图钉
sublunary	上
bumptious	盲目自夸的
mundane	世俗的
infirm	弱的
maldistribution	分布不均
plebby	粗俗
embroglio	=imbroglio
riffle	流过浅滩
sadduceeism	撒都该教派之教义
pasteurisation	=pasteurization
stamineal	雄蕊
omnimane	每晨
potherb	熟食叶用菜野菜
nonstandard	不标准
fine	变细
abbreviative	缩略
uptodate	最新式
incendive	易燃烧的
synthetase	合成酶
audacity	大胆
pretreatment	预处理期间
auralize	在心灵深处听到
bloomer	完全成熟的人
thankfully	感谢
mitred	斜接的
stud	柱头螺栓
bucentaur	半牛半人的怪物
taborin	狭长小鼓
adolescent	青春的
abiotic	无生命
unentertained	未被逗乐的
equivocal	可疑的
plumbeous	铅的
praedial	耕地的
lactary	奶似
bang	突然巨响
baize	台面呢
lemma	引理
done	做好了
snoop	调查
vote	选举权
npl	Laboratory
endotherm	温血动物
stride	大步走
hoodwink	遮眼
upload	上载
jed	杰德
pronto	急速地
lubricant	滑润剂
earthpea	花生
luciferous	光亮的
dapple	有斑纹的
oakling	栎树萌发枝
agedly	老年人似地
omniscience	全知
leukoplasia	黏膜白斑病
unavoidable	不能取消
unfortunate	不幸的
arborize	使分叉
connivence	默许
natural	普通的
twerp	蠢人
gpm	per
bunghole	桶孔
nitwitted	笨的
slither	不稳地滑动
appointer	任命者
uranic	天的
set	接受机
jutish	朱特人
towards	朝
imbosom	怀抱
clavated	一端膨大的
tousy	临时凑合的
gasthof	小旅馆
psephite	砾质岩
handcart	手推车
overoccupied	过于拥挤
scurfy	皮屑
flannelled	穿法兰绒衣服
companding	压缩扩展
apocrine	泌离的
apostatic	背信的
clear	净
boredom	厌倦
unitarian	一神派的
insipidity	无精神
raising	浮雕装饰
regale	享受
cacorhythmic	节奏不和谐的
countability	可数性
twig	注意
cultus	礼拜
semble	看来好象
benthoal	湖底的
aspire	立志
multipad'	NULL)
ismec	机械工程情报服务
allicin	蒜素
mistakenly	错误地
peg	固定
staphylotomy	悬雍垂切除术
eucalypt	桉树
pli	inch
goddamn	讨厌
supernate	上清液
yieldly	生产地
pshaw	轻蔑时的叫声
uppermost	最主要的
pluriaxial	多轴的
tearful	含泪
sedate	安静的
tootle	轻吹
battlewise	富有战场经验的
wash	洗
brusquely	唐突地
pedes	pes
covenanter	契约者
itt	Telegraph
diametical	正相反
memberless	无会员的
subcutaneous	皮下
injuriously	伤害
nondrinking	戒酒的
meed	奖赏
nc	Computer
lipper	浪花
haunting	不易忘怀的
iaru	国际业余无线电爱好者联合会
shuddering	发抖
lax	松驰的
waterline	水线
goy	异教徒
nidget	白痴
baptist	施洗约翰
dodo	古代巨鸟
oestrous	发情
kyoto	京都
implausible	不象真实
lysine	赖氨酸
pesky	讨厌的
imprest	预付款
cypriote	塞浦路斯的
spizzerinctum	雄心壮志
exclusivist	排他主义者
specilize	专攻
macedonic	=Macedonian
doughboy	步兵
annulment	取消
nacred	真珠质的
grammarian	文法教师
man	丈夫
attendance	照料
viscus	内脏
douai	=Douay
kalmyk	=Kalmuck
irreplaceable	不能代替的
aerostatic	空气静力学的
baronne	=baroness
therme	=therm
libertine	放荡
abloom	开花的
expeditious	敏捷
nostradamus	语意含混的预言家
veinulet	小静脉
surloin	牛的上部腰肉
diversionist	在敌后活动者
tejo	特茹河(源出西班牙东北部的塔霍河
cornball	似乡巴佬的
gom	Grand
affectation	做作
filthily	污秽
ole	and
prattle	唠叨
riant	笑盈盈
rident	兴高采烈
unbusinesslike	无组织的
tropism	取向
cobwebby	蛛网密布
syenite	黑花岗石
lubricative	有润滑作用
colorless	无色的
oceanid	海洋的女神
swizz	欺骗
devoid	缺乏
clank	发叮当声
unwearied	孜孜不倦
unbitt	解下
asymptotic	渐近线的
oap	Pension
alsatia	伦敦一地区
fishbed	鱼化石沈积层
eyeable	可见的
overturn	倾覆
rabbiter	猎兔者
rubeola	麻疹
ravel	解开
productively	有成果地
milimeter	公里
contextless	无上下文的
fisher	渔船
vapor	自夸者
evita	埃维塔
fpe	一个用于修改游戏的工具软件
unsocial	非社会的
interoceanic	大洋间
psychrophilic	好寒性
wassail	酒宴
dissected	分割的
haulm	稻草
macrocephalus	巨头人
pomiferous	结梨果
emargination	尖端微凹
thermic	由于热造成的
excubitorium	值夜人的职位或岗位
spectrogram	声谱图
politer	优雅
untense	使不紧张
tendentious	有偏见的
coarseness	粗劣的
primary	主要
carroty	胡萝卜色的
rosily	带玫瑰色地
turgescent	肿
vop	original
succussatory	摇动的
sabugalite	铝钙铀云母
tdn	digestible
strickle	斗刮
medical	内科的
philological	文献学
soot	烟灰
boring	令人厌烦的
puttie	=puttee
entice	诱使
inadvisable	失策
scorbutic	坏血病
stepper	跳舞者
ejaculation	突然说出
justicial	正义的
subequal	几乎相等
gassy	气状
skeletony	骨骼似的
ran	run的过去式
aspermous	无种子
innutrient	营养不良
predormition	睡前期
goosy	愚蠢
comsymp	同情共党分子
antimalarial	抗疟药
coalfish	黑鳕
performance	执行
wobbly	不稳定的
leaky	漏
runch	charlock
braky	多矮树林
softy	笨蛋
smithereen	把……炸成碎片
exobiology	外空生物学
cogent	使人信服的
unparalleled	无比的
polonaise	波兰连衫裙
fenestella	小窗
incalculability	不计其数
withershins	左向转动地
lowish	小声
felicitous	善于措词的
nccj	National
cautel	警觉
elegant	上品
haemocytoblast	原
ashiver	颤抖
underbuy	购货不足
stemma	家谱
gunmetal	青铜
gso	General
foulmouthed	出言不逊
taligrade	拐脚的
isolation	孤立
uplooking	向上看
fleckered	有污点
ioc	Olympic
pfda	and
unleased	未租出的
compunctious	悔
normanize	诺曼化
ccpit	Promotion
towering	杰出的
chaldaic	古巴比伦人
polyandrist	多夫妇女
falcial	镍的
sile	大雨如注
virogenesis	病毒产生
saleswoman	女售货员
superduper	非常好
smith	铁匠
thersites	瑟赛蒂兹
genuinely	真诚
snugly	尚可的
impropriation	移交私人保管
force	武力
refer	归诸于
inhibitory	抑制的
ornl	National
velveteen	棉绒衣服
compellent	有强烈吸引力
possibilistic	可能主义的
tot	微量
sustenance	食物
antipyrotic	消炎剂
smacking	活泼的
talent	天才
ethnohistoric	人种史学
cyclamate	一种有害的糖精
hemigroup	半群
coupist	政变者
prefixion	置于前面
grovy	在树丛中
ingenerate	内在的
kamasutra	爱经
about	周围
putschism	鼓吹起义
fond	温柔
letterweight	纸压
saint	圣徒
hydrocrack	加氢裂化
penally	刑事上
nu	Niue
addicted	沉溺于某种嗜好中的
infuse	鼓舞
fishgig	鱼叉
obtuse	迟钝的
trephine	有柄的环锯
injured	受委屈
biconditional	双态的
apagoge	反证法
tapping	出铁
twisty	扭曲的
isacoustic	与等声强有关的
resolvent	溶剂
facebar	夹脸
isomorphic	同构的
secretarial	书记
gus	格斯
gustavus	古斯塔夫斯
virtually	事实上
willem	the
duodecagon	十二边形
battlement	城垛
subsequently	随后
mascon	质量密集的物质
moondown	月落
daiquiri	一种鸡尾酒
nasogastric	鼻饲
mortuary	太平间
certain	某几个
invitatory	邀请
angiography	血管照相术
tlas	如WWW等
yowl	吼
troublous	动乱不安的
unregarded	不受注意的
spine	脊骨
bva	British
tattler	说闲话的人
sensed	感觉
bobtail	截尾的动物
engrain	根深蒂固
exist	继续存在
stridulation	磨擦声
baalism	太阳神崇拜
windbag	风囊
stipes	叶柄
phylactic	防御疾病的
abeam	与船的龙骨成直角
reinaugurate	重新开始
scalprum	骨锉
sidetrack	转移目标
lg	German
kiangsi	江西
flammenwerfer	喷火器
recitative	背诵
progress	发展
divestiture	剥夺
scope	余
inarticulately	笨嘴笨舌
clean	干净的
lempert	operation
market	在市场上买卖
chogh	咳嗽
phosphocreatin	磷酸肌酸
buddybuddy	非常友好
cladogenesis	分枝进化
oily	油
foveolate	有小凹
subentry	副条目
subcuticular	角质层下
join	结合
possessory	所有的
hump	隆起
rebore	镗大的孔径
econometrics	经济计量学
revel	狂欢
competition	竞争
fictitious	小说中
trivially	琐细
gloomy	令人沮丧的
purulency	脓汁
posb	savings
pesterous	纠缠不休的
primely	极好地
mock	骗
complemental	补足的
practicum	实习课
bto	一流人物
microammeter	微安计
reentrant	凹角
zone	圈
sniggle	向鳝鱼洞垂下钓钩钓
ileitis	回肠炎
investment	投资
stalwart	坚定
interpolation	篡改
tide	潮
quick	活人
cicatrix	脱离痕
circumambient	围绕
pulperia	酒店
roughrider	驯马师
unpenetrable	难穿入
tendencious	立场倾向的
leer	送秋波
pentode	五极真空管
acquirability	可得
methodism	美以美教派教会
amphibious	两栖
poky	慢吞吞的
histological	组织学的
podgy	短粗
tremulously	畏惧地
ophiophagous	食蛇的
hyposensitization	使敏感度减弱
californian	加州
metis	有八分之一黑人血统的混血儿
paletot	一种男女通用的宽外套
nicotian	烟草的
primarily	根本上
arthrogryposis	关节弯曲
manicou	鼠鼹
pasteboard	纸板做的
redbreast	知更鸟
raffish	卑鄙的
sinai	Peninsula
tarsi	睑板
exploitative	剥削的
cockleshell	小船
circumnutate	曲绕
heteroploid	异倍体
fls	Society林奈学会会员
march	行军
auriferous	含金的
gerontogeous	旧世界
polynuclear	多环
faultily	不完美
wineglass	葡萄酒杯
pumice	用浮石去污
most	最
nannyish	过分拘谨的
unshod	赤脚
staple	把……分级
bayou	河口
adiabatic	隔热
imprecise	不精确的
mediterranean	地中海民族的
accessory	副
gunmetal	炮铜
add	增加
machinator	阴谋家
fine	澄清
remedially	矫正
crackless	无裂痕的
druidic	督伊德教徒
flyer	飞跳
foe	危害物
tautomer	互变体
gelatinize	涂胶
jbs	John
yale	耶鲁
curtal	切短
semishrub	亚灌木
positivist	实证主义者
auspicate	v
revival	复兴
africanism	非洲文化研究
emotionless	没有情感
wilkes	Land
congeniality	同性质
remittent	间歇性
washy	无活力
monthly	每月一次
ichthyologic	鱼类学的
mousseux	起泡
tethyan	古地中海
neurogram	记忆痕迹
commemorative	纪念
bouquetiere	加蔬菜作配菜
product	乘积
pride	使自夸
panoply	全套甲胄
ssfdc	Card
meccano	组合玩具
unmeasurable	无限
pose	形成
unjustly	不义
phenomenal	现象的
deodorant	除臭
ms	Standard
antivivisection	反对sekFEnIzEm/
totem	图腾
teletypewriter	电传打字机
costotomy	肋骨切开术
smudgily	污垢
olio	什锦菜
myringitis	鼓膜炎
insinuate	使逐步而巧妙地取得
lawny	平坦并铺有草皮
shoulder	肩
brownie	核仁巧克力饼
iaf	国际宇航联合会
liveried	穿规定服装
tonga	汤加
clearsighted	眼力好
emendation	修正
bigeneric	两属
keynesian	凯恩斯理论的
csma	Avoidance
addle	使糊涂
mature	到期的
lemme	me
gondi	冈德语
intervocalic	元
pemphigus	天疱疮
hogback	陡峭的山
hit	偶然发现
anthropolater	人类崇拜者
weeklong	持续一星期
dirigible	可驾驶
hindermost	最靠近后方
supermundane	非现世
kaon	K
moreover	此外
praedial	土地的
masty	讨人厌
antifertility	避孕的
murphy	土豆
scrouge	推
ecclesia	会友
uglily	丑陋地
spellbound	着迷的
prognoses	预测
ineffaceable	不能取消的
deserved	应
overdrive	超速传动
amok	杀人狂
wealthily	富有地
automatization	自动化
pythonic	大蟒似
megapolis	多人口地
asexually	无性生殖
vibram	伐柏拉姆牌登山靴橡胶底
dogfight	狗咬狗
ayh	Youth
suprarenalin	肾上腺素
cabriolet	蓬式汽车
cureless	不能救济
grundyism	注重规矩
screech	尖叫声
abiotic	非生物
bully	威逼
capsular	蒴状
kibei	移居美国的第二代日本人移民
verisimilar	好象真实
hasher	侍者
tortuous	曲折的
ace	Command
outworn	用旧的
hottest	热
chiphead	计算机迷
geotropism	向地性
electrotype	制电版
couchette	睡铺
flabellifoliate	叶呈扇形排列的
builder	施工人员
husk	无价值之物
acetophenone	苯乙酮
fifteenfold	十五倍
nose	侦察出
tractorman	拖拉机手
wiseass	alec
muster	一群
acidity	酸性
theonomous	由上帝统治的
spawn	菌丝
tubuliflorous	管状小花的
lrl	receiving
recelebrate	重新庆祝
gastroduodenostomy	胃与十二指肠吻合术
prelude	序幕
sudorific	促使发汗
autoboat	汽艇
biwa	琵琶湖
brash	性急的
resurge	复活
african	非洲的
unabiding	短暂的
franchise	赋予特权
lycopodium	石松属的植物
qmc	Quartermaster
invalidism	病身
spasmodism	突发的情绪
gazetteer	公报记者
camporee	童子军露营
cakewalk	步态竞赛
imitate	模仿
oozy	软泥
waterbury	沃特伯里
rubefaction	使……发红
show	指示
swagger	狂妄自大者
habilimented	衣着整齐
ameristic	不分割
mediagenic	为传媒服务对象
subminiaturize	把……制成超小型
lucid	明晰
filthily	不洁
hempy	似麻的
isomeric	同质异构
masterful	专横的
hieroglyphical	象形文字的文章
crustaceous	外壳
ecliptical	食
delir	陷入谵妄状态
hit	碰撞
unmarriageable	不能结婚的
ninetieth	第九十
affectionate	亲爱的
soho	哈!
buic	Control
augustly	庄严
sketchbook	写生簿
counterdeed	反对证书
moorish	摩尔人
seafront	面向海的一面
afl	Labor
panmixis	随机交配群体
discophile	唱片收集家
stratigraphical	层学
unef	Emergency
mirador	凸窗
flee	消散
adoptive	采用
bathos	陈腐的
equally	相等
untalented	不聪明
imitate	仿造
nitrosyl	亚硝酰基
triserial	排成三列
pleiotaxy	多轮式
zesty	兴致很高
pulmonary	肺部的
atheromatous	动脉粥样化
rarely	很少
globelet	滴
subacute	亚急性
kilocurie	千居里
devotional	专心的
stale	疲倦的
excite	刺激
unstrikable	不得罢工
preselective	预选式的
biogeochemical	生物地球化学的
semioviparous	半胎生
omission	冗长
helicoidal	=helicoid
overcareful	过分谨慎
surely	安全
formication	蚁走感
faddish	趋于时尚
southernwood	青蒿
cresylic	杂酚油的
semifinal	半决赛
servitude	奴隶状态
babu	相当于Mr或Sir的称谓
castrative	产生阉割效果的
unfatherly	严厉
maldivian	马尔代夫人
disestablishmentarian	主张国家对教会不予承认者
fluffhead	轻佻女子
boney	=bony
bromidic	无聊
ravenna	拉文纳
oxo	含氧
slag	火山岩渣
peristaltic	蠕动
s3	全球最大的图像、视像及多媒体加速器供应商
snicker	窃笑
coring	去除中心部份
cognation	血亲
sinophile	爱好中国
panther	豹
otp	Trading
pellagrin	糙皮病患者
ble	Locomotive
rda	recommended
taxi	出租汽车
shadowboxing	太极拳
launder	流水槽
mack	老弟
sanscrit	=Sanskrit
tallboy	高脚橱
transshipment	转载
unrepulsive	未被击退
polyantha	多花蔷薇
aneroid	不利用液体
unbonnet	除去……的帽子
ponderance	重要性
abborrent	嫌恶的
pyrometry	测高温学
spode	斯波德陶瓷
downcast	沮丧
bold	大胆
esol	Speakers
sapanwood	苏木材
christmassy	有圣诞气氛
chinagraph	瓷器描笔
unauspicious	=inauspicious
pert	Review
eia	Association
ppcc	People''s
parallel	并联的
alfreda	阿弗丽达
coed	对男女都开放的
diploma	毕业证书
complaint	牢骚
zilpah	悉帕
criminality	有罪
antimicrobial	抗菌的
lamby	多毛如羊
upstairs	上楼
enjail	软禁
sorbefacient	吸收促进药
scurvily	粗鄙地
hidropoiesis	流汗
unfathered	出处不明
meiobenthos	较小型水底生物
unrepealed	仍有效的
quietistic	寂静主义的
hyde	海德
jocularity	滑稽
theologically	神学上地
biologic	生物学
scalpriform	凿形的
cathartic	通便药
embroil	牵连
hatefully	憎恨地
distributivity	分配性
rsgb	大不列颠无线电学会
drink	酗酒
berliozian	柏辽兹乐曲
tentmaker	制造帐蓬的人
atwain	分为二
colloquium	讨论会
nop	provided
deadstart	静启动
proprioceptive	本体感受的
lingulate	舌状的
waffie	流浪者
reticula	错综复杂的
nucleus	核子
catacomb	地下墓穴
extraovate	卵外的
photoelectroluminescence	光控场致发光
ingrained	根深蒂固的
commonsensible	常识的
unfathomable	深不可测的
gust	汹涌
dismiss	使离开
trichopathy	毛发病
nasserite	纳赛尔主义者
borderland	朦胧之境
suicidal	自取灭亡的
firstling	初生物
sound	语音
beatific	祝福
transnatural	超自然
stockpot	杂烩锅
virginiamycin	维及霉素
amusedly	开心地
minus	减的
hierocratic	僧侣统治制度的
exhaustible	被汲尽
hexachlorethane	=hexachloroethane
lubricative	润滑
present	当面的
wearproof	耐用的
mezzo	中间
humanities	人文学科
rap	交谈
dumet	杜美丝
timbal	鼓膜
joking	开玩笑的
fete	宴请
sweeting	情人
planirostral	具扁喙的
ringent	开口的
ac	Armored
overcanopy	以帐蓬覆盖
plug	插头
propound	提出
notarize	证明
offhand	随便
cession	让与债权
mineraloid	准矿物
camerlingo	财政官
khond	冈德人
hydel	水力发电
inertial	惯性的
loxodromic	斜驶
partialness	部分
pareu	一块长方形印花布
esemplastic	有融合作用的
shitticism	污言秽语
blacketeer	=black
fake	假的
inconsequently	不合理
moko	毛利人的文身制
meaty	肉的
snug	暖和的
reniform	肾脏形
isostemony	同基数雄蕊式
hunan	湖南
encyclopedic	如百科辞典
jackpot	累积奖金
flanker	两侧的东西
festschrift	纪念文集
oblatory	奉献的
squawk	抗议
idioglottic	自语症
impastation	用浆糊封涂
secondhand	二手
hypergolic	自燃的
face	脸
maintain	供养
equitable	公平
widower	鳏夫
unambivalent	明确的
recreance	怯懦
aplomb	泰然
strange	奇异
semiconducting	半导体
titivate	化妆
thibet	=Tibet
genital	生殖
alterative	体质改善疗法
aok	完美
functionalism	实用第一主义
wattless	无功率
etcetera	附加的人
cerebrotonic	孤僻气质
voluminous	容积大的
pomiferous	结梨果的
overdraw	透支
brekkie	早餐
slingback	露跟女鞋
tasimeter	微压计
chalk	白垩
ampoule	安瓿
comate	伙伴
enterovirus	肠道病毒
thin	稀疏地
interstitial	空隙的
unyieldingly	不屈服
renegotiation	重新谈判
gust	迸发
haemolytic	血球溶解
innate	天生
symmetrical	对称的
enthrall	迷惑
mum	沉默
inextinguishable	不能消灭
benthonic	湖底的
sexualize	使有性别
aciculate	有刺
resistible	可抵抗的
outdoorsy	爱好野外活动的
punch	打孔机
he	He
enforceable	可强行的
sexton	寺庙里的杂役
ethnographer	人种学者
time	合拍
str	reactor
poppycock	废话
scissorsbird	=scissortail
subderivative	次派生词
stoutly	坚决
discant	=descant
bacteroid	细菌状
contubernal	一起生活
aurae	先兆
sociologize	用社会学观点解释
effendi	先生
amidship	在船中部
gisarme	中世纪士兵用的战斧
playroom	娱乐室
arraignment	提问
bibliotics	文件真伪鉴定学
deliquescent	溶解
cineaste	电影制作人员
scepticize	持怀疑论
zanza	一种敲击木琴
sheila	少女
vassalage	家臣身份
sialic	硅铝质的
usurpation	篡夺
piling	打桩工程
cytotoxic	细胞毒素的
brassy	象黄铜的
testacy	留有遗嘱
parasitoid	拟寄生物
ambition	野心
supper	晚餐
scrutable	可解读
discrimination	区别
landstream	陆潮流
interfoliaceous	两叶间
multiparty	包含多党党员的
amatory	情人的
primage	运费贴补
indeliberate	未经考虑
counterfort	扶垛
local	地方的
kobold	土地神
cassandra	凶事预言家
nauseate	使作呕
synthetical	综合的
resedaceous	木犀草属的
wound	击伤
germanic	德国的
filoselle	散丝
graphy	书写单位
golden	金色的
intersection	十字路口
mouthless	无孔的
quietive	镇静剂
tack	大头钉
intuitivism	直觉知识
schmitt	施密特的
fordless	没有浅滩的
spartanize	斯巴达化
multicolor	五彩缤纷
zooty	华丽
harl	羽上的细毛
mas	Agency
unrounded	非圆唇的
tap	轻叩
unuseful	无益
suicidal	自毁的
guide	导游者
international	国际
inbreeding	同系繁殖
emend	校勘
compelled	迫使
murrhine	默勒石制的
manservant	仆役
indication	暗示
profitability	利益率
insensibility	不关心
structureless	无结构的
agonizingly	使人烦恼
irreclaimable	不可恢复
wishfully	希望地
preponderance	优势
powder	搽粉
riparian	河边的
motile	显示活力的
billiard	弹子戏
fossorial	适于掘地的
insinuative	讽刺
recharge	再控告
singlehanded	独力的
hesitatingly	支吾其词
comusmacv	Vietnam
attitudinal	态度的
shackle	桎梏
doubleheader	连赛
struggle	尽力使得
hugely	巨大地
subtilin	枯草菌素
chipmunk	花栗鼠
stateliness	庄严
legalize	使合法化
cometary	彗星
tractable	易驾驭
peddling	无关紧要的
fog	迷惑
when	在……的时候
poussette	跳环舞
montilla	蒙蒂勒白葡萄酒
divisional	分割
karman	卡门导管
evader	逃避物
subtetanic	轻度强直的
fusiform	两端渐细
frilly	镶褶边的
condensative	可凝结
levelheaded	清醒
dagmar	达格玛
certifier	证明者
lipolytic	引起脂肪分解的
derogatory	贬损
notify	通报
undeviating	坚定不移
sutlery	随军小商贩的职业
eucharist	圣餐
encouraged	被鼓励
athwartships	横向地
diplophonia	复音
gambian	冈比亚人
hackle	颈上的羽毛
wri	risk
spermic	精子
manoeuvre	调动
necropolis	古代的埋葬地
niddering	不诚实的人
disbelieving	不相信
cremationist	主张火葬的人
betsy	的昵称
unshirted	赤裸裸
nextel	"纳克斯泰尔"人造血
amplexicaul	抱茎的
armoric	阿莫里凯的
fasten	闩住
nettlesome	恼人的
septate	具隔膜
diplomatic	外交
course	经过
nascar	Auto
yaff	以锐声叫
extrovertish	如外向者
graticule	分成小方格以便复制的图形
trousers	裤子
attitudinize	装腔作势
atabal	小鼓
ovotestis	卵精巢
japan	日本
partook	partake的过去式
bisync	二进制同步通信
arthroplasty	关节形成术
refreshen	=refresh
glimpse	瞥见
procurance	实现
baathist	叙利亚社会党的
oner	极佳的事情
geometric	几何学
unmarried	单身
inarticulately	难以表达
cueist	玩撞球的人
presentative	有推荐权的
keynesian	凯恩斯主义者
unilateralization	单向化
equally	平等
ingenital	天生
meiji	明治(日本明治天皇睦仁
conn	驾船
cokuloris	调光板
miscreance	异教信仰
tetchy	易暴怒
murein	胞壁质
cineole	桉树脑
swiss	瑞士的
taileron	尾部升降副翼
gravitate	受引力作用
sill	基石
extent	长度
dinoceratan	恐角兽
assimilative	同化力的
corbel	承材
genie	鬼
residential	住宅
federate	联邦制度下的
unga	United
iaupe	Professors
delaney	amendment
hardhat	建筑工人
termwise	逐项地
through	经由
rubberlike	如橡胶
husky	沙哑
saurian	蜥蜴类的
seize	抓住
lepton	希腊的货币单位
nccj	and
lyrical	充满感情的
contrivance	发明
rupicoline	=rupestrine
calchas	卡尔克斯
leporide	比利时野兔
supergranular	超米粒组织的
terebene	松节油精
scall	痂病
metier	职业
aymaran	艾马拉族的
trisyllabic	三音节的
peremptoriness	武断
bacteremic	菌血症
foldboat	涂胶帆布艇
uncomplex	易懂的
galvanograph	电铸版印刷品
gravy	不法利润
lousy	污秽
finlander	芬兰人
mingily	吝啬地
imputable	可归咎的
demiseason	介于两季之间的
separative	有分离倾向
twitch	抽搐
houselessness	无家
biennialy	每二年一次
canonist	圣典学者
beau	情郎
deathly	死一般的
tied	约束
fian	=Fiann
misconstrue	曲解
one	一个
preplacement	录用前
beautydom	美人圈
urtext	原始文本
bulb	球形物
vesiculous	=vesicular
demonetize	使通货废止使用
albuminoid	蛋白似的
illustrative	说明性
occultist	术士
elliptical	省略的
yakuza	日本瘪三
pentomic	五群制
hircine	山羊般
sarsa	由撒尔沙根中提炼的药
unspliced	未拼接
outmarch	追过
publish	发表
muggletonian	马格莱顿教派信徒
ocdm	Defense
guide	指南
synchronological	展示同时发生的
matronly	安祥
nummulary	货币
backbend	卖艺人身体向后仰作弓状的姿势
semiscientific	不十分科学化的
rantipole	粗野的人
swinishly	贪婪地
exophthalmic	突眼
nitty	笨的
unthought	未加思考
grogram	丝或丝毛交织的粗松斜纹布
uncommonly	很
reginal	威严
feathery	柔软如羽毛
allegorical	寓言
unnilquadium	104号元素
ablator	烧蚀挡板
cornetto	小铜喇叭
legality	墨守陈规
malcontent	不满者
amuse	使发笑
palaeoanthropology	古人类学
irreconcilable	矛盾
said	say的过去式和过去分词
shaky	颤抖
mccarthyite	麦卡锡主义信徒
fasten	抓住
attend	护理
summoner	法院传票送达员
exuviation	脱壳
twopenny	不足道
haemolytic	溶血的
fos	轮船上交货
hormone	激素
propylite	青磐岩
distribution	法院对无遗嘱死亡者财产的分配
genealogical	系谱
pauperdom	=pauperism
expanding	展开
jarful	一瓶
isthmic	=isthmian
projecting	伸出
alienator	赠予者
gore	缝以补裆
cottier	农夫
immediateness	直接
ambassadorial	大使的
bandobast	=bundobust
damning	诅咒
quickish	相当快的
endowment	天资
irised	彩虹色
uaw	Automobile联合汽车工会
termly	定期的
spoken	口语
benedictive	赐福的
charpit	烧木炭的坑
megalithic	使用巨石
hausfrau	主妇
unwrought	未加工的
romance	浪漫史
rearview	mirror后视镜
scavenger	食腐动物
unurged	未被催促
devise	图谋
deovolente	若一切顺利
capitalintensive	资本集约
versicolor	杂色
prickle	柳条篮子
donau	=Danube
ophiolite	蛇纹石
credulously	轻信地
cuticular	表皮
billbug	谷象
ousel	鹤类的小鸟
cc	科科斯群岛
chart	海图
nattily	整洁
channel	引导
coul	=cowl
endobiotic	组织内寄生
fleetingly	疾驰
knickknack	小玩意儿
preheating	预热
carfare	公共汽车费
electrophoretogram	电泳图
intussuscept	摄取
aeroginous	产气的的
investitive	赋予的
inexcitable	难以激动的
highly	高
transactor	办理人
intrench	固守
claspt	clap的过去式及过去分词
plant	工厂
signboard	招牌
fucker	傻瓜
president	行长
infernal	恶魔的
monticulous	=monticulate
his	他的
arouse	鼓励
abortively	流产
barnstormer	江湖艺人
antemeridiem	上午
assimilative	同化
conjugal	结婚
flickering	忽隐忽现
euphory	=euphoria
anetic	弛缓
adventuress	用不正当手段谋求名利的女人
dps	每秒衰变数
vomit	吐出
downwash	因机翼所产生的下降气流
optimal	最理想
say	发言权
azof	=Azov
pecuniarily	在金钱方面
hedgepig	反潜火箭
kitakyushu	北九州
giggly	傻笑的
blackness	阴险
diaxon	二轴突细胞
carboy	用藤罩保护的大玻璃瓶
overhead	高架的
bottlebrush	洗瓶刷
emi	百代唱片公司
martian	火星人
averse	不愿意的
preemphasis	预加重
osmanli	土耳其语
pompey	英国南部的军港
reglaze	再上釉
auric	三价金的
momentary	瞬间
yardman	场地工人
darwinism	达尔文学说
fifteenth	第十五
nhk	Kyokai
birdshot	小号铅弹
sophister	大学的二年级学生
demand	要求知道
plane	平面
armenian	亚美尼亚人
unlash	放开
valsalva	manoeuvre瓦耳萨耳瓦氏手法
folknik	民谣迷
kiri	泡桐树
likewise	照样地
lawson	劳森
polyether	聚醚
forgetive	能够创造发明的
granularity	间隔尺寸
founderous	易使人摔倒
wagonload	货车装载量
emr	educable
vociferate	大叫
idiosyncratic	特殊物质的
outroot	根绝
playgame	儿戏
governess	女家庭教师
carbachol	碳酰胆碱
replicate	复制
flackery	推销
lilacky	淡紫色
lame	跛足的
sick	病态
affluent	丰富
disbud	去蕾
undecagon	十一边形
snowberry	雪果
scalprum	骨刮
idiocy	白痴
fluoroplastic	氟塑料
recuperative	有恢复力的
indigestible	不吸收的
coordinate	同等物
retail	零售的
chaw	嚼
isolated	孤立的
guileless	不狡诈的
methinks	我以为
exsection	切去
strict	严厉
conversus	教友
slatted	覆有板条的
osprey	白色的羽毛
carbonaceous	碳的
setover	偏距
mowburnt	因堆积发热而霉烂
aluminize	以铝覆盖
aminobenzene	酸
aerocar	可变为汽车或飞机的一种运输工具
proptosis	前垂
preadamite	认为亚当以前便有人类
slender	苗条
gazette	学报
inscape	内在的特性
ddn	Digital
calenture	中暑
fillagree	金银细丝工艺
meterstick	米尺
preferential	特惠的
rube	土包子
cegb	中央电力局
plane	程度
sulfonmethane	=sulphonmethane
inconsistently	不一致
unslumbering	一直警惕着
jungian	支持易雍的人
velvety	柔软的
valued	尊贵的
warranty	根据
coding	译码
rigor	苛刻
dacron	的确良
embroidery	装饰
hotelman	旅馆经理
gawp	呆人
backroom	私下的
ream	铰除
one	一方的
remove	开除
purl	用金银丝绣
garlandry	花环装饰品
bum	无价值的
pantomime	打手势
diabetic	糖尿病患者
housewife	家庭主妇
tup	锤头
degradation	降级
grimly	严格
indivisible	除不尽
acoustooptics	声光学
energise	=energize
keratometric	角膜散光计的
masochism	受虐狂
odorously	香气
idle	懒惰
headily	任性地
cartology	三角图学
hbms	Ship
icosidodecahedron	三十二面体
kusso	苦苏花
lingayen	仁牙因
univocal	意义明确
thankfulness	感激
westbound	西行
temptation	诱惑物
antimonarchic	反君主制
anterolateral	在前面偏一边的
trichopathy	毛发病疗法
haematopoietic	造血
erect	树立
saponifiable	可皂化
essentialize	使精炼
superior	出众的
atelectatic	肺膨胀不全的
quadripartite	分成四组的
catamnestic	病后经过的
farmisht	混乱
pike	用矛刺穿
diplomatic	老练的
maundy	洗足礼
synapse	神经原的神经线连接
working	经营
sightworthy	值得一看
fluster	混乱
solidary	休戚相关的
elburz	Mountains厄尔布尔士山脉
atherosis	动脉粥样化
dessert	餐后甜点
rhinopolypus	鼻息肉
intragalactic	星系内
roguish	流氓
kiddle	鱼梁
indaba	野营聚会
entelechy	圆满实现
cornelia	科妮莉亚
sexton	教堂司事
ultrasonics	超音波学
sncf	Societe
jargon	行话
exposed	无掩蔽
handbarrow	搬运工具
clinical	临床的
grassland	牧草地
amethystine	紫色
duplicate	复制品
roach	蟑螂
erythropoietic	红血球生成
counterpulsation	反搏
sql	Language
omniscient	无所不知的
upstairs	楼上的
zincography	刻锌版
coownership	共同所有
skywards	向天空地
frontlessness	没有前部
quotable	可引用的
renascent	新生的
conflagration	突发
cursely	该受诅咒
bored	无趣的
homophonous	齐唱的
heeler	一帮捧场的人
waxen	似蜡的
soavemente	=soave
factious	好搞派系
mechanism	机构
assumed	假装
inhospitality	冷淡
forthcoming	即将来临
dolomite	白云石
unadvantageous	不利
ultraviolet	紫外线辐射
sinkage	下沉
prepayment	预缴
attitudinal	态度
cowtail	有牛味
unconstrained	不受强制的
scurrilous	说话粗鄙恶劣
clathrate	窗格形
beauteously	美
dingily	暗黑地
gandhian	甘地的
lactoovovegetarian	乳蛋素食者
knawel	纱球草
conchae	半圆屋顶
cornered	有角
differentiable	可区分
inseminate	栽植
subclavate	略似棒形
clop	发得得声
flowing	通顺
utilitarian	功利论者
pediment	山形墙
parkland	温带之草木区
correlativity	相关关系
shiur	犹太人传统课
philippines	菲律宾群岛
sedimentable	可沉淀的
compute	估计
ably	能干
yetorofu	=Etorofu
gutty	生气勃勃的
counterplot	用反计
humate	腐殖酸盐
strac	战略陆军部队
rosarian	玫瑰花栽培者
dbms	数据库管理系统
hermetic	密封的
excorticate	剥去……的外皮
sebaceous	脂肪过多
margarine	人造黄油
degasify	排除……的毒气
burdensome	繁重
armangite	砷锰矿
unaccountable	无法解释
swidden	临时性农田
chargeable	可记在某项帐目上
over	结束
policy	政策
aarnet	the
flit	迅速飞过
muzzleloader	前装炮
worshipful	可贵
do	可用
somatosensory	体觉
mezcaline	=mescaline
scepter	授予节杖
ferocious	十分强烈的
rudely	无礼地
semiyearly	半年一次的
frequentative	表示反复动作
damsel	处女
evillooking	相貌凶恶的
barbicel	羽纤支
fill	填充
ream	令
spadework	基本研究
ataraxy	心气和平
chromatin	核染质
acidifier	成酸剂
resourceless	无资力的
elegance	雅致
nullification	废弃
anonymity	作者不明
saleroom	销售活动
spoonbill	篦鹭
tsoris	烦恼
chromize	对处理
saving	存款
trellis	格架
cegb	Generating
mopey	没精打采
spindle	纺锤
ungirt	不缚带的
blackboard	黑板
commensal	同吃
optometrist	视力测定者
cathodal	阴极的
hereditable	可继承的
waterlogged	浸满水
quaker	教友派信徒
histidine	组氨酸
pc	Personal
current	草写的
frequentative	表示反复动作的
adder	猪鼻蛇
haven	港口
doa	on
curlypate	有鬈发的人
chalybeate	铁剂
meretricious	俗气
umbellar	伞状花的
idioglottic	自我语法的
consider	考虑
pilferage	偷盗
herbary	药草园
wareroom	商品储藏室
knotweed	紫菀科植物
caespitose	丛生的
racer	比赛者
floristic	植物的
proteiform	多型
sulfate	硫酸盐
ripsnorting	了不起的
foucquet	Nicolas
downy	丘原
galactopoietic	催乳剂
embolic	插子的
copperworm	衣裳蛀虫
cgh	of
exquay	码头交货
meteorologic	气象学
pedestrianize	使无车辆行驶
pure	抽象
ethereality	轻妙
rising	起立
goodman	夫
sciurine	松鼠科的
southmost	最南的
urnflower	瓮花草属植物
ultraclean	超净的
nautical	船员
desalinize	除去盐分
neatherd	牧牛人
lima	利马
hiding	隐匿之所
octangle	八边形
asean	East
cyprian	淫荡的人
conquerable	可征服的
botheration	讨厌!
obsidionary	=obsidional
cultrate	锋利且尖锐的
sessioneer	=session
tajo	塔霍河
illinoisan	伊利诺斯州人的
stormy	有暴风雨
fun	玩笑
angioma	血管肿
unwit	使丧失智能
finecomb	仔细搜索
jellyfish	水母
continuous	持续的
simulator	假装者
shakiness	不坚定
auc	founding
grisly	令人毛骨悚然
ptolemaic	托勒密的
felicitation	庆祝
buran	布冷风
putter	置放者
valeric	颉草的
flunkey	穿制服的仆役
quizzical	引人发笑的
upstream	逆流地
homosexuality	同性恋
lowball	向虚报低价
sweepback	后掠角
eyewink	霎眼
explant	外植体
plutocratic	有钱有势的
ignatius	伊格内修斯
transferability	可转移性
barbarous	残暴的
unlighted	未被点燃的
inductile	没有延性的
thereagainst	反之
baculiform	杆状的
skyey	高耸云霄的
rushing	旺盛
obelisk	疑问记号
tilt	以言词或文字抨击
decamp	秘密而匆忙地移居
quivive	谁
scuttle	天窗
flageolet	六孔的木箫
lacunosis	网状
microteaching	微型教学
worry	担心
secretory	促分泌
gunnery	重炮
camphene	莰烯
sweepstakes	赌金
anestrus	不动情期
broad	宽阔部分
shivering	颤抖的
grub	食物
renunciative	脱离关系
polarisation	=polarization
apollyon	亚玻伦
arsphenamine	六零六
platiniridium	铂铱
acutilingual	尖嘴
communicate	传达
norsteroid	去甲类固醇
weldable	可焊
scraggly	零乱
rooty	根似的
roundly	全面
olea	oleum的复数
prolific	丰富的
muttonhead	笨人
premium	奖金
binate	成对
snubbingly	冷落怠慢地
noblesse	贵族阶级
ark	约柜
aseptic	防腐剂
inertial	不活泼的
bridle	昂首
unbeknown	不为人知的
mirror	典范
subhepatic	肝下
yielder	屈服者
taps	熄灯号音
sailing	航行
indigoid	靛蓝类
duds	衣服
photoinduced	光致的
marked	显著的
promptitude	敏捷
stem	干
dungeness	crab
furbelow	饰以俗丽的装饰
electrograph	传真机
dilutive	冲减每股收益的
optotype	试视力字体
poikilothermic	冷血动物
monospermal	单种子
dumpy	粗短
democritean	德谟克利特
experimentalism	试验者
pneumonolysis	=pneumolysis
shoreless	没有岸
seti	extraterrestrial
mellowness	怡然
cancha	手球场
sanidine	透长石
frisian	Friland的
bastardize	使质次
unsubstantial	薄弱的
denali	德纳里峰(即麦金利山
cinerous	灰色
zamboanga	三宝颜
rendezvous	在指定地点集合
allegorization	讽喻方式的叙述
josh	玩笑
howl	喝住
heartstricken	悲痛欲绝的
xenix	微软开发的用于PC机的UNIX操作系统
transcontinental	横贯大陆
flog	鞭策
olent	有气味的
reen	沟
floriculture	栽培花卉
laval	似熔岩般灼热
shockheaded	头发乱蓬蓬
emcee	司仪
uncontradicted	不矛盾的
nonentanglement	不牵连
costless	无须付出代价的
ralline	秧鸡科
hand	交给
tenacity	坚韧
cinchonize	使金鸡纳中毒
linguatulid	舌形虫
ventriloquial	口技
incorruptibly	不被腐蚀
ichthyotic	鱼鳞癣
inherency	天赋
fruition	成就
neptunian	海王星
scrambler	扰频器
valdez	瓦尔迪兹
lunatic	疯狂
sulk	生气
ingrained	彻底的
unbefriended	无人扶助的
dissociate	游离
plaza	露天汽车停车场
overhead	高架
creviced	有裂缝
sadhu	苦行僧
hose	用软管浇水
crafty	狡诈的
leftlaid	左搓
lexigraphic	词素文字
specifical	=specific
bucker	突然跃腾使骑者摔下
organic	组织
choplogic	诡辩
enate	母系亲戚
viticultural	葡萄栽培
haemophilic	嗜血
naw	不
shakable	可摇动的
ashy	苍白
deadwood	朽木
flambeau	有装饰的大烛台
singly	直截了当
windup	挥臂准备投球的动作
vtc	Compression
washingtonologist	华盛顿学家
unrecognized	未被承认
enthrall	迷住
pop	抛出
rasp	刺耳声
home	家庭的
foolery	蠢事
casuistry	决疑法
prosecute	起诉
surgent	澎湃的
capucine	=capuchin
emesis	呕吐
parsonian	帕森斯社会学理论
table	桌子的
synechia	虹膜黏连
alcometer	测醉仪
wetland	沼泽地
commend	推荐
reign	统治时期
plagiarize	剽窃
andes	安第斯山脉
late	最近
spar	晶石
exteriority	在外
hereat	此际
sunny	照耀
unremitted	未赦免的
tell	吩咐
hoosegow	监狱拘留所
kindlessly	薄情
restrainedly	有限制地
fibrillous	纤维状的
digitalose	毛地黄糖
strikingly	醒目
procurance	获
gloss	光泽的表面
semiurban	半城市的
puggry	印度人用的头巾
uneventful	平凡
hsaa	Advancement
canadian	加拿大人
lynch	诽谤
spongious	海绵般多孔的
chrysophyte	金藻
seismonastic	感震
elf	恶人
reperforator	复孔机
digit	一指宽
medical	医学
chrysarobin	柯桠素
upcast	向上
whp	water
abdomen	腹
swat	重拍
deep	纵深
subcapsular	囊下
sooty	乌黑的
imbody	拼凑
heterotopy	异位移植
atremble	发抖
realize	了解
metapsychic	心理玄学
flowery	华丽
suburbia	郊区居民
coparceny	=coparcenary
female	女子的
laryngeal	喉的
weird	超乎事理之外
owlish	面孔严肃
towel	手巾
tee	T字形
bleaching	漂白的
runover	超过篇幅的排印材料
deed	契约
iconometer	直视取景器
effusively	热情洋溢
whipsaw	利用一方打击另一方
ameristic	不分割的
kelleg	锚
rapine	掠夺
word	字
entozoologist	内寄生动物学
hid	hide的过去式和过去分词
subdolous	有点狡猾的
sinneh	=Sanandaj
dog	卑鄙的人
demagoguism	煽动方式
odour	名声
heathland	欧石南丛生的荒野
lookum	吊车棚
flexure	打褶
ensorcellment	迷惑
grand	盛大的
radiophone	光线电话机
enate	母系的
homozygotic	纯合基因的
surjective	满射
catchweight	无体重限制的
yearbook	年鉴
orchidist	兰栽培者
totality	全体
usphs	Service
occlude	使闭塞
foreordination	预定
marcando	=marcato
boorish	乡土气的
copulation	交配
circumspection	慎重
jointer	接合人
videoporn	色情电视
saccate	囊状的
housework	家务
unembroidered	简单的
candle	对着光检查
incoherently	无条理地
oddly	奇特地
cumulostratus	层积云
prey	掠食
tcs	station
arsenical	砷
willow	柳树
strac	Corps
amimeche	I
schoolmate	同学
biyearly	两年一次
resume	重新开始
prosecute	告发
deterrence	妨碍物
tattersall	塔特萨尔花格呢
epsom	英国
pointillist	点彩派画家
hefa	Higher
unbent	不屈服
unassuming	不装腔作势
naeb	Educational
grasping	贪婪
econometric	计量经济学的
unvanquishable	不能征服的
foozle	笨拙的人
wise	狡猾
grinningly	露齿而笑以示
stoke	大吃
ppe	Ploitics
done	注定要完蛋的
taint	感染
gmbh	股份有限公司
jeer	嘲笑
quick	急剧的
iatrical	医学
epidural	硬脑膜外的
pyrogen	热原
pool	共享
enforce	执行
themselves	她们亲自
soddish	极坏的
substantive	独立存在
jointing	填料
bumpity	=bumpety
testacean	贝壳的
gramineous	青草味的
hoarsely	嘶哑
fecundity	丰饶
testacean	贝壳类
assumably	大概
auriscopic	耳镜的
concentrical	共中心的
treacherousness	奸诈
convexity	凸状
brokenhearted	极度沮丧的
incorrigibility	难望矫正
suctorial	有吸附
underlaid	置于下面的
unhip	非赶时髦派的
whisk	扫帚
throwback	阻止
toucan	犀鸟
cybele	西布莉
scr	Scout
unremitted	继续不断
inspiratory	吸气
mithraic	密特拉神的
labouratory	研究室
xanthein	花黄素
flocculus	一丛柔毛
counterelectrophoresis	对流电泳
lomentaceous	节荚的
plp	Party
sled	用雪橇运
paint	颜料
cantonment	兵站
menstrual	一月一次
spintherism	闪光幻觉
catoptrics	反射光学
macronutrient	大量营养素
virion	病毒粒子
gold	金币
counterdrive	反强攻
hand	搀扶
ox	牛
someway	以某种方式
micromeritics	微晶学
cyprian	放纵
erne	白尾鹫
gummatous	梅毒瘤的
transitional	过渡期的
ridable	可以骑的
undetermined	未确定
edge	尖锐
khfos	=Chios
muddle	使微醉
sartorial	缝纫
isolato	与世隔绝者
blae	青灰色
safener	安全剂
funny	有趣的
asexually	无性
stingy	小气的
callous	无情
aga	宗教领袖
lackluster	暗淡
notionalist	理论家
ringlet	小圈
disharmonic	不和谐
scarcely	简直没有
present	礼物
thermalgesia	热性痛觉
snatchy	不规则的
computerizable	可以电脑处理的
shutdown	停工
eccentric	古怪
vlbi	baseline
cleanser	清洁剂
conservative	守旧
jsp	Java服务器页
psoas	腰肌
inexpressive	无表现力
dna	acid
naxian	纳克索斯岛人
othello	奥赛罗
veracious	准确的
event	精力
innocent	清白的
monochromatic	单频的
waylay	伏击
crewmate	同船工作之船员
elliptic	椭圆形的
sphenoid	楔状
omniscient	全知的
biocidal	杀生
stylish	流行
stannous	含有锡的
frank	老实的
winter	对……进行冬天保护
controversial	争议的
clou	中心思想
botswana	博茨瓦纳
reflexible	可反射
intelligentsia	知识界
antitrade	反贸易风的
rude	粗鲁的
enforceable	可实施
fob	混骗
pedestal	搁在台上
containershipping	货柜运输
ppm	per
schumpeterian	熊彼特的
adjustive	调整的
eremurus	独尾草属植物
introspective	反省的
witted	头脑……的
decillion	数达1
tyrannously	压制
handwoven	以手织机编织的
fertility	丰产
fasten	扎牢
gftu	General
file	用锉刀锉
imp	小淘气
dirtily	龌龊
waver	犹豫
disbursement	支付
excitatory	兴奋的
uninspired	平凡
hexagonal	六角形
baccalaureate	学士学位
meliorative	改善
hurricane	飓风
hypostatization	使实体化
sterile	毫无结果的
improvvisatrice	女即兴赋诗朗诵者
myth	神话
inexact	不精确
exhilarative	使高兴
defrayal	支出
haematological	血液学的
sparsely	稀少
womanlike	像女人
gelable	能变成胶状
sundry	各式各样的
stump	截去
magnetic	有磁性
visive	视力
pyramidion	小金字塔
prognathous	下巴突出的
velutinous	有绒毛
prewar	战前
miesian	密斯建筑式样的
sickee	道德败坏者
senary	以六为基础的
silex	硅石
lessee	承租人
lumber	砍伐木材
changer	改变者
taoist	道士
eunuchoid	似阉人
apt	敏捷
sedately	镇静
outdoor	野外的
animatingly	鼓励地
bigoted	顽固
themselves	它们亲自
substantiate	证实
roydon	克里登
sophistic	强词夺理
apical	顶上
boomerang	回飞棒
uptodate	最新式的
milieu	周围
micronutrient	微量营养素
flaringly	华丽而俗
snatchy	断断续续
distichous	二列
interlocution	对话
lumber	乱堆
proprietary	所有的
useless	无益
barbadian	巴贝多人
rowboat	小舟
timberwork	木结构
nccw	Catholic
twistification	歪曲
capitulary	法令集
spate	大水
kevlar	纤维B
amimeche	Member
unbuttoned	无拘束
corydon	农夫
drolly	诙谐
nietzschean	尼采哲学的
submedian	位于近中央处的
eunomia	欧诺弥亚
thumbmark	拇指痕
trisomic	一套半染色体的
sleazy	质量差的
ddn	Defense
wrest	费力取得
gastrology	烹饪学
objectively	客观地
novel	异常的
monotony	单调
efficaciously	有效地
enserf	使成农奴:
involve	笼罩
pernoctation	彻夜不眠
limacine	似蛞蝓的
fmi	taire
invertible	颠倒的
minorite	小兄弟会修士
dance	舞蹈
continentalism	大陆主义
emulate	仿效
apathetically	无动于衷
quadriplegia	四肢麻痹
morose	郁闷
unreasonably	不合理地
gruffly	粗声
infective	会传染的
countrify	使土里土气
abscond	潜逃
dissertation	论文
preatomic	原子弹使用前的
filiopietistic	过分表示孝敬的
collaborative	合作
stemma	侧单眼
zwinglian	茨温利
unfoiled	未被击退
vase	花瓶
break	休息
inanimation	不活动
visitatorial	访问
ocherous	含赭石
weakly	软弱地
heroicomical	戏谑性的
tripodic	有三脚
incorporation	组成公司
herpetic	疱疹的
fin	鳍状物
chewie	橡皮糖
anniversarian	为庆祝周年纪念而演说之人
semiannular	半圆形的
legpuller	捉弄
swart	有害的
subdual	缓和
overawe	威慑
cdgps	Positioning
circumvent	智取
veinstone	脉石
starfish	海星
teen	激怒
sadhu	圣人
ninny	笨人
overall	全部的
unef	Nations
hoodoo	不祥的人
scheme	图谋
bacteriform	细菌状的
bashlyk	头巾
algorism	阿拉伯数字系统
northeastwardly	向东北
sempiternal	永久的
impeccability	无罪
rammish	象公羊的
honestly	公正地
whyever	无论为什么原因
aristate	有刺
decipher	密电译文
resplend	灿烂
heterogeneous	异类的
doughty	勇敢的
refractory	难熔
askance	斜
resale	再贩卖
fess	供认
photophilous	嗜光的
striven	strive的过去分词
guanidine	胍
recherche	罕有的
loo	洗手间
marshy	湿软的
infrared	红外线
delicate	灵敏的
apolitically	非政治地
key	使用钥匙
malleolus	踝
droog	流氓团伙成员
auteur	电影导演
aapss	American
stormy	多风暴
swellish	时髦的
taletelling	搬弄是非
stactometer	滴量计
zincky	含锌
concomitant	伴随物
oos	无库存
flamboyance	华丽
unoffended	未被冒犯
ileac	回肠的
rack	变形
calvarial	颅顶
antemeridian	上午
acidimetric	酸量滴定
kennel	狗屋
late	迟
hyp	疑病
speculum	金属镜
colorific	产生颜色的
pert	Evaluation
wheelbase	前后轮之车轮轴距离
watertight	不漏水的
quinacrine	阿的平
saving	挽救
bedclothes	床单被褥类
organic	器官
foreworld	史前世界
illegitimation	认为非嫡出子
clot	凝结
lethargize	使无生气
subinfeudatory	受分封者
escapeproof	十分牢靠的
solicitudinous	挂念
verbid	动词的非谓语形式
bdtr	Data
wound	伤口
fibbery	小谎
eternity	永远
cleanout	清除
pipit	田云雀之类
somnivolency	催眠药
windbaggary	空谈
wilding	野生的苹果树
mechanoreception	机械感受作用
townspeople	市民
glumpy	忧郁
quits	两相抵消
logorrhea	速语症
vivify	使生动
menstrual	月经的
prow	船首
undergo	遭受
overrule	驳回
tafia	塔非亚酒
horrific	可怕的
ectogenic	外生的
man	Area
text	课文
pensile	做吊巢的
depopulate	人口减少
lingy	石南很多
goldbrick	假金砖
broadcloth	一种精细棉布或人造丝织物
nongovernmental	非政治的
seed	结实
marginalia	旁注
coopery	制桶
alchemic	炼金术的
pipelining	流水线操作
dihydrate	二水合物
wharf	靠码头
retour	回到原地
counterplot	对抗策略
sculpsit	由……所雕刻
mount	衬纸
hongi	毛利族人的以鼻相触的见面礼
beanball	投中打击者头部的球
garuda	揭路荼
stoup	大杯子
insufflation	喷洒
demark	区别
teledu	獾类
ebn	north
nidamental	缠卵的
who	那……
cubby	小房间
dart	飞奔
bespeak	预订
russophobe	厌恶俄国者
hope	信心
crablike	似蟹行般的
insanity	精神错乱
acronical	日落时发生的
testamentary	遗嘱的
ceratin	=keratin
hierachical	等级制度的
streptococci	的复数形
invertebrate	无脊椎动物
instrumentally	仪器地
yaf	Americans
shin	爬
furred	毛皮制
profound	意义深远的
homonymous	同音异义的
dispositive	决定性的
groin	使成穹窿形
narcissist	自我陶醉者
ethos	风气
altocumulus	高积云
koumiss	马奶酒
admirer	景慕者
unscale	刮去的鳞
cap	戴帽子
counterprogram	9kaJntE`prEm/争夺观众
indelible	不能拭除
strategy	军略
ila	Association国际码头工人联合会
lox	液态氧
undoubled	不再对折
pricy	=pricey
excess	额外
immobilism	墨守成规
myofilament	肌丝
undemonstrable	难以证明的
enravish	=enrapture
exclusively	排外地
significs	意义学
ural	乌拉尔山脉的
mortally	致命
weldable	可焊的
phenetics	表现型分类法
unfinished	未染色的
atoxic	非毒的
uncleanness	不清洁
aerodynamically	空气动力学地
reducible	可还原的
intravital	作用于活体
inkwell	墨水池
eliminant	结式
dicrotisc	二波
essentialize	扼要表达
abundant	充裕的
about	在……周围
fumy	多蒸汽的
waste	消耗
compress	敷布
incremate	火葬
tortive	扭曲
outspan	去轭
tame	沉闷的
keratin	角蛋白
combust	消耗
westernmost	极西
assertion	声明
derivational	诱导的
foreigner	外国人
avouchment	保证
tweedy	爱穿粗花呢服装
refreshing	提神
accessory	补充
truehearted	忠实的
toft	宅地
lowery	阴暗的
cleistogamous	闭花受精的
surpassingly	卓越
galtonian	高尔顿优生学说
inconducive	无益的
perfect	完成式
gonion	下颌角点
able	有才能
conceptive	有想象
mastication	咀嚼
worsted	精纺的
methoxyflurane	二氟二氯乙基甲醚
unadvised	未曾受到劝告的
analysis	分解
produce	引起
tinnitus	耳鸣
bareheaded	不戴帽子
modernbuilt	现代建筑
blaze	照耀
seismographic	地震仪的
heddle	综线
pugilistic	拳击家
sexist	男性至上主义者
untoward	困难
fitted	按实物尺寸做
breezy	轻松愉快
counterpart	配对物
kvass	克瓦斯
humbleness	粗鄙
curiosa	奇品
bagarre	殴斗
indistinctively	不显著
ungual	爪
unfavourably	不利地
ballistically	弹道学
kirov	基洛夫(旧称维亚特卡
ciliated	有纤毛的
requiem	安灵祢撒
pallid	暗淡的
impeccant	无罪过的
slovene	斯洛文尼亚人的
license	许可
alkyl	烃基
isotropic	等方性的
infirm	柔弱的
interblend	相混
sonicguide	=sonic
koranic	可兰经
subadult	接近成年的人
slime	变粘滑
fnma	Federal
clericate	牧师的职位
mantelet	小斗蓬
hambone	扮黑人说黑人方言的杂耍演员
inquiry	调查
herodian	效忠希律一世
itn	Independent
dishonourable	不名誉的
water	流泪
imaginable	可能
external	表面
elliptoid	椭圆状
bluish	带蓝色
khanate	可汗的领土
locoplant	疯草
dogmatical	教理
illuviate	经受淀积作用
planigale	扁头袋鼠
whitehanded	诚实
singlehanded	独力
hecla	=Hekla
weave	织物
hendecahedral	十一面体的
discursively	推论地
uranology	天体学
brush	刷子
arret	逮捕
gutter	排水沟
pocket	钱
rabble	乌合之众
brace	撑牢
abstractively	抽象地
aboard	在船
yew	紫杉
australasian	澳大拉西亚人
ringwise	成环形
sucrier	糖罐
blast	冲击波
fluvioglacial	河冰的
infatuated	昏头昏脑的
pop	突然出现
typo	排字工
gloss	发光
excitement	兴奋
airliner	客机
steeliness	钢制
goldenrod	秋麒麟草属植物
streaked	不安的
saltationist	突变论
poikilitic	嵌晶结构的
client	顾客
means	想要
quindecagon	十五角形
caulicolous	附生在他种植物茎部
otherwise	别的方式
sudsy	肥皂一般的
gutterman	卖便宜货的小贩
italian	意大利语的
postorbital	眼窝后部的
famed	著名
iaf	Federation
systemic	全身的
tortious	侵权行为
manicotti	番茄沙司烙通心粉
final	报纸最晚版
proprietor	经营者
referenced	引用的
rake	耙子
dantean	但丁崇拜者
aurelian	昆虫采集家
warrant	批准
pare	剥
makable	可标记
adiabatic	绝热的
ophthalmitis	=ophthalmia
innumerability	无数
borak	挖苦
franseria	佛伦塞属植物
snugly	尚可
scullery	碗碟洗涤处
repentant	后悔
versatile	万能
daffodil	水仙花
tapeta	tapetum
diffusible	可传播的
feverish	狂热
epigram	警句
fumatory	烟薰的
wigged	戴假发的
disembosom	泄露
puffy	一阵阵吹的
retributive	报应
cry	喊声
unerringly	无过失
indebted	负债
cruelty	残忍
unsyllabic	不构成音节
afrikanerdom	南非白人统治集团
aphthoid	像口疮的
rsvp	you
tryptophan	色氨酸
combo	小型爵士乐团
bicorporeal	有两个主要部分的
ferment	酵素
president	总统
verticil	环生体
nonfigurative	没有比喻用法
bumbledom	妄自尊大
inferior	下级
calf	小腿
mantelshelf	壁炉架
design	花样
contumacious	不听令的
automatic	自动的
mortlake	弓形湖
ligulate	舌状的
elaborately	苦心经营
concern	关注
tradition	惯例
hippophagistical	食马肉的
masonry	石匠职业
formfitting	合身的
megabit	兆位
granular	由小粒而成
pictograph	古代石壁画
obviosity	显然的事物
bestially	野兽
enormously	巨大地
catching	传染
planigraph	图器
refurnish	再供给
babysitter	临时照顾幼儿者
homophonous	同音的
dsrv	deep
chinatown	唐人街
hyperglycaemia	高血糖症
reconcentrate	再集中
catafalque	灵柩台
sympathetic	有同情心
connatural	先天的
evan	埃文
nouny	具有名词性质的
methodically	有系统
notum	背板
frighten	惊恐
friskful	活泼的
periphrasis	迂回说法
kyack	驮袋
ironclad	打不破的
champion	战士
ribby	精疲力竭的
downstage	在舞台前
imbrute	残忍
folly	放荡
shaef	Headquarters
unimpassioned	不感情用事的
desire	期望
inoccupation	无职业
snoopy	爱管闲事的
pooch	狗
euphemistical	婉转的
aerotaxis	趋氧性
unacquirable	不能获得的
push	进取心
piratic	盗版的
ichthyoacanthotoxism	鱼刺中毒
oncidium	金蝶兰属植物
digest	摘要
juratory	以誓言表达的
tiepin	领带别针
restoration	复职
autochthon	土著
mazurka	玛祖卡舞曲
rehear	复审
ceriferous	产蜡的
bimillennial	两千周年的
veto	否决
valued	经估价
flinch	畏首畏尾
intellectual	智力的
polyploid	多倍数体
excursion	偏移
waistline	腰围
satisfaction	满足
tryptophane	色氨基酸
coryphaeus	主唱
furcate	分叉
partialness	偏爱的
wnp	威尔士国民党
ftc	Trade
scalar	数量
leeway	退路
indispensable	不可缺少的
zululand	祖鲁兰
scaletail	鳞尾松鼠
archeolithic	旧时器时代
transracial	不同种族间
jingoish	好战主义
plumbiferous	产铅的
sulphinyl	亚磺酰
atomix	Atomix
semistarved	半饥饿
trinary	三倍
corolline	似花冠的
unattended	没有同伴
screech	发出尖锐的声音
nulliparous	未产妇
indonesia	印尼
oppressive	压制性的
tide	趋势
perennial	四季不断
nbw	west
chawbacon	乡下人
keelboat	一种河船
deterrent	威慑
lawny	草坪般的
plotz	变得激动万分
impedimentary	妨碍的
floozie	粗俗的女子
aerometer	量气计
echograph	音响测深自动记录仪
changeful	富于变化
leukocytotic	白血球增多的
errand	使命
distressing	悲伤
floodlighting	泛光灯照明
ursine	象熊
scrofulous	淋巴结核
overturn	翻倒
yellowknife	耶洛奈夫
recruit	新分子
gastronomic	美食法
sigillography	印记学
immensely	庞大地
horsetail	马尾
irreversible	不能撤回
modernminded	有现代头脑的
dank	阴湿寒冷的
plug	插上
wavelike	波浪般的
bookmarker	书签
jury	临时应急
pop	流行的
afterglow	夕照
colourfast	不退色
dextrane	=dextran
flushing	使人脸红的
boniface	小旅店的老板
setback	顿挫
aging	使变老
unromantic	平淡无奇
holomorphic	对当
endogenic	内生的
divorce	离婚
prettily	悦人地
repeal	废除
catarrhal	鼻黏膜炎的
crackpot	疯子
ventriloquous	口技的
breathless	气喘吁吁的
bujumbura	布琼布拉(旧称乌松布拉
unfathered	私生的
counterstroke	反击
polarity	极性
tungstic	钨
marvel	奇迹
hindrance	妨碍
australian	澳洲的
untapped	塞子未开的
cycas	凤尾松
studious	勤学的
kanggye	江界
hydremia	稀血症
perceptible	感觉得到
jut	突出部分
unbounded	极大的
gemel	铰链
reflexible	可反射的
restructure	改组
homopolar	同极
superlatively	无上
stressor	紧张性刺激
unassuming	不装腔作势的
teenager	十几岁的青少年
undistinguishable	难辨别
puling	哀诉
thematic	主题
reconcilably	可调停地
multiparty	多党的
birdbath	供小鸟戏水或饮水的盆形装饰物
overfull	太满的
sensibly	敏感
hematopoiesis	造血作用
ekman	dredge埃克曼采泥器
pyrex	耐热玻璃
offhandedly	立即地
printmaking	版画复制
blockette'	NULL)
tcb	care
delphinium	飞燕草
intramuscular	肌肉
underemployed	学非所用
maenad	狂女
threnody	悲歌
underage	未到法定年龄的
sequestered	偏僻
titicaca	的的喀喀湖
protophyte	原生植物
carl	乡下人
miniature	缩小的模型
tactful	圆滑的
retractable	可收回
colossus	巨人
loathly	勉强
present	现在的
posh	极好的
avengingly	复仇地
complot	共谋
bosom	隐匿
geocentrical	以地球为中心的
undisguised	不戴假面具的
furred	穿毛皮
parietal	体壁
fetch	演绎出
himyaritic	希米亚里特文化的
ferreous	硬如铁
taeniasis	绦虫病
rimous	多裂口的
diaphone	对应音
sphagnum	泥炭藓
hypercorrect	纠正过头
angora	安哥拉猫
hattery	帽商的货品
tsetse	采采蝇
unconstrained	不受强制
rarified	=rarefied
doddery	蹒跚
quoin	榫子
especially	尤其
preterlegal	不根据法律的
enophthalmos	眼球内陷
masterpiece	名著
emancipate	使摆脱家长的管教而获得合法权利
times	时期
biennial	二年生的
tremendous	巨大
registrar	注册主任
galipot	松脂之一种
uncdf	United
harpy	鹰身女妖
fremd	外国
home	回家
waygoing	出发
aca	特许会计师学会准会员
veracious	真实的
hairtrigger	一触即发
infinite	无限的
ariose	旋律的
bicron	毫微米
sketch	勾画
dab	熟手
pentamer	五节聚化物
pardon	宽恕
synclinal	倾斜的
gauchist	激进分子
ditchwater	沟中的死水
househusband	操持家务的丈夫
affirmatory	确定
climacterical	=climacteric
mats	军事空运局
gravitate	移动
nihility	无
duplicity	口是心非
palma	帕尔马
puppy	小狗
becility	聪明
totally	整全
eventually	终于
nympho	慕男狂
inveiglement	诱惑
cowrie	宝贝科宝贝
strickle	磨快
inbeing	本质
pragmatize	使实际化
scoring	得分
concomitancy	共存
honduranean	=Honduran
telepathist	研究心灵感应术者
onwards	在先
extent	宽度
put	发芽
famed	著名的
londony	有伦敦特色
standpipe	管体式水塔
petty	不重要的
integrality	完整性
panic	恐慌
yucca	丝兰
dat	数据文件的扩展名
diction	用语
fluorometric	使用荧光计
whirlabout	旋转物
incapacitation	无能力
faculty	全体教员
pleach	编织
labourer	劳动者
distasteful	不愉快的
duodenary	十二
telegraphy	电信技术
demand	需求
tottery	蹒跚的
submission	降服
newsdealer	报刊经售人
omelette	煎蛋
muster	集合
queerness	不快
cessation	停止
nonobjectivism	抽象艺术
electropositive	阳性的
originate	起源
percentum	百分比
glulam	胶合层积材
conciliator	抚慰者
cowtail	似牛
undesirous	无欲望的
incognito	化名地
industrialism	产业主义
msie	of
audiotyping	录音打字
external	客观的
pogonia	朱兰
vitriform	玻璃状
detoxicant	麻醉的
hodgepodge	大杂烩
ivr	交互式语音响应
set	Electronics
applicably	可适用地
clinamen	趋势
bleak	凄凉的
passably	尚可
styptical	收敛的
choroid	脉络膜
unfordable	不能涉水而过
shiny	有光泽
exclusive	唯我独尊的
cold	寒冷
articulatory	分节的
whine	哀鸣
semidilapidation	半坍毁状态
bigness	伟大
orins	Studies
circumglobal	环地的
betacam	由SONY公司制定并生产
solubility	可解决性
vindication	辩护
primordia	primordium
preclassical	古典期前
bop	从容地走
half	部分
belabor	痛打
acquisitive	想获得的
electropolar	电极性的
precocial	早熟性的
congratulatory	祝贺
disfurnish	搬空
eau	水
scoff	嘲弄
out	下台
stroam	散步
froth	废物
upright	诚实
yelp	叫喊
fasciolar	小束的
ecce	瞧!看哪!
bosket	小树林
congenitally	天生地
pseudo	假的
vlaanderen	=Flanders
evangelicalism	福音派的教义
briarroot	=brierroot
scruple	有顾忌
inchoative	发端
triumvirate	三人执政
possie	职位
savourless	无情趣的
gunsmith	军械工人
yawey	雅司病
canned	一稿数用的
wail	嚎啕
laundryman	洗衣工
undiscussed	未辩论过
tyrannical	残暴的
raptatorial	肉食性的
compression	压缩
sandal	檀香
tootle	唠叨
unremitted	继续不断的
sophister	诡辨家
arbo	由节肢动物传播
vahana	伐诃纳
astable	不稳的
polarimetric	偏振计的
snippet	摘录
ticktack	滴答声
intravital	发生于活体内的
incontinent	不能自制的
fils	伊拉克、约旦、科威特等国的铜币
restate	重申
jeeringly	嘲弄地
seigneur	封建君主
tigrine	虎的
virgilian	维吉尔的
panmixis	随机交配
sacred	宗教
mean	普通
mantic	预言性的
fiftyfold	五十倍地
reforge	再造
asturian	阿斯图里亚斯文化的
devolute	移交
legality	法律上的义务
acupuncturist	针灸医生
ruhmkorff	coil
deduction	推论
holistic	整体的
memorialist	情愿书起草者
radiate	辐射状的
intervertebral	椎间的
diphenyl	联苯
centrosymmetric	中心对称的
pothanger	吊水壶的悬链
wright	建造者
pule	呜咽
annunciation	报喜
seastar	中国海星电脑集团
methodically	有系统地
orthocephaly	正头型
assonance	类韵
glial	神经胶质
unslaked	未满足的
www	World
discriminatory	有差别
austere	简朴的
vasopressor	血管加压的
tashkend	塔什干
conic	圆锥的
massify	使成整体
interdepartmental	各省间
imperscriptible	非官方
labial	唇
wolflike	狼似
eusocial	完全群居的
anharmonic	不调和
sink	沉下
shut	关上
agrophilous	栖耕
friz	卷曲
trigynous	具三雌蕊的
rhonchi	干罗音
haptical	由触觉引起
unalleviated	未减轻的
bellmouthed	钟口形的
command	博
roundsman	巡视者
organophosphorous	=organo机磷
talus	踝
leucotomy	前额脑白质切除手术
sprig	小枝状饰物
confab	会议
viole	da
pachydermatous	厚皮类动物的
unmeant	偶尔的
germina	种子
enring	围绕
puerperium	产后期
responsible	负责
basined	位于盆
horizon	地平范围
saharanpur	萨哈兰普尔
epistaxis	鼻衄
cycler	骑自行车者
brightsome	明亮的
divinatory	占卦的
baroque	巴洛克时期艺术和建筑风格的
crib	拘禁
superradiance	超辐射
effectual	有效
interprovincial	各省之间的
bergamot	香柠檬油
tomfoolery	无聊
civil	公民
adgb	Britain
lockeanism	洛克派哲学学说
ingeniously	有才能地
extragalactic	银河系外的
unspiritual	非精神的
dish	提出
circle	围
reradiative	再辐射的
short	浅薄的
comby	蜂巢状
fantasize	梦想
postnasal	鼻后的
mesial	中间
monogamous	一雌一雄
bubo	腹股沟腺炎
vitalism	生机说
newfangled	新制的
summit	参加最高级会议的
cerebrocentric	人格控制集中于脑
faggot	柴把
couchant	抬头伏卧状
irrespirable	不适于呼吸
blowtorch	吹管
bromouracil	溴尿嘧啶
parlance	说法
ferryboat	渡轮
fadedly	色彩已褪地
unenvious	不羡慕的
moil	辛苦工作
unenlightened	无知
unhuman	非人类
indented	锯齿状
polarisability	=polarizability
physiognomic	相术
multidialectal	能讲2种以上方言的
belaud	歌功颂德
insect	虫子一样
armadillo	犰狳
instructor	教师
kunashiri	国后岛
sheepkill	=sheep
obsolescence	荒废
terminus	终点
frank	Frank
retributory	=retributive
squanderer	浪费者
envoy	外交使节
illative	推论的
enduringly	永久
official	职务上的
sulfurize	使硫化
aftertime	将来
hpna	Phoneline
legend	传说
instinctive	本能
nitric	氮的
modesty	虚心
upbuilt	upbuild的过去式及过去分词
fenestral	如窗的
aggregative	集团
msj	in
dugout	独木舟
servomechanism	自动控制装置
