bier	棺材架
overemphasized	过份强调
devitaminize	失去维生素
interstation	台际的
showerproof	防水
flighty	心情浮动的
amphimixis	两性混合
trinitrotoluene	三硝基甲苯
necessary	必要
lentic	静水
stolid	感觉迟钝
cheerily	快活
laudableness	值得佩服
facs	of
honestly	真诚
scotopic	暗适应
cowper	发现此腺的英国解剖学家]
matchlock	火绳
countercheck	复查
hanger	绞刑执行者
squash	挤压
stench	发恶臭
rufus	鲁弗斯
roumanian	罗马尼亚
cooperation	合作
recite	背诵
slip	使滑动
vacuous	空虚
lutetian	巴黎
uplighter	向上照射的灯
haffir	临时蓄水池
pillowy	柔软
pogonotrophy	蓄须
takeoff	卸除
enthymeme	省略三段论法
faithful	忠实
conciliatory	抚慰的
unperceptive	无感觉的
ideaistic	观念
reconvey	送还
uninstructed	未经教导的
quist	林鸽
sinai	=Sinai
aluminum	铝
disloyalty	不义
dovetail	吻合
maidless	不雇女仆
reconcile	使顺从
packinghouse	食品加工厂
zouave	轻步兵
pietism	虔信主义
iniquitously	非法地
lavish	过分丰富
nerviness	有勇气
diffusible	可传播
rode	ride的过去式
searching	搜索
corona	光环
incisory	门牙
lusty	精力充沛的
tacky	缺乏教养或风度的
viscounty	子爵的管辖区
varsity	大学运动代表队
bookable	可预订
bindery	装订厂
touch	缺点
hotter	热烈的
factually	真实
honorific	敬称的
unknit	平整
meteorite	陨星
kraut	泡菜
laotian	老挝语
shortall	短连衣裤
director	控制器
sheathe	覆盖
trifid	三裂的
supermarket	超级市场
inky	墨水
ningbo	宁波
semismile	淡淡的微笑
flee	消失
elsass	=Alsace
dysphoric	烦躁不安的
elaborate	详细阐述
chromoplasmic	易染浆
basilic	重要
acetifier	醋化器
reduplicate	重复的
mephistophelean	冷酷
counterplea	反驳
conduit	喷泉
precapillary	前毛细管的
anatomize	解剖
subtle	微妙的
unsharp	不明显
triad	三和音
unpresentable	见不得人的
pachydermatous	迟钝的
abaddon	魔鬼
sprig	子孙
pedometer	步程计
demotic	通俗的
discriminatorily	有区别地
darkminded	阴险的
sizable	大小相当的
chapped	裂开的
dotard	老糊涂
lmbc	Lady
minatory	威胁
suicidal	自取灭亡
nexus	连结
logogram	语标符号
culpability	有罪性
ambassador	大使
succinctly	简便地
provocable	=provokable
lugubrious	悲哀
inept	无能的
steerage	最低票价的舱位
quintan	每隔五天发作
sbc	Board
tympanic	鼓皮似
hyperdulia	圣母崇拜
unbranded	无物主
vigorous	精力旺盛
anthropomorphosis	有人形
messina	墨西拿
bromide	溴化物
ectotrophic	体外营养的
unselfish	不自私
somatotopic	躯体特定区的
presidial	驻防军的
acesodyne	止痛
pitiably	可怜地
lenticellate	产皮孔
simulative	模拟的
indisposed	不舒服
dipartite	区分的
leniently	仁慈
fopling	矫饰者
crossly	相反地
efficaciously	灵验
digest	分类
uppiled	堆积起来的
misinformant	提供错误消息者
yankeefied	美国化
fieldsman	垒外球员
nefariously	邪恶
clannishly	团结地
microgametocyte	小配子体
conamore	带着爱心地
lend	借给
slob	懒汉
rejoicing	欣喜
dorp	村落
latency	性潜伏期
inhalatorium	吸入治疗所
atoxic	非毒
beer	啤酒
crackbrain	傻子
angiomatous	血管肿
foaming	布满泡沫
wistfully	渴望地
leisured	从容不迫的
knightly	侠义
help	显示命令格式的简短概述
onrush	突进
amphitheatrical	圆剧场式
gentile	异教徒
telecamera	远距离撮影机
counterpropaganda	反宣传
regret	抱歉
oxidizable	可氧化的
libido	生命力
unwatched	未受监视的
esc	转换字符
hyalography	玻璃雕刻术
bargaining	交涉
ineffaceable	不能取消
running	连接
crackling	烤猪肉的脆皮
pinkwash	粉红色涂料
unhidden	不隐瞒的
subroutine	子程序
let	障碍
breadthwise	横向地
upon	在……之上
glenurquhart	=glen
swivel	旋转
potbellied	大腹便便
prescientific	近代科学以前
adscription	归于
udag	Urban
saprophagous	以腐败物为生
monochromator	单色仪
uricotelic	排尿酸
dulocracy	奴隶统治
countian	县民
impromptu	即席地
rimal	细长之口
dauphiness	法国皇太子的妃
labilise	=labilize
criticise	非难
sorrow	悲哀
teachable	驯良
garpike	雀鳝
infidel	异端
perpetuator	永久保存的人
berserk	狂暴的
mcpo	Officer
farmyard	农家庭院
clypeate	有唇基的
naturalize	移植
bogota	波哥大
indistinctly	朦胧
correctional	矫正的
nubbly	块状
barren	没有结果
jitteriness	战战兢兢
anaemic	患贫血症的
weal	福利
hateable	可憎的
insectile	昆虫的
micromodule	微模块
leaded	行间空格特别大的
sent	send的过去式和过去分词
recision	废除
knickerbocker	纽约早期荷兰移民的后代
fishpound	潜网
rhonda	朗达
equational	均分的
fisticuff	一掌
zygoma	颧骨
therapeutist	临床医学家
spent	用尽的
rippling	起涟漪
leaden	沉重
retrocardiac	在心脏后的
imperialism	帝国主义
archer	弓术家
intercolonial	殖民地间
arapaima	巨滑舌鱼
cramp	狭窄
ungrammatical	不合文法
infrasonic	使用次声
myelofibrosis	骨髓纤维变性
banyan	印度榕树
aliform	有翼壮物的
abiogenetic	自然发生论的
sailage	全部船帆
zoroastrianism	拜火教
shamash	沙玛什
rafter	椽
duplicate	使加倍
hemeralopia	夜盲症
tigon	虎狮
disannul	取消
pinafore	围涎
gioconda	迷一般
avoid	避免
upper	上面
antigen	抗原
evaluating	评测
judenhetze	对犹太人的迫害
animadversion	批评
counterpart	极相似的人或物
bicentennial	二百周年纪念
merrymaker	嬉戏者
feminacy	妇女的性质
stigmatic	有烙印的
emancipative	旨在解放
fanwise	成扇形地
fable	编寓言
egger	幼虫食叶子的蛾类
xenoglossia	讲陌生语言的能力
pensile	悬挂的
excite	使激动
dullard	愚人
jollop	烈酒
wettable	可湿
menstruous	月经来潮
adoringly	敬慕
hiaa	Health
womanish	像女人
differentiable	可辨
sparerib	带肉肋骨
accoutrement	配备
slosh	泼
occasionalism	机会论
stablish	使坚固
metropolitan	主要都市的
daily	朝来夜去的女佣
onstage	台上
sunburnt	晒黑
nother	不同
olympian	奥运会选手
sciatica	坐骨神经痛
tealess	无茶的
pack	压紧
disagreeably	不愉快
employee	店员
labradorian	拉布拉多的居民
unclassifiable	不可归类的
nidget	愚人
templelike	似庙宇
underperform	表现不佳
sunstroke	日射病
sheathy	合身
betweentimes	在中间的时间
paramount	极为重要
equimultiple	等倍数
endangeitis	血管内膜炎
captan	克菌丹
heteroploid	非整倍体
hulled	有壳
begohm	十亿欧姆
dynastic	王朝
polygon	多角形
sanctified	神圣化
staccato	断唱
multimegaton	有数百万吨级爆炸力
digitation	指状分裂
radiocontamination	放射污染
fanback	有扇形靠背的
moneygrubber	守财奴
salmon	鲜肉色
unheard	未知的
stall	货摊
marmaduke	马默杜克
water	注入水
alignment	结盟
sneak	鬼鬼祟祟做事
overstock	过多的进货
paleness	苍白
lose	使迷路
tonometer	音调计
blazing	强烈
spicula	针状体
corsage	胸衣
gloomy	阴沉
curl	卷曲
undeflected	不偏离的
campesino	农夫
scantily	吝啬
double	加倍努力
coterie	圈内人
bottomless	无底
dodgery	推托
headstock	主轴箱
thinnest	瘦
contrastively	对比
carboniferous	石炭纪
undimmed	清楚
letup	停顿
labyrinthine	曲折的
theatromania	过度爱好看戏
chaffer	吹毛求疵
trainee	练习生
monomania	对一事的热狂
meshy	象网的
originator	创作者
jumpy	跳跃的
sanely	心智健全
capacious	容积大的
mow	干草堆
muck	搞坏
sncc	全国学生统一行动委员会
scotch	刻痕
remissive	减轻
naseberry	人心果树
scoriaceous	铁渣子
pickled	盐渍
caravaggesque	卡拉瓦乔作品
jurisconsult	法学家
holiness	陛下
catechist	盘问者
actuarial	保险精算
bygone	过去的事
owlwise	像猫头鹰一样聪慧的
plane	飞机
saponated	用皂处理过
equitableness	公平
molecular	分子
lakeport	湖畔港埠
warp	歪曲
recidivous	有经常犯罪倾向
halt	有缺点
stimy	妨碍球
corpus	文集
ban	取缔
nazification	纳粹化
external	外用
lockable	可锁定
crackly	容易破裂的
cineprojector	放映机
complyingly	顺从
perch	有利的地位
pubescent	有软毛的
curiosa	珍品
breathlessly	闷热
worrying	焦虑
jesuitically	阴险地
western	西方
photocube	立方照片架
mephitic	恶臭的
charry	似炭
vision	梦见
blackish	带黑色的
idioglossia	自语症
vellum	牛皮纸
hydrodynamic	水力
key	关键
barrelled	桶装的
laxation	轻泻
ludditish	反对机械化自动化
rotfl	the
gazette	在公报上刊登
unsharp	不清晰
livelily	敏捷地
frilly	镶褶边
corvus	乌鸦座
adunc	向内弯曲的
sacw	senior
corolliform	花冠状的
tombstone	墓碑
photoacoustic	=optoacoustic
isometrical	等容积的
singlehanded	单枪匹马的
infuser	鼓吹者
obviate	排除
caballer	阴谋家
unwilled	非自愿
skunk	臭鼬
infamize	使声名狼藉
mill	使乱转
nelson	压住对方头部或颈后及一臂或二臂的手法
peleus	珀琉斯
fumy	冒烟
ozonic	臭氧的
sneaky	卑鄙
whelp	幼兽
disaffect	使不满意
interlude	两段时期中间之时间
morsel	少量
contrary	相反的
introsusception	=intussusception
elective	选修课程
oily	油的
hymnist	赞美诗作者
disposal	处置
physiognomic	人相
unbacked	无助
windrow	狭长的一行
pitch	搭帐篷
teutones	条顿族
groovy	常规的
unabridged	未经删节
rough	大致的
delphian	暧昧
chauvinism	盲目的爱国心
underserved	服务水平低下的
polarize	两极分化
gmat	mean
abstruse	深奥
sorceress	女巫
fundament	基本原理
freaky	捉摸不定的
orient	向东
consolidation	合并
digital	数字
thermoduric	耐热
quadrangularly	正方形或矩形
undivorced	未离婚的
aedes	伊蚊
slavophobe	厌恶斯拉夫人
malformed	畸形的
interpunctuate	=punctuate
matronly	主管的
rue	后悔
theropod	兽脚亚目的
careen	使倾侧
raptured	狂喜
pogonotomy	剃须
cocky	骄傲
bassinet	摇篮车
moneychanger	货币兑换机
wendell	温德尔
db	decibel
satyagraha	非暴力抵抗及不合作主义
ferial	平日
rupestrian	由石头构成
inextricable	无法解脱的
unseparated	未分隔
repellency	排斥性
gerontogeous	旧世界的
monocular	单眼用的
gownsman	教士
tornado	旋风
ungirt	不缚带
westfalen	威斯特法伦
ingrowth	长在肉内
noumenally	本体地
lenticulated	双凸透镜状
sprat	瘦小个子
erotologist	色情文艺家
crackbrain	无理性的人
brakie	司闸员
shelter	庇护所
aok	极好
yirr	怒吼
vestige	痕迹
getup	装订格式
feckly	差不多
eisa	Architecture
eosinophil	嗜曙红的
anticorrosion	防
sanatory	治疗病症
photosensitise	9fEJtEJ`sensItIz/
eudiometrical	空气纯度测定管的
asshead	笨蛋
gray	广告商
noia	无聊
sulfonamide	磺胺药物
stragglingly	脱离队伍地
its	pro
supposable	可想象得到的
enfold	折迭
fabrication	装配工
profiteering	牟取暴利的
clypeate	有额板
undefended	无辩护人
sociogenic	社会因素影响
kindless	冷酷的
bacteriorhodopsin	噬菌调理素
uproariously	喧嚣
covert	偷偷摸摸的
salmon	大麻哈鱼
grimness	冷酷
dendroclimatic	年轮气候学的
lwop	pay留职停薪
disposal	安排
intellectual	有智力
opuntia	仙人掌属植物
lavolta	=volta
calamity	不幸事件
quick	快
amimeche	the
guttatim	逐滴地
jinx	使倒霉
fulminant	爆发性的
far	远处
nephroid	肾形的
amenorrhea	无月经
aphrodisiac	引起性欲
mortify	苦行
misfit	不称职的人
invertebrate	无脊椎的
paragraphic	章节
downtime	停工期
haply	大致上
scorbutic	患坏血病
fatuous	发呆
remissness	怠慢
olfaction	嗅觉
accoucheur	男助产士
unwinnable	攻不破的
gracioso	小丑
understock	不充分进货而存货不足的
recontaminate	再污染
reglaze	重装玻璃
cerebrocentric	大脑中枢
accessory	附属
grounder	沿地面跳滚的球
swam	swim的过去式
scurrilous	说话粗鄙恶劣的
constancy	恒久不变的状态或性质
xl	extra
grocer	杂货店
tinwork	洋铁器
prosodic	作诗法
dissever	割裂
naturalise	使归化
moldy	发霉
cristated	冠状的
malam	=mallam
feeling	知觉
bindin	结合素
recital	叙述
photometric	光度计的
catfacing	畸形
savourless	缺少风味
foliose	多叶
contortion	歪曲
preignition	自动点火
cant	伪善之言
circumstanced	在……情况下的
googol	10的100次方
lattimore	拉蒂摩尔
puff	宣传广告
hurt	伤害
independently	独立地
exhumation	尸体发掘
riempie	皮条
lactim	内酰亚胺
smokemeter	烟度计
destructivity	摧毁能力
hen	母鸡
aphorism	谚语
indissociably	不能分离地
drunk	drink
spinout	回形滑行
coronae	圆烛架
rudderpost	舵柱
sequential	相续的
removal	移动
humorous	异想天开的
mf	不要脸的家伙
bezant	银币名
audio	音频
desmotropism	稳变异构
byronic	冷笑而浪漫的
negentropy	负熵
grassfinch	草雀
neopentane	季戊烷
rotiform	轮形的
quinnat	salmon
thixotropic	触变的
chillout	室温过低
hairy	毛似的
quadrophonic	四声道
radioactive	放射性的
err	走上歧途
ssafa	Airmen''s
libyan	利比亚
discrimination	歧视
slinkingly	偷偷
interconversion	互换现象
backseat	后座
handle	处理
icily	冷冰冰
galactophore	乳腺
circassian	切尔克斯的
appreciate	增值
shimmy	摇动
body	主要部分
sassy	失礼的
connatural	固有
contretemps	令人尴尬的事
extorsion	外旋
goboon	痰盂
inhumane	残忍的
spheriform	球形
thickly	浓地
jetliner	喷气客机
embryotic	初期的
cannabic	大麻
boniness	憔悴
calcic	钙
inexactitude	不精密
discouraging	令人气馁
essay	企图
solvent	有偿付能力
preponderance	占优势
flunkee	因考试不及格而被迫退学的人
coarsely	粗俗地
wormhole	蛀洞
sling	投掷
ideologist	思想家
dep	of
venireman	陪审员
jejune	不成熟的
jaff	复式干扰
adze	扁斧
unwarrantable	无法辩护的
schradan	八甲基焦磷酰胺
shrubby	灌木一般
underdress	内裙
uncontemplated	未经周密考虑
tenuirostral	细喙
erasmian	伊拉斯谟作品的
titlist	冠军
proud	得意的
whaler	捕鲸人
such	这样的人或物
enhance	增强
gnaw	啮
spaceworthy	具有太空耐航力
jot	稍许
mutafacient	突变加强的
solubilization	溶解
cozily	安逸地
pawnbroking	典当业
greg	格雷格
investiture	授权
land	陆地
dextrorsely	右旋地
pyaemic	脓血症
liege	君臣关系
colloidal	胶质
briticism	英国英语语法
uteralgia	子宫痛
instantaneous	即刻的
proteolytic	解蛋白
lst	当地标准时间
undamped	不潮湿的
thermosiphon	温差环流系统
memory	回忆
died	消逝
register	登记
penetrative	渗透
chrysler	克莱斯勒汽车
moodiness	喜怒无常
aequum	热量所需量
whew	吹哨声
drooly	流口水的
habakkuk	希伯来的先知
fact	论据
baffleboard	证券交易所之行情板
parkland	公用场地
emiction	排尿
newshen	女性新闻记者
punishable	可罚的
interarticular	关节间的
gainer	获得者
enthalpy	热函
mhc	major
charactron	字符管
allo	紧密相联
bloodwort	仙茅科植物
clamp	夹钳
polluting	污染
pim	个人信息管理
odious	讨厌
reviewable	可回顾
stupid	愚蠢的
revalve	装新阀于
sublimate	纯化
strongyloid	圆线虫总科
unvexed	沉着
isothere	等夏温线
infallibly	绝对无误地
multipoint	多点
bibliotheca	书目
consuela	康斯薇拉
peak	最高的
berline	四轮双座篷盖马车
folksy	友好的
despondence	沮丧
yieldly	生产
unwrung	不感到苦恼的
gammon	作假
nitroparaffin	硝基烷
circumcolumnar	绕柱的
mpp	大规模并行处理系统
tty	teletypewriter
rebate	打折扣
peddling	行商
nsec	nanosecond
electrology	电疗学
sonorously	朗朗
playscript	剧本原稿
sanguiferous	含血的
photooxidation	光致氧化
maker	发期票的人
suffragette	妇女参政权论者
whitewash	白色涂料
quotient	商
reknit	再织
owllight	薄暮
straw	麦杆
backflow	逆流
presidial	管辖的
fuddled	醉
euratom	欧洲原子能共同体
trencher	木制食盘
juan	胡安
mulct	抢夺
swapo	People''s
peripherad	向外
warranty	担保
drunken	酒醉
gassy	气体的
radicant	从茎部生根的
avatar	天神下凡
bluntness	迟钝
narrowfisted	小气
krummhorn	变号
dot	点
fulguration	闪光
unthoughtful	轻率
flack	宣传员
anthophilous	爱花
incubus	梦魇
ark	方舟
preambulate	作序言
inadaptability	非适合性
supersensible	超感觉
pyogenic	化脓
leniently	仁慈地
abwatt	电磁瓦
exacerbate	使加剧
brash	胃灼热
calumnious	中伤的
mdt	山区时区
gilberte	吉尔伯特
chemoprophylactic	化学预防
incubative	潜伏的
hook	沉迷
doodad	小摆设
transversal	横向
reward	报酬
regardless	不注意
multiped	多足
flexural	弯曲的
insuppressive	抑制不住的
literal	无夸张
ganglion	力量、兴趣、活动等的中心
billsticker	张贴广告者
coolville	极好的
waspie	妇女紧身胸衣
polymolecular	多分子
multidisciplinary	包括各种学科的
aeronef	飞机
nephralgia	肾痛
forficate	分叉
rule	惯例
confrere	会友
moabite	摩押语
schoolboy	男学生
equiponderance	平衡
transpositional	变调的
clamjamfry	暴民
ljubljana	卢布尔雅那
succus	汁
gastrocnemius	腓肠肌
singular	异常
backswing	回复
ragefully	狂怒
castrate	阉割
convinced	确信的
hemagglutination	红血球凝聚的
serpentinize	使蛇纹石化
undynamic	精力不够
polyarchy	多头政治
dogmatic	独断
publisher	出版者
garlandage	以花圈做的装饰品
chalkstone	白垩块
officiate	行使
nitrous	硝石的
frequentation	常往
desperateness	拼命
eam	Metopo
septicopyaemia	=pyaemia
lacunal	空隙
flutey	=fluty
reengineer	再设法处理
tarnal	极其
alsorunner	失败的参赛者
diadem	带状头饰
afterglow	晚霞
lignose	木质素
evaporator	脱水器
colewort	芸苔属
poise	砝码
retrocede	交还
distinguish	区别
zedoary	莪木
citronellol	香茅醇
elementoid	元素状的
lumber	木材
exhibit	展览品
weak	软弱的
methylcellulose	甲基纤维素
weak	不牢固的
sidewards	向旁边
diphthongal	双重元音的
pulpitry	说教
locker	有锁的橱柜
uncreated	尚未产生的
cake	饼
fogbound	因浓雾而进退不
girlhood	少女身份
horrific	令人毛骨悚然的
epeirogenic	造陆作用的
solon	贤人
syriac	叙利亚语的
antitrust	反托拉斯
conqueror	胜利者
foolproof	十分简单
monogram	字母组合
metachrome	变色粒
backroom	密谋策划的场所
kidling	羔羊
ferrara	阔刃剑
cacographer	拼写错误的人
peenge	发怨言
divinization	奉为神圣
stoss	向冰川面
crawfish	小龙虾
oversimple	过于简单的
ransack	到处搜索
winnow	吹掉
burnish	擦亮
urbanity	有礼貌
methimazole	甲硫咪唑
muff	漏接
winded	喘气
sidehead	侧标题
salem	塞伦
multimode	多方式
registration	注册
aerography	气象学
nonnegotiable	不可流通的
cannoli	奶油甜馅煎饼卷
inhospitably	荒凉地
phthisiology	结核病学
batwing	状似蝙蝠之翼
interfile	使归入系列
blastodisc	胚盘
hydrocracking	碳氢化合物分裂
choker	噎住的人
maskless'	NULL)
cadence	抑扬顿挫
listerize	消毒
cruet	调味瓶
discordance	不调和
discommode	使为难
dermometer	皮肤电阻计
usac	Auto
irrepealable	不可撤销
hal	Abstract
down	绒毛
rechargeable	可再充电的
megaversity	巨型大学
ataxia	无秩序
illumine	点亮
norward	北部
tsangpo	River见Yarlung
shade	荫凉处
decentralization	分散
pollard	被修剪的树木
divisive	区分
aristarch	严厉的批评家
squamose	有鳞片的
unchangeably	不变地
flowing	平滑
counterdrain	漏水渠
astigmatic	散光
autonym	实名
sphacelus	坏疽
ostensible	表面
grading	分阶段
flexuous	曲折
skilful	技术好的
approbatory	赞赏的
rhombohedral	菱形
steep	陡峭
anxiously	忧虑
nogg	用木钉钉牢
stupefactive	致昏迷
sporicidal	杀孢子的
contingently	临时地
glenoid	关节窝的
reafforest	在……重新造林
gingerly	慎重地
bigoted	固执的
accumulative	积聚的
transmutable	可变形
community	群落
saponification	皂化
epileptogenic	致癫痫的
painty	着色过度
winter	冬天的
compressional	有压缩性的
sortilege	抽签决定
cold	冷淡
calibrate	校准
meat	肉
subaerial	天空下
agog	兴奋的
tetralogy	四部剧
flaunt	炫耀
algebraical	代数的
uncontainable	压抑不住
displease	使生气
coprophobic	粪便恐怖
streakily	有条纹
circular	循环的
shaver	剃须刀
true	正确的
manhandle	粗暴地对付
flop	脚步沉重地走
witling	自以为嘴巧的人
elocutionary	演说法
tetraspore	四分芽孢
premarital	结婚前的
statutory	法令的
breezeway	有屋顶的通路
questioning	质问
feudalistic	封建制度的
dastard	怯懦
biliteral	由两个字母组成
chautauqua	有关文化讲习集会的
cheerly	欣然
partisanship	党派偏见
appall	使胆寒
quizmaster	主持测验的人
unmoor	起锚
sympathetically	同情地
astronautically	太空航行员地
epeiric	伸入内
foliate	有叶
fin	猛挥鳍
detrital	由岩屑形成
supereminent	卓越的
everglade	湿
unbroken	完整的
hutted	设在小屋里
launder	洗涤
justicer	法官
triumphant	洋洋得意的
manicure	修指甲
swagger	吹牛
undimmed	清楚的
sousaphone	大号
olive	橄榄树
saltate	跳跃
crusade	投身正义运动
anaphrodisiac	制欲的
inauspicious	不吉利
lubricious	滑
sequential	相续
corbelled	以承材支撑的
multiform	多种形式的
bowsman	艏位手
rich	充足
conversable	谈得来的
bargaining	商谈
assembly	集结
preinvasion	入侵之前的
brandling	红蚯蚓
waver	摆动
spumone	千层冰淇淋
cutdown	删减
cogged	作弊的
abandonee	被遗弃者
sanguinity	气色好
lippie	唇膏
participled	受诅咒
whiskey	威士忌酒的
innerve	鼓舞
pechora	伯朝拉河
stockholm	斯德哥尔摩
chorology	分布学
pavilion	大帐蓬
block	阻滞
tack	粗缝
counterbalance	弥补
dyslexia	诵读困难
woman	妇女的
liquorice	甘草
microslide	显微镜玻片
springtime	春天
ever	曾经
spencerian	斯宾塞哲学
aching	疼痛的
fingery	排成指状的
orchidaceous	兰科
diuretic	利尿
essential	要点
toss	投
limy	含石灰的
buxom	体态丰满
mods	学位初试
shrubbery	灌木
ream	欺骗
overmodest	过分谦虚的
murkiness	黝暗
topographic	地形学上的
steerage	操纵
redevelopment	恢复经济发展
ulceration	溃疡
heavyish	稍重的
twister	不老实的人
saintly	圣洁的
drawn	拔出的
parietes	paries的复数
run	进行
device	图案
untearable	拔不掉的
intolerant	不宽容
fundament	基础
executive	执行
bedside	枕边的
alcaic	Alcaeus
rasp	激怒人的举动
rontgen	有关X光的
imagination	想象力
radiance	辐射率
minicab	微型出租汽车
lytta	蚯蚓体
computable	可计算的
amortization	分期偿付
numbing	使失去感觉的
gftu	Federation
dystopian	反面乌托邦的鼓吹者
probing	探通术
previous	在前
cryptography	密码术
microlens	显微透镜
foxed	有褐斑的
lovesick	为爱情而生病或忧愁
deliberate	深思熟虑
sunny	阳光充足
prank	打扮
basined	位于盆地的
scribble	潦草地写
heavyset	体格魁伟
toedrop	垂趾
embarrassingly	使人尴尬地
amiss	有毛病的
juncture	接合点
gibbose	拱起的
silt	煤粉
tawdry	俗丽的东西
quaky	震动
misjudgement	估计错误
prospect	寻找
libelee	被控告者
pantomimist	凭动作表演的喜剧演员
advertize	通知
suffumigate	从下面熏蒸
scalper	圆凿
ulianovsk	=Ulyanovsk
tictoc	=ticktock
tenemental	产
pod	密集小群
sketchy	粗略
bronzesmith	青铜匠
exercitant	从事精神活动者
impermissible	不许可的
nosophobia	疾病恐怖症
melancholic	忧郁症患者
precostal	肋前
rewake	再弄醒
sari	卷布
wallaby	澳洲土人
sadly	悲哀地
cold	失去知觉的
avertible	可避开
manhattanize	使曼哈顿化
podzolization	土壤灰化作用
nutted	用螺帽固定
fascinatress	令人着迷的女人
unstatutable	不符合法令
odditional	附加
septangular	七边形的
hebdomadary	=hebdomadal
actinozoan	珊瑚虫的
unsympathizing	无同情心的
psn	processor
waterishlogged	进水
umlaut	使变音
arabesque	蔓藤花纹
jointly	连带
gossamer	薄弱的
sciolto	自由地
from	由于
chinaware	陶瓷器
passim	各处
glowing	容光焕发
butane	丁烷
pornie	色情影片
statistical	统计学
declivous	下坡
elated	得意洋洋
terminal	末期
overspread	蔓延
phenolic	石碳酸
charta	纸剂
barbaric	粗野
lushly	繁荣
disaster	天灾
untalented	没有天赋的
substantive	有实质
gerontic	老年人
hypokinesis	运动功能减退
athleticism	运动竞赛
serve	供职
interindividual	个人与个人之间的
hibernal	寒冷
feeling	有感觉
erosive	腐蚀性的
compadre	教父
corporatism	给合主义
suctorial	吸吮
harrumph	发哼声
textbox	文本框
annuation	生物数量年变化
unspiritual	非宗教的
greensick	患绿色贫血
rendzina	黑色石灰土
commentate	评论时事
gastrohepatic	胃与肝脏的
unimaginative	无趣
unlawfully	非法
sumless	无数量的
relegate	归入
condolent	慰问
cippus	希腊之纪念碑石
laryngoscopic	喉镜检查的
fogbound	为浓雾所围困的
inpouring	增加
forefeet	船龙骨的前端部分
inkle	亚麻有色织带
nut	螺母
trondheim	特隆赫姆
demineralise	=demineralize
disquiet	使不安
bewitch	蛊惑
cussed	该诅咒
pincushion	针垫
erythrochroism	=erythrism
thalamostriate	连接丘脑和纹状体
puzzledom	为难
antiquity	古代的遗物
sao	Once
controlment	控制
utriculitis	椭圆囊炎
overword	重复的词
uprose	uprise的过去式
fractional	碎片的
erin	Ireland的诗名
outpour	倾注
arboraceous	长满树木的
clonesome	无独创性
subcellular	亚细胞
pilus	毛
unmarked	无记号的
tapping	出钢
italian	意大利语
rifle	来复枪
indusium	柱头下毛圈
siva	大自在天
thropple	气管
woofy	粗直浓密的
restart	重新开始
cell	单人房间
trangam	小摆设
kinaesthesia	动觉
crabwise	小心
ten	十个
spga	开关门阵列
hyperphysical	超自然的
matilda	行囊
congruous	适合的
agamous	无性生殖的
supravital	超活体的
xxx	30
occultation	隐藏
cyclostomatous	有圆口的
checkered	多变的
deliquescent	溶解性
bayeux	Tapestry
impaludism	疟疾
mariupol	马里乌波尔(苏联乌克兰东南部港市日丹诺夫
grantor	授予者
decayed	朽了的
datum	数据
padlock	禁止进入
anthesis	开花
amphictyony	近邻同盟
synergize	起增效剂作用
presidial	省区的
countrymen	同乡
tension	紧张
misspent	浪费
redressal	调整
contextual	文脉上的
purple	紫色的
pks	pecks
recruitment	征募新兵
combatant	战士
carbonate	使变成碳酸盐
burglarious	夜盗
contrail	轨迹
hangar	飞机棚
photographica	摄影爱好者的希冀物
outlandish	偏僻的
tannery	制革厂
broad	阔
severity	严肃
maul	粗手粗脚地摆弄
foucquet	即Fouquet
setwall	缬草
inebrious	醉的
eclogue	田园诗
exceptional	例外的
evict	驱逐
triumphant	胜利
ringhals	粗皮小眼镜蛇
seaward	海那一边的
marage	使受马氏体时效处理
damper	节气闸
bdtr	磁盘在特定的情况下
forestall	先……预防
sycamore	小无花果树
circadian	生理节奏的
cession	转让
lasque	形态较差的扁平钻石
dermoid	皮样
dicrotisc	量重搏脉的
clothesbasket	放待洗衣物的篮子
knotwork	编结工艺品
lyreflower	荷包牡丹
unhandily	不灵巧地
middlescent	中年的
undernourish	使营养不足
uneven	奇数的
caliginous	昏暗的
dequeue	出列
browser	浏览书本的人
electroplate	电镀
nymphomaniac	慕男狂患者
withers	马肩隆
identity	身份
carnal	色欲的
priscan	涉及古代的
goth	哥特人
respirometric	透气性测定
hydric	含氢
stadium	露天大型运动场
isolating	孤立
lank	瘦的
telebus	电话叫来的客车
ploughstaff	小铲
dwc	capacity
pigtail	辫子
dissolve	溶解
present	引见
shaky	摇晃的
charm	有魔力
uniface	单面
aposteriori	后天
raving	狂乱
unhesitatingly	迅速地
unscripted	不用稿子的
podunk	偏僻小村
troopship	军队运输船
deice	装以除冰装置
butterine	人造奶油
beneficiary	受惠者
brachydactylic	短趾
sialidan	泥蛉
taking	可爱
viridescence	嫩绿
ingulf	投入深渊
comity	联合
hydrolysis	水解
imam	教长
timbre	音色
chirography	笔法
cutthroat	残酷的
gluey	胶
holdall	手提箱或手提袋
fractional	小数的
riffy	连复段过多
haemangioma	血管瘤
weeping	下雨
dtv	桌面视频
antidiabetic	抗糖尿病的
steal	偷盗
lustful	淫荡
rantipole	放荡的
seedy	不适的
some	某些
actiniae'	NULL)
uniplanar	单平面
wide	广阔地
rotc	Reserve
teletransportation	=teleportation
demimondaine	妓女
verse	韵文
noncommittal	不明朗
heavier	巨大的
histopathologic	组织病理学说CdVIk/
scottie	苏格兰的一种野狗
ureterostomy	输尿管造口术
bombardon	低音簧舌塞子
windowy	窗多的
cask	木桶
kingpin	中央木柱
wolfram	钨锰铁矿
yodel	用真假嗓音陡然互换地唱
smelt	smell的过去式和过去分词
blastocyst	胚泡
scouting	童子军的活动
reschedule	重订……的时间表
unrifled	滑膛的
uc	case
woodwind	木管乐器
linstock	火绳杆
anglewing	一种翼前有凹痕的蝴蝶
culpably	该罚地
viciousness	邪恶
fledgy	盖以羽毛
bedmaker	制床者
insipidly	没有味道地
www	Wide
slopwork	成衣
mariology	圣母马利亚研究
edification	熏陶
unclimbable	爬不上去的
downy	绒毛
apery	摹仿
podiatry	脚病学
conmanship	骗子手法
officialize	使官方化
cravenly	胆怯地
gaudiness	华美
basined	为盆地所围绕
animalistic	兽性说的
doloroso	感伤的
heterochthonous	外来的
breechless	无后膛的
epicurean	贪口福
hulking	粗陋
chandleress	女蜡烛贩卖商
rushes	工作样片
compulsively	禁不住地
tenderize	使嫩
timebargain	期货交易
dairy	奶品场
injunctive	禁止令
pupillage	未成年
heptagonal	七边形
expatriation	放逐国外
buggy	双轮单座的轻马车
landplane	陆上飞机
wheeled	有轮
espanol	西班牙的
ettu	原来还有你啊
twyformed	=twiformed
exception	异议
camorrism	克莫拉的活动
precambrian	前寒武层
cinerous	灰烬的
expositive	说明的
dockside	码头前沿
ittf	Table
stratigraphy	地层学
contract	婚约
galvanise	=galvanize
cryptococcus	aI隐球酵母
instead	代替
harm	损害
skive	磨
quass	=kvas
hetaera	交际花
partite	深裂
creta	白垩
carter	运货马车夫
ultrarightist	极右
fsb	Side
pop	汽水
vanadous	亚钒的
fm	密克罗尼西亚
imprudently	不小心地
aciniform	如成串葡萄状
inauthoritative	v/
geraniol	香叶醇
correlated	有相互关系的
ritz	豪华的旅馆
asinine	象驴一样的
actualize	实现
aba	长袍
volation	飞行
undynamic	无生气的
mahatma	大圣
flandre	=Flanders
hotchkiss	一种机关枪
gluey	胶质的
hairsbreadth	极狭的
fibula	扣针
intercommunion	互相来往
recliner	可躺式椅
haemophilia	血友病
enterocolitis	小肠结肠炎
mistakable	易弄错
hypotheses	假定
admonition	警告
thioguanine	硫鸟嘌呤
robbery	抢夺
sheep	羞答答的人
laf	French
swift	迅速地
poke	闲荡
pallia	pallium的复数
latchet	鞋带
kickback	强烈反应
distress	忧伤
untoward	倔强
kaisership	皇帝的职位
whoopla	狂欢
disciplinarian	训育
telegraph	发电报
upswing	改进
pyin	脓素
test	检验
workpaper	作业报告
salivarian	通过唾液传播的
ectoplasm	外质
davit	吊艇柱
insouciant	无忧无虑
baht	铢
haemocytoblast	成血细胞
recognizant	意识的
victoriously	胜利
majestic	宏伟的
orient	确定方向
crus	后腿的
monocle	单片眼镜
windstorm	暴风
bunkum	废话
inextricably	解不开
tastefully	风流
alcoholometer	酒精表
wardship	监护
barbaric	毫无约束的
abbreviation	缩写词
shellproof	防弹的
arafura	Sea阿拉弗拉海
polite	有礼貌
firmer	坚硬的
photosystem	光合体系
boutonniere	插于钮孔上之花
wany	=waney
goodby	=goodbye
eleventhly	在第十一号
gaba	伽马氨基丁酸
unhurried	不慌忙
watcher	看守人
handbag	手提包
semidiurnal	一天两次的
fiftieth	第五十
lutrine	水獭
gust	一阵狂风
typeface	字体
trifilar	三股的
painstaking	辛苦
protractile	伸出
gargle	漱口
xylocarpous	结硬木质果
tremulousness	发抖
asce	Civil
dodo	还不能单独飞行的航校学员
potboil	为混饭吃而粗制滥造
softish	有点柔和的
quaint	奇怪
pomeranian	波美拉尼亚
stag	全是男人
inevitable	必然
celloidin	火棉胶
carpetbag	毯制的旅行袋
extricable	可救出
shopworn	陈腐
addible	可添加
disappoint	使失望
explain	说明
can	把食品装罐
congest	使充满
floristic	植物种类
millisecond	毫秒
becky	贝基
sleeve	袖子
climactic	渐层法的
yakitori	串肉扦上腌泡过的小鸡块
contemplative	祈祷
divarication	分叉
radioscopy	X光透视
unfailingly	可靠地
nacrous	=nacreous
exertive	费力
controvertist	=controversialist
rathskeller	设在地下室的德国式饭馆
celebration	庆典
fusional	熔化
defeat	战胜
tetrasporangium	四分孢子囊
fuzzy	有绒毛
musingly	沉思
crenulate	小圆齿状的
sorta	近似
uncalled	未叫到的
decoder	解码器
unite	联合
bizonal	二地区的
automate	自动操作
overcoat	外套大衣
tranquilization	安静
banyan	菩提树
show	假装
suasive	劝说
sequelae	结局
amazingly	可惊
mfh	Master
abstentious	有节制
exophasia	外部语言
digitated	趾状的
telium	冬孢子堆
dystrophia	营养障碍
doubled	加倍努力
edificatory	教诲的
redwood	红木树
lovingness	钟情
augmented	增音的
ate	自动试验设备
nullah	水路
golan	Heights戈兰高
stanch	使止血
independent	无党派者
overnight	通宵的
anourous	无尾的
sinopite	赭石
ablutionary	洗礼
emancipative	有助于解放的
kalevala	芬兰的民族史诗
hexameter	六步格的诗
bailment	寄托
subsellium	凸出托板
outcast	被遗弃
pully	具吸引力
tetrasyllabic	四音节
exsect	根除
temple	神殿
predeterminate	先定的
epidotic	绿帘石的
unabroken	无破损
reconfirm	再次证实
signboard	布告板
inauthoritative	膊豢煽
sinsemilla	精育无籽大麻
zoophoric	具有动物形的
gammon	腌猪腿
surpassingly	超群
perfective	完成的
corneous	似角的
saturable	可饱和的
blackart	魔法
nih	Health
comments	注释
ogreish	鬼似
physical	自然的
monstrous	恐怖
exhortative	劝告
slinky	偷偷摸摸的
equiprobably	等概率
unglamorous	无浪漫色彩
functionalist	机能主义者
compressure	抑制
geohydrology	地下
tuck	缩拢
exedra	半圆形室外坐椅
obstetric	产科
point	指出
bladebone	肩胛骨
masterwork	极品
forced	动用武力
color	获得颜色
micromanipulation	[蓀jJleItE
wosa	Architecture
muzzy	酩酊的
dypass	绕道
dumpling	面团布丁
steep	陡峭的
youngly	年纪尚轻时
berne	伯尔尼
autographical	亲笔
deliquescence	液化
samphire	一种伞形科植物
special	专门的
guardee	卫士
tellable	值得说的
lacunar	有花格平顶的
abominator	憎恶者
xeroderma	皮肤干燥症
floriculture	花艺
degree	次数
subservient	屈从
chanciness	危险性
isokeraunic	=isoceraunic
sabina	萨拜娜
invidious	诽谤
pauper	乞丐
eurybathic	广深性的
keystone	楔石
hypercorrect	纠正过头的
celature	浮凸纹饰
sombrous	阴沉
coven	女巫大聚会
alfresco	在户外
silentious	习惯性沉默
polynuclear	多环的
inartistic	无味
laryngeal	喉
early	早先
vodka	伏特加酒
rebel	反抗
tartarean	狱
simonstown	西蒙斯敦
obit	讣告
catastrophist	劫数难逃论者
bivallate	围有两层防护土墙的
upcoil	=coil
epanaphora	首语重覆
archangel	大天使
pusher	文书
carbuncle	红榴石
feasible	切实可行的
domiciliation	决定住处
antipodal	对跖的
twill	斜纹织物的
medicine	给……用药
colocynth	用苦西瓜提取的泻药
sinicize	使中国化
hereon	从此
parlous	非常地
asymptomatic	无症状
chemakuan	彻默库安语
ammino	氨络的
branchia	鳃
gaping	多洞穴
radioacoustics	无线电声学
discernable	可辨别
smell	嗅觉
solarium	日晷
singular	持异议的
tret	添头
borosilicate	硼硅酸盐
compression	密集
flow	涌流
soed	English
castigatory	修订
dedans	球场发球线后的观众席
impeditive	阻碍
pasticheur	仿作者
sisyphean	徒劳的
counterphobic	反恐怖的
landsman	未出过海的人
unload	卸
vitriolic	象硫酸
greasy	油污的
atalanta	捷足善走的美女
fellmonger	皮革商
integrate	使一体化
asepticism	无菌法
awol	擅离职守
upright	垂直
desmoenzyme	不溶性酶
crosswalk	人行横道
locale	现场
gallinipper	咬人的昆虫
seta	刺毛
siree	=sirree
prodigiouss	惊人的
chemostat	恒化器
variolate	给……接种人痘
lessened	减少的
indophenol	靛酚染料
anesthetize	使麻痹
neomorphic	新变体的
vermicide	驱虫剂
chaussee	公路
greenhorn	缺乏经验的人
declamatory	朗读式
handmaiden	女仆
dandify	打扮得时髦
multidisciplinary	有关各种学问
respectively	分别
episcopalism	主教制主义
hyposarca	全身水肿
band	联合
unforgiving	不可宽恕
cutcha	暂时
blacklist	黑名单
fco	外交联邦部
confessant	供认者
warrior	尚武
huntingdonshire	亨廷登郡
sverige	=Sweden
tatiana	塔蒂阿娜
dragline	索斗铲
ashy	灰
contextless	无连贯性
incipience	发端
inveterate	成癖的
spumous	泡沫状的
ephor	监督官
meretricious	适合娼妓
frad	Device
wherethrough	经其处
underproduce	使减产
halogenide	卤化物
supramundane	远离俗世的
bodice	女服的紧身胸衣
tellable	可述说
vitally	极其
unpresentable	拿不出去的
ackemma	上午
corpus	本金
microporous	多微孔
commons	英国国会下院
superstruct	把……建在另一结构之上
openmouthed	张嘴的
ashen	灰色的
hmv	Master''s
engird	使佩带
sententiously	简洁
ecc	and
unwrought	未加工
stride	大步行走
inoperable	手术不能治愈的
bridgeable	可架桥
aniconic	象征的
blackmailer	勒索者
motherly	母亲
grizzled	灰色的
venezuelan	委内瑞拉人
ibew	Electrical
dogwatch	两小时换班的值班
narcotic	催眠
retinol	视黄醇
inhaust	吸
offput	使倒胃口
explore	探险
kinaesthetic	动觉的
switch	转换
heptavalent	七价
ebullism	体液沸腾
aboriginal	原来的
sweetness	可爱
laced	有花边的
popular	流行的
flustration	紧张不安
hypoesthesia	触感减退
cast	投
actinozoan	珊瑚虫
ahold	抓
strain	损伤
satyagrahi	不合作主义者
nympha	蛹
maladjustment	失调
desolation	荒废
untidy	凌乱
whereunto	向何处
isocephaly	人体等高构图法
brasil	=Brazil
illume	启发
traveling	移动
parle	谈话
toynbeean	汤因比
ideational	构思
early	及早
debug	改正有毛病部分
dqdb	Bus
retrieval	取回
scrag	弱不禁风的植物
debauch	使堕落
breezily	活泼轻松地
aspi	Advanced
doubly	双摺
terminate	停止
singly	逐一
seminal	精液的
thin	稀疏
ground	打基础
various	多样
zinckiferous	=zinciferous
driftwood	浮木
abscond	避债
danish	丹麦语
uricolysis	尿酸分解
last	末尾
monotype	单版画
faintish	微弱
uddi	Integration"
ural	乌拉尔河
uncommon	难
breadless	缺粮
laddie	少年
leaning	倾斜
pedigreed	血统明白的
antiaircraft	防空的
easiness	容易
spurious	欺骗的
oss	开放源代码软件
entertainment	娱乐
rayon	人造丝织物
multirole	多作用的
chloritize	把岩石中的矿物变为亚氯酸盐
astronautically	太空航行员
conscientious	尽责
coolly	沉着
andromeda	埃塞俄比亚的公主
cavity	腔
rouge	胭脂
epiblast	外胚层
trenail	木拴
gunn	基于耿氏效应
hypermetrical	音节过多
gcf	factor最大公因子
trusting	信赖
autoaggressive	disease=autoimmune
cloistered	隐居的
pessimist	悲观论者
fecundity	肥沃
ferrety	似雪貂的
tapestried	织在绣帷上
paisan	=paisano
driftingly	漂流地
kinetosome	基体
strigillose	覆盖着糙伏毛
intoxicate	醉人
rushing	急流
shebang	酒馆
refinance	再为……筹钱
layoff	失业期
megapolis	多人口
attitudinal	根据个人态度
aicpa	Certified
cannabinol	大麻醇
oneirocritical	解梦的
yellowy	略带黄色
reposal	休息
oak	橡木制
lesson	课
lycian	利西亚语的
varied	杂色的
closter	修道院
arteriogram	动脉X光照片
residuary	残余
obdurately	顽固
whitley	惠特利协议会
ecdysiast	脱衣舞女
alveolar	齿槽的
musicotherapy	音乐疗法
inchoative	开始状态
resid	残油
orins	橡树岭原子核研究所
imponderabilia	无法估量之事物
victimize	牺牲
thin	淡的
inconnu	食用淡水鱼的一种
fiddle	无意识而不停地拨弄
subdividable	适于再分
fusional	熔化的
arnhem	阿纳姆
acerbic	尖刻
karma	因果报应
intenerate	软化
microprogrammed	微程序控制的
submission	投降
hecatonstylon	百柱式建筑物
perineuritis	神经束膜炎
diploblastic	双胚层
auk	海雀
cordial	热忱
peckish	饥饿的
apyretic	无热的
meadowsweet	绣线菊属的灌木
incorrect	错误的
jovial	朱庇特的
rarest	最稀罕
strange	生疏的
tunicate	有被囊的
culprit	犯人
punji	尖竹钉
sustainable	足可支撑
cuprum	铜
tinny	锡的
lapidicolous	生长在石头底下
handle	易于操纵
patrin	路标
afdc	to
hypochromia	着色不足
gah	嗨
hindbrain	脑的最后部
loudmouth	高声谈话的人
stylite	修行的人
massagist	按摩师
fat	肥的
gaillardia	天人菊属植物
condemned	被责难的
pyjamas	睡衣
whithersoever	无论何处
vitta	色条
crt	Cathode
beastly	残忍的
cac	帐户管理中心
beautifully	美好
motor	发动机
hoggerel	小羊
endlessly	不断地
octopodes	octopus的复数
uncorrectably	无望地
concretive	凝结性的
sleeping	睡着
ferocious	凶猛的
plasticity	塑性
piranesi	Giambattista
strobilation	横裂
pathetical	可怜
sanctified	神圣化的
tuberose	似块茎的
cinematographer	放映技师
inkyo	引退者
odditional	加添的
marquee	大帐篷
telfordize	用大石块铺砌
whittle	削减
woodruff	车叶草
spinachy	具菠菜特点
incomprehensibility	不可理絣e/InkRmprI5hensly//
uncivil	失礼的
flyspeck	弄脏
evitable	可避免的
ultravirus	超显微病毒
unweary	不疲倦的
once	从前
triradius	指纹三角
skyward	向天空的
vitriolate	把……变成硫酸
equalarea	等面积
backroom	密室
salification	成盐作用
sbc	subband
halfheartedly	无兴趣地
denverite	丹佛市居民
hirable	能租用的
sudoriferous	分泌汗的
breeding	饲养
lawk	嗳呀!
raiment	服饰
overspill	过剩人口
my	我
raver	社交场常客
gulfy	遍布裂口
tagger	附加物
phenylethylamine	苯
fairyland	奇境
duff	布丁的一种
vrml	Reality
slapdash	匆促的
flowing	流动的
paint	逼真地描述
recolor	重新着色
neolithic	新石器时代
nonbeliever	不信上帝的人
misshapen	奇形怪状
uninterpretable	无法说明的
fillip	激起
skin	外皮
mdr	日最低需要量
originative	有发明之才能
gypsy	吉普赛语
recheat	猎犬集合号
confide	倾诉
ally	结盟
remorseless	坚持不懈的
tindery	火绒似的
franklinite	锌铁尖晶石
heaps	很
retention	保持力
idealistic	空想主义的
latex	橡胶
envy	羡慕
nucleocapsid	病毒粒子
irrepleviable	不准保释的
waucht	大口的吞饮
thermoregulation	体温调节
shane	谢恩
muddily	下流地
reprovingly	申斥
automata	自动操作
wifely	适合做妻子
sermon	训诫
stirring	忙碌的
gnp	国民生产总值
hibernian	爱尔兰人
writable	可写下的
etesian	每年发生
quitch	茅草类植物
enweave	=inweave
icj	Court
subaqueous	水中
imperatorial	至尊的
zilch	无价值之物
treasonable	不忠的
embosom	环绕
lambert	朗伯
lifeboatman	救生艇人员
exhaustive	彻底的
corruptive	使堕落的
neoimpressionism	新印象主义
incomparably	无比地
expand	扩张
clottish	笨
hoar	灰白
winifred	威妮弗蕾德
valuable	贵重的
reft	reave的过去式及过去分词
ryukyuan	琉球人
albania	阿尔巴尼亚
financing	融资
hashery	廉价小饭馆
stick	粘住
apatetic	拟色
hillock	小丘
gerry	格里
thinly	稀疏
beetling	悬垂
usia	States
finis	结尾
inextricable	逃脱不掉的
effeminize	使柔弱
businesslike	公事公办的
starchy	浆硬
ovulation	产卵作用
obsequious	奉承的
meconic	罂粟的
luxe	奢侈
liquid	液体的
limner	画匠
fungivorous	食真菌
temporal	暂时的
chimera	妖怪
sexidecimal	16进位
insatiably	不知足地
bestir	激励
arenaceous	沙质
navigate	驾驶
new	新
overexert	用力过猛
adrenocorticotro	nEJ质荷尔蒙
domeliner	设有玻璃圆顶车厢的列车
leaflet	传单
radically	以激进的方式
lacunar	有花格平顶
official	官方的
salvageable	可挽回
zwinglian	茨温利教义的
performing	表演的
reimbursement	退还
unsight	未见过的
bodmin	博德明
cineast	=cineaste
cissoid	凹边的
besieger	围攻军
undeviating	坚定不移的
entomostracan	切甲类
unlessened	未减少的
immusical	不和调的
frolicly	嬉戏
unseen	看不见的
trapball	射球戏
connatural	固有的
supposable	可假定
hymnary	=hymnbook
palingenesis	轮回
sulfate	使变为硫酸盐
way	大大
acknowiedged	公认的
ravined	布满沟壑
ultraviolet	紫外线的
rhythmed	有节奏
beefeater	伦敦塔守卫者
unstressed	不着重
outlook	观点
iota	9位
circumstantial	间接证据
affiance	信托
scriber	描绘标记的用具
khz	千次每秒
injudicial	欠思考
bedraggled	荒废的
fulgurous	闪电似的
brutehood	兽性
decrescendo	渐弱
encroachment	侵犯
footpath	小路
grand	豪华的
jealous	猜疑
colory	颜色显著
genuine	真正的
specific	特殊
unpruned	任其自然生长的
ligamentary	韧带的
contrapuntal	对位
confucian	儒家学者
elusively	易忘记地
roadworthy	适于行路的
blackhearted	邪恶
resplendent	光辉
swashbuckler	流氓
outbreak	发作
wizard	奇才
rear	高耸
ravc	Veterinary
defacto	事实上
phytolaccaceous	商陆科的
ragabash	=riffraff
loose	散漫的
namaland	=Namaqualand
effortful	显示努力
tarantella	一种快速旋转舞
effloresce	开花
leafy	树叶茂盛的
great	大人物
fuzzbuzz	忙乱
burra	大人
sialic	硅铝质
orthophotograph	=orthophoto
gangue	脉石
beaverette	轻装甲车
concise	简明
dubitable	怀疑的
thermolabile	感热
hanoverian	汉诺威的
melodist	旋律美妙的作曲家
remunerative	有利的
vote	投票
inscription	碑铭
tableaux	静态画面、场面
disulphide	二硫化物
dukhobors	=Doukhobors
haver	消磨时间
riant	快活
darner	缝补针
greenhorn	不懂世故的人
anonaceous	=annonaceous
locomotive	运动的
reversionary	倒退
sanatory	治疗病症的
fulcrum	支点
calendarian	历书编纂人
chd	heart
mommy	妈咪
mild	温柔的
bromidic	平庸的
gauze	纱布
inveigle	诱骗
dipterocarp	龙脑香科树
frequence	频繁
pontoon	浮桥
decomposer	分解体
toup	=toupee
astarte	阿施塔特
frizzle	卷毛
alley	巷
bedside	枕边
ozonic	含臭氧的
diarrhoea	腹泻
acupuncture	针刺疗法
existential	存在判断
killing	猎护品
manrope	安全索
surfeit	饮食过度
loamy	肥沃的
diligent	细心而继续不断
textile	纺织的
presbyter	长老
symmetrization	使对称
eclaircissement	说明
subeconomic	缺乏经济意义
thriller	使人毛骨悚然的东西
blowtorch	喷灯
activity	活跃
dendrophagous	食树的
dysteleological	生活或自然之漫无目标
scoutcraft	童子军活动
whist	肃静!
fireplug	消防塞
zoom	急速上升
lux	勒克斯
conditionality	制约性
doubly	双摺地
waver	动摇
uscf	美国国际象棋联合会
vestock	长绸领带
slush	溅湿
miotic	瞳孔缩小
isopycnosis	等凝缩
ocher	赭土
emasculate	使无力
viridian	鲜绿色的
shoji	亦作shoji
swink	辛苦
cubicule	=cubicle
california	加州
commute	抵偿
unworthy	不足取
decolorant	有脱色作用的
thermopylae	塞莫皮莱
downshift	调低速档
ludicrously	滑稽
gravelly	碎石构成
convey	转让
sebaceous	脂肪质
incretionary	a的
demolishment	破坏
reverberatory	反射的
soucar	银行家
agonizing	痛苦难忍
slipware	施釉陶器
outrigged	装有外伸支架
anaplastic	退行发育术的
physicky	由药物引起的
nouakchott	努瓦克肖特
interior	内部
fabrication	构成
amity	友好
stigmatic	丑恶的
succous	汁的
ladderman	云梯消防队员
ineffectually	无益
vixen	坏心眼的女人
vagrant	漂泊
reprogram	程序重调
awhirl	旋转的
rural	田园的
trowelman	泥工
needless	不必要
tractile	可拉长
boxy	矮胖
aacs	Airways
fourteener	一行有十四个音节的诗
hulking	笨重
tempi	拍子
lemberg	=Lvov
readily	容易地
gloss	使有光彩
outsat	outsit的过去式
toric	环形圆纹曲面
flaring	燃烧
microhm	微欧姆
cobber	好友
supercolossal	超大的
gnathonic	谄媚的
allantoic	尿囊
fevertrap	易使人感染热病的地方
nonjuring	拒绝立誓效忠的
metacommunication	元信息传递
x	X形
rimester	打油诗人
honeyed	甜如蜜的
arouse	引起
vituperator	责骂者
ragamuffinly	衣衫褴褛
spacesickness	宇航病
distillable	可由蒸馏而
acetarious	凉拌用的
overplay	打得比……好
everydayness	平淡无奇
exceptant	以外
kindle	点燃
hydrophanous	水蛋白石
amboceptor	溶血素
decuplet	十个的一组
slipslop	懒散的
lucidity	明朗
guesstimate	估计
shebang	住所
dairyman	乳品加工工人
thine	你的
tonometer	气压计
sunken	sink的过去分词
solanaceous	茄属的
delawyer	使
lampstandard	灯柱
mediterranean	中海
doored	有门的
odea	odeum的复数
crinkle	起皱
sicative	促进干燥的
antihero	反英雄
manchuria	满洲
intersexual	两性间的
maritime	海员
barbarous	粗野
psf	磅[平方英尺
smoke	烟
sponsorship	赞助者的地位
hypostyle	多柱式建筑
crackdown	镇压
variegate	使成斑驳
gentile	非摩门教徒
karate	空手道
malversation	贪污
alkanet	由朱草根部提制之红色染料
rimrock	顶岩
fossilify	成为化石
cut	削减
unprecedented	空前的
entomologize	研究昆虫学
kinsfolk	亲属
sturdiness	雄壮
blurry	模糊的
breather	喘息者
grandisonian	模范绅士的
ghibli	基布利风
idiochromatic	自色
indian	印度人的
repoint	重嵌
gammasonde	γ探空仪
firn	万年雪
icecap	冰盖
gilbert	吉伯
prankish	恶作剧的
corrugate	成波状
divisibility	可分割
vote	建议
monarticular	单关节
successivity	接连
benchmark'	NULL)
dermatoid	皮状
azinphosmethyl	保棉磷
absoluteness	无限制
jumbled	乱七八糟
goluptious	可口
mandi	大集市
irresolute	犹豫不决的
vein	静脉
arbitrariness	任意
electrosynthesis	电合成
walk	散步
regenerate	更新
veni	came
pintoresque	可作绘画题材
mobile	机动
silviculture	森林学
osf	方济各会
umbilic	脐带
farcically	闹剧一般地
weightily	沉重地
antisexist	反对歧视女性的
adulterate	掺假
bagwash	初洗
benefit	利益
excitron	单阳极汞池整流管
bluff	断崖
dextrocular	惯用右眼
stubbed	多梗株的
abolisher	废除者
garcon	未婚男子
webernesque	韦伯恩音乐
neglect	漏做
ninetieth	九十分之一
misinform	告诉错误的消息
interrogation	审问
sihanouk	西哈努克
chasse	以快滑步跳舞
nopal	胭脂仙人掌属植物
royal	皇家
nonage	青年时期
ironbound	包铁的
circa	大约
phytochrome	光敏色素
realize	实行
uvula	小舌
phanerozoic	显生宙的
isodiaphere	等超额中子核素
kgps	second
spermatogeny	=spermatogenesis
brooklyn	布鲁克林
painful	使痛苦
talc	云母
bahaism	一种穆斯林教派
visualisation	=visualization
rubricity	遵守教仪
pleasurably	欢愉
westralian	西澳大利亚人的
mediant	中音
symptomatical	=symptomatic
aliphatic	脂肪族
illusory	虚假的
duenna	少女的保姆
oriole	金莺类
extraofficial	职权外的
uncivilized	无文化的
suck	吸
agrestic	粗野
parthenogenetic	单性生殖
cherry	处女
brisk	活泼
mask	参加化装舞会
taintless	纯洁清白
saboteur	从事破坏活动者
choreodrama	舞蹈剧
lung	肺脏
rouge	擦口红
leapfrog	竞相提高
bunned	挽成小圆髻
couth	有礼貌
subform	衍生形式
autoharp	自鸣筝
incommensurability	不能比较
milium	粟粒疹
capable	有能力的
anthropic	人类
cancerian	出生于巨蟹宫时段的人
pitier	同情者
surrender	投降算了
trimly	整齐
hermetic	与外界隔绝的
ingot	工业纯铁
curricle	一种轻便马车
cherrystone	小蛤蜊
orbicular	圆满的
unbusinesslike	无效能的
indulge	纵容
snook	轻蔑的一种动作
isobar	等压线
oilpaper	油纸
glycosuria	糖尿
undated	无限期的
trowbridge	特罗布里奇
gauchesco	加乌乔诗体
nicker	闷笑
fastuously	炫耀
selfishly	自私地
unitar	联合国训练研究所
hugely	巨大
mesityl	oxide
initial	最初
immunize	赋予免疫性
barbellate	有短硬毛
entremets	附加甜点心
ellipsis	省略
acquiescently	默认
towable	可拖拉的
keratode	角质纤维
vend	出售
available	有用的
frosted	受霜害
affected	受到影响
theomancy	求神问卜
myotropic	影响肌肉的
porphyroid	残斑岩
levamisole	左旋
conference	协商会
spica	角宿
gandhian	甘地主义
yakin	扭角羚
sheepshead	羊头
veil	隐藏
northerner	北方人
oligodontia	少牙
dc	直流电
crafty	善于骗人的
biparasitic	双重寄生
philanthropize	从事慈善事业
profane	亵渎的
knout	皮鞭
inswept	前端狭窄的
manito	具有超自然力的事物
crofter	小农场中的佃农
magellanic	麦哲伦海峡的
remit	传送
promiseful	有希望
melphalan	美法仑
slough	腐肉
horsewhip	用马鞭鞭打
cedarapple	苹果胶锈病
knightly	勇武的
pds	Slot
drone	靶标
clever	机灵的
veracious	诚实
thesis	论题
estral	=estrous
league	联合会
insinuate	使迂回地潜入
neronian	尼禄似的
window	窗
rough	粗糙
upright	垂直的
arbo	由节肢动物传播的
broadwise	侧面
striolate	具细线条
underside	下侧
dreadnaught	厚呢
antiwhite	反对白人既成体制的
prawn	对虾
assembly	汇编
exuberant	繁茂的
buddybuddy	亲热的
welfarism	社会福利制度
ancillary	副的
scrappy	不连贯
unaccepted	被拒绝
leer	恶意的目光
eec	Economic
craggy	多峭壁的
time	定时
wasteful	浪费
gutturonasal	软颚鼻的
grotesque	奇形怪状的人
auto	汽车
stivy	塞满的
buddie	军中伙伴
disrelish	讨厌
valediction	告别
roper	诱人进入赌场者
kinsmanship	类似
trikini	三点式女泳装
undergird	巩固……的底部
forbye	接近
surculous	有根出条
inodorous	无气味的
dirty	卑鄙的
omnipresent	同时遍在的
sunny	快乐的
darch	建筑学博士
posthouse	驿站
rashly	无见识地
appointer	指派者
unselfishly	不自私
excerption	精华录
speculation	做投机买卖
ya	年轻人
uninstall	卸载软件
phytography	记述植物学
underlit	照明不足的
scotophil	喜暗
troth	誓言
displeasing	不愉快
unbefriended	无人扶助
tensile	可伸长的
wether	阉过的公羊
incontinuous	间断的
idiocy	白痴的行为
ungated	无闸门
photonuclear	光核
pygmyisn	侏儒似
bukovina	布科维纳
sandy	Sandy
augment	增大
holohedry	全对称晶形
comment	意见
infectivity	易传染
perfector	press双面印刷机
inverse	倒转的
chare	杂务女佣
laudable	值得称赞的
underclothing	内衣
cockle	弄皱
coprocessor	协处理器
colorway	色彩设计
dephosphorization	除磷
jupe	上衣
volcanicity	火山性
labourious	费劲的
decomposite	再混合物
russian	俄国
eff	咒骂
cab	乘出租马车
bacteriostatic	阻止细菌繁帜
hydrophyte	水生植物
sadly	悲哀
atropos	阿特洛波斯
systemless	无系统
floreat	祝他事业兴旺
sunniness	向阳好
resemble	象
palliative	减轻的
webfoot	蹼趾动物
kinsfolk	血族
gombroon	冈布龙陶瓷器皿
kickplate	踢板
deodorant	除臭剂
diffuser	扩散体
afrikaans	南非荷兰语
glomerulate	聚成密集小群
bessarabian	比萨拉比亚
terdiurnal	一日三次的
minimi	minimus
chief	主任的
dinky	整洁的
audacity	厚颜
lumbricoid	蚯蚓状的
algebraical	代数学
tcp	Transfer
stewardess	女乘务员
crock	瓦罐碴
koniscope	尘粒镜
zpg	Population
inducement	动机
crocky	老朽的
bifocal	双焦点
pellicular	薄膜的
kuru	苦鲁病
wonted	习惯的
waver	挥动者
reverberation	反响
pharmacologist	药理学家
disputative	爱争辩的
hemingwayesque	海明威作品特色的
oily	油滑
barrelled	有枪身
clavicytherium	立地型大键琴
felicitous	幸福的
outsole	大底
zveno	作业组
scalariform	阶纹
testaceous	有贝壳的
po	symb
millage	厘计税率
embolic	插子
incessant	不断
judaist	犹太教信徒
ticker	断续器
beclomethasone	倍氯米松
dimethylnitrosamine	二甲基亚硝胺
tsouris	烦恼
alkermes	地中海区的一种酒
halalah	哈拉拉
pinto	有花斑的
vilifier	诬蔑者
folksy	和气的
else	其他
subsequent	后来
analects	文选
true	忠诚
autolithograph	直接平皏t
say	念
peptic	助消化
battleplane	战斗机
division	分割
sonsy	开朗
deva	天神
mandatory	强制
difunctional	双官能的
affinal	同源的
trousering	裤料
exterior	外用的
admeasure	配给
brucine	二甲马钱子碱
tympanic	鼓皮似的
granulometric	粒度测定的
baboonery	笨拙
lightstruck	曝光而不能用
campaign	竞选运动
stope	在采矿场采矿
bathless	无浴室的
vasculotoxic	血管毒性
gutter	贫民区
warp	使翘曲
partnership	队友关系
emanatory	发出的
calibrator	口径测量器
scoff	嘲笑
decathlete	十项运动员
scramble	抢夺
shillalah	橡木棍
spreadhead	大标题
downhill	往下
caprification	虫媒授粉法
out	出声
backen	逆时针方向转变
depressing	抑压的
yesteryear	去年
bateleur	短尾鹰
atmological	水蒸气学
torus	花床
mordancy	尖酸
spurt	喷出
ganefo	Games
shrewdly	机灵的
revelation	显示
temple	庙
shock	浓密
fmcs	Service联邦仲裁与调解局
dovecote	鸽舍
state	国家的
chief	首要的
breadbasket	腹
duchess	女公爵
pluvian	下雨的
swizz	诈取
very	绝对的
tother	另一
zincographic	锌版术
brotherly	亲切
mortify	坏死
rhizogenesis	根之生长
erect	使直立
lithic	结石
vasodilating	引起血管舒张的
foil	挫败
northwestwards	向西北方地
haymaker	干草机
corvina	石首鱼
workaholic	专心工作的人
overhasty	过于草率的
prescient	预见的
throughly	十分地
pigment	颜料
moorage	系泊费
rageful	狂怒
defunct	死了的
askew	歪斜的
last	维持
sapsago	绿干酪
touchline	边线界线
underage	缺乏
pediatrics	小儿科
ballooning	随风飘荡
invigorator	补药
castiron	强壮的
chowder	杂脍
chickling	野豌豆
pyrotechnical	烟火
bastinade	棍
cosmopolite	见闻很广博的
castroism	卡斯特罗主义
halid	卤化物
stealing	有偷窃行为
orexis	食欲
pliancy	柔软
deist	自然神论信仰者
rendering	翻译
antifeedant	拒食素
maja	穿着俗艳的美女
crassly	愚钝地
ambulant	走动
hydrometeorological	i:
overlaid	覆盖
indiscretionary	卤莽的
dispersedly	散开
nonarticulate	不连接的
becoming	适当
nondegree	没有学位
church	礼拜
rifle	膛线
unconcernedly	漠不关心
chamber	室
profitless	无益的
goggle	眼睛睁视
fulgurating	钻心
bouncing	巨大的
gastropod	腹足纲的软体动物
curtilage	宅
mesomorphic	具有由中胚叶发达之筋骨的
nonenzymatic	不涉及酶作用
cist	石柜
person	人
unscriptural	非基督教
belemnoid	形像匕首
infibulate	销住
reposit	贮藏
shiv	刀
product	产物
chatelaine	女主人
chiseled	凿刻
lallygag	无所事事
mabe	Economics农业经营和经济学硕士
pervade	遍及
careen	船的倾侧
precedable	可能被超先
vivify	使活跃
lapm	for
zing	发尖啸声
photoemission	光电效应
interiorly	在国内
uncdf	Fund
talisman	护身符
yea	赞成
scandic	钪
gradualness	徐徐
lcp	Protocol
perionychium	甲周表皮
hep	碎甲弹
darwinian	达尔文
flush	惊飞
interspinous	椎间
superannuated	退休
exaggerated	言过其实
alible	有营养
unifoliate	单叶
kolima	=Kolyma
ganefo	the
stillroom	蒸馏室
unsccur	Utilization
touchwood	火绒
stymy	完全妨碍
jacobinize	灌输雅各宾党的主张
torchlight	火炬之光
msha	Science
persuadable	可以说服的
ostentation	摆阔
scion	子孙
retractile	收回的
cofunction	余函数
contessa	伯爵夫人
unmutilated	非残缺不全的
clipsheet	报刊等只印一面
exopathic	病因在体外
ecdysone	蜕皮激素
field	田间的
beacher	浪涛
flakily	薄片
cerebral	脑
spiritually	在精神上地
hooch	烈酒
pyrograph	烙出图形
petrous	岩石的
sonantize	使发浊辅音
silique	长角果
withy	柳条绳索
zincy	似锌
schmitt	施密特
sleepful	睡眠
nonreliance	不信赖
absolutize	使……绝对化
tablemate	同席进餐者
apophthegm	格言
yavis	事业发达的人
standby	备用
campanological	鸣钟术
obadiah	希伯来的先知
hoar	灰白的
custodianship	管理人之职务或地位
subpena	传票
adopted	被收养的
crisper	新鲜蔬菜保存盒
desiccative	使干燥
circadian	以24小时为周期
scurrilous	使用低级粗俗语言的
frivolously	轻浮地
sissified	女孩子气的
riot	参加骚动
struck	受罢工影响的
gorgio	非吉卜赛人
idiosyncrasy	特性
tuboplasty	输卵管整复术
distention	膨胀
scrappy	爱打架的
wizard	巫术的
overprize	过于珍视
purim	普林节
antimalarial	抗疟的
wrongful	不正当
systematism	组织化
seeder	播种人
denegation	否定
preconscious	前意识
unarguable	无可争辩的
flickeringly	闪烁地
sulfid	硫化物
unsure	不肯定
eacm	Market
bethanechol	乌拉胆碱
signaling	打信号
royster	=roister
begird	以带子缠绕
locrian	洛克里斯人的
goulard	稀铅醋液
parameter	起限定作用的因素
flay	严厉批评
cleverly	灵明
painless	不痛
whenever	随时
unartificial	自然
exceptionable	要不得的
doctrinism	对教义
calesa	二轮敞篷小马车
expectative	预期的
fathom	测量深度
entitle	授权
closing	结束
elide	不予考虑删节
pyralidid	螟蛾
habilimented	穿着服装
eucalyptol	桉油精
clart	泥土或尘土的污点
bodily	身体
compendia	概略
expellee	被开除者
hypostyle	多柱式建筑的
phelloderm	软木皮层
forthcoming	即将来临的
naan	=nan
iatrochemistry	化学疗法
heterogenesis	世代交替
vagodepressor	迷走神经抑制剂
soredium	粉芽
intricately	杂乱
amphimixis	交配
drawerful	大量
bother	烦恼
senusi	赛努西教徒
fucked	fuck的过去时
anaesthesiologist	麻醉学者
buckinghamshire	白金汉郡
scagliola	人造大理石
dorhawk	欧洲夜鹰
unexpiated	未补偿的
capillarimeter	毛细管测液器
doorjamb	门框两侧的直木
larger	多量的
gardenia	2栀子花
helicon	海利空低音大号
contrariant	敌对的
cloistered	隐居
senryu	川柳
shivery	寒冷的
pectinate	梳状的
impious	不尊敬的
bombora	危险水域
longevous	长寿
comingout	为介绍少女初次参加社交活动而举行的正式舞会
brilliantly	光亮
lyon	里昂
accustomed	按照风俗习惯
inspirer	inspiring启发灵感
emilia	伊米莉亚
fddi	Fiber
postharvest	用于采收后
indian	印第安人的
presidial	总统
unfinishable	结束不了
pylori	幽门
ccitt	International
nonconformity	不信奉国教
dimensionally	在尺寸上
insurrectionist	造反者
rising	起义
backpat	拍拍肩
foudroyant	引起敬畏
kennedy	肯尼迪
bughunter	昆虫学者
diphonemic	双音素的
symmograph	绕线图画
suppletive	异干互补
arises	站立
space	留间隔
helicograph	螺旋规
mayhem	伤害罪之一种
magnolia	玉兰类的植物
glucoside	配糖物
polyoxymethylene	聚甲醛
harthacanute	哈瑟克努特
dccc	罗马数字
fuzzbuster	挫警仪
rascally	卑鄙
contrivance	发明才能
romper	嬉戏者
downline	沿下行线
seedtime	准备阶段
anodal	=anodic
epipteric	翼上
naumachy	=naumachia
fozy	愚笨的
narcissistic	自恋
supervenient	意外发生的
glidingly	滑行
waxwork	蜡像
brigandage	盗窃
skulduggery	诡计
celibate	未婚
typo	印刷工
wisperer	耳语者
sequacious	盲从
pomade	涂以润发油
deuteride	氘化物
zoroastrian	与索罗亚斯德教有关的
misfit	不相称
acoustical	听觉
anadyomene	爱与美的女神
wherefore	为什么
solemnness	严肃
paillasse	木屑床垫
unaccepted	未被接纳的
agreed	已经过协议的
ter	=terr
contriver	创制者
pedestal	基架
fulmination	爆鸣
pigmentize	颜色
debarment	排除
chapman	商人
beja	贝沙族
frgs	the
consort	结交
intact	完整无缺
ingoing	进入
touching	令人同情
scrumptious	味美
tripolar	三极
eurybath	广深性水生生物
indispensable	绝对必要的
orbiculate	球状的
clonism	抽搐
tinge	气息
immortalization	不灭
refractional	屈折的
gyratory	旋转的
hendecasyllabic	包含有十一音节
sparid	鲷
incarnate	化身
tendencious	立场倾向
pollution	玷污
molly	懦夫
blameful	该受谴责的
irredeemable	不能赎回
sunnite	逊尼派
senna	晒干的番泻叶
unequalable	敌不过的
blusterous	叫嚷的
gerontogeous	东半球
tenson	吟诗比赛
undenominational	非宗派约束
heterofil	共轭丝的
paleoprimatology	古灵长目学
recoronation	从新为……加冕
harmonicon	口琴
tinkerly	笨拙的
horace	贺瑞斯
complaining	诉苦的
codex	抄本
sphere	球
confect	蜜饯
crotchety	想入非非
inheritance	遗传
inexplicably	到无法说明的程度
townward	往城里的
technological	科技
factious	好捣乱的
hope	希望
wallpaper	壁纸
trunk	象鼻
now	立刻
disciplinarian	训练
lickerish	讲究吃的
emulatory	竞争的
pneumatolytic	气成的
heteronomous	他律的
rightly	端正
frisk	欢跃
edo	扩充的数据总线
priestly	僧侣似的
railhead	铺设中的铁路末端
unenlightened	无偏见
gerontology	老人医学
potpourri	肉菜杂烩
screen	屏
webbing	厚边
ternate	三出的
bemazed	迷惑
maderization	呈现褐色
anabaptist	再洗礼教徒
contrary	相反地
trackball	跟踪球
vernal	和煦的
furthersome	有利的
bryozoan	苔藓虫类
feature	容貌
lace	饰以花边
unstirred	未受激动的
pupal	蛹的
undying	不死的
quadrifid	分成四部份
semicylindric	半圆柱状的
approvable	可核准的
limb	分支
pure	完美
exterior	表面
identity	特性
achondrite	不含球粒陨石
durability	耐久力
intermediary	中间
psat	Scholastic
negritude	对黑人文化传统的自豪感
unsmart	不精明
panties	短衬裤
swale	沼泽
waterscape	水景
hyperinsulinism	胰岛素过多
crawl	蠕动
catatonic	紧张性精神症患者
tzaristic	=czarist
pathognomonic	特殊
binary	二元
floating	漂浮的
unseemly	不适宜
polytene	多线染色体的
reconsolidate	重新合并
viscera	内容
tatty	破旧的
setiparous	生刚毛的
permeation	渗入
eunuchism	阉人状态
african	非洲
mesial	中间的
desolately	荒凉地
spik	=spic
spacious	广大
sale	出售
fete	庆祝
feignedly	装聋作哑
rapidity	迅速
worshipful	值得尊敬的
inharmonious	不合谐
knickerbocker	纽约市人
unsolicitous	未悬念的
score	起跑线
stanchly	忠实地
renouncement	拒绝
striation	条痕
talkie	有声电影
skidder	集材工
bva	Association
jerk	痉挛
haemostatic	止血的
awheel	骑脚踏车地
bumblepuppy	球戏的一种
conscribe	强行征召
merciful	仁慈的
drover	牲畜贩子
formatting'	NULL)
youthfully	无经验地
microscope	显微镜
hemizygous	半合子的
heliograph	太阳摄影机
shem	闪
penstock	水渠
nervy	有勇气的
magnitude	数量
playback	重放
refluent	回流
zincify	在……
linguistic	语言上的
eilat	埃拉特
odds	差别
unshirted	不加装饰
pstn	telephone
execute	经签名盖章等手续使生效
floodgate	水门
arrhythmia	心律不齐
tyre	装轮胎于
architrave	框缘
sinophile	亲华的
ceruse	白粉
tonga	Tonga
verbenaceous	马鞭草科
aleurone	糊粉
whiter	白的
wsa	Shipping
irishman	爱尔兰人
hypoblast	下胚层
locrian	洛克里斯
psychoenergetic	[量
penitentiary	教养所
watteau	华托式
corresponding	通讯的
lousy	恶心的
undersexed	性欲淡泊
leukemogenic	引起白血病的
bepuzzle	使困惑
gdmo	管理对象定义标准
unprescribed	非指定
blender	掺和器
andesite	安山石
venusian	金星
jesus	耶稣
ullmannite	锑硫镍矿
hydraulic	水力
baywood	大叶桃花心木
intellective	智力
ascendency	优越
sitting	在任期中
hodoscope	宇宙射线描迹仪
vaticanologist	梵蒂冈学家
diana	月
tucson	图森
sinew	原动力
misgivings	害怕
legitimization	认为正当
irdp	ICMP
uvulotomy	悬雍垂切开术
underact	不卖力地演
nashville	纳什维尔
tease	戏弄
statedly	庄重
wonder	惊讶
involute	复杂
swish	时髦的
unsalable	滞销
byelaw	内部规则
achromatous	淡色
thrippence	=threepence
exhilarative	令人兴奋的
temptable	可诱惑的
providence	天意
racemization	外消旋作用
respirometric	透气性测定的
headlike	头状
unyieldingly	坚硬地
nakedize	使暴露
promontory	海角
sporular	孢子的
rawheel	新来者
rascal	流氓
amplitude	丰富
digital	数位的
brigadier	旅长
cliff	悬崖
evernormal	平常仓贮
publish	出版
directrice	女董事
specify	指定
thereafter	其后
experientialism	经验主义
scepticism	怀疑论
congener	同属的
ream	扩展
northwards	朝北地
asphodel	日光兰
pacification	平定
ejectment	驱逐
taihang	Mountains
aew	空中预警
obscurity	偏僻
unfavourably	不适宜
synodic	相合
biotical	关于生命
operational	运作
loth	勉强
deed	实行
unreckonable	难预测的
sandboy	卖沙的小孩
protea	山龙眼
undesirous	不存想望
julius	朱利叶斯
hexapodous	昆虫的
barracoon	待贩运的奴隶的临时禁闭处
sainted	上天堂的
scrumptious	极为愉快的
respective	分别
kevazingo	该树的木
thinker	思想家
obsequious	拍马屁的
samyama	内助
foreland	角
pout	撅嘴
unwashed	无知
german	德语
unliveable	=unlivable
diffusionist	传流论者
disqualification	不合格
decasualize	解雇临时工人
dominical	主日
druggist	药材商
left	左派
freemasonic	共济会的
iridescence	彩虹色
adulterator	伪造人
septicaemia	败血病
epitaxial	取向附生
drive	击球
ber	基本编码规则
lankily	过分瘦长
overall	全面
lupulone	蛇麻酮
hereditarily	世袭地
grind	磨
betake	使去
sialic	硅铝带的
direct	顺行
abnormal	变态
minuteness	绵密
nematocyst	刺丝囊
zoomorphize	给予动物形象
minimus	微小
bronzy	仿青铜
leal	忠实的
seducement	诱惑手段
diligent	用功的
cochromatograph	共同色苃y/9kEJkrEJmE`tCrB:f/
nonrecurring	不重现的
posb	office
impartial	公平的
fretful	烦燥的
mousey	多鼠的
wineglassful	一酒杯的量
various	各种各样
ironbound	坚硬
uniform	始终如一
antithetic	对立的
ethelred	埃塞雷德
gyges	古阿斯
siamese	暹罗人
suasion	说服
lentoid	透镜状的
unpropertied	无产
leicestershire	英国爱尔兰东部的郡
usv	States
outrageous	令人不可容忍的
syngen	种群
lacus	湖
general	综合的
immerge	浸没
quick	敏捷的
remedial	治疗
pedestal	底座
hullabaloo	喧嚣
meteorologic	气象的
turtlet	幼海龟
aleatory	偶然的
illustrative	例证性
thermodynamic	使用热动力
towpath	拉船路
separately	分离地
hemochromogen	血色原
centralized	中央集权
enticing	迷人
fancify	幻想
tragus	耳珠
confect	把……制成糖果
owler	走私者
banjulele	弦乐器的一种
persuasion	说服
sked	计划表
riometer	相对电离层吸收仪
flimsy	薄纸
hepatogenous	由肝产生
impotable	不适合饮用的
tinder	易燃物
tuckahoe	茯苓
unperson	被冷落的人
undro	United
condensative	可凝结的
rachiodont	具喉齿的
graveward	向着坟墓
boudin	血肠
micelle	胶束
spend	花费
trod	tread的过去式及过去分词
inimitably	无法仿效地
macrocephalic	大头
ablaze	着火
charas	大麻脂
eminent	优良
spirula	旋壳乌贼
coloration	着色
foreshots	初酿威士忌
handless	笨手笨脚
sydneyite	悉尼居民
doa	dead
piffling	琐碎的
inhumorous	不滑稽的
mdram	Multibank
allostery	变构状态
voltairean	伏尔泰风格
alumnae	女毕业生
hag	砍伐
lousy	恶心
receptiblity	能接受
remediation	辅导
harry	掠夺
mhw	mean
tuvaluan	图瓦卢人
xyster	刮骨刀
coriander	胡荽
variably	易变地
pungent	苦痛的
furzy	像荆豆属植物
chasse	快滑步
cytoplast	细胞质
tarsometatarsus	跗跖骨
inconsonant	不一致
haft	柄
chillily	冷漠地
unable	不会
janus	两面神
unedible	=inedible
hutch	笼
plethoric	过多
lidocaine	利多卡因
spiry	螺旋状
fried	油炸的
shikoku	四国
serf	奴隶
hook	吊钩
christian	基督教
refixation	重新装设
begrimed	污秽
uredium	=uredinium
dentiform	齿形的
talent	才能
rudely	粗暴
steep	浸
espanol	西班牙
monobasic	单碱的
equinoctial	赤道的
queerish	古怪的
factor	因素
betake	使用
isaac	艾萨克
overtime	加班的
uprootal	离开家园
genealogical	宗谱的
gore	顶
falasha	法拉沙人
vacuation	抽空
bimorphemic	双语素
scolopophore	具橛神经胞
repeated	重复的
ingliding	内向滑音
christianism	基督教
incised	切入
nondegree	没有学位的
misunderstanding	误会
coed	男女同学
gramophone	留声机
windless	无风
stigmatic	污辱
futility	轻浮的言行
undertrump	王牌低吃
counterblast	猛烈的反应
macrophotography	低倍摄影
fiddle	虚度时光
millet	粟
ingush	英古什人
kitten	小动物
back	后面
weathering	侵蚀
ciaa	Intercollegiate
christless	不信奉基督的
thrust	延伸
extended	延长的
landmine	投伞水雷
ripely	成熟
unforgiving	不能原谅
klatch	聚会
fleshy	丰满
lawman	执法官
ems	电子函件业务
persist	持续
philobiblic	爱好文学的
aryan	雅利安语系
vulcanist	热月学家
organizational	组织的
bunkhouse	简陋屋
daylong	一整天
pertinently	适切地
autogamy	自核交配
ordure	淫秽的话
wired	接有电线
directorial	管理
bushwhacking	游击战
imperfect	未完成过去时的
reseat	给……装新座
rarp	Resolution
time	时间
impenetrable	难以渗透
sputum	痰
fermentum	一份圣饼
roburite	罗必赖特
solaria	solarium的复数
pertinency	针对性
myelitic	侵入脊髓
politely	优雅地
lesson	课程
unpleasant	讨厌的
ferbam	二甲胺基荒酸铁
heathy	石南的
dermatoid	皮状的
decuple	十倍的
expedite	加速
electrowinning	电解冶金法
arid	沉闷的
bulk	显得重要
alcyonarian	低等腔肠动物
truckman	消防员
jumbled	乱七八糟的
discontented	不满意
orientalism	东方风俗习惯
annunciation	天使报喜
spirogram	呼吸描记图
groovelike	缺乏独创性
artificially	人工
demimondaine	暗娼
unobservance	不观察
commandment	戒律
dichroism	二向色性
podsolise	=podzolise
dpt	pertussis
nonrepresentational	抽象
hungary	匈牙利
earwax	耳垢
manchineel	烛台草科之草木
cheeringly	令人愉快地
savate	一种法国式拳击
flocking	植绒花纹
provenance	出处
irritative	刺激性的
antifebrile	退热
slack	不流畅的
oxytocic	阵痛促进的
worm	慢慢地走
argentous	银
nonparous	未生育过
down	沿着
erubescent	变红的
comically	诙谐地
waiting	等待的
funiculus	细绳
fascinatedly	出神地
securely	安心地
pivotal	枢轴的
rescissible	可废除
uncalculating	未经过仔细分析
retuse	浅凹形的
mandinka	=Malinke
premix	预拌和料
muzzle	动物之鼻口
missaid	missay的过去式及过去分词
saskatchewan	萨斯喀彻温省
biblical	圣经的
thunderous	象打雷
craniad	向头部
plumy	羽毛似
phonevision	电话电视
stethoscope	听诊器
unpresumptuous	谦逊
annonaceous	番荔枝科的
dole	施舍品
lubber	笨拙的
alforja	颊囊
intertribal	部族间的
advertising	广告业
chromatophil	易染色性的
mosquitocide	杀蚊药
vstol	垂直短距起落飞机
gelatinase	白明胶酶
apogeotropic	背地的
physiognomonic	=physiog/
impervious	密封的
amerasian	美亚混血儿
improved	改良的
reefer	冷藏车
rac	Royal
inchon	仁川
affect	侵袭
imperforated	未穿孔的
celt	凯尔特人
industrious	勤勉的
nbs	Bureau
expansion	扩充
swart	有害
tacmar	Radar
row	划
paranormal	超过正常范围的
kenspeckle	显著的
pragmatise	=pragmatize
gallisize	加水和糖于……
unfluctuating	不变的
demonise	=demonize
belizean	伯利兹的
deadness	死
bologna	一种大腊肠
file	锉
recruit	复原
differentiability	可辨性
sovietism	苏维埃制度
unwelcome	不受欢迎的
yavis	雅斐士
elegant	第一流
your	你们
spilikin	做游戏用的小木块
crimea	克里米亚
flaccidity	软弱
capitate	头状花序
anthropopathic	认为神具有人性的说法
prudish	过分规矩
spiritedly	有精神地
erythropsia	红视
cancerous	癌
spiculate	由针状物覆盖
intraepithelial	上皮内的
cooker	蒸为烹食所种水果
rezidentsia	=residentura
fainty	昏晕的
septenary	七年期
fall	击倒
freckly	多雀斑
poise	均衡
kemalist	基马尔式
apophysis	隆起
hemipod	=button
visuospatial	视觉空间
thingamy	某某东西
ace	Allied
mahlerian	马勒的
unformulated	未用公式表示
surgical	外科医生
administrators	管理程序/hip//
countermand	取消
thermoregulation	温度调节
backing	支持者
steepled	有尖塔
mun	蒙河
cell	单元
myosotis	勿忘我草
budgerigar	相思鹦鹉
millihenry	毫亨
vastly	巨额
spurt	冲刺
inlook	向内看
dish	盘装菜
quivery	颤抖的
bassoon	低音管
kaiserdom	皇帝的辖区
beethovenian	贝多芬音乐作品
pannikin	酒杯
x	第二十四
furunculoid	像疔疮的
discolor	使污染
athirst	渴望
abundant	富于
tournament	联赛
burning	燃烧
uncharitable	无情的
marlin	枪鱼
cabalistic	神妙的
stratigraphical	地层学的
foully	下流地
mechanotherapy	机械疗法
scallawag	无赖汉
staple	钉书钉
tumbledung	=tumblebug
matted	缠结的
partyism	党派性
yammer	哭诉
imaginable	可想象
nighttide	夜间
gunn	耿氏效应的
fleuret	花剑
armillary	手镯的
farewell	再见
manganic	得自锰的
biter	骗子
cliffhang	悬疑
toddle	蹒跚走路
splenic	脾
schizothymic	分裂样人格
vigilantly	警惕
berm	崖径
intransit	在旅途中
injective	内射的
photophoresis	光泳现象
inductile	不屈
bioacoustics	生物声学
watertight	不漏水
heathery	似石南
tartarous	酒石的
chamiso	一种蔷薇属灌木
hydrous	含水的
puff	张开
aeromechanical	航空力学
chartered	受特许
manichaeus	Mani
idiomorphism	整形
furuncle	疔疮
fwpca	Water
aliphatic	脂肪族的
polynosic	高湿模量粘胶纤维
semidetached	半离的
tribade	扮男性的女性
jockette	女骑师
unbusinesslike	不认真
impotence	无力
abet	教唆
ahull	卷帆并转舵于下风
strati	的复数形
nautilus	鹦鹉螺号
flivver	廉价小汽车
boson	玻色子
decisionmaker	决策者
overprint	印戳
tatami	榻榻米
inkyo	隐居
monoclinal	单斜
hypercorrect	矫枉过正的
apart	分开
quercitrin	栎素
rush	涌现
tapadera	革制马镫罩
uveitis	葡萄膜炎
mutually	互相
infeasible	不可实行的
fiddlefucking	该诅咒的
centrifugate	以离心力分出之物
anorectal	肛门直肠
japanolatry	亲日
travel	传播
rostellate	有蕊喙的
reciprocity	互惠
coatrack	衣帽架
proline	脯氨酸
undistracted	不分心
tremulously	畏惧
acclivitous	倾斜
phew	咂舌头
acceptance	赞同
prolonge	拖曳钩索
chafferer	愚弄者
semilanceolate	半矛尖状
receptible	能接受
menfolks	男人
spareness	瘦弱
solitarily	寂寞地
pineapple	凤梨
contraorbital	与正常轨道反向
dishing	碟形
yonnie	石头
infante	亲王
mordacious	咬痛的
moocher	敲诈者
periclean	伯里克利统治时期
enregister	记录
ascending	上升的
budding	发芽
pretzel	法国号
unharmful	无害的
inauthoritative	/
rostrate	有喙状突起
agrophilous	栖耕地的
rutherford	卢瑟福
consistent	相容
russet	黄褐色
diglossic	使用两种语言或方言的
highbinder	恶棍
artal	rotl
grok	通过神入作用而理解
telecom	telecommunication
bargeman	平底货船的船员
irretraceable	不能再找到
loving	亲爱
arillate	有假种皮的
antsy	热锅上的蚂蚁般的
motherlike	母亲似的
clag	凝结
compelling	引人注目的
unsensible	无感觉
abbreviative	缩写
to	给……
undone	破灭
costful	珍贵
foreshank	牛前腿上部的肉
glandulose	有腺的
celebret	主教或高神职人员所发可主持弥撒的证件
roughneck	无赖
dateless	虽旧仍好的
electropositive	阳电的
apocalyptician	预言大灾难降临的人
castellar	城堡的
adwoman	女广告人员
faggy	同性恋的
veneration	崇拜
tew	tactical
revelatory	启示性
pillory	颈手枷
substitution	代入法
impermissibility	不许可
anopheles	按蚊
paleogene	=Palaeogene
contignation	台
gristmill	磨粉厂
takahe	=notornis
truest	真的
guyenne	=Guienne
highbush	形成高灌木上
ectypal	复制的
frankincense	乳香
abcoulomb	S
imposturous	欺诈的
unsicker	不确实
itch	疥疮
doughtily	强
endwise	末端朝前或向上
asperifoliate	有粗糙叶子的
arbitral	仲裁
pyrocondensation	热缩
gabble	急促而不清楚地说话
olden	古昔
exit	脱离
offhandedly	即席
waxiness	柔软
nosh	吃点心
iconoscope	映像管
culpable	不周到
var	乏
roughhewn	粗凿
pitchblende	沥青油矿
paraphrasis	意译
zabrze	扎布热(旧称兴登堡
byline	标题下署名之行
ubication	位置
mobility	机动性
frg	of
sciagram	X射线照片
excitably	易兴奋
remunerative	有报酬
clarinda	克拉琳达
quandary	进退两难
poetical	理想化的
sergeant	军士
squiggly	弯弯曲曲
locker	有锁的存物柜
valour	勇猛
tetrachord	四弦琴
embed	嵌入
ate	吃
beneficially	获利地
strychnia	=strychnine
geographer	地理学者
cockish	傲慢
discolored	脱色
forepast	=forepassed
nummulary	货币的
stretch	一段路程
bonze	和尚
fiducial	基准的
geisha	歌妓
febriferous	造成发烧
rhebuck	短角羚
mepacrine	阿的平
haligonian	哈利法克斯的
xenophobia	仇外
encore	要求再演或唱
mpm	per
caulk	填……以防漏
blenheim	布伦海姆
knobbiness	疙瘩
rewake	再唤醒
conation	意动
benignantly	亲切
conformable	一致的
vanessa	Vanessa
endocytose	吞噬
cirrocumulus	卷积云
unbuttoned	无拘束的
maritime	海事的
bolt	跑掉
titivate	打扮
concessively	让步
strongyloid	圆线虫总科的
mph	per
obcompressed	倒扁形
hierachical	天使
conventioner	会议代表
brickfield	砖厂
unicameral	单院的
west	西方
vocalism	发声
incongruity	不调和的
pearlised	=pearlized
nebular	星云
veracious	真实
vicuna	小羊驼
haemoptysis	咯血
time	比赛限时
ateliosis	发育不完全
rebuttable	可辩解
expressionistic	表现主义
greenboard	绿板
setup	装备
prahu	=proa
bucaramanga	布卡拉曼加
gravitational	重力的
patentee	专利权所有人
dutiful	忠实的
lemonlike	似柠檬的
clear	清晰
apocalyptical	启示论
petty	小型的
unacknowledged	不被承认
arquebus	火绳钩枪
spaish	西班牙人
steady	扎实的
podded	有荚的
fleece	剪下羊毛
plasterwork	抹灰泥工作
hypochondrium	疑病症
jollify	使高兴
comprimario	主要配角
frugivore	食果动物
euphemistic	委婉的
poc	port
fabrication	制作
afflux	流入
calculate	考虑
arrant	极恶
usaid	Agency
dracone	弹性拖曳容器
policemen	警察
flavourful	有风趣的
wechty	=weighty
ent	ears
minify	缩小
scarification	乱割
insanity	疯狂
transferrin	铁传递蛋白
underappreciated	未受到充分赏识
democratic	民主主义
souvlaki	=shish
tribasic	三盐基的
nosogeography	地域病理学
thole	钉桨架的钉
sleighing	乘橇
orthoclastic	有彼此直交的解理面
lingy	石南很多的
autodyne	自差收音机
canonicity	合正典
arseniureted	砷化的
gorge	狼吞虎咽
stump	树桩
enceladus	恩克拉多斯
ragwheel	布抛光轮
scotometer	暗点计
quixotically	唐吉诃德式地
chylify	变成乳糜
bto	Big
sympathetically	怜悯地
archaistic	古风
supernatural	神奇
greasepaint	演员化妆用油
morphactin	形态素
hagiography	圣徒传
teleologic	目的论的
antigone	安提歌尼
lh	:
hereto	关于这个
egp	外部网关协议
hypertonia	张力亢进
antiapartheid	反种族隔离
ascesis	禁欲
biserial	双列的
rhumb	罗盘方位单位
unaired	不通风的
submarine	潜水艇
commander	司令官
graveness	重大
scurvy	卑鄙的
frigidity	寒冷
fastigiate	倾斜的
stabbed	中伤
asocial	自私
mayst	=mayest
gpi	of
consensus	舆论
dynamic	动态的
pastorage	=parsonage
admonitory	劝告
austronesia	太平洋中南部诸岛
powwow	举行仪式
monofunctional	单官能的
unpunctuated	未加标点的
voder	语音合成仪
loudly	大声
regally	象帝王地
compaction	紧束之状态
aspire	热望
hypogastrium	腹下部
delaminate	分成细层
sinfonia	序曲
recherche	异国风味的
edification	教诲
ric	Institute
bullish	看涨
handful	少数
dendrophagous	食树
autofocus	自动对光
virtue	功效
duskily	微暗
spoilsman	分肥者
final	最后
att	Co
demission	放弃
penultima	=penult
recirculation	再流通
metrist	作诗者
nbw	north
uneventfully	太平无事
langobardic	伦巴第语的
ptomaine	尸毒
stepson	继子
pyrocatechol	焦儿茶酚
belled	有钟形花
exarchate	exarch
solecistic	违反语法的
odt	of
waddy	牧童
mayonnaise	蛋黄酱
fail	不及格
okie	农夫移民
employment	工作
en	在
burliness	结实
dialogic	对话的
merman	善泳的男子
pacesetting	带头的
goshen	歌珊
lifesaver	水难救生员
drenching	湿透
precipitate	猛抛
penthrite	奔斯乃特
unhelm	除去头盔
falsettist	假嗓子歌手
honiest	honey的最高级
mayoral	市长
browsy	适宜于随便翻阅的
drummer	鼓手
reader	读物
authorless	作者不详
transformation	men/
underlining	在……下面划线
uncle	援助者
disquisitive	探讨
block	石块
uncontroverted	无可争辩
centenary	一百年
parget	粗涂灰泥
gibber	叽哩呱啦言语
portulacaceous	半枝莲的
counterweight	平衡力
engineman	操纵引擎者
insufferably	不能忍受地
ordinance	布告
envious	嫉妒的
linebred	品系繁育
seething	沸腾的
dehydrocanned	脱水装罐头
whitefish	鲑鱼的一种
imaginal	成虫
kitbag	旅行皮包
clinkstone	响石
suspenseful	令人紧张
triserial	只有三个轮生体
crowned	王室
ymha	Hebrew
gigot	羊腿
cpaffc	Chinese
unhappy	不适当
colligable	可连结成类连结的
cymoid	状似聚伞花序的
ruling	划线
surtax	附加税
incommunicative	沉默寡言的
stunner	绝妙的东西
enwreathe	围绕
naskhi	阿拉伯文草体
comisco	国际社会主义者会议委员会
terdiurnal	一日三次
pinnace	装载于舰上的中型艇
rendering	复制图
cascaron	内装碎纸的蛋壳
pople	=popple
dop	dioctyl
montepulciano	蒙蒂普尔查诺红葡萄酒
octocentenary	800周年纪念
flaunt	招摇
townee	同乡
spore	长孢子
cigs	General
enrapture	使狂喜
electrolytic	电解
coevolution	共同进化
megranate	石榴
cockshot	投棒戏
skydive	跳伞运动员在降落伞张开前做空中造型动作
footy	保管很差
determinative	决定的
centreless	无中心
enounce	宣言
pelt	投击
ease	不费力
westernmost	最西的
reign	支配
hierachical	天使的
equalitarian	平均主义的
elytra	翅鞘
frettage	炮尾环
impassable	无路可通的
graunchy	艰难
teleconference	远种电信会议
transdisciplinary	学科间
liquid	流动
riotous	狂欢
frolicsome	嬉戏
foreland	前陆
prelapsarian	人类堕落前
antitrade	反贸易风
after	后来的
villiform	绒毛状的
activated	有活性
uniform	一致
macrodontism	巨牙
lusterless	没有光彩的
unembroidered	未加修饰的
zygomere	接合粒
erstwhile	以前的
ppm	part
mortal	必死
pursy	皱起
pee	撒尿
styliform	末端尖而细长的
retrieve	找回
coxy	骄傲的
infernal	阴间的
etymological	语源的
freak	奇异
heartsick	苦恼的
speculate	做投机买卖
tcb	business
unneighbourly	不喜欢与人交往
caecal	盲肠
sticker	不屈不挠的人
resitting	再次开庭
rp	the
vasodilator	血管扩张
helminth	蠕虫
cankered	腐烂
confidently	安心
lebensspur	古生物活动痕迹
whist	无声的
oak	橡木制的
procellous	多风暴
keeping	保守
persevering	坚忍的
proud	自豪
affrontedly	被侮辱
calypso	特立尼达岛上土人所演唱之歌曲的
multivariable	=multivariate
plane	刨平
wastepaper	纸屑
limnology	湖沼生物学
bhl	Letters
publishing	出版的
motorama	汽车展览
papoose	幼儿
gangster	强盗
speechmaker	演讲人
materialization	具体化
homocentric	同心的
oecd	Economic
beribboned	有饰缎带的
surge	巨涌
refoot	换底脚
glamor	迷人的美
americanist	研究美国问题的人
footage	电影胶片
rainproof	雨衣
result	由于
punic	反复无常
roundup	摘要
disazo	双偶氮
touchstone	试金石
duplicable	可加倍
ruffed	有环状羽毛的
viraemia	病毒血症
turbinal	=turbinate
unction	津津有味
filmic	象电影
inarch	插枝
jain	耆那教
fair	市集
southwesternmost	最西南的
betimes	及时
plop	扑通声
unasked	未经要求的
coverall	无所不包的
fantasticism	怪诞
median	中线
gadhelic	=Goidelic
ladysnow	=cocain
impactful	有力
bibliographer	书目提要编著人
godliness	信仰
sociopolitical	社会政治
paly	发青的
lxxx	80
memory	记忆
omnipresent	无所不在的
garron	=garran
prestissimo	极快
blowzy	红脸的
seadog	=fogbow
skullguard	防护帽
cosurveillance	共同监督
leftward	在左侧的
dyeing	染色
pushily	粗鲁地
oni	of
mss	多光谱扫描器
vernally	春天
necessary	必然
debater	讨论家
liquidly	流畅地
decedent	死者
photocurrent	光电流
jamin	雅明折射计
leisure	空闲
contriver	筹划者
expectability	意料中
misogynic	嫌忌女人
relieved	放心
lecherous	挑动春情的
ampulla	圣瓶
heresimach	积极斗争的人
dud	失败的人或事
partite	分裂的
restorative	有助于复元
dissimulation	掩饰
liable	负有责任
expatiation	铺陈
pedicel	茎
shameless	不知羞耻
shunt	逃避
actinozoan	花形虫
waste	被浪费
voltolize	对……作无声放电处理
scolopidium	弦音器官
unessential	非本质的
polatouche	飞鼠
subsonic	次音速的
flow	飘扬
pyelograph	=pyelogram
identity	恒等式
alnico	铝镍钴合金
cheval	glass穿衣镜
ymodem	是XMODEM的扩充
wooden	木制的
rebellion	反抗
directorial	指挥的
cimex	臭虫属昆虫
melting	混合
irrigate	使潮湿
lent	lend的过去式和过去分词
record	将……录音
apparat	政治组织
vow	发誓
servite	圣母玛利亚会修士的
wayfaring	旅行
cap	盖在……顶上
incaution	不小心
masterstroke	巧妙的动作
bacteriology	细菌学
superrational	超理性的
fuck	他妈的
segment	节
enneahedral	九角
feeling	富于同情心
qcd	quantum
electropositive	盐基性
gondwanaland	冈瓦纳大陆
paisley	佩斯利螺旋花纹呢的
humanly	像人
bushfighter	丛林游击队员
paternal	父亲的
campanulaceous	风轮草属
wifehood	为妻之道
khalifate	职权及领域
quadruplicity	四重
ergatoid	具有拟工蚁特征
significant	重大
oneirology	圆梦学
zygology	接合工艺学
unreasonable	过度的
exploitability	可开发性
pallas	雅典娜
mouseproof	防鼠的
anabaena	淡水藻类的一种
ghostliness	朦胧的
caressant	宠爱的
permanganic	含最高价锰
psychon	精神粒子
tang	特殊气味
intercessory	仲裁
pivotal	枢轴
yearlong	持续一年
ordinary	平常
wakeless	熟的
unboastful	谦虚的
quadruplicity	四倍
fosterage	寄养
dnf	未完成
pinkerton	私人侦探
information	通知
anthropoid	似人类的
hexapody	六音步诗句
taxidermist	剥制师
parenteral	注射用药物
downstairs	往楼下
pinto	有花斑
ripe	熟的
metathesis	调换
bladder	膀胱
thioantimoniate	硫代锑酸盐
mats	Transport
attrited	磨损的
aerogenically	产气地
snowhole	雪坑
amontillado	雪利酒的一种
martial	军事
cast	派
overhasty	过急
concentrate	浓缩
ictus	扬音
plantigrade	脚掌着地行走的
interstrain	杂交的
irrepressible	抑制不住的
hoodle	弹珠
stalinsk	斯大林斯克
arcifinious	天然疆界
cherish	珍爱
liturgician	祭典学家
pinocle	一种纸牌游戏
katathermometer	冷却率温度表
strepitoso	吵闹的
corresponsive	相当的
benthonic	海底的
beau	求爱者
fluviatic	生长在江河中的
immorally	不道德地
lombrosianism	龙勃罗梭的犯罪学说
suggestion	提议
declamatory	演说口吻的
neurasthenia	神经衰弱症
warrior	武士
bicephalous	两头
imperscriptible	非正式的
plantation	殖民
dyslogy	非难
provoke	激怒
outlandish	偏僻
saponaceous	圆滑
encouraging	可奖励
modernbuilt	现代建筑的
imperviable	不能渗透的
hydrocellulose	水解纤维素
facemaking	作苦相
disconnected	不连贯的
beaten	打败了的
personal	人身
mitrailleuse	老式机枪
poortith	贫穷
gadgety	小玩意
flummery	假恭维
semidomesticated	`semIdEJ9mesIkeItId/
wooer	求爱者
soutane	神父的法衣
biologic	生物学的
underquote	对价格
clonic	阵挛的
infamatory	诽谤
vigesimal	以20为基数
shaft	杆状物
summable	可和的
diosmosis	渗透
commensal	共生物
voluminal	容积的
past	越过
pickpocket	扒手
history	历史
radioman	无线电技师
underhand	阴险地
lar	家神
tricel	特列赛尔
saprophyte	腐生物
flamboyantism	过份华丽的格调
manteau	披风
shortgrass	矮草
nhk	Hoso
ken	见
solderability	可焊性
roadworthy	适合道路上使用
robin	罗宾
time	/
igy	Geophysical
disprove	驳斥
massage	按摩
principial	最初的
extant	显著
orthonormal	规格化正交的
kittenish	小猫似
microgauss	百万分之一高斯
taileron	全动平尾副翼
deforestation	森林开伐
halocarbon	卤烃
contemplate	沉思
subservient	有帮助
emendable	可修订的
anonymously	化名地
overkind	过分仁慈的
declarable	应申报
podolsk	波多利斯克
gnaw	侵蚀
synallagmatic	对双方具有约束力
clew	线索
tuitionary	讲授的
beautify	美化
dentin	牙质
immature	未完全发展的
mystically	神秘地
outlandish	外国气派
coprophobic	排粪恐怖的
aqua	水剂
adiaphorous	中立
gremlin	小鬼
sbm	单浮筒系泊
breathlessly	屏息地
rarp	Address
docile	听话的
tacky	俗气的
italiot	意大利南部古希腊移民城邦的居民
xanthosis	黄肤症
gray	老练
leu	其银币
backwoods	未开垦
gentlewoman	贵妇人
gravific	使变重的
frowst	闷气
stripfilm	幻灯片
ostracoderm	甲胄鱼
rbi	Batted
furthermost	最远方
endoerythrocytic	红细胞内的
wair	=ware
jurywoman	女陪审员
proof	证据
northwestwards	向西北方
ephemeral	朝生暮死
daytime	白天
oceanic	生活于海洋的
toot	吹奏出
recidivation	复返
folly	愚蠢
whiff	使被三击出局
underrun	从……下面通过
tachygrapher	速记人
androgenesis	雄性单性生殖
hall	门厅
pintoricchio	即
poop	傻子
lippitude	烂睑缘
pop	Protocol
far	很远
paleocrystic	古结晶
sorption	吸附作用
stupefacient	麻醉的
peekaboo	躲躲猫
treasonable	叛国
heavily	很重地
picromerite	软钾镁矾
senega	美远志根
opisthion	枕骨
parti	合适的婚姻对象
unobstructed	没有障碍的
elitist	优秀人材
most	其中大多数
scarecrow	稻草人
potentiality	潜能
fellow	家伙
dishful	一碟
araneidan	蜘蛛的
indentureship	服务契约期间
unplagued	未受折磨的
backstairs	秘密的
reseat	换……的底座
irreformable	不可改造
aureate	金色的
demonstrate	论证
fumaric	反丁烯二酸
photics	光学
hangtag	使用说明标签
nocuous	有毒
spanking	强烈的
unworthiness	无价值
cloud	天空
uglily	丑陋
psro	organization
rancorous	深恨
vast	巨额
contrapuntist	对位法作曲家
substitutional	代理的
epoxidize	使环氧化
barker	剥皮机
cherry	处女膜
ferlie	令人惊奇的事物
backpedal	后退
airstrip	飞机跑道
strict	严谨
inflexible	顽固
vendible	可销售的
shoreward	面朝岸
ippf	International
kreosote	杂酚油
urinalysis	尿分析
unco	没看惯的
froglet	小蛙
sphinges	天蛾
newsheet	业务通讯
micrometer	千分尺
mass	集中的
runabout	流浪
beamingly	发光地
picotite	铬尖晶石
repulsion	厌恶
parsoness	堂区牧师的妻子
mores	习惯
cyclonic	气旋
naw	没有
cheeringly	兴高采烈地
footcloth	地毯
divinity	神
jain	耆那教徒
manganous	锰的
parabolical	比喻
coronetted	贵族的
endlong	全长地
aggregative	集合性的
lydian	吕底亚人的
silt	充塞
digressive	离题
calumnious	毁谤的
pontificate	主教的地位
rusty	铁锈色的
permeable	能透过
belgravia	中上流社会
inobservant	疏忽的
biofuel	生物燃料
diminutively	小地
uncorrupt	纯正
middlescent	中年人
interpolator	分类机
soloist	独奏者
bespread	铺盖
encore	再演唱一次!
combo	联合体
cotter	农场雇工
storekeeper	店主
galea	盔状突起物
cornerways	对角
harvest	收成
design	设计
tremolo	震音的
ne	Ne
exsanguine	无血的
anachronously	不合时代地
brushwood	矮灌木丛
hippocras	用葡萄酒及香料调制的甜酒
gftu	of
ectypal	副本的
abuzz	活泼的
menses	行经
impregnate	充满的
bastioned	具备棱堡的
slid	slide的过去式和过去分词
redeemable	可弥补的
troupe	剧团
shtick	滑稽场面
aloud	大声
ghostliness	幽灵的
improper	不适当的
quaternate	以四为一组的
fictionist	小说家
collimate	校准
pustular	有小脓疱
twelvepenny	值12便士
coagulator	凝结剂
lucidly	清透地
automatic	机械
illimitable	无边际
oligophagous	狭食性的
vignette	把……
paternalist	家长主义者
cetacean	鲸类的
lacrimal	泪腺
fabled	虚构
formulise	=formulize
duodena	duodenum
ecwa	西亚经济委员会
bunch	束
pillar	重要的支持者
epitasis	剧情向高潮发展
dignity	尊严
fastness	固定性
crud	脏家伙
director	主任
caroline	卡罗琳
advocaat	荷兰产蛋酒
rogatory	调查
erratic	漂泊无定的人
unweighted	无重负的
pa	PA
precedent	先例
fulgurous	闪光的
flexility	柔韧性
trick	哄骗
pocket	袖珍
muck	弄脏
jal	Air
sciuroid	松鼠尾巴
aeroembolism	高空病
bva	Veterinary
outside	外面
inlier	内露层
anacom	分析计算机
ssid	无线服务集标识
demilune	半月形堡垒
fleckless	无斑点的
loon	潜鸟
gynecologic	妇产科医学
felicitator	祝贺者
boondagger	进攻型女同性恋者
predictable	可预言的
malate	苹果酸盐
zedoary	片姜黄
dardan	特洛伊的
plutarchy	=plutocracy
necrotic	坏疽
rushee	准备被拉进大学生联谊会的对象
webbing	边带
honeydew	蜜露
coequality	同等
nacreous	有光彩的
hexastyle	前有六根柱子
cdgps	普通差分全球定位系统
castiron	铸铁制成
unnumbered	无数的
choirmaster	唱诗班指挥
flighty	心情浮动
alphorn	=alpenhorn
micturate	排尿
unprovided	无供给
dichromaticism	二色性
present	呈现
syndactyl	并趾的
gladiatorial	争论
absolutize	使……变成绝对的
reductivism	抽象派还原艺术
latency	潜在
vivisector	活体解剖者
unequivocable	清楚明白的
unformed	无定型的
nonalcoholic	不含酒精
drivespac	磁盘压缩工具
defluent	向下流的部分
extremely	非常
tearaway	流氓
christianize	使成基督徒
kindless	薄情的
chronometer	记时计
readout	读出
winglike	翅状
hydrophanous	浸入水中变透明的
incontrollably	不能支配地
novel	新颖的
freshen	减少咸味
satyr	半人半兽的森林之神
shakable	可震动
derned	=darned
diverticular	憩室的
runtish	矮小
message	通知
unicolour	单色的
associate	使联合
brythonic	布立吞人
aglare	耀眼的
morsel	一口
most	多数的
katie	卡蒂
fluxion	流动
clematis	铁线莲
subtopia	开发为工业区的乡村地区
sacculate	袋状
rectum	直肠
rigid	刚硬
liquid	流音
grab	夺取
retirement	引退
gap	缺口
transfusional	输血引起的
whereabouts	下落
dimorphotheca	非洲雏菊
col	Col
interspecific	中间的
march	前进
pack	包裹
competition	竞赛
umber	棕土
formulaic	公式
guardsman	近卫兵
wide	广大
imaret	小客店
anathematic	厌恶的
hecate	赫卡特
roentgenometer	X光测定器
writable	能写成文
kidnapee	肉票
tad	微量
observable	看得见
classification	分级
culm	草秆
sparkler	宝石
spurgall	靴刺伤斑
mantel	壁炉架
cryptographist	使用密码之人
went	go的过去式
nuclear	原子能的
varsity	大学代表队
corpsman	海军看护兵
reecho	回响
bestialize	使行动如禽兽一般
semicomatose	半昏迷
reasonably	适度
alternately	隔一个
outdoorsman	常在野外活动的人
cissoid	蔓叶线
puncturable	可穿刺
loose	松散地
scuta	盾板
mycelioid	菌丝体状的
hieroglyphical	象形文字
attractable	可被吸引的
cometary	彗星似的
augean	极脏
casualize	将转为临时工
actually	事实上
worthily	重要地
newmown	刚割
multicentric	多发源点的
pye	=pie
rfc	请求注解
uncontested	无异议
agorae	大广场
torsion	转矩
eulogistical	颂词
sahiwal	沙希华牛
naughty	没规矩的
cataleptic	全身僵硬症的
colourant	=colorant
coarseness	粗劣
celt	石斧或石凿
nothingness	虚无
weedkilling	除草
hockey	曲棍球
xsl	eXtensible
incursive	侵略
reversional	继承的
dipteral	四周双列柱廊式的
barren	无益的
midafternoon	下午三时左右
sociable	好交际的
indigent	穷困的
fallen	倒下的
rebel	反叛
san	存储区域网
fleshless	消瘦
sticker	滞销货
basal	构成基部
submicron	亚微型
trimetrical	斜方晶系
agrestal	农田中野生
mx	墨西哥
erotism	性爱倾向
arete	险峭的山脊
pub	酒馆
argent	银
xf	extra
warship	战船
explosive	爆炸
pc	Patrol
dimetric	四边形的
posh	漂亮的
restructure	重建构造
imaginable	可想象的
adultness	成熟
brinkman	边缘主义者
roscoe	左轮枪
amman	安曼
sundays	于每星期日
unestablished	未确立的
antiracism	反种族主义
saving	补偿的
woodcut	木版画
coloured	有色的
lapsable	易犯错
resupplies	新补给
variform	有多种形态
abranchiate	无鳃动物
counterman	拿菜给顾客的服务员
roose	自夸
irksome	令人厌恶
neutral	无确定性质
spinelle	尖晶石
galvanic	抽搐的
faitour	冒名顶替者
hilus	门
deposable	可废除
distributing	分布
parochialism	偏狭
cantonal	市区
amberoid	合成琥珀
gaulish	法国人
nosebleed	鼻出血
counterattraction	反引力
patrician	贵族的
slumland	贫民区
internship	实习医师期
peninsula	半岛
emphatic	用力
japanese	日本的
bilocular	双房
junta	团体
attribute	归结于
reproachingly	非难似地
oversee	视察
macular	有斑点
incogitable	无法猜测的
tuc	英国劳工联合会议
extraocular	眼外的
carinate	有龙骨形的
scapegrace	饭桶
stagy	做作
straightway	立即
viscerogenic	出自脏腑的
redo	重做
scenical	景色的
clocking	孵蛋
raft	乘筏
distribution	分类
polychromasia	多色性
readvance	再推进
subtenant	转借者
emanatory	放射的
subtractive	减去
cauda	尾状物
endocytosis	内吞作用
millicron	=millimicron
forward	向将来
coenzyme	辅酶
imperator	古罗马皇帝
siderography	钢板雕刻术
planetoid	小行星
unfriendly	不利地
cockily	逞能
holi	胡里节
yorks	Yorkshire
homocentric	具同一中心
corselet	盔甲
suberic	木栓
mullion	放射状框
do	做
shansi	见Shanxi
way	情形
tridactyl	有三指
himalayas	喜马拉雅山脉
record	最高纪录
flagging	委顿
polyhedral	多面体
recoverable	可重获的
outbox	待发箱
outrageous	蛮横的
moneyless	贫穷
surfeit	使沉溺于
ferocious	十分强烈
argyll	阿盖尔郡
physical	身体的
scalloping	扇形边
corrupt	腐蚀
unboastful	谦虚
expansible	能扩张的
weariful	疲乏
cramp	腹部绞痛
deliberatively	慎重审议
decagon	十角形
kk	Phonetic
pleat	褶
planetesimal	星子组成
senary	六的
congenial	性格相似的
spool	缠绕
lunokhod	无人驾驶月面自动车
converse	交谈
lacerate	割裂
naturalize	使入国籍
unridden	不受支配的
amebic	变形虫
gardant	面部正对观看者
gambir	黑儿茶
carnous	肉
lithophytic	石生植物
matriliny	母系继嗣
anoxemia	缺氧血症
foudroyant	使人眼花缭乱的
sandbank	沙丘
cognominal	同姓的
lintwhite	朱胸朱顶雀
quagmiry	多泥沼的
crystal	水晶
omnipotence	万能
unanimously	无异议
corrosible	可侵蚀的
worry	使烦恼
pliofilm	胶膜或其商标名
fray	争论
autochthonal	土地固有
japanolatry	崇日
matsuyama	松山
warily	留心
element	自然环境
convergent	收敛的
kingsun	大型专业化软件公司
grievous	令人忧伤
buchmanism	道德重整运动
hoofed	有蹄
ghosty	幽灵
ogreish	鬼似的
indies	东西印度群岛
mastocarcinoma	乳癌
unembellished	未修饰
demonetization	使通货废止使用
lamellicorn	鳃鱼
piligerous	被毛的
grutch	抱怨
condignly	应当地
suboceanic	海底的
necessitous	贫困
warmly	热烈地
pontil	铁棒
domination	支配
hymn	赞美诗
pacifist	和平主义者
magnanimous	有雅量的
hognose	切削刃磨圆的
fraternization	友善
broadbrimmed	边宽
nonprincipled	与原则无关
subtle	微妙
limnology	湖沼学
dynamoelectric	电动
compare	相比
cyclostomous	有圆口
pentoxide	五氧化物
sensuous	给人美感
verrucose	多疣肿
profanation	亵渎
corollar	类似花冠
crotch	丫叉
magdalene	妓女收容所
formal	整齐匀称
emplastic	黏性的
avowable	可承认
trigynous	具三花柱
percent	百分比
sanious	脓液
encash	兑现
clan	宗族
squirearch	地主
rectificative	整流
wristband	袖口
khaph	的变体
solutionist	解答者
goad	驱策
reconvict	重新判决
interoffice	各办公室间的
cachepot	放置花盆的装饰性托盆
tidal	潮汐
bemused	发呆
jomon	绳纹文化的
effervesce	兴奋
atingle	疼痛
pinwheel	轮转焰火
gular	外咽
capstone	顶石
salute	呜礼炮等
integrated	完整
carnelian	红玉髓
tot	加算
flocculus	谱斑
unweeting	=unwitting
lunes	精神病的发作
compulsorily	强制地
compute	计算
arbitrational	关于公断
groom	喂马
specifiable	可指明
girlish	少女
cao	Chief
yarn	纱
protomorphic	原形态的
jadish	疲倦的
usib	United
illusory	产生幻觉
encrustation	=incrustation
proficiency	精通
sophism	诡辩
forefeel	预感
supraorbital	眶上的
aleak	漏水地
admitted	被确认无疑
tomahawk	用战斧斩
osier	柳条
accepter	接受人
gantt	甘特设计的
nard	甘松香
ssbn	Strategic
ultramafic	=ultrabasic
euramerican	欧美
psalmody	赞美诗集
bumbailiff	法警
tajumulco	塔胡木耳科火山
ixionian	伊克西翁
godwards	向神
chlordiazepoxide	甲氨二氮草
crimp	诱迫他人当兵之人
vri	Regina
heartfelt	真心真意
phonic	有声的
impertinent	鲁莽的
arachnephobia	蜘蛛恐惧症
protractile	伸出的
laborage	工钱
suprafacial	同侧的
consultation	磋商
roily	搅浑的
distensile	会膨胀的
chasuble	十字褡
spectacle	眼镜
conjecturable	可猜想
diaconate	助祭之职
circulative	流通
swagger	时髦的
flinders	碎片
corroboration	确证的事实
geometrize	做成几何学图形
unreflecting	浅薄的
dilatory	不慌不忙
acumination	锐利
mutualise	=mutualize
emi	Interference
italianise	意大利化
minimus	最年轻的
inconsistent	不协调的
monotreme	单孔类动物
mugient	哞哞叫
acrogen	顶生植物
clouted	缀补的
hematozoon	血内寄生虫
paleocrystic	由古结晶冰组成
diminutive	小
hyperaggressive	高度侵略性的
cop	警官
compadre	朋友
cockscomb	鸡冠帽
meshugga	发疯似
outworker	外部工作人员
nc	Caledonia
musketeer	持步枪的士兵
creatine	肌肉素
average	平均水平
ost	Science
system	系统
lithomancy	石头占卜术
chromophoric	载色体
peavey	钩棍
short	弱的
crocky	体弱的
upbringing	教养
hubless	无轮毂
spoilbank	弃土堆
featherbrained	愚蠢
inevitable	必然的
djin	=jinn
uncannily	危险
hattery	帽店
monachal	出家的
reinvest	再投资于
caespitose	簇生的
shrinkable	会收缩
stroboscope	频闪观测仪
endwise	向前
raptured	销魂
aif	Imperial
tauromorphic	牛形的
inflammation	炎症
sermonesque	说教的
bullterrier	嚣獍
blindfold	障眼物
exaggerator	夸张者
irak	伊拉克共和国
clamant	喧嚣的
nyp	yet
rodent	咬的
renitent	僵硬的
cover	适用
arciform	弓形
indigest	不消化
crabbily	固执地
statutable	法令
farrowing	产小猪
problemist	棋题设计家
pecan	美洲山核桃
polychrome	彩饰的
yellow	黄色的
inflectional	屈折
forefather	祖宗
piper	风笛手
affreightment	租船货运
nucleocapsid	核蛋白壳
aerogramme	航空邮件
whiff	一吹
newspaperdom	报界
toper	酒徒
prehistoric	史前的
orb	球
prance	昂首阔步
earning	收入
theosophical	通晓神智学
palatable	美味的
blankbook	未登录账簿
technologically	科技地
dichromic	二色
potatotrap	嘴
tousy	临时凑合
nosebleed	鼻血
worrying	烦恼
mummy	妈妈
cirri	触毛
trippant	抬起前蹄行走
treat	视为
parley	会谈
affirmatory	肯定
dilettante	业余艺术爱好的
aggressively	攻势地
encrinite	海百合的化石
deontic	义务
implicit	暗示的
haemathermal	温血
unshroud	展示
enzygotic	同孵性
nitrous	硝石
canvasser	劝诱人
wats	Wide
splotchy	有污点
thoroughwort	贯叶泽兰
codline	船上捕鱼或作其他用途之棉或麻绳
tycoonship	巨头地位
carroty	红发
panorama	全景
wfdy	of
lochial	产褥排泄的
schuss	直线滑降
indeliberately	不是故意地
chloralism	习惯性使用三氯乙醛
adventureful	奇遇
pipy	管状的
behest	命令
wroth	激怒的
sacerdotal	僧侣的
octahedral	八面体的
prius	在前的
humoresque	幽默曲
nutso	发狂的
implicit	固有的
rouser	唤醒者
deck	装饰
calculate	计划
extramitochondrial	位于
monoacidic	一酸的
mrbm	range
datto	马来人的村长
workable	可经营的
trinity	三个一组
ponder	考虑
unwakened	未觉醒
design	计划
dowlas	粗亚麻布
monstrous	难以置信
romanist	天主教徒
fray	冲突
quartz	石英
appropriative	充当的
sudatory	促汗的
castoff	被丢弃的人
pilferer	小偷
calais	加来
understaffing	人员配备不足
dart	刺
fable	寓言
felonious	凶恶
barytron	介子
revanchism	复仇主义
dodgasted	迷惑的
liberally	不受限制地
fim	鱼翅
standpipe	竖管
stanniferous	含锡
bejesus	老天
agitator	煽动者
obsolescent	荒废的
repartee	巧妙应答之才能
soke	司法辖区
backhanded	反手拍击的
deathrate	死亡率
oncer	每周上一次教堂的人
agrestal	农田中野生的
farcically	滑稽
taiz	塔伊兹
rugged	高低不平
unordinary	不平常的
underwrote	underwrite的过去式
wonton	馄饨
bipinnate	二回羽状
supraconscious	超意识
fluke	侥幸
weeping	落泪
sara	萨拉人
dignify	增威严
deliration	神经病
deliberate	预有准备的
depressingly	郁闷
vesa	Vedio
pibroch	风笛曲
islamise	=Islamize
innative	以生具来的
sprit	斜撑帆杆
demonstrably	确然
nonfigurative	没有比喻用法的
unattained	未达到
interterritorial	领土间的
penological	刑罚学
metempirical	超经验论的
hadorwould	有
daytale	按日计酬的
freighter	货船
commensal	共生的
adumbrative	预示的
beauish	轻浮的
apropos	适当地
politicize	使具有政治性
prestigious	享有声望
dehair	拔……之毛
recondensation	凝结
chalcopyrite	黄铜矿
christian	基督教的
infuscate	被弄糊涂
unsight	不检查
larrikin	恶棍
woodskin	用树皮制造的小划子
unescorted	无人陪同
businesslike	有条理
godown	仓库
misspent	misspend的过去式及过去分词
eudiometric	量气管的
carcinomatosis	癌扩散
nitrogen	氮
dittograph	重复的词
hoverferry	气垫渡船
wae	Wireless
catatonic	紧张性精神症的
oestrous	诱发发情
chipper	爽朗的
confrere	同行
septicemic	败血病
scimitar	弯刀
nitty	笨
semilanceolate	半矛尖形的
prosify	写散文
gunslinging	带枪的
raincoat	雨衣
antilyssic	预防狂犬病
eburnation	骨质象牙化
badass	到处惹是生非
unequal	不胜任
oss	open
enrich	装饰
sonorific	产生声音
nonessential	不重要的人
myotropic	侵袭肌肉
buffalofish	牛鱼
insufflate	吹入
advance	预先
electrometry	量电法
cv	计算机视觉
entire	整个
epidermoid	表皮状的
poltroon	胆小鬼
ethical	民族特有的
guide	领路人
pathbreaking	开路先锋
prompter	敦促者
leachability	可滤去
cast	演员表
dah	长划
restoration	归还
momently	时时刻刻
ochrea	=ocrea
theatergoing	看戏
larkishly	嬉戏
gangly	身材瘦长的
screen	筛
thermophile'	NULL)
untearable	扯不破的
preemption	优先购买
stocky	矮壮的
quaintly	离奇有趣
shading	遮蔽
fragmental	破片的
cooker	炊具
shockingly	非常地
federalism	联邦政治
chief	首席的
trucker	卡车司机
taa	技术援助管理处
nudism	裸体主义
reverent	虔诚的
logic	逻辑
divisional	分区
corrasive	侵蚀的
queasiness	恶心
phytography	植物分类学
multiflash	使用多个闪光灯拍摄的
gray	灰暗
uncalculated	一时冲动而造成
jovial	快活
hairiness	有毛
chagrin	懊恼
hwan	圆
cytopathogenic	致细胞病变的
cypriote	塞浦路斯岛之希腊方言
magnanimous	宽宏大量
ungalled	未擦伤的
refractional	折射
ambrosial	芬香的
shock	乱蓬的头发
equivoque	双关语
subventionize	资助
finland	芬兰
moschate	有麝香气味的
unstained	清白的
bedlamite	疯狂的
hairdye	染毛剂
bunkum	博取欢心的演说
fricative	摩擦产生的
col	关隘
dextrous	巧妙
fertility	生产力
phosphatidylethanolamine	磷脂酰乙醇胺
overlord	霸王
frothy	起泡
uc	ubiquitous
imprint	留下烙印
subadolescent	=preadolescent
solfege	视唱练习
rehearse	背诵
conchiferous	有贝壳的
deperm	减少磁性
ancillary	副
piezometer	压力计
subsidise	消退
eurocurrency	欧洲货币
botanize	采集植物
pyemia	脓血症
finality	定局
gobble	狼吞虎咽
momently	时时刻刻地
file	文件夹
leptosomatic	细长型
emigrator	移居外国的人
xl	large
imparipinnate	奇数羽状的
chypre	西普香水
wholescale	不加区别
slotware	槽件
softish	有点软的
blare	奏鸣
sheading	马恩岛的行政区
fuze	引信
cephalic	头
spectacle	展览物
prance	欢跃
transitoriness	暂时
internationally	国际性
crushing	决定性的
solutionist	解谜专家
unsalable	滞销的
roseate	乐观的
publication	出版物
pun	用双关语
picescent	黑色
peltate	盾状
polychrome	多彩艺术品
tassie	=tass
slp	Party
loth	憎恶
novate	契约的代替
monstrous	荒谬
fame	使有名望
dismiss	解散
orange	橙
fermentative	有发酵力的
simulative	假装
cow	威吓
safedeposit	安全保管的
familism	家庭主义
folksy	有民间风味
priapism	阴茎持续勃起症
cheltenham	切尔滕纳姆
acknowledge	答谢
stott	=stot
identifiableness	可认明
platinous	亚铂
cuckoopint	斑叶阿若母
chasmogamy	开花受精
pharyngitis	咽炎
underslung	重心低
psychoenergetic	`psaIkEJ9enE`VetIk/
slaver	奴隶贩卖船
afterschool	供课外活动用
ferromolybdenum	钼钢
alleviation	缓和
corporeity	形体之存在
weatherboarding	护墙板
politely	斯文地
tideway	潮流
idle	空闲
aerostatic	空气静力学
histographically	组织论地
c	/
refinement	文雅
chronicler	年代记编者
desiderate	希求
broadbrimmed	边宽的
unctuously	油腔滑调地
swish	时髦
decree	教令
diadem	王冠
chimera	狂想
uterine	子宫的
lectrice	受雇大声朗读的妇女
hemagogue	通经药
seismic	地震的
rape	葡萄渣
hypospray	无针注射器
msls	Master
gamecock	勇敢有生气的人
doughty	强的
aurantiaceous	似橘柑
granitic	花岗石的
fearmonger	散布恐惧心理者
sufferable	可容忍
poultice	敷膏状药于
insole	鞋内底
triphthong	三重元音
cowitch	=cowhage
embog	使不能动弹
sextant	六分仪
combination	化合
indistributable	不可分配的
usefulness	有效性
saxicolous	岩生的
boughten	买来
tridentate	有三齿的
obviate	回避
subsynchronous	亚同步的
figuration	外形
koodoo	纰角鹿
lipping	唇形变
agrometeorological	农业气候的
laa	light
fastidious	苛求的
numerously	无数
philosophy	哲学
twigged	有嫩枝的
prejudicious	不利
monocrystal	单晶
flunkey	谄媚者
pervert	反常
shat	的过去式或过去分词
thanatophoric	导致死亡的侏儒症
superimpose	双重
transilient	骤变的
compartmental	区划
solicitudinous	挂念的
decretal	法令
parvus	小的
headstrong	不听命令的
mythologise	=mythologize
azo	含氮
furuncle	疖
lipsticky	搽满口红
depletory	放血
unheroical	胆怯的
unweakened	未削弱的
unprompted	自发
hsaa	Award
tripy	=tripey
future	未来
around	四处
moot	大会
incarnate	使具体化
crusher	打击
pyonephritis	脓性肾炎
assessable	可征收的
aneroid	无液
unsurveyed	未测量过
immolator	供奉牲礼的人
hexad	六价原子
amrita	长生不老的仙露
uproot	连根拔起
toric	环形圆纹曲面的
hyperostotic	骨肥厚的
accessibility	可到达的
multifactor	多因子
kickback	酬金
aurantiaceous	似橘柑的
perjured	犯伪证罪的
intersection	交集
scalp	剥头皮
sympatric	同域
lightweight	轻量级选手
flourish	茂盛
clement	和蔼
sofar	水底测音装置
intersected	分割
stream	流
ulva	石莼
trinitarianism	三位一体之教理
lashing	鞭打
ethan	伊桑
broider	刺绣
venospasm	静脉痉挛
decompress	减压
nannyish	一本正经的
parturition	生产
stream	溪
milord	老爷
sonobuoy	声纳浮标
hemagglutination	使红血球`neIFEn/
unreversed	未撤销
ser	液量的单位
cumbrous	累赘的
postnasal	后鼻
taaffeite	铍镁晶石
exclamatory	惊叹的
tetrapolis	四城镇城邦
heterozygous	杂合
charmless	无吸引力
turgescence	夸张
lousy	污秽的
pittance	少量
herpetic	疱疹
depauperize	使免于贫困
flanger	排雪板
shaky	震动
saltish	微咸的
acetum	醋
cose	聊天
outstep	超过
xenocentric	喜爱外国之文化的
epochmaking	划时代
millionaire	百万富翁
humorous	想入非非的
cephaloid	形状像头的花
rhythmical	节奏
hoariness	灰白
rontgen	X光的光量单位
antechoir	教堂唱诗班座席入口处
otaru	小樽
rink	溜冰
shellless	无硬壳的
electroacoustic	电声裞s/I9lektrEJE`kUstIk/
isapi	Application
infinite	无数
bioinstrumentation	生物仪器
resinoid	象树脂
wgmc	WGmc
polarization	两极化
hedge	用树篱围住
pergola	凉棚
roose	称赞
lessen	减少
glycolipid	醣脂类
fenitrothion	杀螟硫磷
stub	用突了的笔
nobody	没有任何人
service	仪式
sourdough	拓荒者
universalize	使一般化
prospectus	内容说明书
unhinge	拉开
drillion	无限大数目
extravehicular	/
psia	per
confoundedly	十分
epicyclic	本轮的
correlate	使相互关联
flextime	弹性上班制
balsas	巴尔萨斯河
interzonal	地区间的
punishable	该罚的
spellbound	出神
regeneratress	女改革者
motoscafo	汽艇
finfish	=finback
postharvest	收割期后的
javan	爪哇人
anathematize	诅咒
verve	活力
millionfold	百万倍的
punctuation	标点符号
windless	无风的
smorgasbord	瑞典式自助餐
eyespot	眼状斑纹
impious	不虔诚的
libelous	用言语中伤他人
sapphiric	像蓝宝石的
subchloride	碱式氯化物
seasoned	老练的
banlieue	郊区
elide	取消
canonically	照宗规
inaugural	就职演说
sunlike	辉煌的
goldfield	金矿区
sperm	精液
symmetric	均衡的
glaciation	冰河作用
radiograph	拍射线照片
haubergeon	中世纪的无袖衣
larghettos	稍宽广
soporific	想睡的
antisexist	反对歧视女性
travelling	旅行
nur	of
symmetrophobia	反对称
valletta	瓦莱塔
arrantly	声名狼籍
flank	守侧面
polygamy	一夫多妻
pluuiose	雨量多的
remedy	治疗
penetrable	可穿透的
inby	朝内
frailty	意志薄弱
marquee	华盖
avp	Antivirus
megamachine	巨大机器
mortarman	迫击炮手
frse	Fellow
whomever	pro
mosquito	蚊子
lightly	轻松地
appendiculate	横节状
still	更
front	态度
cardiac	心脏的
kit	工具箱
motorcoach	=motorbus
hydrographic	与水道测量有关
chicano	奇卡诺人
moulmein	毛淡棉
mace	肉豆蔻树
wipo	World
intersensory	多感官的
unsmart	不洒脱的
camisard	十八世纪初反叛法王路易十四的法国新教徒
ile	表示"能"
expend	支出
kickoff	开始
factionary	派别成员
basement	墙脚
excision	删除
trinitarian	三位一体
covered	隐蔽着的
submission	屈服
heptahydrated	七水混合物的
extended	长期
editioprinceps	初版
parfocal	等焦面
defer	使推迟
stickjaw	粘牙的糖果
plantsman	苗圃工作者
thalassic	海湾
secularism	凡俗之心
