trail	没精打采地走
cemental	白垩质
coexecutrix	共同执行人
degradand	被贬黜者
sabbatism	守安息
conciliationism	调和主义者//调和主义
supremacy	至高
termitarium	白蚁窝
coziness	安逸
suberect	接近垂直
warp	弯曲
polemology	战争学
cranic	脑的
preconception	预想
triumvirate	三头统治
accelerograph	油门
kolkhoznik	集体农庄庄员
argus	阿耳弋斯
lithesome	轻快
govern	管理
ferric	铁
alertness	机敏
avian	鸟类
kinetophonograph	有声电影摄影机
nidify	筑巢
tale	传说
sunshine	阳光
quaint	奇怪的
hypermetrical	音节过多的
diseconomy	不经济
les	Lesbian女子们
validity	有效性
augmentative	有增加力
autobiographic	自传体
hinterland	内
awhirl	旋转
exalbuminous	无胚乳
pharmacopoeia	一批备用药品
pilgrimize	使成为漫游者
distasteful	不愉快
ketogenic	能转化为酮的
eerie	不安
broadmoor	布罗德莫精神病院
aerostatic	航空
minus	负数
magnetostatics	静磁学
pest	有害物
current	通用的
acanthoid	棘状的
primer	初级读本
derepressor	去阻遏物
strome	=stroam
baitandswitch	"上钩调包"诱售法
ahoy	喂
rotta	=rote
beseechingly	恳求地
rhebok	短角羚
rarely	罕有地
metalled	碎石铺面的
antimonarchic	反君主政体
flick	飘扬
overwhelm	制服
whacking	惊人的
acidulous	多少带酸味的
disaccordit	对……不再信任
kafue	喀辅埃河
lithophyl	含有叶子化石的石块
lifelong	毕生的
logroll	滚木材
bucephalus	亚历山大王的战马
earbender	非听不可之人
dolorimetry	痛觉强度测量法
nuke	以核武器摧毁
repulsion	反驳
inobservant	不注意的
generous	慷慨
acting	演戏的
underdress	穿着过分朴素的衣服
swoop	突然袭击
unrestraint	无拘束
accusable	可指控
undivorced	未离婚
marital	婚姻
coat	涂上
hassle	激战
weekend	周末
costly	贵重的
imperceptible	感觉不到的
expiration	满期
dementation	发狂
denitrify	除去氮素
graven	不可磨灭的
chymotrypsinogen	胰凝乳蛋白酶原
bisync	双同步
quickness	迅速
mortuary	死亡的
yearningly	思慕地
gallantly	勇敢地
cybersex	计算机空间的""性""
insolate	曝晒
lesson	功课
fidget	玩弄
strafford	Wentworth
while	直到
extraviolet	紫外线的
photocathode	光电阴极
arrester	制动器
drawplate	拉模板
flavorous	有滋味的
bedazzle	使困惑
patrilinear	=patrilineal
neighbouring	附近
impiously	不信神
homocercy	正尾
balky	倔强
creepy	匍匐的
detinue	非法占有
ahermatype	不造礁珊瑚
hungerly	面有饥色
abjectly	悲惨
ilka	各自
dainty	挑剔
past	结束
tachinid	寄蝇
untalented	不聪明的
tired	疲倦的
grisliness	令人毛骨不悚然的可怕
regardlessly	不受注意
abolition	废除
crossbelt	两条交叉的皮带
stuff	填充
tribalism	部落的特征
jap	日本人
undefended	无防备的
hopefully	有希望地
apterous	无翼的
autopsy	尸体解剖
spree	狂饮
server	服务器
honorable	可敬
unredeemable	不能收回的
vyborg	维堡
fizzle	微弱地结束
refuse	垃圾
markman	=marksman
waxbill	梅花雀
dishonor	拒付
sheridan	谢里丹
piper	吹笛者
deep	深奥
benzomorphan	镇痛药
asexually	无性地
scienter	故意
panthalassa	泛大洋
curling	卷缩
stratocumulus	层积云
subseptate	稍具隔膜
coppery	铜一样
mayhap	希望
immorally	品行不良地
gonial	angle下颌角
brassily	黄铜地
jet	喷射
entelechy	圆极
speedometer	里程计
nevoid	=naevoid
paisleyite	佩斯利主义者
econometrical	计量经济学的
confab	confabulation
pacchionian	bodies
lighterage	驳运费
punctulate	有凹陷
brokerage	回扣
hammy	闹剧
advertizement	=advertisement
containerization	货柜运输
methenamine	六亚甲基四胺
borrowed	虚构的
waxy	苍白
endearing	令人钟爱
webfoot	蹼足
transducer	传感器
armature	电枢爪
eradicate	根除
trichomonacide	杀
snr	年长者
classy	优等的
statistic	统计的
outplay	击败
disfurnish	使无家具或用具
premises	前提
catchy	易使人上当的
buna	丁纳橡胶
offhand	无准备的
decimal	十进的
eidoptometry	视力测定法
embranchment	分支
visualization	使看得见
pioneer	先锋
nobeing	不存在
sensate	可感觉
hitchy	急跳
licorice	由欧亚甘草根熬成的精
foreboding	预感
raja	王侯
waterway	排水沟
gazer	凝视者
hinoki	日本扁柏
kafir	=kaffir
arcover	飞弧
contradictory	反对的
pennatula	=sea
independent	不受约束的
editing	编辑
porket	小猪
ndr	网络数据表示形式
try	审问
allowance	津贴
afips	美国信息处理学会联合会
floral	花
harshly	苛刻
larine	象鸥
attending	主治的
titrimetric	滴定
stardust	幻觉
altogether	完全
subterposition	在下面的位置
ties	结
sultrily	粗暴
andron	古罗马两圆柱中走道
fissureless	无裂缝的
kcb	Knight
webernish	有点像韦伯恩音乐的
piosity	过分虔诚
shoes	鞋子
conceptive	构思
valvulotomy	瓣膜切开术
whoremaster	=whoremonger
minitank	小型坦克
caseworker	社会工作者
fluidextract	流浸膏剂
amerceable	可罚款的
griffin	狮身鹫首的怪兽
bat	Basic
fifth	第五
undercharge	索价低于常价
amoral	与道德无关
benzocaine	对氨基苯酸乙酯
mouthiness	说大话
spurious	欺骗
isodynamic	等磁力
bacteria	细菌
trivially	琐细地
venezuela	委内瑞拉
feretory	棺架
kuwaiti	科威特人
rurban	靠近都市之农村
overstrain	过度紧张
intramarginal	页边内的
clag	阻碍
eldest	年事最高的
pyrometamorphism	高热变质
spelunker	业余性质的洞窟探勘者
oxalidaceous	酢浆草科的
corps	兵队
haemic	血性的
leafage	树饰
reparative	修缮的
photology	光学
extravasation	熔岩外喷
beckoningly	引诱人地
dirtiness	肮脏
sketchily	大略
founder	创始人
lyrate	竖琴状的
obumbrant	悬垂的
vocabular	词汇的
torsel	=tassel
pelletize	使成团
fine	细微地
uncovered	未保险的
charge	充气
laziness	怠惰
trailside	在小路边
offwhite	米色
demonetization	使货币废止通用
apricot	杏
periventricular	室周
adsum	到
condemned	被宣告有罪的
chartreuse	查特酒
unisist	联合国政府间科技情报系统
monstrous	巨大的
southland	南国
deverbal	=deverbative
freshness	气味清新地
campagna	平原
rapper	敲门者
bifilar	双线的
underline	强调
phoenicia	腓尼基
ankara	安卡拉
verifiable	能证实
psychotherapy	心理疗法
nonparous	未生育过的
whence	根源
wandering	离题
unspiritual	非灵魂的
fixative	定色
unpitying	无恻隐之心的
harmonious	和谐的
papistic	天主教的
swish	嗖嗖声
hoarding	临时围墙
malodor	恶臭
shebang	全部家当
antisepticize	防腐
maui	毛伊岛
potty	琐碎的
softheaded	傻
acrimoniously	尖刻
transpersonal	超过人
stunt	妨碍……生长
stalemate	成为僵局
coach	教练
patagonia	巴塔哥尼亚
mechanical	机械制
rationale	基本原理
primitive	远古的
flattering	讨人欢喜
blacktailed	deer
mithraic	密特拉神
wrecker	肇事者
chield	小伙子
journalese	新闻文体
mwa	of
sap	坑道
valkyr	瓦尔基里
dm	数据管理
alms	施舍
smartness	机灵
medullary	髓质
photokinesis	趋光性
predacity	捕食性
tired	累
squillagee	=squeegee
casaba	甜瓜的一种
idealistic	唯心论
uninjurious	无害
bedeck	使美丽
unwary	粗心
unexpectable	无法预料
tell	作证
inquilinous	寄居动物的
shorefront	沿岸陆地
chilly	寒冷的
sloyd	瑞典式的手工艺教育
evident	明显
torchy	感伤恋歌式
samos	卫星反导弹观测系统
sourdine	弱音器
thumbnail	极小的
acierate	化铁为钢
aylmer	艾尔默
agrology	实用土壤学
alsatian	阿尔萨斯人的
blackhearted	恶毒
crisscross	交叉往来
feigned	假
radiocolloid	放射胶体
hooch	私酒
disprovable	可证明为误的
freebee	免费赠品
expellant	驱逐
organa	organon和organum的复数
stoutness	刚毅
corking	非常
marcescent	雕存的
deplumate	除去羽毛的
therewith	随其
lather	肥皂泡
glyph	字的轮廓
calcaneal	脚后跟的
craniopharyngioma	颅咽管瘤
calque	仿造
bloke	笨蛋
alburnum	边材
undependable	靠不住的
ichthyomorphic	鱼状的
verily	肯定
arcover	电弧放电
natural	关于自然界
borzoi	俄国狼狗
ludicrously	可笑地
fold	抱住
inarticulately	口齿不清
osf	Order
guitarist	吉他弹奏者
loutish	粗野
propagandistic	宣传家的
worrying	令人担心的
uremia	尿毒症
resend	再寄
shakable	可动摇
reserved	包租
ironhanded	严厉
rectilineal	哥特式建筑的
mazaedium	粉状物
holarctic	全北区的
scourer	洗刷物品
beady	饰有珠子
benefice	有俸圣职
noctambulation	梦行症
graham	全麦
humerus	肱部
swat	Warfare
sememe	义素
soberize	使严肃
passionflower	西番莲科
ovarian	卵巢
worms	计算机网络"蠕虫"
cyathiform	杯状的
patella	膝盖骨
dextrorsely	右旋
nomenclatorial	术语
cartesianism	笛卡儿思想
puffingly	气喘吁吁地
elopement	潜逃
sackless	麻木
dissuasive	劝戒的
froe	劈板斧
radius	辐射光线
winchman	卷扬机操纵工
weakly	软弱
monteith	凹口碗边大银碗
arthroplasty	关节造形术
equivalent	相当
spatterware	杂色釉陶
sao	At
pyogenic	生脓的
earlobe	耳垂
homoeopath	顺势疗法医师
cephalated	有头的
gentile	异教徒的
uniflow	单向流动
maternal	母亲
hypnotically	催眠
flamboyancy	火焰状
garnet	石榴石
cloudless	无云
chico	藜科灌木
diminish	变小
armory	纹章学
infix	让……插进
pump	抽水机
falderal	愚蠢的想法
anthropopathic	拟人
potstone	粗皂石
creviced	有裂缝的
battlewagon	战舰
heady	猛烈
recomfort	鼓励
cernet	Research
kashmirian	克什米尔的
wri	insurance
brash	无礼
fusain	炭笔画
gem	珍宝
telstar	通讯卫星
boffo	风行一时
tablet	牌匾
dinosaurian	恐龙
browsy	浏览性质的
guyana	圭亚那
orient	东方的
unshapely	不匀称
autarchic	专制国家的
tall	长的
swith	立刻
saxicolous	生于岩石上
thwack	重击
pillowy	枕头般的
brize	牛虻
peart	聪明
phalanx	方阵
beuthen	=Bytom
sandrock	沙岩
propagandism	传道
hateful	讨厌的
fac	空军前进引导员
adenoidal	腺状
crump	爆炸
lactate	乳酸盐
fretful	起波纹
scribble	潦草的写法
technetronic	电子技术所支配
trigonometer	三角计
left	左侧的
participial	分词
copious	广识
sustentaculum	支持物
mousse	一种多泡沫含奶油的甜点
revisability	可订正
cassab	亚洲籍商船水手
postliterate	文字后的
cathartic	导泻
zuni	祖尼人
genuflexion	曲膝
clinicopathologic	罰E`lCdVIk/
chereme	语素
bonza	=bonzer
fhwa	Administration
retire	引退
brainwash	洗脑
segment	片断
animated	愉快的
lean	歉收
harvesttime	收割期
diageotropism	横生
plan	计划
spray	飞沫
unbeknown	不为人知
waiting	等待
bazar	市场
outrageous	残暴
precedence	居先
solidungulate	马科的
drouth	长期缺乏
anthea	安西娅
catalogic	目录的
coprophilia	粪便嗜好症
adenoidal	腺状肿
edmonton	埃德蒙顿
gular	喉部
constriction	收缩
french	法国人
rodent	嚼
steak	肉片
demission	辞职
overhead	在头顶上
vein	象脉络般分布于
trangam	小装饰品
rhizophoraceous	红树科
hetaerism	群婚
louis	路易斯
zoography	动物志学
somnambulary	梦游者的
childmind	照看孩子
hyperboloidal	北极
gular	喉部的
moistureless	干燥
glidingly	滑顺
varvel	奇异之景
cableship	海底电缆敷设船
spinally	在脊骨方面
monocarboxylic	一元羧
gilbertian	吉柏特派
medium	媒介
lanthanide	58至81
rumination	沉思
confirm	确定
spiny	剌状的
zoologic	动物学的
cogged	作弊
undeveloped	不发达
seminal	种子
pesky	极端
overmodest	过分羞怯的
level	拉平
shaven	刮过脸
machinable	可加工
doubtfully	含糊
remigration	再迁移
unmotherly	不慈爱
imperceptivity	无知觉能力
seaweed	海草
andiron	壁炉
brachyuran	蟹
hairstreak	灰蝶科
schoolmate	同窗
waterloo	惨败
infidel	不信宗教的
waxy	蜡色的
sustentaculum	支柱
glaring	耀眼
queen	女王
novelle	短篇故事
inositol	纤维醇
imperceptible	觉察不到
viscerocranium	面颅
devotedly	一心一意地
heathery	似石南的
uncovered	未保险
smd	圣乐博士
electrocoagulation	电凝法
ceremony	礼节
be	在
lavendery	芳香的
plump	沉重
flapjack	烤饼
enneahedral	九面
oath	诅咒
nunchaku	索连棍
equalarea	等面积的
seel	使盲目
bacchantic	狂饮作乐的
gene	Gene
sybase	美国赛贝斯公司
monomaniacal	偏执狂的
scarecrow	衣衫褴褛的人
jackaroo	新手
tentative	尝试
nursing	养育
prongy	叉状的
love	热爱
untogether	乱七八糟的
tinea	癣
christhood	基督的地位
liquid	明亮的
opus	作品
dene	沙丘
baltic	波罗的语的
sneery	嗤笑的
hypermetamorphic	变态过度
wallpiece	舷炮
mirky	黑暗
crookedly	弯曲地
maroon	栗色
obstupefy	使愚钝
vug	晶簇
madid	湿润的
hornless	无号角的
everywhither	至各处
frankness	坦白
irdp	Router
pyrocrystalline	火成晶质
disaffection	不满
screech	尖声喊叫
proof	证明用
professional	职业运动员
bag	猎获物
intelligentsia	知识分子
liveried	穿制服
saltchuck	海洋
haunted	受到折磨的
fondly	天真地
esthetical	美的
antagonise	使反抗
scutella	角质鳞片
puritan	清教徒的
crenelet	小枪眼
raffish	艳俗的
slopewash	坡积物
clift	绝壁
uddi	and
polder	开拓
presentational	直觉
nightwalker	夜行症患者
evolution	演变
elongate	伸长的
perfect	熟练的
deadwood	枯枝
cognate	同类
cins	需监管的孩子
deck	甲板
bft	File
dowel	木钉
personal	身体的
indivisibility	除不尽
convenable	可召唤的
fibrovascular	维管的
papule	丘疹
wfp	Program世界粮食计划署
villeggiatura	乡居
festoon	使成为花彩形
declaim	演讲
crank	转动曲柄
textured	织地粗糙的
steep	悬崖
deficient	缺乏
inappropriate	不适当的
seed	子孙
inoculate	接种
edging	流苏
kilowatt	千瓦
jbs	Society约翰·伯奇协会
imminent	即将来临
foresighted	能预料的
achates	忠实的朋友
incommensurability	不能通约
repulse	憎恶
ansate	有柄状部分的
unreported	未报告的
entrance	门口
jet	黑玉
forbidden	forbid的过去分词
habitably	适于居住地
endotherm	恒温动物
unassimilable	不能消化的
juvenescent	变年轻的
token	象征
ectomorphic	外胚层体型
libertine	浪子
aesthetical	=aesthetic
nidamental	缠卵
condonable	宽恕
vertical	直立的
feuilleton	报纸下面的专栏
greengage	青梅
adventureful	富于惊险事件的
subsist	存在
antiremonstrant	反对抗议者
sweetly	甜地
quixotically	唐吉诃德式
sternutative	催嚏剂
ephemeral	短命的
bam	迷惑
enactment	设定
bale	大包
baronship	男爵之地位
plating	电镀
waltz	前进
hypobranchial	鳃下的
pithless	无力的
paleornithology	古鸟类学
avulsion	扯离的部分
chert	黑硅石
optical	视力的
depressing	沉闷
splitsaw	粗齿锯
balmy	温和
transmethylation	转甲基作用
repentance	悔改
recopy	再抄写
inflammatory	煽动性的
fishable	可钓鱼
vegan	严格的素食主义者
rubbly	碎石构成
cluj	克鲁日
gladdest	的最高级
singularly	不常见地
deposition	废王位
exceptant	例外的
sandbag	堆沙袋
reform	感化
lumping	很多
aluminography	铝版术
keyswitch	键形开关
disfavour	失宠
thickening	使变厚
roseal	玫瑰色的
shock	休克
mendelism	孟德尔遗传学说
mildness	温暖
gerontophil	嗜耄癖
corolline	似花冠
width	宽/高比
decorous	有礼貌
sternforemost	船尾向前
tsarist	主张独裁政治者
outwardly	外观上
tahsildar	收税人
naderite	主张保护消费者利益者
place	地方
omoplate	肩胛骨
trihydroxy	三羟
linguistic	语言学上的
paramnesia	记忆错误
charlatanry	吹牛
intrusive	打扰的
entablature	柱上楣构
lcp	Control
sheba	~
astir	骚动的
orthorhombic	正交
exhilarative	令人兴奋
marlin	四鳃旗鱼
factionalize	使分裂成对立的派系
gena	颊
klik	=klick
wicket	便门
puzzlehead	头脑不清楚的人
quincy	昆西
spherometer	球径计
acclivitous	上斜
conservancy	保护
algoid	海藻般
hypothetically	假设
boding	凶兆
plenteous	充足
hexachloroethanc	六氯乙烷
nonvector	非传病媒介
eximious	超凡
synchroneity	=synchronism
wobble	不稳定
msls	图书馆学理科硕士
schedular	时间表的
depolymerize	解聚
alms	救济物
galliwasp	数种长蜥蜴
jun	六月
muzhik	农夫
wet	多雨的
tonoscope	音高镜
clem	使饥饿
unvouched	未被证实的
reusage	再使用
peer	窥视
maternalize	使充满母性
saxtuba	低音萨克斯管
corruptible	易腐败
tarsal	眼睑软骨
swanky	漂亮
nonsensical	无意义的
tenant	房客
deteriorate	恶化
evidence	明白
verecund	谦卑
unseaworthy	不适于航海的
nuts	胡说
patient	忍耐
score	记分
souse	腌制食品用的盐水
hematology	血液学
spoiler	抢夺者
unga	Assembly
riflery	步枪射击
abcoulomb	G
general	普通
sootlike	似煤炱
infrequent	罕见的
element	要素
lionly	狮子似的
woody	多树木的
galenic	古希腊名医伽林的
insomuch	由于
bromelin	菠萝蛋白酶
parallelism	平行
gradation	顺序
fabricate	伪造
submillimetre	小于1毫米的
testily	易怒地
hydroxylase	羟化酶
intrazonal	隐域性
reenlistment	再从军
diapedetic	血球渗出的
humourous	滑稽
archangelic	天使长的
nuclear	核子的
hum	嗡嗡叫
practicing	在工作的
mycophilic	食蘑菇
scarlet	鲜红色布
meek	驯服的
monticulate	有小丘陵
cuprous	亚铜的
forcipate	钳状的
interruption	中断
kamerad	朋友
propriety	适当
tipsily	喝酒
savable	可储蓄
flagelliform	鞭状
stop	填塞
methodical	有方法
feature	是……的特色
horunspatio	unius
packager	包装者
unlike	不象……
every	全部
usmcr	United
lateritic	含有红土的
key	插上栓
harper	竖琴师
acknowiedged	得到普遍承认的
gatekeeper	看门人
bromidic	陈腐
offside	越位
autobus	巴士
unveil	显露
monogamous	单配
vengeance	报仇
splendidly	华丽地
gyral	回旋
shaky	动摇的
pour	倾盆大雨
petechia	瘀点
corkwood	软木斛
glamourpuss	迷人的人
nailery	制钉工厂
ope	开放
deflect	偏转
controllable	可控制
borage	尤指琉璃苣
desmolysis	碳链分解作用
technocrat	技术统治论者
tromp	跺脚
nonuple	九倍
dona	夫人
quarterdecker	海军官员
diquat	杀草快
deadlatch	弹簧锁
ivorian	象牙海岸
emphatic	断然
turnabout	转变
deface	损伤外观
sopite	使入睡
racially	按人种
diagnostics	诊断学
arroyo	干枯的河床
squama	鳞
lax	泻肚
calligraphic	缮写
uncivil	粗野
interfusion	混入
softy	傻子
sponsor	赞助
delawarean	特拉华州人
compound	配合
ecarte	纸牌的一种玩法
biltong	干肉
lousiness	卑鄙
whetter	磨刀人
bab	巴巴拉的昵称
inequilateral	不等边的
reductive	减少
seeing	视觉
polariscope	偏光器
ultrared	红外
masturbatory	自淫的
unimpressionable	无情
immunosuppress	9ImjJnEJsE`pion/9ImjJnEJsE`pive/9ImjJnEJsE`por//
toiler	辛苦工作的人
interminably	冗长
strappado	吊刑
cock	公鸡
down	下去
grown	成年的
toltec	托尔特克人文化的
enisei	=Yenisei
fly	使飘扬
toadstool	伞菌
to	直到……为止
dichlorodifluoromethane	二氯二氟甲烷
softheaded	傻的
truckle	讨好
fortran	FORTRAN语言
strung	string的过去式和过去分词
rehearse	预演
accusatorial	控告者的
farthest	far
unsmart	不聪明
dimorphism	同种二形
circean	使人着迷
hereditarian	遗传论者
mental	精神的
referend	=referent
resolutely	毅然地
ahf	factor抗血友病因子
amphictyon	近邻各邦联盟
scot	苏格兰人
grassplot	庭园青草
finegrained	有细密纹理的
newmarket	纽马克特
antiscience	反对科学
mettlesome	勇敢的
perchlorinate	使全氯化
dallis	grass
decline	斜坡
saltimbanque	江湖医生
tragopan	角雉
nwa	Northwest
conversable	健谈的
shady	多荫的
cachou	驱口臭片
vicissitudinous	变迁
footwork	要跑腿的工作
circumpolar	围绕天极
ultrasonication	=sonication
poitrine	胸脯
ignominy	耻辱
ricin	篦麻蛋白
fluke	意外的挫折
prove	检验
hallstadt	=Hallstatt
ioof	Order
wuhan	武汉
churrigueresque	具有西班牙巴洛克建筑风格的
multiloquence	多言
vasoconstrictor	血管收缩
uncate	钩状
resend	再发
exertion	运用
polemarch	文官
reboil	再煮沸
polymethyl	聚甲基丙烯酸甲酯
tritanopia	第三色盲
equational	方程式的
ventriloquism	腹语术
derogate	毁损
ordonnance	法令
time	安排……的时间
referenced	参考
unapprehensive	理解力差的
cisc	complex
form	形成
demoded	不合时宜的
posttranslational	转译后
propagable	可传播的
unhip	非赶时髦派
underprivilege	生活d/
angora	安哥拉山羊
sternutative	喷嚏
areaway	下室前的空
disrespectable	不值得尊重的
impecuniosity	贫穷
prehistorian	史前学家
autopia	汽车专用区
hertha	赫莎
reinflame	再次激起
mirror	真实反映情况的东西
cutworm	毛虫
teletranscription	电视屏幕录像片
jadishly	下贱
varied	杂色
spindle	锭子似
autoindex	自动索引
primigenial	原始型的
hematogenesis	生血
neurotransmitter	神经传递素
biferous	一年开花或结实两次的
lazyish	懒洋洋
aquaria	aquarium的复数
acetaldehyde	乙醛
sunburnt	sunburn过去式及过去分词
homosex	=homosexuality
sulfuretted	含硫磺
pumice	浮石
salmagundi	大杂烩
lingerie	妇女贴身内衣
glandulose	有腺
biotical	生物的
vapidly	没有生气地
hurl	推翻
wold	荒野
lapdog	供玩赏用的小狗
unco	陌生的
stownlins	秘密
fashioner	裁缝
snoopy	爱窥探的
bygone	过去
avianize	使禽化
aob	其他事
subcompact	微型小客车
superb	庄重
restriction	约束
apochromat	高度消色透镜
quad	空铅
shimmer	微光
toplofty	瞧不起人
multinomial	多项式
bavarian	巴伐利亚人的
fan	爱好者
jade	翡翠
considering	顾及
adagietto	更缓慢
tasian	塔萨文化的
boo	作嘘声
abaya	=aba
physical	体格检查
protohippus	原马
inaudibility	不可闻
apsidiole	小半圆壁龛
retransfer	重新传送
nephrolith	肾结石
reflexology	反射论
functional	功能
excitedly	兴奋地
pmla	the
booze	豪饮
rheda	四轮旅行马车
retractation	收回
epilator	脱毛者
propel	驱使
gaggle	嘎嘎叫
crosscut	横切
christianism	耶稣教
vigilant	警惕着的
timetable	时间表
flagging	逐渐衰退的
card	纸牌
umbrous	荫处的
ground	搁浅
thermoregulate	调节
grave	坟墓
rogatory	调查的
ilo	International
fortran	公式翻译程序语言
grill	烤架
contour	周线
effortful	显示努力的
withy	柳树
bootlegger	走私贩
slicken	擦亮的
dolly	洋娃娃
aethereally	非人间的
fiche	卡片
backlash	反斜线
fraulein	未婚女人
polysyndeton	连词叠用
filar	丝状
pereopod	=pereiopod
realism	现实主义
disgust	使作呕
coppery	铜制
postmortem	验尸
darling	心爱的人
kickup	社交集会
diadelphous	两体雄蕊
disvalue	反面价值
epileptogenic	由癫痫引起
carlot	达法定最低载重量之货物
prongy	有尖齿的
abound	富于
reckoner	计算手册
suprarenal	肾脏上
apologise	=apologize
toplofty	骄傲
cterm	Terminal
delaney	Delaney
vitaglass	维他玻璃
purificant	净化剂
deduction	减除额
indigence	贫乏
simplehearted	心地纯洁的
weel	=well
walker	参加竞走者
vernal	青春的
facp	Fellow
congregant	召集人
divert	使高兴
hopeful	有希望的
screwdriver	螺丝起子
meum	我
towardly	适宜
punctilio	细节
anlage	原基
lunette	半圆壁
wharf	靠在码头
outachieve	胜过
unhealthy	对健康有害
tipstaves	警察
praedial	土
picomole	皮摩尔
bilboa	=bilbo
plattdeutsch	低地德语
stargazer	占星师
punch	冲孔
mnemonist	研究记忆术者
winterbeaten	被冰寒所伤的
squarish	有点方
discriminatory	有辨识力的
clave	cleave的过去式
presiding	指挥的
elegiac	哀歌
outsourcing	外部采办
hotel	客栈
plss	support
tachometry	转速测定
pathomorphology	病理形态学
misalliance	不适当的结合
sweltering	中暑的
isolable	可隔离的
actinomycin	放射菌素
suave	温和的
configurate	形成
precordial	心前的
wayahead	北京前导软件有限公司
pert	无礼
tankage	桶槽的容量
froufrou	大量的装饰
unformed	未成形的
newmown	刚割的
unsight	未见过
trunk	主干
summing	求和的
horunspatio	spatio
soapsuds	有泡沫的肥皂水
homologous	类似的
cling	附着
ucla	Angeles
unconcernedly	漠不关心地
dictatorially	自大地
spermatogenous	产生精子的
duds	服饰
anglophile	亲英派的人
artillery	炮兵的总称
road	道路
stale	撒尿
floricultural	种花
overperform	超乐谱演奏
companionably	适合做朋友地
heretic	异教徒
pneumatic	气胎
acidhead	瘾君子
theatregoer	经常看戏的人
batracotoxin	蛙毒素
kavadi	赎罪架
meanie	反派
spermatic	生殖
graphomaniac	书写迷者
christology	基督论
calotte	半球状的东西
inclinometer	倾斜计
strikebound	因罢工而歇业
barren	没有结果的
impetus	促进
janfu	大失调
polyanthus	多花
random	任意的
pillaret	小柱
slank	slink的过去式
mossback	野牛
endocranium	颅内骨膜
indwelling	存于内心中的
asymptotic	渐近的
quasimolecule	准分子
archly	狡猾
physiognomonic	=physiognomicnomic
waveoff	禁止着陆
grimness	严格
unbodied	无形
obstinate	倔强
manak	海豹打捞器
frightfully	非常
edict	法令
modify	修改
hydropower	水力发出的电力
harmonically	调和地
mealy	粉状
shortage	缺乏
flexura	折曲
roomette	小房间
reunification	重新团结
crmp	Corps
slime	粘土
electrostriction	电致伸缩的kFLn/
mummy	木乃伊
luxuriancy	多产
cupule	杯状凹
founder	弄跛
horatio	霍雷肖
soupcon	些微
strass	铅质玻璃
wysiwyg	所见即所
unfreedom	无自由
rube	土里土气
lyase	裂合酶
ignitron	引燃管
carefully	谨慎地
trustee	理事
you	你们
cladogram	进化分枝图
baptisia	=wild
essentialist	实在说
rampart	垒
dextrous	巧妙的
antacid	抗酸性
tropicalize	使热带化
tenebrous	黑暗
rainless	少雨
excommunicate	被逐出教会的人
cariostatic	止龋
punition	=punishment
instreaming	内流
hypnotherapy	催眠术疗法
remanent	残余的
frond	叶
thin	薄
sedentary	沉积
launcher	运载火箭
diphtheritic	患白喉
isthmectomy	甲状腺切除术
microquake	微震
corollaceous	花冠
inspirational	有灵感
factorize	第三债务人
pacifistic	和平主义的
paramenstruum	经前及行经初期
charnel	恐怖的
iliac	回肠的
flivver	欺骗
sweetstuff	甜点
syncretic	类并
saudi	沙特阿拉伯人
stagey	=stagy
superficies	面积
captive	俘虏
valued	宝贵的
quintic	方次方程
phagosome	吞噬体
gymkhana	运动会
bla	Liberal
tricentenary	三百周年纪念的
pipy	笛声
cyclical	循环的
spry	敏捷
lowland	苏格兰低
hussy	轻佻或粗野的女子
titaniferous	产钛
dipsey	深海
spore	孢子
mightiness	强大
fly	逃脱
cutinization	角化
kistna	基斯特纳河
outercoat	大衣
deuteronomic	预言性
unlove	不再爱
lhd	Humaniorum
performance	履行
baluchi	俾路支人
zoogony	胎生
germanization	德国化
exuberant	非凡
temblor	地震
nondurable	非耐久品
teabowl	茶碗
jewelly	光彩夺目的
favourite	中意的
ordzhonikidze	奥尔忠尼启则(苏联高加索城市弗拉基高加索
monamine	一元胺
mamillate	有乳头状突出物的
passionless	没热情的
sabbatize	过安息日
human	人性
smacker	发声的接吻
drouth	久旱
interfix	中间定位
bogus	伪造的
singly	直截了当地
destruct	破坏的
nicety	纤细
simplehearted	纯朴真诚的
pony	小型
drumbeater	对某种政策、主张大事宣传者
eel	鳗鲡
cataphyll	叶芽
terraneous	陆生的
flitty	同性恋
syrupy	糖浆似的
commemorable	值得纪念的
sunghua	Songhua
soberminded	自我节制
smacking	精力充沛
hyperpyrexial	高烧
prior	在前
iadl	Democratic
mercurian	水星
conj	连词
dour	不爱讲话
mankind	人类
afterheat	核子反应炉所产生的残热
verecund	害羞
homothallic	同宗配合的
helaine	赫莱茵
erasmian	伊拉斯谟的
sympatric	分布区重叠
finitist	有极限论
norwegian	挪威语
housewifery	家政
eloquently	善辩地
primary	主要的
copperknob	=coppernob
shoreline	海岸线
generic	属
lacunal	有孔
vagabondage	流浪
matrah	马特拉
pit	使竞争
hominoid	人
mailer	信封
saphenous	隐
bouffe	喜剧性
absorb	吸引
ancient	旧的
iatrology	治疗学
absorbingly	非常有趣
incubative	潜伏
kindle	引起
disclaim	弃权
statuesque	均衡
paye	开车入内付费
handicap	障碍
extremity	极度
spoony	痴情
runtish	发育不良
devonshire	英格兰西南部的州
special	专车
equal	不相上下
rail	横杆
thiamin	硫胺
elfish	小妖精的
domesticable	习于家居的
jsd	Juris
glove	戴手套
exchangeability	可交换性
understandability	易懂
scabland	凹凸不平而不毛的火山地带
leaping	跳跃而行的
nephropathy	肾病
tong	堂
desipient	顽皮的
chill	扫兴的
brd	Bundesrepublik
rhetoric	花言巧语
choreographic	舞台舞蹈
billabong	死河
parvus	少
rouse	惊起
caporal	质量一般
imperator	绝对统治者
sick	恶心的
albion	英格兰或不列颠的雅称
vituperation	谩骂
tonsil	扁桃腺
tantalizing	非常着急的
hosel	使用水龙带的消防人员
bios	Output
rsn	Soon
possibilism	可能派信条
thrapple	咽喉
sulphamethazine	磺胺二甲嘧啶
rifampicin	利福平
superheat	过热
forested	草木丛生
offhandedly	即席地
minium	朱红色
paladin	骑士
failing	缺点
distichous	二列的
lifeline	重要的交通线
joyful	可喜
cutler	刀商
memsahib	太太
dropt	放掉
arsenicate	使与砒混合
introgress	基因渗入
preemptor	获优先购买权者
receptacle	容器
tempestuousness	风暴
nihilistic	虚无主义的
lepidocrocite	纤铁矿
calamine	菱锌矿
chuff	乡下人
capulet	凯普莱特
joppa	=Jaffa
zelanian	新西兰的
reaganism	里根主义
arcaded	有列拱的
most	大部分的
yell	大叫
sheeny	光亮
skinny	似皮的
crackajack	上等
predestination	预定
careworn	饱经忧患
firestone	燧石
bidden	出价
robbin	=roband
plugboard	线路连接板
fane	寺院
meanie	刻薄鬼
despicably	卑劣地
fastening	扎牢
gorblimey	岂有此理
isopathy	同源疗法
patellar	膝盖骨
crmp	Military
karst	石灰岩地区常见的地形
unspiritual	非灵魂
termly	定期地
drive	开车
nooning	午餐
libidinous	好色的
mediterranean	地中海沿岸的居民
adversarial	对手
apteral	无侧柱的
ectozoic	外寄生虫的
translatory	平移的
sun	晒
neuropathic	神经性的
acotyledonous	无子叶的
hydrophilic	亲水的
oaw	Winchester
spree	狂欢
puppyish	小狗的
uncomfortableness	不安
tumultuously	骚乱
existent	存在的
hardcore	无条件
iconologist	偶像学
hermetical	与外界隔绝的
dewlap	胖人喉部鼓出的肥肉
reagin	变应性反应素
ketchup	调味蕃茄酱
undersheriff	代理郡长
slam	砰地放下
impelling	迫使性的
regrater	转手倒卖者
starveling	贫穷的
nicish	细心
eudemon	善良的精灵
scoff	嘲弄的对象
uart	通用异步收发器
rub	擦掉
wampish	使晃动
characterless	不出众
block	防碍
intuitivism	直觉说
confirmedly	根深蒂固
zapotecan	=Zapotec
fussily	小题大做地
madreporite	穿孔板
precaution	警惕
midge	蚊
silence	静默
jerquer	船舶检查员
retrieve	重新得到
share	分配
gpd	加仑[日
tarawa	塔拉瓦岛
flectional	可弯曲
bathymeter	水深测量器
commercially	通商上
spacing	间隔
unheard	未知
lendable	可借贷的
ludicrous	可笑
confessionary	告罪
defilement	弄脏
coessential	同素的
algarroba	牧豆树
jangler	n
gunpowder	有烟火药
succedaneous	代用的
skewback	拱座
bess	贝丝
snob	假内行
reredos	祭坛背后墙壁上的雕饰
salivous	唾液
gunsight	瞄准具
loxodromic	斜驶的
gardenless	无花园的
pizazzy	潇洒
hurlbutite	磷钙铍石
abscise	被切除
stabilizer	水平尾翼
ast	Target
miniver	白鼬
owing	应归功于
inaugural	开始的
complement	余角
quadrillion	百万之四次方
irrelevantly	不恰当
veiled	以面罩遮掩
moriori	莫里奥里人
indusiate	幼虫膜的
vasostimulant	促血管舒缩
reconnaissance	勘测
postmarital	婚姻结束后的
tetramethyl	四甲基的
pretreat	预处理
cobweb	蛛丝
mauritius	毛里求斯
marasmic	衰弱的
namely	即
protostellar	原恒星的
windbreak	防风物
modernday	当代的
furious	热烈兴奋的
lubricious	光滑的
purgatorial	炼狱
compendiary	简略的
divulged	暴露
multinomial	多项的
tigrine	似虎
extort	强取
cold	零下温度
trumpery	零星杂物
hexavalent	有六价
remnant	剩余的
accompt	=account
bondservice	奴役
igy	International
agelong	持续很久的
coincidental	巧合的
wring	折磨
diallel	双列的
usv	United
phoneticism	语音拼字法
rhythmed	有节奏的
project	工程
funiculus	细索
coaction	合作
superior	上好
excommunicant	被革出教会的人
septimal	七
austere	操行上一丝不苟
fibrillate	有原纤维组织
cryobiology	低温生物学
ambisyllabic	属二音节的
apprenticeship	学徒的身份
midwifery	催生
permissionist	=permissivist
fatigue	使心智衰弱
pollux	双子座之星
glaucous	绿灰色的
c	往来账
riskful	危险重重的
phagosome	吞噬小体
rack	在架上制作
trundle	推动
trijugate	具三对羽片的
gasless	无气体
studiously	好学
melancholic	忧郁
unlistening	不敏感
palm	手掌
exsanguine	无血
halt	中断
lucullian	富裕
millepore	千孔虫
unfordable	无法通过的
downright	显明
innuendo	影射
villatic	别墅的
masturbatory	自淫
predominate	控制
cystic	膀胱
tempeh	印尼豆豉
blotch	弄脏
oven	灶
rawalpindi	拉瓦尔品第
unjustifiable	不能分辩的
qingdao	青岛
feulgen	reaction
dreamy	空幻
jigsaw	用竖锯锯
everyday	每天
nora	Leonora
atropism	颠茄碱中毒
premonitor	预先警告者
imperfectly	有缺点
avestan	阿维斯陀语
bakeshop	=bakehouse
ellsworth	埃尔斯沃思
cycle	使轮转
charnel	阴森的
ladified	有贵妇人风度
skintight	紧身的
scheduler	日程安排程序
onchocerciasis	盘尾丝虫病
inherently	天性
discommendable	不赞成的
eared	有穗的
arrange	协商
ckd	knocked
zooplastic	动物组织移植术的
unmerited	无功受禄
place	任命
outlie	放在……外面
donor	捐赠人
vegetative	有生长力
disputation	议论
singlehanded	单独
ridable	可骑马通过
wearily	疲倦地
africanist	非洲独立运动拥护者
auxotroph	营养缺陷体
aspirant	有野心
contrarily	反对地
unsympathetic	不同情的
tamp	捣棒
stand	立足点
uptown	住宅区的
tartarean	阴间
intermezzi	间乐曲
rill	小河般流
shiftless	无能
volant	会飞
towery	高耸
trainbearer	长尾蜂鸟
rumpty	极好的
ergastulum	囚禁奴隶的私人监狱
regular	合格的
seamanlike	熟练水手似的
twopenny	淡色啤酒
innutrient	营养不良的
homegrown	国产
chemurgy	实用化学
reduce	简化
older	年长的
babblingly	胡说
wayfaring	徒步旅行
throat	窄路
platyhelminth	扁形动物
progressionist	进步论者
clostridial	梭菌的
ordovician	奥陶纪
malemute	=Alaskan
intact	完整无缺的
parenchyma	软组织
panasonic	日本松下公司
wananchi	当地工人
backless	无靠背部
thesaurosis	沉着病
rubicund	透红的
wickedly	顽皮地
deadweight	重负
pucka	第一流的
antienzymic	抗酵素的
csma	Sense
god	神像
dissave	动用储蓄余
tentative	试验性
nunnery	尼姑庵
eccentric	行为古怪的人
kamerad	伙伴
ostensorium	=monstrance
mummification	木乃伊化
carbonylic	碳酰基
silly	无聊
bloodwort	地榆
cpc	中国共产党
hybridisation	=hybridization
scimitar	半月形刀
baculum	阴茎骨
magellan	麦哲伦海峡
sanatory	有益健康
mycobacterium	分支杆菌
pregnant	孕育
wheezy	气喘声
homoplastic	类似的
traffic	通信量
ursiform	熊状的
abundant	充裕
airbrush	油漆喷雾器
winnow	扬
theaceous	茶科的
exponence	说明
gloriole	后光
emotional	情绪的
rattly	格格响的
bellyband	腹带
hoist	提升间
garnishment	出庭传票
doughty	强
tininess	微小
buff	浅黄色
waste	损耗
wrangle	争论
sketchy	粗略的
waxplant	球兰
usia	Information
jus	法律的原则
electroculture	电气栽培
jag	尖齿
raspy	易怒的
guerdon	给报酬
carmine	洋红色的
economy	机体
cetus	鲸鱼座
odorant	有气味的东西
oncost	间接成本
reflected	得自他人的
militant	好战
lose	使失去
immobilise	使不动
deviser	设计者
spongiose	多孔的
msee	Engineering
immodesty	无礼
preciously	过分讲究地
reenact	再制定
dumfriesshire	邓弗里斯郡
subovate	近似卵圆形
prefigurative	预示
compilatory	编纂
conically	成圆锥形
diethyl	二乙基的
dominating	专横的
verity	真实
waste	废弃的
oozie	驭象者
disclaimer	放弃者
fishpound	拦鱼堰
jibe	使转向
columbian	哥伦布的
vehement	热烈
basification	碱化
acerb	刻薄
apathetic	缺乏感情的
rongeur	咬骨钳
suzuribako	文房四宝盒
festally	如节日
ferriferous	含铁的
pathetic	悲惨
half	半场
dysthymic	精神抑郁的
trust	信任
malvinas	Malvinas
nematocyst	刺细胞
traveled	富有旅行经验的
orthodox	传统的
sublimate	理想化
unnerve	使失去勇气
nonmedical	非医学
transmitter	发报机
windward	上风
cleavage	劈开
araneidan	真蜘蛛类
loud	高声地
discipular	门徒的
dyspnoea	呼吸困难
unthoughtful	粗心
meandrine	成襞皱
econometric	计量经济学
complain	控诉
rancher	牧童
romance	冒险故事
ndis	网络驱动程序接口规范
seventeeth	第十七的
instigate	鼓动
excusably	可宽恕
trinomial	三项式
labialization	唇音化
soot	煤烟
eyelike	眼状
joking	戏谑
tubate	有管
armature	盔甲
obelize	加剑号
jocosely	说玩笑地
daf	the
trinitrophenol	acid
lamellose	似薄片层的
unversed	不精通的
mins	需监护的未成年人
nut	螺帽
wyswyg	所见即所得
ampelopsis	美国蔓藤
irregular	不规则的
reflectingly	深思
scribe	划线器
loadstone	磁性氧化物
rhumb	罗盘方位
drink	酒
colory	颜色显著的
charade	看手势猜字谜游戏
etic	素
pauper	叫花子
suboceanic	海底
insurrectional	叛乱的
thriftily	兴旺
empyreumatic	焦臭的
posttreatment	后治疗
barren	不生育
xms	memory
procuratorship	之职
drinker	酒徒
overlie	躺在……上面
legato	连奏
promissory	约定
tindery	易燃
ferricyanogen	氰铁酸盐的三价基
lapland	拉普兰
panicmonger	制造恐慌的人
trior	审判员
cavalcade	队伍
aldosterone	醛甾酮
arrogant	自大的
cutler	刀具工人
lassock	小女孩
sicky	=sickie
residuary	剩余的
funny	滑稽
infatuated	入迷
last	后来
instant	紧迫的
motiveless	无动机的
lst	Local
rattling	卡嗒卡嗒
corporeity	体质
sting	刺痛
cadmus	卡德摩斯
cataclysm	灾难
vegetal	植物性
unmotherly	不慈爱的
haemophilioid	类血友病
underhand	秘密地
rightly	公正
recompute	验算
macrobiosis	长寿
ostraca	的复数
phlebosclerosis	静脉硬化
brigatisti	红色旅
antirachitic	治疗佝偻症
secularism	宗教教育分离论
fishpond	养鱼塘
roam	徜徉
wayahead	致力于消费类软件的制作、发行及信息服务
heliocentric	以太阳为中心
insubordinately	犯上地
pupiparous	蛹生的
unconspicuous	不引人注目的
unsuspecting	信任
antipodes	相对极
uncaused	非外因引起的
conjecture	臆说
cycle	周波
filicoid	如羊齿植物
saronic	萨罗尼克湾
bmr	basal
hairdressing	理发
washhouse	洗衣房
unpleasing	不愉快的
pander	勾引
hibernian	爱尔兰
malvina	玛尔维娜
johnsonian	庄重
misogamy	厌恶结婚
reincrease	再增大
telecentric	远心
antipole	正相反之物
gleaning	落穗
meiofauna	=meiobenthos
perception	感觉
kebele	自治街坊联合会
slithery	滑溜的
remedially	治疗地
precipitate	突如其来的
blatant	喧嚣的
abaca	马尼拉麻
physical	物质
kaiserdom	皇帝的地位
hepburnian	使用该拼法的人
spilt	spill的过去式及过去分词
fictionalize	把编成小说
zooty	花哩花哨的
riant	快活的
deference	顺从
holloo	=hallo
mercurialise	=mercurialize
klystron	速调管
anaesthetic	麻醉剂
soothe	使缓和或减轻
lawyeress	女律师
mass	使集合
ophthalmic	眼
gemutlich	安逸
trotskyist	托派分子
waywardly	任性地
salutatory	致敬意的
painstaking	艰苦的
apocalypticist	预言大灾难降临的人
ecaudate	无尾
noogenic	心理发生
invertebrate	无脊椎
altair	牵牛星
romeo	室内便鞋
gramadan	=gramdan
kathiawar	卡提瓦半岛
microcosmic	微观世界
vivify	使复生
whop	征服
dour	顽强
gastrovascular	消化与循环两用
insectile	由昆虫组成的
attainture	不名誉
astounding	令人惊骇的
cutoff	中止
papilio	凤蝶
outlandish	奇异的
laitakarite	硫硒铋矿
chrismon	=Christogram
frug	扭摆舞
ib	Intelligence
uniaxial	单轴
fim	鱼类
outlive	比……耐久
consequently	因此
pictorialize	使图示化
phalangal	=phalangeal
tutiorism	更稳妥说
meshugaas	蠢话
whatnot	放古董的架子
moonshine	月光
trashsport	体育运动表演
gyrate	不停地转动
geomancer	地占者
absorbingly	引人入胜地
replay	重新比赛
curbing	边石
southland	南部地方
parallel	相同的
sadhana	成就法
namaycush	湖红点鲑
almond	杏树
spiceberry	香料植物
machiavellian	权谋政治家
tumble	翻筋斗
deep	迟
tungus	通古斯语
about	关于
coprecipitation	一起沉淀
untrod	人迹罕至
rattling	卡嗒卡嗒的
foresleeve	前袖
indeliberateness	不是故意
abed	在床上
homespun	手织物
duteously	守本分地
inductive	诱导的
amadavat	梅花雀
worm	蠕虫
detector	检波器
adelantado	西班牙贵族
styrax	=storax
symphysis	骨的愈合
rhombohedral	斜方六面体
expanding	展开的
equivalent	相等物
homespun	朴素的
acidulous	不悦
ambrosia	神的食物
rareripe	早熟的
heliograph	日光仪
amort	意志消沉的
oblivion	赦免
antifoulant	防塞物质
telega	四轮运货马车
exchangeable	可替交
impure	不纯
exudation	分泌
aggressor	侵略者
sensuality	淫荡
termly	每一期的
castigatory	斥责
unprojected	非预料的
shune	shoe的复数
hevea	三叶胶
gingerly	谨慎的
tolerance	忍受
pronate	俯身
autnumber	比……多
worrier	发愁的人
chromatics	色彩论
inviolate	未亵渎的
dsn	数据源名
manned	有人驾驶
isolated	隔离的
sansculotte	下层阶级
hatchery	孵卵所
polyhydroxy	多羟
vfat	Virtual
fst	超平面技术
update	现代化
carroty	红发的
bubble	起泡
stanchly	坚强地
rime	白霜
trembler	震颤者
meropia	部分盲
forcible	强制
meretricious	娼妓
fanega	法内格
criminy	基督
cytospectrophotometry	细胞分光光度学
nwbw	by
fatness	肥沃
heteronomous	他治
plf	磅/英尺
concelebrate	共做弥撒
soreness	痛苦
incorporator	合并者
reubenite	流便支派人
unrazored	未剃过的
dumpage	倾倒
usable	便于使用的
inhumanly	无人情味地
neoplasm	赘生物
papillose	多疣的
shaven	削发的
sparing	节俭的
bronchiectasis	支气管扩张
coetaneous	同时代
odorously	香气地
sankhya	数论派
redemandable	要求归还
nix	无
constituency	赞助者
hexastyle	六柱的
unobvious	不显著的
outact	行动上胜过
lowness	微弱
unexcited	不激动的
assemblyman	议员
anonym	匿名者
gradualness	徐徐的
enteritidis	肠炎
hesitatingly	踌躇地
dysphasic	言语困难的
prolificacy	多产
whereover	在那上方
something	某事
admissibility	有入场的资格
noninitially	不是最早地
charily	俭省地
proctoclysis	直肠滴注法
bratislava	布拉迪斯拉发
alba	of
assiduous	刻苦的
proletarian	工人
semiformal	适于半正式场合
anality	肛恋
way	习惯
reversal	逆转
quarantinable	应隔离
cretan	克里特岛人
ast	Time
isospore	同形孢子
eurithermophile	`jJErI9W\:mE`Il/
pregnable	可攻击
redraw	重画
bowel	肠
oppress	压迫
accountably	可说明地
fastidium	无聊
metonymic	转喻的
daystar	晨星
glazer	上釉工人
brachycranial	圆颅型
lawlessly	非法地
spy	间谍
irresolute	犹豫不决
cool	冷静的
praepostor	级长
expensively	高价
epigastrium	第一腹片
effectively	有力
cranked	有曲柄
afflux	注入
gelt	geld的过去式及过去分词
reportorial	记者的
regionally	方
bondsman	奴隶
tranquility	宁静
dukka	=duka
gyratory	旋转
veining	脉纹的排列
while	虽然
seam	裂开
immunochemist	免疫化学
liceity	合法性
polarization	分化
wolfy	狼一样凶残
leapt	leap的过去式及过去分词
composition	合成物
grayhound	快速船
hirer	雇主
resentful	怨恨
unstuffed	未填塞
dement	疯狂
giraffine	长颈鹿
exudation	渗出
society	友伴
umbilicate	中间凹
cleanup	清除
idle	停顿的
squish	咯吱吱地走
selected	经由选择的
mainline	静脉注射
chunky	矮矮胖胖的
phosphite	亚磷酸盐
mullein	毛蕊花属的植物
sporule	小孢子
baronial	男爵的
relatively	相关
fail	舍弃
hucklebone	距骨
rebelled	反叛
ruined	毁灭的
jargonaphasia	杂乱性失语
fontal	本源
hypernotion	超概念
capo	分支头目
corned	盐腌的
coxcombical	虚浮
polemist	争论者
pantoum	由隔行同韵的四行诗节组成的诗
grizzly	灰熊
homologous	类似
at	于
destabilize	使动摇
nelumbium	莲属植物
menat	护身符
mortal	临终的
zg	zoological
eject	逐出
semiplastic	半塑性的
croupy	义膜性的
konfyt	蜜饯水果
fusiform	两端渐细的
furnishings	室内陈设品
attractively	迷人地
frontlet	额前饰
communally	公有
deathsman	刽子手
conscienceless	不知廉耻的
tillable	可耕种的
coxal	腰节的
keratinization	角质化
depreciate	贬值
stownlins	偷偷
penelope	期间她拒绝了无数求婚者
counterbalance	平衡量
nananne	纳南
winning	获得
gph	加仑
born	天生
banteringly	半开玩笑
startling	令人吃惊的
generation	产生
parametric	参量
hypoploid	亚倍体
emunctory	排泄器官
dwarfish	象侏儒的
secretiveness	分泌
baltic	波罗的海
encouraging	奖励
zeatin	玉米素
displease	惹怒
quartan	四日热
usib	Board
carryout	供打包的酒菜
antidromic	逆向的
superheater	过热器
unimposing	不动人
scalper	做投机抽头的人
rebore	重镗
os	儒略历
emit	放射
conglobulate	结聚成球状
linenfold	布轴式
indigently	贫乏
rocketry	火箭技术
whoop	哮喘声
autocratic	专制
greediness	贪欲
unassailed	未受袭击
honorific	尊敬的
distinct	明显
vehemently	暴烈地
rutilant	闪光
metachrosis	变色机能
antihemophilic	抗血友病的
misapprehend	误解
gesticulate	做姿势表达
accordant	一致
aurelia	蛹
ream	刮
flareback	激烈的反驳
metaplasia	组织变形
therian	兽亚纲哺乳动物
shelter	躲避
homozygosity	纯合性
quadraphonic	四声道的
roundwood	圆材
surround	包围
sellout	脱销
counterstroke	还击
equanimity	镇定
orientalise	=Orientalize
autoimmunization	自身免疫
tauntingly	嘲骂地
hexyl	己基的
eximious	优良的
anthropic	有关人类的
caesural	主要停顿的
possibly	可能
fondu	干酪
slither	使滑动
chauvinistic	沙文主义
outward	表面上
profane	亵渎
cms	management
callow	未生羽毛的
spiritualize	使精神化
arthritis	关节炎
secondly	其次
overelaborate	过分精心制作
fan	成扇形散开
institutional	制度上的
multiplicity	多样性
immoderately	过度的
musette	法国的小风笛
yellowback	廉价小说
inharmony	冲突
neronian	暴虐的
herbaceous	草本的
plonk	劣等廉价葡萄酒
leadenhearted	没有恻隐之心
combination	合并
banishment	放逐
medical	医生
unprescribed	非限定的
inn	客栈
plug	塞
spark	情郎
sacrament	立誓
eyre	巡回
hamartoma	错构瘤
laval	熔岩
gramineous	草的
ghostlike	灵魂似
kymogram	记波图
xylophilous	木生
iconometer	光像测定器
transnatural	超自然的
thereto	往那里
amygdalaceous	蔷薇科李属植物的
luetically	疫病
beatific	幸福的
domaine	葡萄园
umbles	牲畜的内脏
myriapodal	多足纲节肢动物
livelily	敏捷
enforce	加强
parasympathetic	副交感神经神经系
unenvious	不妒忌的
lumbaginous	腰痛
housemother	女舍监
chary	谨慎的
impelling	强有力
hypobarism	低比重
pewchair	教堂长椅旁的加座
thermoset	热固树脂
officer	船长
unavoidably	无可奈何
hypothenar	小指球
continental	欧洲人
overnight	前夜的
unbailable	不能保释的
iconological	偶像学
hydrodesulphurization	氢化脱硫作用
incompatible	矛盾的
lawks	嗳呀!
preachify	讲道
superorganism	超个体
phonetician	语言学者
speechifier	演说者
posh	极好
nonbeing	=nonexistence
muscovado	黑砂糖
awag	摇动
thence	从那时起
misogynic	厌女
ccpit	the
nonobjectivity	抽象艺术派之作风
cityfied	=citified
every	每一的
centric	中央
hypersexual	非常好色的
halterbreak	使小马带惯笼头
feldspathic	由长石构成
strained	做作的
crakeberry	岩高兰
capitol	国会大厦
aryan	印欧语系的人
wistfully	希望
delicate	脆弱的
antinode	腹
musicassette	卡式音乐录音带
feculence	污物
phylactic	防御疾病
study	试作
ovalbumin	卵清蛋白
gossoon	小伙子
reliable	可信赖的
acutilingual	尖舌
lex	法
porn	色情描写
interested	感兴趣
disgust	令人厌恶
overmany	过多
toynbeean	汤因比风格
behindhand	耽误的
uncultured	未开垦的
quick	要点
raunchy	肮脏
agriculture	农艺
separatory	用于分离
golosh	橡胶套鞋
prefigure	预示
diluent	稀释液
priority	先
bilateral	双边
erstwhile	往昔地
lesson	教训
cantate	篇
unworking	闲着的
backbit	backbite的过去式
impairer	损害者
subscapular	肩胛前面
predicative	肯定的
balloonkite	军用细长气球
unsmirched	未弄脏
caledonian	苏格兰的
numega	出品Softice
lacrimal	泪
welter	混乱
hospitably	招待周到
spinosity	难题
millimicro	毫微
apartment	单元住宅
laic	俗人
juratory	以誓言表达
meant	mean的过去式和过去分词
tapper	电报键
unperceptive	无识别力
bedclothing	寝具
msy	sustainable
demob	复员
cranked	有曲柄的
leaning	倾向
salient	跳跃的
phocine	像海豹的
choleraic	类似霍乱
overwhelm	覆没
stipulate	保证
varicella	水痘
billbug	喙甲
diester	二酯
nicotiana	花烟草
set	坚决的
flyman	管理大道具的人
circumnavigator	世界一周旅行者
transfixion	贯穿
sycophant	谄媚者
mechanotherapy	力学疗法
thixotropic	摇溶
johannes	葡萄牙十八
ludic	开玩笑
welfarism	福利费
cardiac	强心剂
slaughter	屠宰
trickish	难对付
dilutive	冲减每股收益
noodlework	脑力活动
asphyxiator	动物窒息器
umbrageous	多荫的
discreetly	小心地
touse	吵架
arithmetical	算术上
rule	控制
aspi	高级SCSI编程接口
stickykey'	NULL)
schmo	愚人
unicolor	单色
grandiloquent	夸大的
lactescency	乳白色
cardinalate	枢机主教之职
skin	皮毛
after	后来
hemosiderotic	血铁质的
crymotherapy	冷冻疗法
coda	乐章结尾部
lithophilous	爱石的
residentiary	居民
catonian	加图式的
polaris	北极星
reflex	反射的
minor	较小
stammer	结结巴巴地说
puzzling	使迷惑
ravishing	引人入胜
motivic	动机
transtage	中间级
overswing	挥动弧度过大
embedded	植入的
ucla	California
can	可以
confer	授予
dynistor	负阻半导体
poorness	贫穷
charity	施舍
cyclothymic	循环性精神病
euthanasia	安乐死
sere	干枯的
befitting	适当
kook	怪人
floatman	花车管理员
madness	愚蠢的行为
gentlewomanly	淑女
unregimented	未严加管制
unconfiding	缄默的
cryptorchid	患隐睾病的人
adiaphoresis	无汗
earning	所赚的钱
msgm	Government
furtively	暗中
plaintful	悲叹
fadeaway	消退
gaffer	领班
redemandable	再要求
newsworthy	有报导价值的
draff	残渣
nonfinite	非定式的
allocate	分派
eyeless	盲目
surpliced	穿白袈裟
fossula	小窝
restate	重新叙述
theanthropical	具有神人两性的
unyieldingly	不屈服地
pedestal	加座
odt	国防运输局
solicitudinous	关心
cinematic	影片的
lipochrome	脂色素
spread	涂
utricular	具胞
stoma	气门
marquis	侯爵
yielding	易弯曲
grandee	贵族
federalization	同盟化
diphtherial	白喉
bla	of
yird	陆地
whirl	急走
salient	易见的
lawless	非法的
humorously	滑稽
fogey	抱残守缺的人
suburbicarian	罗马市郊的
magnoliaceous	木兰科
fitment	家具
shm	simple
repot	移植
infinite	极大
northwards	面向北地
unheroical	给人印象不深
dihydro	有二个氢原子
mossback	乡巴佬
sobriquet	假名
colorimetric	比色
stand	停止
meum	pro
calendric	按日历的
bloomy	盛开
residuum	残滓
backsheesh	酒钱
profligate	不检点的
weediness	杂草状
surculous	有根出条的
metallographic	金相学的/学的
venomous	分泌毒液
adagissimo	很慢
theroid	兽性的
wll	Loop
chambertin	香贝坦红葡萄酒
bedaze	令眩惑
lysol	来沙尔
toffee	太妃糖
demurely	认真
franking	邮资
hematoid	血样
mucic	黏酸
suspicion	猜疑
agrestal	野生的
hyperuricaemia	血
thrasonical	沉重的
pomander	香丸
kure	吴
importation	输入品
weftwise	横向地
muddily	多泥
egoistically	利己
nancified	女人气
columbian	哥伦布
subnormal	低于正常
median	中值
gentamicin	艮他霉素
caudal	尾部
ridgling	=ridgeling
lane	里弄
zincic	锌的
degrading	丧失体面
second	支持
intrigue	密谋
lagniappe	商店给顾客的小赠品
laurel	月桂树
chlorospinel	绿尖晶石
zoolatrous	动物崇拜的
singaporean	新加坡
harassed	厌烦的
reference	证明书
disjunct	不相连的
automorphism	自守
graduation	毕业典礼
craniofacial	颅面的
illiberally	吝啬
overdrawn	overdraw的过去分词
gasometric	气体定量分析的
bromate	溴酸盐
always	始终
ornate	华丽的
slash	抽打
cenobite	修道士
frailty	品德上的弱点
mean	简陋的
obtain	得到
inbred	先天的
forgivable	可宽恕
renovate	修复
attrition	磨擦
racker	使人痛苦者
hematocryal	冷血的
autocatalytic	自身催化的
octandrious	八雄蕊的
centric	中央的
cmtc	Training
appealing	恳求似
milestone	里程碑
unpaid	不受报酬的
upcoming	预定将要
madreporite	筛板
notable	著名的
famine	严重的缺乏
pathogenicity	病原性
ashore	在岸上
chantable	可歌
hagride	困扰
injured	受伤
angiopathy	淋巴管病
let	出租
playclothes	游乐装
revest	重新投资
unwound	unwind的过去式和过去分词
cydonia	为Canea之古名
thylacine	袋狼
volley	齐鸣
prudently	谨慎地
ratite	平胸类鸟
henceforth	自此以后
formal	合礼仪的
catapult	飞机弹射器
wassat	that
neutralise	中和
personalize	使成私人
whist	嘘!
ungated	无闸门的
agley	斜斜地
birdieback	=birdyback
recur	重现
uncharitable	严厉
circumvent	围绕
pilot	引水员
basophil	大浅盆
dihedral	有两个平面
handsel	贺礼
ppe	Philosophy
ruddle	使发红
laurie	劳里
start	发动
silkworm	桑蚕
resign	辞去
cinquefoil	五叶形的装饰
hypopharyngoscope	`haIpE9fArInN^EskEJp/
xanthospermous	有黄色种子的
cosmologic	宇宙论
expiate	赎
voluble	有口才
kindly	亲切
kcps	second
zollverein	关税同盟
terai	毡帽
planometer	平规
unknowing	无知的
transcutaneous	经皮的
inhospitably	荒凉
quaere	请问
lacustrian	湖上居民
aboardage	两船接近于平行时的相撞
redraft	反汇票
hepatocyte	肝细胞
sadistic	残酷成性
restrictivist	限制的
froward	不易控制
oinochoe	=oenochoe
whinger	短刀
auric	含金的
state	声明
thy	你的
sbm	single
perineal	会阴
progesterone	黄体酮
stauroscope	十字镜
howe	洞
unsung	未赞颂
annuities	养老金
pressboxer	体育记者
navalist	海军至上主义者
indiscreet	不慎重的
senatorial	参议员
inboard	在船内
progress	进步
rainproof	防水的
nee	娘家姓
woodland	林地
augustan	奥古斯都的
cacographer	书法不佳的人
tee	字母T
contrived	人为
crossword	纵横字谜
dodecagon	十二边形
cashbox	金库
adenohypophysis	腺
renowned	有名的
corp	公司
tepic	特皮克
roundabout	转弯抹角的
buccal	口的
rayonnant	辐射式
bluebell	野风信子
aerify	使蒸发
adjuster	调停者
hurried	催促
pein	=peen
skittish	易激动的
commix	混合
adman	拉广告者
diagonal	斜纹
blooming	盛开
database	数据库
assyrian	亚述语的
photonuclear	光致核反应的
jemadar	警官
aponeurosis	腱膜
encumber	阻碍
street	街道
plush	长毛绒做的
interwreathe	使互相缠绕
muscoid	苔藓状的
linearize	使线性化
electrofishing	电气捕鱼
fervent	炽热的
ocso	Strict
nice	精密的
antidiuretic	抑制尿分泌
igneous	似火的
stunsail	补助帆
precess	产生进动
fatimid	法蒂玛的后裔
moralistic	道学的
crisp	易碎
cyclades	基克拉迪群岛
methene	=methylene
gestic	与身体动作有关
assembly	装配
heliotropism	趋日性
mycenaean	希腊古代都市迈锡尼
kangaroo	袋鼠
sculduddery	=skulduggery
environmental	周围的
denture	一副牙齿
plenitude	充分
detchable	可自……分离
eunuch	太监
spasmodic	痉挛的
doughfoot	美军步兵
sbc	子带编码
project	方案
pelagic	远洋的
germina	病菌
fidelity	重现精度
sob	发呜咽声
warring	发动战争
pit	去……之核
infusorium	滴虫
girth	肚带
ankylose	僵硬
aru	American
pretended	假装
lifeless	无生命的
oxygenate	氧化
softening	变软
kerosene	煤油
unlikely	未必的
aerobatic	特技飞行
endangered	有危险
hydraemic	稀血症的
applicatively	合用
engrail	使成锯齿状
minish	减小
econut	生态迷
rurally	乡下
amendable	可修正
cogency	中肯
eicon	加拿大网络软件公司
ramapithecine	腊玛古猿
flowage	泛滥
lacedaemonian	古代斯巴达的别称
iffy	可疑
prelimit	预先限制
halfhourly	半小时地
cutie	漂亮的女孩
flowing	如流
nutritional	营养的
thermoscope	测温器
verse	诗节
unskillful	不熟练
matroclinal	=matriclinous
po	pos
shift	变化
cleanness	洁白
overmaster	征服
interrogator	质问者
coagulatory	引起凝结的
might	可以
aplomb	沉着
recommendatory	劝告的
therapeutical	治疗的
tricksy	淘气
about	在附近
taboret	绣框
hairlike	细微的
pmkd	邮戳盖讫
eutrapelia	机智
gay	欢迎的
abraser	磨石
flare	闪耀
friz	使卷曲
multisensory	多种感觉
fiddler	蟹的一种
keypad	键区
nonneoplastic	非肿瘤的
leucosis	白血性增生
finite	有穷的
rubescent	变红
nautical	船员的
arm	供给
pelvimetry	骨盆测量
neurogenic	起源于神经组织
joseph	Joseph
latifundism	拥有大庄园
furrier	毛皮商
nannyish	过时的
tsingtao	见Qingdao
cardioid	心形线
haste	匆忙
dechlorinate	脱去……的氯
deep	深入
skew	歪斜的
deacidify	使脱酸
puri	=puree
jumpy	跳跃
thankless	不感谢的
irretentive	不能保持的
supinely	掌心向上
inquiring	打听
approver	赞同者
engrain	使根深蒂固
investigate	调查
geophysics	地球物理学
subpleural	胸膜下的
bureaucrat	官僚主义者
laggardly	落后
tractable	易管教
corrosively	侵蚀地
chilean	智利人所说的西班牙语
tmo	telegraph
phenoxy	含苯氧基的
madding	狂乱
spider	三脚架
darkminded	黑心
antiodontalgic	止牙痛
phot	厘米烛光
kleptomania	盗窃癖
ccst	Teletext
fox	狐皮
scene	发生地点
troublous	暴乱
fictionist	创作家
dovetail	与……吻合
multipoint	多位置的
dermatitis	皮炎
frivol	浪费
monobloc	单层
crumbly	脆
macrodont	巨牙
gynander	雌雄嵌体
bung	堵
absorptive	吸收性
maxiskirt	超长裙
fimbria	毛缘
judaea	朱迪亚
tubilingual	有管状舌
hyperpyrexial	体温过高的
irreducible	不可约分的
vfd	department
icy	冰冷的
voces	的复数
griseous	浅灰的
dandriff	头垢
bramble	荆棘
phenol	石碳酸
baulk	阻碍
junc	接合
chiastolite	空晶石
remit	汇出
akin	类似
hummock	圆丘
blindworm	无脚蜥蜴
rigescent	生硬
nabobess	富翁的妻子
rockbound	被岩石包围
rewardless	无报酬
anther	花粉囊
metanephros	后肾
alkalescent	弱碱性
interbedded	层间的
peritoneum	腹膜
asme	Society
ifo	identified
dumpy	短雨伞
harborer	窝藏
employless	失业
dantonesque	大无畏
scum	产生泡沫
amu	mass
eurystomatous	有可扩展的嘴的
merchantable	可买卖的
gynaecocracy	妇女当政
tenacious	顽强的
accommodable	可适应
calculate	以为
railroading	仓促行事
osteotome	骨凿
cutesy	忸怩作态
shiny	发亮
ntfs	File
devilkin	小魔鬼
cyprian	淫荡
sacchariferous	产生糖的
trimetrical	斜方晶系的
salvy	软膏似的
haemostat	止血药
orion	猎户星座
indigently	穷困地
bacteriuria	细菌尿
sulfuretted	含硫磺的
ending	结尾
gay	同性恋者
dopy	被麻醉的
humped	有瘤
bangle	脚镯
locution	惯用语
flap	拍打声
derogation	毁损
frailty	脆弱
sawtimber	锯材原木
hypochondrium	季肋部
antrum	腔
airspace	领空
tussor	柞蚕
yielding	屈从
insuppressive	抑制不住
sequestrator	没收者
homework	副业
antiulcer	治溃疡
enunciative	表明
countercommercial	一则反广告
eremacausis	慢性氧化
ream	榨取
manganin	锰铜
sacred	庄严的
everyway	任从那一方面来看
subclavian	锁骨下神经的
frequent	频繁的
accusation	谴责
qos	Service
shoeless	无鞋
veni	I
mandioca	=manioc
baculiform	棒状
incisal	切
propagable	可推广
zamia	泽米属植物
bait	诱惑物
chamotte	火泥
manifestation	示威运动
temperate	有节制的
reductive	还原
heartsick	悲痛的
analytics	分析论
bridgeboard	楼梯之侧板
subcrust	路面底层
swanskin	天鹅绒般的
asap	尽快
please	满足
roundly	有力地
reflex	优角的
tussah	野蚕丝
thundering	打雷
smalti	的复数
mammee	曼密苹果树
kerbela	=Karbala
herculean	力大无比
valiantly	英勇地
mudflow	泥流
revisal	修改
rabbin	拉比
uso	劳军联合组织
baldish	无草木
barbadian	巴贝多
penetrability	穿透能
ginny	杜松子酒
acronymous	关于首字母缩略字的
tarsi	跗骨
euramerican	欧美混血儿
quellenforschung	原始资料研究
discomposure	狼狈
crankous	急躁
detector	检电器
griseous	珍珠灰的
sigmoid	S状弯曲
northeasternmost	最东北
arriviste	一心想发迹的人
preciously	过分讲究
municipally	市制上
reproduce	再生
holotypic	正模标本的
tandour	方桌火盆
legit	正统剧院
droopy	下垂
synchronous	同时
novial	创新语
fearnaught	和毛机
agrin	微笑
peg	钉
weldment	焊成件
batty	疯狂的
endogenic	内成
rowdyism	粗暴的行为
bunchgrass	丛生禾草
protension	持续
incivism	无爱国精神
biochore	生态域
vocationally	职业上
omnipresent	无所不在
leaf	树叶
psychoneurotic	患精神神经症的
lowest	最小的
uri	Uniform
cardan	joint
suggestive	提示
queensland	昆士兰州
flagpole	旗杆
unitary	归一的
deposable	可罢黜
sticking	有粘性的
accumulative	累积的
dazzle	眼花
initio	在卷首
pokey	狭小
kilmer	基尔默
unmarked	未被注意
phenomenal	显著的
blond	金发的
minicoy	米尼科伊岛
stateside	在美国
batleship	战舰
quadrate	长方形
purr	咕噜咕噜叫
hantu	鬼
aeronautical	航空学
starched	浆硬
fortlike	像城堡的
botb	British
luddism	Luddite
endochondral	软骨内
malversation	盗用
thrasonical	自夸的
kegeree	=kedgeree
supportably	可忍受地
introversible	可向内翻
spool	缠线用的框
inceptive	起初的
reproducer	扬声器
xql	XML查询语言
dampish	含湿气的
depasturage	吃草
estreat	征收
slickster	滑头
isogeneic	同系
nicol	prism
hieland	易上当的
fix	装置
spirited	英勇
fake	假造
inviolately	未受侵犯地
cherbourg	瑟堡
variant	不同
uninterrupted	不间断
credulously	易被瞒
clump	丛生
slack	松弛的
unhand	把手从……移开
yaup	喧嚷声
sleight	熟练
fescennine	下流
chronological	按年代顺序排列的
concretion	具体化
impervious	不会受到损伤
weekend	度周末的
tenement	住户
decline	下倾
noncommissioned	未经任命的
depressed	降低的
stole	圣衣
scathe	伤害
collectedly	收集成
aerobiological	`eErEJ9baIE`lVIkLl/
unerring	正确的
acardiac	无心畸形
collaboration	协作
attune	使相合
feetfirst	脚先着
affective	表达感情的
spcc	Children
frock	上衣
rightable	可纠正
reconvict	再判决
unstuck	未粘住
phatic	交流感情
mre	Education
vituperator	辱骂者
desquamative	脱皮的
damson	西洋李树
stolidly	神经麻木地
discarnate	无形
invariably	不变地
unbrace	使衰弱
fenestrate	有窗状小孔的
exsanguinate	给……除血
castration	阉割
follicular	小囊的
cosmin	齿鳞质
pathoneurosis	躯体神经机能病
igmp	Group
cloze	完形的
overpowering	无法抵抗
surgy	动摇得很厉害的
ozoniferous	生臭氧的
ramous	分枝的
irreproachable	无过失的
auxocardia	心增大
knickers	灯笼裤
nonpolicy	非政策
landowning	拥有土
clc	Canadian
charity	慈善
melpomene	墨尔波墨
axial	轴的
foreworn	=forworn
sheriff	州长
tied	打结
chloronaphthalene	氯奈
landtag	州议会
vote	选举
problematic	有疑问的
skfros	=Skyros
glacieret	小冰川
redroot	西风古
filamentary	细丝
democratic	民主政体的
suk	苏克人
nottingham	诺丁汉
ghosty	鬼
untilled	未耕种的
penuche	红糖糖果
irbm	missile
preharvest	收获前的
romping	嬉戏喧闹的
wooden	木制
desertion	开小差
stole	长巾
idea	观念
coitus	性交
scud	飞云
searching	透彻
ethnology	人类文化学
ultrasonic	超音速
rodingitize	使异剥钙榴岩化
tsktsk	啧啧
unpolarized	不分化
apologist	护教论者
sextodecimo	十六开本
fleece	羊毛状之物
lacunosis	网状的
hassle	与……争辩
machiavel	=Machiavellian
topnotch	最高质量
romany	吉普赛人
piping	吹笛
encourage	怂恿
gail	盖尔
protective	给予保护的
disproduct	有害产品
sliprail	活动栅栏
promotional	增进
uv	紫外的
compliment	致意
rhapsodize	狂热地说
featherhead	轻率的人
unate	非蚀
cripple	跛子
leatherette	假皮
supporter	赡养者
exacting	苛求
herpesvirus	疱疹病毒
reader	读本
preface	绪言
think	以为
quinquepartite	由五部构成的
participation	参与
oldwomanish	谨小慎微的
stick	戳
visional	梦幻般
communistic	共产主义者的
succade	蜜饯
cubital	前膊的
loutish	粗野的
psychosomatic	受心理影响
algometry	痛觉计
gascony	加斯科涅
affected	受侵袭
boston	波士顿
mortuary	死亡
roupet	=roupy
subcollege	准大学程度
depart	起程
unhesitatingly	坚定
vfr	visual
cutthroat	凶手
gilt	镀金的
vaporization	汽化器
questionnaire	问卷
vehicle	车辆
henceforward	从今以后
straightaway	直线跑道
great	主要
bosom	中间
poacher	偷猎者
ac	装甲车
awry	歪曲
preantiseptic	防腐法采用前
hydrometric	液体比重测定
choreographic	舞台舞蹈的
quadrilingual	四国语言的
geology	地质概况
slavic	斯拉夫语
californiate	使加利福尼亚化
emit	发行
undiscerning	迟钝
unlovely	不可爱的
baconian	培根哲学
volti	翻页
imparadise	使成乐园
cone	使成锥形
allspice	多香果
befitting	适合的
weather	处境
trousseau	嫁装
beaux	求爱者
beat	打
leavisian	利维斯派的
connotative	内涵
glonoin	硝酸甘油
interpolymer	互聚物
anthropopathism	认为神具有人性的说法
monostylous	单花柱的
earcap	耳套
versification	作诗
indeliberate	不是故意的
increately	非创造出来
resolved	下定决心
spiritist	巫师
incumbrance	阻碍物
procurance	达成
ratcatcher	灭鼠者
keylight	主光
diphenyl	苯基苯
sheller	剥壳者
isogony	等称增长
tuberculoma	结核瘤
spasmogen	致痉药
nautical	海军
unspecific	非特定
patency	明显
allspice	多香果粉
pleader	抗辩人
leavisian	利维斯追随者
demeanour	举止
illinois	伊利诺斯州
chopfallen	垂头丧气
teachable	驯良的
pond	筑成池塘
hitchhiker	顺便插入的广告
characterful	有特殊风格
comptroller	审计员
spatchcock	急忙填写进去
cansure	谴责
retirement	退休
phenobarbital	镇静安眠剂
current	草写
sandbag	用沙袋打
lamelliform	薄片形的
unenlightened	无知的
reserved	保留
corrupt	腐败的
kinchin	小孩
nettlefish	水母
inner	里面
hodiernal	现在的
add	又说
akkadian	阿卡得人
echopraxia	模仿动作
herts	=Hertfordshire
paramedian	正中旁的
lunisolar	由于日月的引力的
beamed	有梁
auditorial	审计员的
outvoice	话讲得比……更响
lino	漆布
percolation	浸透
pinealoma	松果体瘤
galvanization	镀锌
ferromagnetic	铁磁的
aperitive	轻泻剂
firebox	机车锅炉炉膛火室
snuffle	鼻音
paludal	沼泽
interchannel	通道间
extramural	市外的
couchant	蹲着的
streptococcus	链球菌
recusancy	不服国教
grained	漆成木纹
orthography	正字学
remediless	不可救药的
droppable	可抛弃
unreachable	取不到
interlocutory	对话的
jobbernowl	愚蠢
chenab	奇纳布河
aesthetic	美学的
delian	得洛斯人
fade	淡入
bukharan	布哈拉
federative	联邦性的
disfavour	讨厌
levity	轻率
cembalo	羽管键琴
preterlegal	超过法律范围的
vineyardist	葡萄园主
interterritorial	领土间
charismatic	超凡魅力
justificatory	用以辩解的
spirivalve	有螺状壳的
acrid	刻薄的
biscay	Bay
unprincipled	不合人道
ephesians	以非所书
injunctive	命令
splenii	splenius的复数
jinn	神灵
idahoan	爱达荷州
overrun	蔓延
uss	美国军舰
politically	贤明地
anecdotical	轶事
eligibility	适任
riskily	冒险地
auxiliary	辅助的
jetty	防波堤
teleordering	远程订购
priscan	古代存在
imino	亚氨基的
nattily	整洁地
adi	每日允许摄入量
neighborly	友好的
xeroma	干眼病
mesmerist	催眠术师
inbreath	吸气
ethyne	乙炔
immensely	广大
beg	乞求
naiad	女游泳家
depredate	掠夺
imperturbability	沉着
gastrotomy	胃切开术
porcellanic	=porcelanic
sebaceous	脂肪的
billingual	开发多媒体英语教学软件
interlinear	写在行间
suicidal	自毁
leggy	有优美的腿
retgersite	镍矾
leporid	兔类
mismate	使配合不当
paramnesia	错构症
absinthism	苦艾酒中毒
pascual	牧场的
cromerian	克劳默文化的
prolocutor	发言人
piffle	蠢话
brute	残忍的
paroquet	=parakeet
fibrotic	纤维化的
nonfat	脱脂
unstatutable	非法定
oust	驱逐
extrusion	挤出
finned	有鳍状物的
fat	丰满的
playmaker	场上组织进攻的队员
doneness	煮熟的程度
ciliiform	睫毛状的
exacerbation	增剧
screech	急煞车声
luganda	卢干达语
abridgement	缩短
smeary	弄脏
interstage	级间
bungaloid	到处是平房的
everyman	一般人
grovy	树丛
sorus	芽胞囊群
regality	君权
diquat	敌草快
knap	猛咬
winded	喘气的
peremptorily	专横
isodose	等剂量
inofficial	非正式的
forepost	=outpost
redescend	再次下
conceitedly	自满
forwearied	筋疲力尽的
anopisthograph	单面有字的书ic//
ho	引人注意
detectivism	侦探工作或活动
stag	阉割过的雄鹿
lapse	流逝
thin	稀薄
your	你的
anthropography	人类地理分布学
folkie	民谣歌手
thalassocrat	海上统治者
monochromical	单色的
unspoke	unspeak的过去式
rate	估价
inadvisable	失策的
think	想
true	真正
comparative	比较的
oxidize	氧化
recessional	后退
lollardry	=Lollardism
insignia	勋章
anomalism	畸形物
unfetter	解放
insect	昆虫
endoradiosonde	体腔内无线电测压器
corba	公用对象请求代理程序体系结构
persuade	某事
consummative	使完婚
hemic	血
unicef	United
commencement	毕业典礼
ohm	欧姆
bim	巴巴多斯人
menstruous	行经
haslet	肚杂
habited	穿着衣服
piss	小便
moocher	乞丐
anil	假蓝靛
nystatin	制霉菌素
idly	空闲
ritually	仪式上
determinately	有限花序
assertor	主张者
nondelivery	不能引渡
funneled	漏斗状的
pots	Plain
verein	联盟
ethnography	民族志学
cloture	结束辩论
tuscarora	塔斯卡洛拉语
anfractuosity	弯曲的道路
undisguised	无伪装
wicker	柳条制的
appoint	约定
antihypertensive	抗高血压
smaragd	祖母绿
keno	一种赌博
station	地位
fluxional	不定
smooth	使优雅
affricative	塞擦音
eliminate	消除
encephala'	NULL)
complice	共犯
jaunty	感到自信和自满的
spasmodical	痉挛
lymphocytotic	淋巴球增多
uncorrectable	不能补救的
puff	喷出
photoactinic	能产生光化作用的
brake	刹车
syllabicate	使分成音节
interpretable	可判断的
calydonian	boar卡莱敦的野猪
incautious	不谨慎
ravenous	狼吞虎咽
tachymetabolism	代谢过速
applique	嵌花的
redefinition	重新定义
scholastic	经院的或经院哲学家的
succinct	压缩在小范围内的
socially	善于交际
bedspread	床单
showup	揭发
mirador	眺台
bromo	镇静剂
unrelenting	不宽恕的
hospitium	=hospice
thin	使变薄
burnable	可燃
nobbily	华丽地
sculptural	雕刻的
ruthlessly	冷酷
decentralization	地方分权
bef	British
subgum	素什锦的
engage	交战
ustulate	烧焦
damocles	为叙拉古暴君Dionysius的宠信
resentment	愤恨
tuberculoid	结核样的
retem	杜松豆
postmortem	死后发生的
imo	My
rhodonite	蔷薇辉石
sampan	小船
nii	National
aglare	闪耀地
corsetry	紧身衣销售业
floatable	可浮起的
revisionary	修正的
guardrail	栏杆
benchboard	台式配电盘
shelly	有壳的
blithesome	高兴
voluminous	卷数多
carcel	卡索
triblet	心轴
lamellibranchiate	瓣鳃类
agranulocytosis	粒性白血球缺乏症
rockabilly	山区乡村摇滚乐
availablein	有效范围
orient	上升
weakly	有病地
teratogenic	产生畸形
rhizoma	根状茎
altherbosa	高草群落
jeer	戏弄
chief	酋长
baroque	结构复杂
versicolor	杂色的
striola	细条纹
repairer	修补者
impertinently	不切题
hydrargyrism	水银中毒
land	登陆
mealtime	进餐时间
discontinuous	间断的
cater	备办食物
relativist	相对论者
chomskian	乔姆斯基语言学理论
canaliculate	有细管的
chaliced	有杯状花的
surgicenter	手术中心
mere	仅仅
hearthstone	炉底石
facetiae	黄色小说
flicker	扑动
unmeditated	未加思考的
daunomycin	红比霉素
camshaft	凸轮轴
iadl	of
axial	轴向
ringneck	环颈动物
wog	病菌
unisonous	和谐
repetitiousness	反复
catastrophe	大灾难
azoth	水银
chromocentre	染色质核仁
cyanine	青色素
gherkin	黄瓜之一种
hell	苦境
checkerwork	方格花样
expeditiously	敏捷
mutiny	叛变
atapi	AT
rantipole	粗野
exclusion	排除
manful	勇敢
bowery	象亭子
aculeated	有刺的
diplopia	复视
toyama	富山
centrifugate	利用离心力分离
ganelon	冈隆
protomartyr	第一个殉教者
chiefless	没有首领
autumnal	秋天
enactory	制定法律
expatiation	详细的说明
escot	供养
dimensionality	幅员
bibliographic	著书目录的
phase	阶段
divorce	与……脱离
relapse	故态复萌
forgive	宽免之债务
hex	施魔法
other	另外一个
exoneration	免罪
unsmirched	干净
shutter	以百叶窗遮闭
capacious	宽敞
objectionable	引起反对的
quezon	City
iconographic	图示法的象征
anopia	上斜眼
blithering	胡扯
yaffle	绿色啄木鸟
cosmopolitan	四海为家的人
tundish	漏斗
smtp	Simple
unformulated	未用公式表示的
children	孩子
adidas	阿迪达斯运动服
craquelure	龟裂缝
regulate	调节
deterministic	确定性的
lacunaris	多孔
pockpit	=pockmark
crumb	弄碎
auditorship	会计检查官之职
ferine	野生的
molina	Molina
tajikistan	=Tadzhikistan
distractingly	精神涣散
opal	猫眼石
fetial	古罗马祭司团成员
investigatory	=investigative
renvoi	驱逐出境
fanlike	扇状的
paumotu	Archipelago
sanious	由脓液构成的
prescription	命令
countersign	连署
samisen	日本三弦
autoantibody	自体抗体
tdy	temporary
excitation	兴奋
nebulize	使成雾状
mucosity	粘
microlens	显微镜头
baccate	结浆果
wysiwyg	Get
myriorama	万景画
anthropophagi	食人族
virologist	滤过性病原体学者
roomily	广阔地
censurable	可非难的
doodling	乱写之物
ruttish	交尾热
gunn	耿氏效应
modernise	=modernize
redemptive	赎回的
nucleoplasm	核浆
collaborative	合作的
rouncy	马
enemy	敌方
force	军队
clausal	条款的
mohammed	穆罕默德
wiring	配线
infinite	无数的
glace	糖渍
rumble	吵嚷声
evangelical	新教会
npr	国内公用无线电台
fable	神话
carpaccio	擅用红白两色而得名]
outbound	开往外
circle	环绕
speiss	黄渣
nonenzymic	不涉及酶作用的
exemplariness	可作模范
qbp	bishop''s
peremptory	专横的
grindingly	虐待地
chlorine	氯
slovenry	凌乱
rosace	圆花窗
avidity	热望
langobardic	伦巴第的
immensely	无限
bhutan	不丹
imploringly	哀求地
hemimetabolic	具有半变态特性
escuage	服役
usufructuary	有用益权
fac	controller空军前进控制员
peroration	结束语
nonnasal	非鼻音的
osfcw	Coordinator
inhibitory	禁止
pad	衬垫
frostbitten	受霜害
form	形态
droit	权利
bleb	气泡
portent	征兆
libratory	游移
thalassochemical	海洋化学
pyramid	叠罗汉
gadgetry	小配件
buirdly	高大结实的
treehopper	角蝉
somasteroid	体海星纲
netware	Novell公司出的网络操作系统
sullenly	阴沉
exiled	流亡的
trothplight	订婚
coprozoic	生长在粪便中
upcountry	向内的
supertonic	上主音
hamel	阉羊
trusteeship	托管领土
dragon	龙
biconical	双锥的
wrecker	使船失事的人
carnaby	Street卡纳比街时装
lusus	naturae
mechanomorphic	机械形成论的
unredeemable	不能赎回
perceptive	有理解
haligonian	哈利法克斯
legendary	传奇故事书
zip	一种压缩的文件格式
bugger	鸡奸者
handgrip	手柄
semirural	半农村的
criosphinx	狮身羊头像
ultrasonic	超声波
napier	纳皮尔紫狼尾草
intensively	集中地
mammonist	拜金主义者
mpeg	Pictures
immediate	立即的
early	早先的
cyclostomatous	圆口动物的
abundant	盛产
intellectualize	智能化的//aIz/
process	加工
hitchhiker	搭便车的旅行者
cowson	杂种
plasticize	使成可塑体
calyculate	有杯状小体
illiberally	吝啬地
constantia	康斯坦莎
insincerely	无诚意地
rosebud	初入社交界的少女
pathbreaking	开路先锋的
epistrophy	异常形态的恢复正常
squiffer	六角形手风琴
graphy	书写符号
antiscience	科学无用论
cardoon	刺棘蓟
print	印章
perplexed	困惑的
treasonous	叛逆的
complaisant	殷勤
irregular	无规律
sightsinging	视唱
verbose	冗长的
servohydraulic	伺服液压控制的
atria	排泄腔
divisive	分裂的
therapsid	兽孔目的
develop	发育
episcopate	主教之职
cytomorphology	细胞形态学
unshaped	未定型的
anticatarrhal	消炎的
gitano	吉卜赛男子
gobbledegook	冗长的官样文章
amputation	切断手术
ayh	Hostels美国青年招待所
photosensitivity	感光性
footsie	脚
sforzando	加强
heah	=here
autunite	铀云母
nsm	Smoking
mightily	非常
corrosively	腐蚀
predikant	荷兰新教的牧师
hingeless	无铰链
asynergy	协同不能
dixy	露营用大锅
harmoniously	调和
cazique	热带金莺
zany	愚蠢的
deprecatingly	恳求
shindy	喧哗
fallalery	无用的饰物
telomitic	=telocentric
gentile	非犹太人的
humble	使……卑下
pentlandite	硫镍铁矿
babiche	皮条
extemportize	即席演说
adrenocorticotro	tIkEJ`trCpIぶ世喙檀
avery	艾弗里
yva	Yangtze
palimpsest	重写本
chaldaic	居于古巴比伦之闪族人
nonluminous	不发光
tacket	钉
snr	Snr
samel	未烧透的
lactescence	乳汁状
unmarriageable	不能结婚
filterability	过滤性
maungy	闹别扭的
considerate	考虑周到的
selective	选择的
chordoma	脊索癌
varangian	瓦兰吉人
pop	砰然声
ostracean	牡蛎的
homeric	荷马式的
acinus	浆果
obstruct	阻隔
indigent	贫乏的
peacekeeping	执行停火协定的
recurve	向后弯曲
trichi	=trichinopoli
shirttail	远房的
ciliiform	均匀细密的
hardy	艰苦的
breadless	无面包的
gorgy	多峡的
tattered	褴褛的
thorough	彻底的
sentiment	情操
wetly	潮湿地
glum	阴郁
ennoble	封……为贵族
hepatic	肝
doge	共和国总督
rockwork	天然岩石群
translation	译文
ablator	烧灼体
some	一些
cupule	吸盘
gunflint	引火燧石
grandchildren	孙子
rendrock	爆破炸药
broadloom	织为单色宽幅
watchword	标语
virtue	优点
tritural	适合于研成粉
cytotechnology	细胞技术学
re	symb
resojet	共鸣式喷气发动机
pinda	花生米
crepuscle	朦胧
displeasing	不愉快的
eerie	奇异
rook	欺骗
neuropathic	神经病
alumni	男毕业生
planetokhod	行星探索车
pendulous	下垂的
mediation	调解
luteolin	毛地黄黄酮
preexilian	犹太人被放逐至巴比伦以前的
former	创造者
lentando	渐慢
wetter	湿润剂
conferment	给予
tenor	要旨
diamantiferous	藏有钻石的
mango	芒果
waste	挥霍钱财
pulpous	纸浆状
mediaeval	中世纪
chime	和谐
average	海损
endophilic	生态上与人及其所处环境有关联的
diplon	氘核
frostbiter	冬季赛艇运动用的赛艇
cleaver	突出的悬崖
leapfrog	跳背
constrictor	使压缩之物
phonotypy	表音速记法
intricacy	复杂
gyroidal	回转的
sudbury	萨德伯里
lunar	月
mootah	大麻
peasen	pease
footbath	洗脚盆
silverless	不用银制
giggit	急运
crinkleroot	美洲荠
uncalculating	未经过仔细分析的
introspection	内省
partisanship	党派性
splendidly	壮观地
infrequence	罕见
unaccustomed	奇怪
somesthetic	体觉
controversy	辩论
foredo	毁
punctulated	有细孔的
concourse	合流
amaranthine	紫红
semiotic	记号语言
galactometer	乳液比重计
sadly	悲痛
aquatic	水的
tuberculize	使感染结核菌
mediatrix	女仲裁者
rollaway	滚移的
settltment	决定
creamometer	乳脂计
curvulate	稍有弯曲的
endobiotic	体内生
crudity	不熟
abrade	磨损
pickeer	侦察
hatchel	麻栉
cubanize	使古巴化
folksy	无拘束的
pythagoric	=Pythagorean
vote	选票
attenuation	稀薄化
adh	抗利尿激素
watcher	注视者
obstruct	障碍物
basal	基部的
constellate	使形成星座
fabular	寓言的
qualmish	受良心责备
motivic	乐旨
orient	使朝东
magnitude	巨大
ideograph	象形文字
contrasuggestible	反暗示的
cinematic	影片
cuticular	表皮的
contretemps	意外事故
justus	贾斯特斯
trench	电缆沟
ropery	开玩笑
incondite	粗劣
fleshy	肉
haematothermal	温血的
manner	习惯
heptahydrated	七水混合物
unneutral	片面
nhg	New
swash	溅出
awol	擅离职守的
after	在……后面
responsion	应答
sternutation	打喷嚏
siphonal	水管
squareflipper	髯海豹
vila	维拉港
indigenization	本地化
other	其他
paleographic	古文书学的
irreproachable	无缺点
tabid	衰弱的
napooed	杀死
fat	File
wirephoto	有线传真
counteragent	中和力
annularity	轮状
ungulate	蹄状的
rural	生活在农村的
aau	Amateur
midas	善赚大钱者
downhearted	垂头丧气
pout	生气
leftover	剩菜
navigate	使通过
canned	喝醉了
singlehanded	单独的
abalone	鲍鱼
composition	作文
subassembly	组件
australian	澳大利亚的
everbearing	连续不断结果
turgor	浮夸
square	直角尺
caterwauling	抱怨声
myositis	肌炎
dun	讨债者
prepay	预付
proparoxytone	在语尾算起第三音节读重音
arrogancy	傲慢
scene	现场
phanerite	显晶岩
hematinic	补血
isapi	Interface
emanant	放射式
tumultuous	喧嚣的
unsolvable	不能解决的
crakeberry	岩高兰之浆果
notable	值得注意
unpenetrable	不能穿入
assuming	傲慢
zulu	字母Z的代称
collarless	无马轭的
lacedaemonian	古代斯巴达
dare	挑战
dmd	Medicinae
penitential	苦行赎罪的
doloroso	悲痛
folly	轻松歌舞剧
pinnatilobed	裂
iniquitious	邪恶
novell	美国Novell公司
judaeophile	对犹太人亲善
rumansh	=Romansh
pusher	作家
indoor	户内
salvolatile	碳酸铵
context	上下文
jobber	批发商
uncommitted	未被授权
visa	维萨信用卡
magnitogorsk	马格尼托哥尔斯克
hilum	粒心
undrape	除去帐幕
paragraphic	短评
turning	转向
wobble	使摇摆
diversion	牵制
antiquate	使古旧
hummock	山岗
slaughter	残杀
poser	装腔作势者
acta	Carriers
secularity	烦恼
landowning	有关土地所有权
cymometer	频率计
renounce	断绝关系
bedding	被褥
finale	最后的一个乐章
moonstruck	神经错乱
quarrying	采石
ransack	掠夺
emotivity	表现感情
fanged	有毒牙
wanta	=want
agave	龙舌兰属植物
living	现存
ricket	失风
hybridist	杂交工作者
giglot	轻浮的女孩
coverall	包罗万象
zenana	闺房
bibliographical	书籍解题的
hamulate	弯曲
fulminating	呵斥
custodial	圣物保管容器
microecology	狭域生态学
hematosis	造血作用
armoric	阿莫里凯语的
flagitious	罪大恶极的
diamante	镶人造钻石装饰
belled	有钟形花的
xylocarpous	结硬木质果的
pyroligneous	干馏木材而得
amt	丹麦最大的行政单位
ang	Newspaper
booker	登记人
revision	修订
farmisht	糊涂的
section	节
cataphyll	初叶
shmear	=schmear
harbor	海港
nymphomaniacal	患慕男狂的
judaist	尊崇犹太教风俗的人
fecit	……画
motoric	肌肉运动
picnicker	郊游的人
aeroengine	飞机引擎
indefensible	无辩护余
grail	杯
hill	山岗
winston	温斯顿
jowl	颚骨
foppishly	艳冶
explanate	展开的
genearch	家长
intensively	强烈
shirty	发怒
blotchy	有泡的
inappreciably	微不足道地
inclip	围绕
oxyphile	=acidophil
skeletonize	使成骸骨
intestinal	肠的
deanery	教区
disgustful	唾弃的使人发呕的
humanly	用人力
valuable	贵重
holytide	宗教季节
ciliary	毛状的
ageratum	藿香
crucifixion	磨难
sirenian	海牛类
fast	牢
imploring	哀求的
outbuild	比……建得更多
crystallizability	可结晶性
meshwork	网
tartarus	地狱底下暗无天日之深渊
hpna	Alliance
parietal	腔壁
anopisthograph	单面有字
coed	男女兼收的
quinquevalence	五价
crosspiece	横木
concluding	结束
isomorphic	同形
terawatt	太瓦
color	脸色
cotter	住茅屋的人
verdigris	碱性碳酸铜
kirmess	大市集
insnare	诱入圈套
critic	吹毛求疵者
jaguar	美洲虎
chime	打
softening	软化
square	自乘
saury	刀鱼
shady	成荫
drive	猛击
unneighbourly	不友善的
feirie	灵活的
kinematograph	电影放映机
ingather	收入
crystalloid	晶体
betweenbrain	间脑
asperity	严酷
crashworthiness	防撞性
call	通话
piercingly	刺透
documentary	记录片
uniat	东仪天主教会
mile	英里
striking	显著
sided	有面
civil	市民
coombe	深陷的山谷
concentricity	集中
irene	女性名
bipolar	双极
tchick	发出催马快跑之声
newsworthy	有报导价值
quaggy	沼地的
make	安排
pondokkie	茅棚
asleep	睡熟
flexible	可通融
out	明显地
vesicle	小泡
unbolt	打开
shag	粗毛
shakespeareana	莎士比亚研究资料汇编
heavy	沉重的
appealingly	哀求地
passionflower	西番莲
flush	奔流
inorb	围绕
misapplication	误用
reassess	再评价
althea	蜀癸属植物
reptilia	爬行动物
yardbird	新兵
southwesterly	向西南
variedly	各种各样
octad	八个一组
goiterogenic	=goitrogenic
kenspeckle	引人注意的
nongreen	不含叶绿素
eulogist	称赞者
claptrap	讨好
impalement	围住
inapplicable	不适用的
westy	Highland
loaner	债权人
counterphobic	反恐怖
episcopalian	美国圣公会教徒
hent	企图
exarate	足翅不贴着在身体上
npcf	Pollution
hand	指针
varia	杂物
leachate	沥出液
forcible	有说服力
humph	哼
farcy	鼻疽
square	彻底的
walnut	胡桃
hookey	多钩的
suspension	吊
monody	独唱颂歌
lionize	游览名胜
irascibly	易怒地
furfuraceous	糠的
plainchant	单声圣歌
soigne	整齐
electropositive	带阳电的
codex	法律
semiconducting	有半导体特性的
bethought	bethink的过去式和过去分词
ensepulcher	安葬
codebook	电报密码本
ferromagnesian	含有铁与镁的
cunt	女人
campbellite	基督门徒会教徒
newsmagazine	新闻杂志
amnionic	有羊膜
reprobate	非难
toxicomania	毒物瘾
fuzz	变成绒毛状
justly	正当
orbiculate	完整的
quadrable	可为平方的
superjacent	在上
mythologize	写神话
apocrine	顶泌
respectfully	谦恭地
yucatecan	尤卡坦人
tarred	涂了焦油的
unprescribed	自愿
creosote	木馏油
position	安置
adman	广告部门职员
tweedle	以音乐诱惑
antifederalism	非盟政主义
floorer	难以解答的试卷
infracostal	位于肋骨下面
sassy	时髦的
braggadocio	吹牛大王
cosigner	联合签署
saucebox	傲慢的家伙
readdress	改写受信人姓名地址
hydromancer	水占术
unverifiable	无法证实的
incondensable	不能凝缩
zugunruhe	迁徙兴奋
piezometry	压力测定
bellmouthed	钟口形
vermont	佛蒙特州
munificent	慷慨的
apoplectic	中风
coverer	包装工人
unhealthiness	有病
pedagoguism	儿童教授法
saint	成为圣徒
tetralogy	四部曲
compulsively	强制
overfraught	过于充满
pipestem	细长的东西
hydri	的所有格
virginal	七世纪的小型有键乐器
nidificant	筑巢的
repossess	复得
oversew	缝合
dogmatical	教义的
ericeticolous	成长在石南丛中
recurrent	周期性发生的
horticulturist	园艺家
choplogic	好辩的
medieval	中世纪的
building	建筑物
akkadian	阿卡得人的
cutout	删除部分
oxenstjerna	Count
recidivous	经常犯罪
cast	抛
lamp	灯
alg	globulin
unrelenting	无情的
interuniversity	大学校际
handlebar	手把
pob	box
whosit	=whoosis
quilter	绗缝附件
euphoriant	安乐药
busulphan	白消安
blackcoat	职员
cutinize	使充满蜡状质
greengrocery	青菜
accounting	会计学
deconvolution	反褶积
lonely	孤独
arblast	=arbalest
apperceive	洞察
rpg	Games
spasmolytic	解痉的
pastorly	牧师
deawood	韩国大宇集团
oxter	挽住……手臂
rusty	生了锈的
marasmus	消瘦
fenderboard	挡泥板
mdcccxcix	罗马数字
double	使加倍
larksome	嬉戏的
tanager	唐纳雀
alvera	阿尔维拉
cutlet	肉片
inspan	把牲口套于车上
bir	Revenue
moult	换毛
alimentative	富于营养
meanly	卑贱
housecraft	管家的技能
fakement	欺骗
plastosome	=chondriosome
overtop	高出
pineland	松林
refocillate	使振作精神
solecist	失礼者
unbarbered	未剃须的
baby	婴孩
weathermost	最上风
tv	Tuvalu
accessible	可理解的
sustainable	足可支撑的
sioux	苏人的
spiky	装有大钉
interrogate	询问
haversack	帆布背包
affirmatory	肯定的
sensually	官能地
pbx	exchange
amitriptyline	阿密曲替林
dodgems	碰碰车
masquerade	化妆舞会
back	向后
puree	煮成浓汤
flighty	轻浮
washing	洗涤
shebang	赌场
scute	鳞甲
nannyish	旧式
columbus	哥伦布
barbell	杠铃
annulose	有环的
trimetallic	三金属的
tympanic	鼓室的
piffling	不足道的
incurve	向内弯曲的事物
datum	资料
kent	英国东南部州名
baathist	叙利亚社会党党员
despatch	派遣
overfall	溢流
batrachian	无尾两栖动物
morillo	公牛颈背部肌肉
captivation	迷惑
doodad	新出品
bethel	圣
grouch	不高兴的人
supracrustal	上地壳
choice	宠爱
waldensian	韦而多教派
contrite	由悔悟引起的
supplicant	恳求
process	推移
undevout	不虔诚的
drainage	排泄
interdisciplinary	各学科间的
topmost	顶端的
indeterminable	不能决定
gloriously	辉煌
retch	作呕
karnaugh	卡诺图
paranoia	偏执狂
accoutrements	服装
usng	United
hawkshaw	侦探
iis	Information
outwardly	表面地
physiognomic	人相的
roguery	流氓行为
fasten	系
aeolian	伊奥利亚人
garget	乳房炎
utilization	利用
wrackful	毁坏的
edification	启迪
catty	猫的
warden	学监
zakiya	扎吉雅
steaminess	雾深
rassle	摔跤
atomics	原子学
beplaster	覆满
parade	阅兵场
paraplegia	下身麻痹
obstreperous	喧嚣
liaoning	辽宁
holmic	含钬
unassured	不确定的
dunk	浸
chromatophil	嗜染性
enlace	捆扎
zemindary	=zamindari
coaly	煤状
electrothermal	电热的
flagging	衰弱的
biplane	复翼飞机
rupee	卢比
arris	棱
sensation	耸人听闻
hedge	障碍物
topology	布局
loach	泥鳅
natalist	鼓励生育者
preclusive	除外
subthreshold	低于最低限度
bovril	肉汁
saxicavous	钻岩
pallet	货盘
astonishing	可惊异
necromantic	降神术
uncorrectable	不能修复
truer	真的
hageman	哈格曼因子
origin	由来
mandamus	发训令
pigskin	猪皮革
irritating	气人的
zoosperm	游动孢子
tusky	有獠牙
unblushing	不客气的
acutilingual	尖舌的
insistently	坚持地
scission	分离
historied	史上所载的
pseudoclassic	伪古典
acetate	醋酸纤维素及其制成的产品
selectman	行政委员
antimonarchic	反君主制的
komatsu	小松
asyllabic	非音节的
fawny	近浅黄褐色的
hairy	毛似
microscale	微尺度
sneezy	打喷嚏的
kyrie	eleison
recommendable	值得推荐的
cordwood	以单位出售或成堆积之木材
begin	开始
farce	笑剧
quintessential	精髓
branch	分枝
taibei	台北
covenantee	订约人
impermeability	不能透过的性质
credited	记入贷方
ebulliometer	沸点测定器
murky	黑暗的
vexatious	伤脑筋
vegetative	植物
stickpin	领带夹
bland	温和的
slicker	雨衣
seashell	海贝壳
plesser	叩诊槌
formulation	用公式表示
effortless	不费力气
scruple	吩
fasti	岁时纪
unread	无学问的
striated	有细条的
frailish	无力的
picketboat	警哨巡逻艇
charmless	无魅力的
contumacy	拒不服从
trespass	罪过
interiorly	在内部
diplomate	获有官方证明的专科医师
incident	附带
kob	非洲水羚
hemagglutination	红血球凝聚
otherworldliness	理想世界
cramp	月经痛
lot	一块地
scintiscanner	闪烁扫描器
unshakeable	不可动摇
flexional	可弯曲的
incisory	切割用
brobdingnag	大人国
sciolous	知识浅薄的
complacent	得意的
absord	吸收
uproariously	喧嚣地
teens	十多岁
gerontophilia	亲老人癖
lathhouse	遮光育苗室
stomatology	口腔病学
cytochalasin	松胞素
voyageable	能航海
cdrom	只读光盘
nidifugous	孵出后立即离巢
enema	灌肠剂
demob	遣散
foe	敌人
hussif	针线盒
exurban	城市远郊的
hyperrectangle	超矩形
uriniferous	输尿
softgoods	非耐用品
kanaima	被恶鬼附身的人
underlying	优先的
burry	有粗喉音的
pcav	局部恒定角速度
chirognomy	观掌术
tubal	管的
salted	有免疫力的
abbreviatory	缩略
deathtrap	危险的建筑物
plunderage	掠夺
buckhorn	鹿角
pripet	普里皮亚特河
umbel	伞状花序
ogive	交错骨
nomadic	游牧的
viridescent	淡绿色的
develop	发展
cankered	溃疡的
lange	兰格
aurora	极光
nicy	糖果糕饼
triumphant	成功的
rapaciously	贪婪地
murray	默里
abegging	无人问津的
cabbagehead	笨蛋
transact	谈判
exterior	外部
nondiscrimination	不歧视/InEtErI/
usia	Agency
counterplan	替补计划
malacostracan	软甲亚纲的
emotionless	不露情感的
exospheric	外逸层
prise	捕获
distinguishable	可区别的
founder	奠基人
oceanic	海洋的
scant	不足的
pretended	虚假的
poppied	鸦片麻醉的
desertion	遗弃
devise	遗赠给
hemosiderin	血黄铁质
preappoint	预先指定
scheme	阴谋
denominative	自名词派生出来的动词
impleadable	控告的
underivative	不乏独创性
flammable	可燃性的
pyromaniac	放火狂的
deexcite	退激
uncommitted	未遂
syriac	古代叙利亚语
lophobranch	总鳃类的
analogic	类似的
laocoon	拉奥孔
scrap	剪下来的图片
ambidexter	十分灵光
whee	啊
lapidarian	碑文
summarily	立刻
deafening	震耳欲聋
babesiosis	巴贝西虫病
temperate	适度的
tetrazzini	烤制成脆皮
ceeb	Board
unexpired	未终止
unco	奇怪的
sss	选征兵役制
blarney	奉承话
attenuable	能稀释的
yowl	恸哭
antifertility	反受精的
raising	高岗
calcareously	石灰
authenticate	鉴别
vectorcardiogram	`vektE9kB:
concetto	矫揉造作的文体
autochthonal	土著的
gradus	练习曲集
colonize	殖民
streptothricosis	链丝菌病
strunzite	纤磷锰铁矿
sixpenny	六便士
reposefully	平稳地
unexaggerated	未夸张的
gold	金的
comparative	相当的
slimming	减轻体重的
courtlike	彬彬有礼
anonyma	无名动脉
water	水的
msp	Security
levoglucose	左旋葡萄糖
spinster	未婚妇女
roadway	车行道
blueish	带青色
interdependent	ly//
thermotherapy	温热疗法
meadow	牧场
cylindric	圆筒
pharaoh	暴君
veteran	经验丰富的
parachutist	伞兵
nitwitted	傻的
tellus	特勒斯
flagging	逐渐衰退
declensional	变格的
steamtight	汽密
kokura	现为北九州市
paneling	镶板
lycian	利西亚的
plummer	=plumber
incisive	激烈
rif	裁减
decarock	颓废派摇滚乐
divot	一块草皮
dysthymic	心境恶劣
beaker	大口杯
infrasonic	次声
parashah	律法书片段
blah	无聊的
multiped	多足的
vacuole	液泡
seamster	裁缝
sizing	胶料
patteran	=patrin
demisable	可让渡的
acceptable	可接受的
undisguisedly	公然
phenomenological	现象学
serous	血浆
fancy	自负
rout	溃退
heteroduplex	异源双链核酸分子
queenly	慷慨
whammy	晦气
lexigram	符号字
barbate	有须
ilocano	伊洛卡诺人的
barely	仅仅
gorsy	金雀花的
permeable	能透过的
stormy	多风暴的
underactivity	不够活跃
psid	square
esr	spin
crewman	机组乘务员
bfr	Under
stop	难倒
advertising	广告的
borborygmus	腹鸣
sexagesimal	以六十为分母的分数
inscriptionless	无题字
speedily	快快
precipitate	贸然轻率
infundibular	漏斗形
wash	粉刷
tortuous	曲折
regally	为王
society	……社
triangulation	三角测量
scenario	游戏的关
capable	可以……的
sweetheart	求爱
rinforzando	特别加重的
fifth	第五的
dayak	婆罗洲土著的一部族
unreflecting	无思虑
contest	争论
preclusion	阻止
initial	词首
stream	一串
evenminded	平静的
count	伯爵
ironworker	铁工场工人
illyrian	伊利里亚人
enhalo	使有光环
inferior	差
foolery	愚蠢
sloughy	泥泞的
dervish	苦修僧人
eradicable	可根除的
variety	多样性
discretely	分离
calescent	变热
homologous	一致
calcareousness	含钙
lacemaking	饰带
ingressive	进得去的
undissembling	不加掩盖
eia	Industries
microsporangiate	小孢子囊的
shoddy	翻制
other	从前的
doer	行为者
telpher	缆车的
almond	杏仁
colourbred	按特定毛色培育的
perfluorochemical	全氟化合物的
scoot	疾走
collocutor	参加谈话的人
satinize	给……打光
justly	正当地
hoofbound	兽蹄因病而感到疼痛紧缩
giraffine	像长颈鹿的
ingrowing	生进肉内的
separatory	分离性的
such	pro
disuse	废止
proteinic	蛋白质的
gasworker	煤气厂工人
daedalian	巧妙
babe	小孩
fleece	羊毛
seasonal	季节
washy	水分多的
oxidative	具有氧化特性
budding	少壮的
metamorphic	改变结构的
catbrier	金刚刺属植物
coalman	煤商
dogsleep	假寐
tumultuous	喧嚣
cadre	基础结构
regardant	注视的
fresnel	菲
discaire	选播迪斯科唱片的人
foughten	曾为战场
geanticline	大背斜层
anticaries	防龋的
loathing	讨厌
triumphant	狂欢
ferdinanda	费迪南达
idolater	追星族
astylar	无柱式的
for	为了
sequential	连续的
appurtenant	附属的
holomorphic	对当的
evenness	平均
whirlabout	旋转
quizzical	古怪的
mezzogiorno	意大利南部地区
ebracteate	无苞的
halidom	圣
grenoble	格勒诺布尔
ideational	设想的
radioteletype	无线电传打字电报机网络
unbearable	无法忍受的
aethereally	天上的
slipcover	覆盖物
rattling	非常
silenus	森林之神
esthesis	感觉
trination	同日由同一神父主持三次弥撒的庆祝活动
pyrenoid	淀粉核
rawhide	生牛皮鞭
wrecker	失事现场清理人
bicapsular	两蒴
prior	优先的
greensboro	格林斯博罗
homozygously	同型结合
garri	加里
bemazed	恍惚
tumidly	隆起地
yond	那边的
trinkum	=trinket
bacteremically	菌血症
salicetum	柳树园
cytomegalic	巨细胞的
irrevocably	不能取消
barefaced	厚颜无耻
flagitious	极恶的
storage	存储
emotional	情感的
athonite	阿陀斯山
home	家庭
toilworn	工作疲劳
aphorism	格言
suspender	悬挂物
intrada	前奏
sachet	香粉
muciferous	生黏液
riprap	乱石堆
prohibitor	禁止者
premaxilla	前颌骨
hitlerite	希特勒主义者的
numbfish	电鳗
whence	来处
proctorial	代诉人
tubule	小管
rattlepate	愚蠢多嘴的人
concoctive	捏造
eec	汽车废气排放系统
epical	英勇
nowaday	现在的
since	以后
jmb	Matriculation
cao	Administrative
lockbox	有锁的箱子
rollerdrome	旱冰溜冰场
chiller	使寒冷之人或事物
semimilitary	半军用的
thaddaeus	达太
allophonic	音位变体的
dropsy	浮肿
coq	feather
deadass	大笨蛋
willpower	意志力
sexualist	性主义者
impurity	不纯
twistification	扭曲
cyanate	氰酸盐
pedigreed	有来历
sportful	娱乐
wicked	恶劣的
fontal	本源的
evagination	外翻部份
skulduggery	使诈
solyanka	蔬菜肉汤
nameable	可指名
avianize	通过在鸡胚中重复培养减轻的毒力
cirrose	有触毛
numerical	用数字表示的
dioestrous	间情期
daemonic	恶魔的
acpi	Advanced
slip	Line
avail	有帮助
socket	孔
draft	草稿
complete	完全的
ashtoreth	阿什脱雷思
paragon	模范
amphitheater	竞技场
rubberize	用橡胶处理
moroni	莫罗尼
woodland	森林地
fluid	可另派用场的
naughty	没规矩
riproaring	骚动
compere	指挥
craving	渴望
tecnology	儿童学
paper	纸
qbe	by
faint	无力的
costuming	服装
unspiritual	尘世
contest	论争
plangent	轰鸣的
neoplasitc	新造型主义的
feracious	丰富
infantine	小孩似的
excitation	激感
fractionary	断片的
unsubstantial	不坚固的
tumorous	浮华
anamorphic	失真的
stormbound	因暴风雨而被困
multiparty	导致多党并存的选举制度
larghettos	稍慢乐章
wrote	write的过去式
mods	A
bloodless	冷酷的
fadeaway	低速曲球
woody	木头般
smart	大大
lgm	green
spindle	心轴
pierce	穿透
skimeister	滑雪能手
balustrade	栏杆
infeasible	不可实行
borsch	罗宋汤
underbuy	以较定价便宜的价格买进
mesonephros	中肾
imperia	司法权
devotedly	忠实地
hippocampi'	NULL)
irradiative	有启发作用的
wabbly	摆动的
bended	弯曲
chunderous	令人作呕的
hippolytus	希波吕托斯
asynergia	协同不能
vesicotomy	膀胱切开术
luxuriant	奢华
calefaction	加热
weather	使风化
goonda	流氓
holoscopic	纵观全局
euclidean	欧几里得的
motherhood	母亲身份
auriga	御夫座
glary	光辉
stager	老练的人
relativistic	相对论
iridaceous	鸢尾属的
internality	内在性
rhizophilous	寄生于根上
maldivian	马尔代夫
jollo	社交性聚会
ghaut	河边的石梯
transcortin	皮质素传递蛋白
fuliginous	烟垢的
fudge	逃避责任
dae	航空学博士
prayerless	不祈祷
wisely	精明地
silly	愚蠢
lyssophobia	狂犬病恐怖症
breathlessly	闷热的
nonbank	与银行无关的
stage	举行
phimosis	包皮过长
wob	washed
macadamize	简易地铺装
scraggy	凸凹不平
ramequin	小干酪蛋糕
insignia	徽章
objurgatory	非难的
classroom	教室
belletristic	纯文学的
lewdness	淫荡
contiguous	接近的
bullous	大疱
sortie	突围
translatese	=translationese
navvy	挖土机
gingery	姜味的
rachiodont	具脊齿
beneficially	获利
faithlessly	靠不住
enunciate	阐明
exhalable	可蒸发
cloddish	粗鲁的
floodgate	水闸
lockram	旧时英国产的)
red	革命
pronounced	显著
anamorphoscope	歪像转正的曲面镜
outrecuidance	目空一切
antibiotic	抗生素
avifauna	鸟类志
borickite	磷钙铁矿
vainglory	极度的虚荣心
compo	混合涂料
forficate	分叉的
fighter	战士
clubbed	棒状的
involuntarily	无心
ppcp	Platform
pilot	领航员
final	最终的
nervy	冷静的
blackout	灯火管制
tetrachloroethane	n/
pucka	第一流
polychresty	有多种用途的东西
tutty	未加工的氧化锌
immunise	使免疫
lumme	噢
actinotheraphy	放射疗法
bhoodan	捐地运动
deliverly	灵巧地
twain	双
inefficiently	无效率地
yaren	亚伦
courtesy	谦恭
xsl	Stylesheet
interbang	"?"
instant	直接
irreversibility	不可改变性
studiously	好学地
exfacto	根据事实
nethermost	最下面
inexactly	不正确地
sweetmouth	向……献媚
cainozoic	新生代的
peccavi	认罪
subchloride	低氯化物
leathercraft	皮革艺品
cero	大马鲛
sleeveless	无袖的
parnassian	希腊帕纳塞斯山
budo	武道
hrip	pace
identifiability	可辨认性
bracteal	似苞
tenebrescence	变色荧光
oceanological	有关海洋学的
tergiant	显示出背部
vhs	Video
invectively	恶言恶语
doughy	半熟
mediamorphosis	传媒歪曲
maravedi	铜币
lateral	边音
tapotement	叩抚法
parietal	学院生活的
virogenic	病毒原
supposition	假定
terrier	国防自卫队
shit	企图欺骗
cardsharping	职业性之诈赌手段
orbicular	完整的
wuxi	无锡
calfbound	用小牛皮作封面
admitted	被承认
argosy	商船队
pyemic	脓血症
meikle	=mickle
wiredrawn	抽成铁丝的
timebargain	期货买卖
brittany	布列塔尼
deficient	不完善
babycham	"杯杯香"
condensator	冷凝器
sporter	运动者
microcomputer	微型计
dissolute	风流
frigidarium	冷水浴室
microstomatous	小嘴的
crannied	裂缝的
san	Networks
sewer	下水道
hazily	朦胧地
stage	上演
easterly	向东方
fenestrate	有窗
platitudinous	陈腐
face	表情
noodlework	思考
puddening	船首碰垫
tortuous	转弯抹角
ftc	Commission
videography	摄像
divinely	象神一样
heliograph	用太阳摄影机拍摄
macroengineering	大规模工程
rangeland	牧场
undershrub	小灌木
rhabdome	=rhabdom
ethnomusicological	人种音乐学/y/`eWnEJ9mjU:zI`zIkE`lCdVIkLl/ad音乐学
mosstrooper	匪徒
icehouse	冰室
nonstriker	没有接到对方来球的击球员
commissionaire	守门员
refiner	精炼机
cabriole	跳跃中以脚碰脚的动作
renew	重新开始
defaulter	违反军规者
biopack	生命包
rushlike	像灯心草的
antasthmatic	镇喘剂
granivorous	食谷类的
bergen	卑尔根
reportable	可报告的
craggy	崎岖的
motherfucking	不要脸的
invective	漫骂
disulfate	=disulphate
fishkill	鱼难
stockpot	汤锅
nitrifier	氮化物
unproportionate	=disproportionate
catling	小猫
semideaf	不完全聋的
retrocognition	倒摄认知
wreck	失事船失事
sybaritic	柔弱的
luetic	梅毒
la	Republic
teachy	爱说教
ketosteroid	酮类固醇
gangman	一起工作的人
bicuspid	有两个尖头的
impenitent	不悔悟
wasteweir	弃水堰
blueprint	蓝图
foolish	可爱的
lichenaceous	青苔属的
album	照相簿
sandro	桑德罗
susceptive	敏感
petrarchan	sonnet
aga	大官
archly	顽皮
unparliamentary	违反议会法的
landblink	陆光
marrowless	无力的
sexivalent	六价的
laryngotracheitis	家禽呼吸气管病
disaffirm	取消
strainometer	伸长计
parmigiano	撒有帕尔马干酪
cluw	Women
tabard	传令所穿衣服
unsound	谬误
bottomless	无底的
brae	斜坡
openable	能开
zoosporangium	游动的孢子囊
chemiluminescnet	化学发光的
embosom	珍爱
feu	封
vulcanization	硫化
seconder	后援者
spicy	有风味
max	至多
mondrian	蒙德里安绘画风格的
gpl	General
osmeterium	Y腺
plasmal	浆醛
oversailing	挑出
nonstandard	不标准的
buttermilk	白脱牛奶
isoantigen	同种抗原
flexional	屈折
planking	加衬
unhealthy	不健康
tile	瓷砖
outfielder	外场手
deceit	欺骗
asme	Mechanical
vestiary	藏衣室
frankforter	=frankfurter
unmirthful	严肃
markarian	galaxy马卡林星系
geocentric	由地球中心所见成测量
pearlash	珍珠灰
limy	石灰似的
thermodiffusion	热扩散
multidisciplinary	包括各种学科
sociocentric	社会中心论
yob	游手好闲且而令人讨厌的人
derealize	使不现实
lawfulness	法制
ungimmicky	不耍花招
photomagnetism	光磁学
super	不重要的角色
wpm	words
potent	有力
flocculous	像毛状物
conquer	占领
eudipleural	左右对称的
topiary	修剪灌木
sri	Imperium
neighborless	孤独
bernard	伯纳德
agonising	苦闷的
exegetics	解经学
jade	玉制
salient	显著的
thermolabile	不耐热
fecaloid	似渣滓的
yachtie	帆船运动员
horehound	其苦汁
suprafacial	同侧
impendent	即将发生的
lionhearted	豪胆的
cargojet	喷气式运输机
elevator	升降机
restructure	更改结构
unfadingly	不凋萎
agama	飞龙科蜥蜴
pyxides	盖果
mnas	Academy
campshedding	=campshot
nc	新喀里多尼亚
cabinetwork	细木工
sigil	魔符
antewar	战争前
endobiotic	组织内寄生的
jorum	大碗型酒杯
botanize	研究植物
neonatal	初生的
boatload	船的载货量
detonation	爆裂
crappy	讨厌的
epidermis	表皮
odorize	给……添味
ranker	现役士兵
vegetal	生长
trigenic	三基因的
overslept	oversleep的过去式和过去分词
ectomorphic	瘦型体质的
crucifixion	刑罚
flabbily	松弛地
loadability	载荷能力
profile	外形
gofer	兼勤杂工作的办事员
guidepost	路标
sainted	成为圣人的
unneighbourly	不睦邻
clergy	牧师
everwhich	pro
revolted	起义的
threpsology	营养学
embryology	胚胎学
squirish	乡绅
rongalite	雕白粉
local	当
plant	栽培
immaculate	完美的
chlorite	亚氯酸盐
dilettantish	半吊子的
bracket	括弧
transylvania	特兰西瓦尼亚
smite	重击
culturalize	使受文化薰陶
genitourinary	泌尿生殖器的
fractious	倔强
fiber	=fibre
toothsome	可口
retire	就寝
permanganic	含最高价锰的
germanization	德语翻译
ankh	T形十字章
adamancy	坚强
solstice	至日
wally	大
cliffhang	扣人心弦
katharevousa	现代希腊语
despotically	专制
thriftless	浪费的
run	趋向
bea	比衣
hoveler	无执照领港员
saprobiology	腐生环境学
rough	粗暴
neoterize	创新辞
tafferel	船尾栏杆
familygram	家事简讯电报
repetitiousness	重复
dictionary	字典
desulfurize	除去硫磺
statoscope	灵敏高度表
biocytinase	生物胞素酶
saponated	皂化
insupportably	不能忍受地
narcosis	麻醉
unhappen	使未发生
neuston	漂浮生物
lincoln	林肯
centrism	中间派的政策
incurvate	内曲
undivulged	未经透露
considered	考虑过的
stride	步幅
comtian	实证哲学的
rhythmizable	使有节奏
humorless	一本正经的
earthborn	中长出
muley	母牛
landmine	地雷
airscape	航空照片
eudora	一种电子邮件软件
cool	冷静
ripe	熟
dichromat	二色视者
alternate	轮流
squeal	告密
resiny	=resinous
godward	向神
spuriously	伪造地
desipient	顽皮
securable	可得到
rabid	激烈
zoetic	有生命的
sureshot	神枪手
heimisch	家常的
aptotic	固定的
melodic	有旋律的
aomen	澳门
offset	胶印
sorta	有几分
musky	有麝香味
destination	目的地
subhuman	近似人类的
lousily	讨厌
algarroba	角豆树
playlet	短剧
msa	Agriculture
fork	耙
princekin	幼主
adjudgement	审判
shearing	剪羊毛
cauterant	腐蚀
wheaten	小麦制成
spectacularity	引人注目
fermentor	发酵桶
stride	跨过
soak	浸透
cherup	吱喳鸣声
procurance	取
jumper	跳高运动员
collude	勾结
canaliculated	有细管的
grue	雪
acetabuliform	碟状
ensepulcher	埋入墓中
incredibility	不能相信
smelt	精炼
sadist	虐待狂者
virion	毒粒
judicially	公平
philae	菲莱岛
fault	挑剔
vociferate	大声叫
slighting	藐视的
mahlerian	马勒乐曲的
fit	合适
scaphoid	舟骨
ramdac	数模转换器
gastronome	美食者
increately	非创造出来地
varioloid	类似天花的
plss	system
roentgenise	=roentgenize
acerbating	使烦恼的
nefarious	邪恶
sparkling	发泡的
undertake	担任
oreo	奥利奥奶油夹心巧克力饼干
series	丛书
endothermic	温血的
bedeck	修饰
scowl	皱眉头
sycophant	奉承者
aggradational	沉积
misjoinder	不合法的共同诉讼
flagitious	残忍
yolande	约兰德
concupiscent	好色
sancta	sanctum的复数
sly	狡猾的
thwartships	横向地
misaligned	线向不正
scatt	=scat
unstable	不稳定
pyroceram	耐高温陶瓷
orderliness	整洁
superserviceable	极肯帮忙
misaligned	未对准
confraternity	团体
refuse	拒绝
spermous	精液
leewardly	动辄要滑向下风处的
counteragent	反对的东西
brash	无礼的
cambodia	高棉
suppurative	化脓的
co	Origin
rage	大怒
pallet	扁平工具
override	代理佣金
sigla	siglum的复数
craftsperson	手艺人
taking	会传染的
digital	数字的
pinon	矮松
synthetically	综合
contrariwise	顽固地
tremendously	可怕
bavarian	巴伐利亚
nicotinize	使中烟碱毒
selsyn	自动同步机
paean	欢乐歌
alayne	阿莱恩
untrue	不真实
asahikawa	旭川
grademark	货品质量等级标记
unwanted	空闲的
semicylinder	半圆柱
unacknowledged	未答复
bipolar	双极的
snugly	整洁
counsel	劝告
purpure	纹章中的紫色
subjacent	在下级
several	几个
company	连队
argonautic	号船员
bahamas	巴哈马群岛
metonymical	换喻
pindus	品都斯山脉
detractress	女性恶意批评者
patroness	女资助人
somatological	比较体格学的
capriciously	任性地
impalpably	不能感知
hypotonicity	张力减退
inexpugnable	不能驳倒
appealing	吸引人的
faithfulness	正确
slack	不流畅
clause	子句
pitometer	流速计
quasar	恒星状球体
homonid	=hominid
mini	迷你型
lomentaceous	节荚
bemusement	困惑
irreciprocal	非互惠的
woefully	不幸地
unexpectedly	出乎意料地
crustification	=incrustation
gesticulation	手势
message	通讯
chirpily	嚓嚓叫地
divarication	分枝
dilutee	非熟练工人
sonance	有声状态
friendship	友谊
laingian	兰恩学说的追随者
nosocomial	医院的
dekare	=decare
rubdown	擦身
chemigraphy	化学镌版术
kiss	吻
winnower	风车
division	除法
pdm	特性驱动模型
somnial	睡梦中的
isomeric	同质异构的
dingbat	办法
unaspiring	无志气的
chiropractor	脊椎指压治疗者
uncatchable	抓不住的
volgograd	伏尔加格勒
gappy	有缺口的
misallocation	分配不当
andantino	小行板
hep	玫瑰
numskull	傻瓜
splosh	突然倒下的大量水
violin	小提琴
augustan	奥古斯都
nupe	National
standaway	撑开的
skittish	轻佻
submission	服从
unromantic	平庸
constipated	患便秘症
wimble	锥
insatiably	贪得无厌
graver	雕刻刀
inobtrusive	不冒失的
unvaryingly	从无变化
fruit	果类
triaxial	空间的
hereupon	于此
league	联盟
roseleaf	玫瑰花瓣
stoss	迎鼻崖
oceanics	海洋工程学
pictorialize	用图画说明
clear	清楚地
preagricultural	农业社会前
snot	蛮横无礼的人
navarchy	古希腊舰队指挥官职务
carpogenic	生果实的
interrupter	断续器
polynia	冰间湖
behest	吩咐
whish	呼呼声
basset	呈现
rented	租用的
caracara	长腿兀鹰
contrite	由悔悟引起
olla	土制冰瓮
iolite	=cordierite
sphere	球体
concatenation	串联
disallowable	可拒绝
crt	Ray
sterling	英币的
concyclic	在同一圆周上
foreclose	自称
southwardly	来自南方的
placard	布告
aurelian	蝶蛾研究家
seignory	领主权
labour	支持工党
betwixt	由……到……
unfamiliar	新奇
feverweed	刺芹属植物
detent	制动器
apogamous	无配子生殖
emma	艾玛
pythagorist	=Pythagorean
officer	政府官员
tetrafluoride	四氟化物
accuser	原告
carrie	卡丽
goldstar	韩国高仕达公司
ldc	Developed
agitational	鼓动性的
vlsm	变长子网掩码
upwafted	被向上飘送的
irritant	刺激
vistavision	超视综艺体
euphuist	用浮华词句的人
somatotonic	体力旺盛性格
dragoniye	使变成龙
febrifuge	退热
deflexed	向下弯曲的
prothoracic	前胸
aggrieve	令苦恼
finnicking	挑三拣四的
blutwurst	黑香肠
congregationalist	公理会的
novelty	新奇
mrcp	Member
baffle	为难
boastful	自负
nakedly	裸体
balzacian	巴尔扎克的
nasopharyngitis	鼻咽炎
alkanet	朱草
swakara	西南非洲波斯羊羔毛皮
sanguiferous	运血的
sanctimonious	假装神圣的
freethinking	自由思想的
fontal	泉的
expressible	可表现的
capriccio	恶作剧
pong	恶臭
liquefactive	液化
latticework	格子
tsarist	俄国帝制的
asthmatoid	似气喘的
maidenly	处女般的
indivertible	不能引开的
volume	量
outrageous	残暴的
unimpressionable	不易受影响
repository	贮藏室
learning	学习
steading	农场的建筑物
morganize	暗杀……以灭口
quirkish	双关语
constrained	被强迫
antalkali	抗碱剂
function	函数
apperceive	认识
terrify	使恐怖
firebase	重火力点
unwavering	坚定
porism	不定设题
inharmony	不和睦
teen	不幸
cymous	聚伞花序
closure	关闭
epitomize	概括
glaringness	显著
nickelous	亚镍的
visitorial	访问
duplicate	副的
apertured	有孔
protective	保护
schvartzer	黑人
scallop	干贝
filipinize	绝大部分以菲律宾人担任
haily	冰雹的
condignly	应当
aok	一切就绪!一切正常!
reckless	不计后果的
divisional	分割的
hithermost	最靠近
demurely	装成端庄
kmps	per
camboose	伐木者棚屋
elongate	延长
pellagrin	陪拉格病
embossment	浮凸装饰
proteus	多变的人
fluviatic	生长在江河中
abortive	异常终止的
libyan	利比亚人
aleuronic	糊粉的
senior	位较高
faultily	有缺点
increasable	可增加的
lairy	华丽而俗气
hombre	西班牙系的人
preside	主持
antiradical	反激进主义
russian	俄国人
frg	Federal
metaphysicize	形而上学地思考
intersexuality	兼具两性
affluently	富裕
lavishly	浪费
anisocytosis	红血球大小不等症
vxd	虚拟设备驱动程序
responsible	可依赖
deweyism	实用主义
calash	车篷
obsessive	分神的
americana	有关美国的文物
lathyritic	山黧豆中毒的
scum	糟粕
dispart	分
fat	文件分配表
karnataka	卡纳塔克邦(旧称迈索尔邦
creditability	可信性
flubdubbed	易犯错误
drumbeat	打鼓
quin	=quintuplet
nakedly	裸体地
funster	幽默家
erection	直立
generalise	=generalize
romanian	罗马尼亚人
aculeated	尖锐
entryman	公共土地侵占者
crowhop	蹦蹦跳跳地前进
tentative	暂定
forestall	阻止
cystinosis	胱氨酸病
brawn	强壮的肌肉
papilloma	乳突淋瘤
squally	天气愈变愈坏的
private	私有
exhalable	可吐出
abide	忍受
undermost	最下
crosswise	斜
calling	点名
cynical	愤世嫉俗
random	随意
unready	没有准备的
practicant	=practitioner
popie	罂粟花饰
nectar	花蜜
kelpy	马形水鬼
remanet	残余
mrs	Reference
joad	流动工人
outcrop	露出地面的岩层
apocalyptical	天启
stoplight	停止行进号志
hermes	material
include	包含
tell	告发
tuitionary	学费的
tired	疲劳
whort	=whortleberry
quadrilateral	四边地
uncharitable	无情
disappreciation	轻视
cisc	computing
ajar	微开的
towerless	无塔
nummulated	钱串状
sectarianism	派别心
monadic	单细胞生物的
dawdling	懒散
photolyze	进行光分解
lcd	Crystal
accompanyist	伴奏者
riot	暴乱
carrier	带菌者
multidimensional	多维的
calypso	卡里普索
fly	苍蝇
memory	记忆力
acpi	Power
sweety	甜点
uddered	有……之乳房的
haven	避难所
druidical	督伊德教
coextend	在同面积或长度扩张或伸张
enclisis	与前词连接发音
archangel	天使长
automatism	自动力
potash	碳酸钾
essay	小品文
pitch	定位于
scalewing	蝴蝶
groid	黑人
terror	恐怖时期
proletarianism	无产阶级性
macroglobulin	巨球蛋白
astrocyte	星细胞
lcp	Landing
plumb	使垂直
anamorphic	失真
abreact	发泄
laborite	劳工党党员
delomorphous	显形
depollute	防止污染
afdc	Children对有子女家庭补助计划
hallux	大拇趾
sacahuiste	诺力草
overgraze	过度放牧
wysbygi	What
feed	喂养
frothy	空洞的
anadiplosis	联珠法
keelyvine	=keelivine
metaphyte	后生植物
sinuous	不老实
owly	像鸮
brushhook	钩镰
empanada	肉馅卷饼
cisrhenane	莱茵河西岸的
apery	仿人
unwell	不舒服
adopt	收养
urge	强烈欲望
sinuous	错综复杂的
gorge	山峡
amerceable	可罚款
queenly	慷慨的
achaean	亚该亚
whirl	—连串快速的活动
northwesterly	从西北来的
caique	地中海轻帆船
godward	对神
pythonic	大蟒似的
tamburitza	坦姆布里扎琴
setigerous	=setiferous
wfd	of
locker	锁扣装置
cineangiogram	脉搏电影描记图
freeware	免费软件
