insectivorous	食虫动植物的
invulnerable	无懈可击
priesthood	神父
martialize	使变得好战
trichromic	三色
haunted	鬼魂出没的
grassiness	草深
rallicar	四人座的小型二轮马车
closehanded	小气
internist	内科医师
standaway	撑开
subgovernment	影子政府
decree	颁布
heterosis	混种盛势
vpd	Virtual
infinitesimal	极微量
temporal	暂时
remiped	桨足类的
penitent	悔罪者
dipshit	笨蛋
staig	马驹
pergunnah	大区
egghead	有知识者
amphibology	模棱两可的言辞
gifford	吉福德
acetophenone	苯基甲基甲酮
governable	可控制
identic	同一的
clinicopathologic	[屹床病理的
mandatory	命令
whp	horsepower
reprobative	指责
galactopoiesis	产乳
squawk	叫声
circumgyration	翻斤斗
zenana	女用薄衣料
telangiectasia	=telangiectasis
vesicular	由小泡组成的
unpropitious	恶运的
community	公社
bilberry	越桔
humerus	肱上膊
excessively	过分
whippet	小灵狗
biquinary	二五混合进制的
fertilize	施肥
different	不同的
girdle	浅锅
word	命令
macrometeorology	大气象学
anticoherer	反检波粉屑粘合装置
flop	噗地一声
farmhouse	农舍
camalig	小屋
park	停车场
jitters	神经过敏
aep	Protocol
backboned	有脊椎骨的
contiguously	接触
enwheel	=encircle
dialyzer	透析器
cerebral	大脑
calabazilla	野南瓜
jimmy	用铁撬撬开
transom	气窗
fecund	生殖力旺盛
expanding	扩大的
sustainer	维持者
immensurable	无垠的
scumble	薄涂
geez	吉兹语
feu	永久租借
nursing	看护
greisen	云英岩
statuesque	均衡的
anaesthetic	麻醉
modernism	现代主义
menses	月经
limonitic	俗褐铁矿
nivation	雪蚀
discontinuous	中断
absonant	不协调
bidarka	海豹皮小艇
offhand	唐突的
flagellate	有鞭毛
leukon	白细胞系
nulliparous	从未生育过者
gimpy	跛的
homologate	承认
terribly	可怕
minutiose	关心小事的
ooa	面向对象分析
daf	Department
plenteous	许多的
dissertation	论述
instrumentalism	饕
usts	Travel
parthenospore	无配合子
sprowsie	6便士硬币
absorptance	吸收比
pyretic	热病
panathenaea	泛雅典娜节
superciliary	眼睛上方
twentieth	第二十的第二十日
coulda	=could
streptokinase	溶栓酶
abjectly	卑鄙地
kibed	患冻疮的
gum	口香糖
helpful	有用
dulcite	己六醇
quadragesima	四旬节
retired	退役的
service	维修
unblushing	不客气
paye	You
feebleminded	低能
humilis	淡
amelia	阿米莉娅
rollicking	嬉戏耍闹作乐的
muck	肥料
woodhorse	竹节虫
incarnadine	肉色
sentencehood	完整句状态
basilar	基部的
pluperfect	过去完成时
addax	曲角羚羊
landship	篷车或其他类似的车辆
easiest	轻松
way	远远
gilt	表面装饰
misgiving	疑惧
array	大批
weedkilling	灭草
negotiator	谈判代表
reductive	减少的
faceplate	花盘
flesh	赋以血肉
pyromaniac	放火狂
castiron	铸铁制成的
abstinent	有节制
osteochondrosis	骨软骨病
thymectomize	给……切除胸腺
salty	咸味浓的
enfetter	上脚镣
incurvation	弯曲
aether	乙醚
edge	边缘
heimisch	家常
guttersnipe	贫民窟的小孩
riposte	尖锐回答
nannofossil	微化石
bymotive	暗中的打算
baleful	恶意的
speaker	演讲人
vacuous	无所事事的
worthy	相称的
uncharming	不可爱的
purulency	化脓
asteraceous	紫菀科的
remittal	宽恕
playfully	开玩笑
autoecious	寄生
landrail	=corncrake
frondescent	长树叶的
langobard	伦巴第人
anyone	pro
incumbent	负有……义务
parturifacient	催产的
quadrable	可自乘
attenuate	削弱
topgallant	上桅的
imaret	朝圣者之旅舍
puny	弱
pseudocrystal	赝晶体
dielectrophoresis	双向电泳
liner	划线者
inker	油墨轮
ruffian	残暴
anecdotical	轶事的
hesitantly	迟疑
mongolism	蒙古症
nattiness	整洁
nonelastic	无弹性的
flotative	可漂浮的
wash	洗清
spool	线轴
squinch	突角拱
hypsicephaly	尖头畸形
overshoot	行动过火
zarf	金属杯状的托
pithless	无髓
justly	公正
suspensive	未决定
mycelium	菌丝体
rummage	零星杂物
lawlessly	非法
atechnic	无技术知识
imp	补充
local	乡土
amie	女朋友
cove	山凹
cospar	Research
hemanalysis	血液分析
bauxite	铁铝氧石
rasp	锉磨
tongued	说话……的
inextinguishable	压不住
marrowy	有力的
pteridine	蝶啶
espionage	侦探
administrivia	每天重复性的电子信件
bowler	投手
quench	结束
smearcase	cheese
ecp	Extended
touch	接触
ruddiness	带红色
sidra	锡德拉湾
monocotyledonous	单子叶植物
vincible	容易征服
resignation	顺从
abraser	研磨器
tap	轻声走
sheltery	庇护
slanguage	使用俚语的表现法
reprimand	申斥
traitress	女性叛逆者
anchorpeople	新闻节目主持人们
homeric	荷马式
poke	伸出
nasara	的复数
rouse	唤醒
adjoin	毗连
gabrovo	加布罗沃
spectacled	戴了眼镜的
thiomersal	硫柳汞
aryan	印欧语系的
organophosphorous	=organo机磷的
fearsome	可怕的
diastole	心脏舒张
nih	Institutes
perfidiously	不忠实地
psychognosy	=psychognosis
scoundrel	恶棍
revolted	厌恶
biotope	生物小区
pentangular	有五个角的
nix	女水神
glycin	甘氨酸
sawmill	锯木厂
pyroclastic	火成碎屑物
myocardia	myocardium
unploughed	未耕的
noncombustible	不燃
kneed	有膝一般的关节的
foreplane	前舵
vanadic	钒的
northern	北部的
outer	环外命中
account	认为
hydrofluoric	含氟化氢的
congrats	恭喜
adrenotropic	亲肾上腺的
fen	沼泽
implicit	盲从
exigency	苛求
cover	盖子
goethean	歌德的
ultramundane	世界之外的
inobtrusive	客气的
rewin	赢回
ragworm	=clamworm
prosy	单调的
exilic	放逐的
galvanic	抽搐
ceeb	Examination
girlish	少女似的
soporific	催眠的
peshawar	白沙瓦
hospitably	亲切地
columelliform	小柱形的
copilot	副驾驶员
magnesic	含镁的
kroo	克鲁族人
procuratorial	代诉
solvate	溶剂化物
intercurrent	间发
follicular	小囊
ultrafine	极其细小的
photoeffect	effect
liechtenstein	列支敦士登的
dividable	=divisible
oddity	怪癖
heterogenous	异质
portiere	门帷
upbraidingly	叱责地
apotropaism	用魔术驱邪
bronchoscopy	支气管镜检
puberal	发育期的
burning	燃烧的
ila	Longshoremen''s
volscan	立体扫描器
beaune	红葡萄酒的一种
sightless	盲
selcall	选择呼叫
grille	格子
terminative	限定
vacuous	无所事事
attributive	归属的
zairois	=Zairean
con	肺病
humped	有瘤的
tudor	都铎式建筑式样
lend	贷
landward	向陆的
columbine	鸽色
convey	搬运
out	外面
gardenesque	花园般
happenstantial	偶然的
serve	发球
attributable	可归于……的
mucky	肮脏的
mise	协定
crescive	成长的
astrachan	俄国羔皮
compulsively	强制地
inflammable	易怒的
chitin	壳质
spook	逃窜
like	爱好
rep	棱纹平布
loop	以圈结
julienne	切成条
hazard	冒险
sulfuryl	=sulphuryl
mdr	Requirement
serration	锯齿状
mazda	马自达汽车
crass	愚钝的
gee	一千美元
arhythmical	无节奏
cupula	吸盘
ripply	波纹状
pertinent	中肯
cambo	柬埔寨人
hypnogenetically	催眠地
mungarian	匈牙利语的
biennial	二年生植物
account	理由
feringhee	欧洲人
amatively	恋爱
incurve	向内弯曲
smack	用掌击
gph	每小时加仑数
guitar	六弦琴
raises	建造
videogenic	适合电视的
virtue	美德
traduce	中伤
silicate	硅酸盐
hieron	圣
wash	洼地
jadish	下贱的
macromolecule	高分子
swastika	纳粹党所用的十字记号
fortuitist	偶然论者
venomous	恶意
swbs	southwest
several	个别的
aeroflot	苏联民用航空总局
visitation	访问
meltability	可溶解性
dentifrice	牙粉
lille	里尔
euhedral	自形
oki	冲电气
culicid	蚊科的
whisper	飒飒地响
sphygmometer	脉搏计
anarchistic	无政府主义
nightmarish	恶梦似
atactic	不合语法
abound	大量存在
ultradian	次昼夜的
spark	鼓舞
counterglow	对日
cany	藤的
brigand	强盗
bleak	凄凉
contend	斗争
eccrine	分泌腺
indubitable	确实的
romanticism	浪漫精神
paragraph	段落
loungewear	家常便服
posseman	义警队员
sick	不舒服
inveigher	漫骂者
phenol	苯酚
foreordination	注定
ichnite	=ichnolite
feed	饲料
antianxiety	抗焦虑的
chi	希腊字母的第
relievable	可减轻
glutaminase	谷氨酰胺酶
glaucous	蓝绿色的
rationalism	唯理论
brotherliness	弟兄之爱
mathematization	数学处理
join	接合点
arthrotropic	亲关节的
following	下列
originative	有创作力
peach	桃色
exploration	探查
stichomythia	轮流对白
mistreatment	虐待
mangily	生满疥癣地
facs	College
ajut	伸出的
tumorous	肿胀
offset	用平版印刷
cisalpine	其南侧
oversweep	掠过
elisor	代理人
molto	甚
loan	借给
working	运转
verrucose	疣
magnetometive	磁势
left	左派的
bloated	浮肿
concoctive	策划
polyzonal	多区域
treatise	论文
digressive	枝节的
odontornithic	齿鸟类的
convolution	卷绕
backstretch	非终点直道
bloodline	血族
benignantly	亲切地
conjunction	连接词
med	地中海
epigeal	生长在地上的
travel	行进
buckle	变弯曲
semioviparous	半胎生的
disunite	不和
humble	贬抑
paupiette	肉卷
nuff	=enough
repeal	撤销
indumentum	羽毛
duration	为期
bastardize	使不纯
virulent	恶毒的
udag	Development
genealogist	系谱专家
landslide	山崩
compliableness	屈从
fleming	说佛兰芒语的比利时人
clamorously	鼓躁地
frothy	多泡
polygamy	一妻多夫
leukodermal	白斑病
fishlike	冷淡
exclusive	独占
dreamily	爱梦想地
garboil	混乱
madonna	圣母玛利亚
rejuvenator	返老还童药
quoin	隅石
naturalisation	移入
traitorous	不忠的
lay	平息
showerproof	防水的
ness	海角
ellington	即Ellington
harmonious	协调
incompetent	不胜任
tracheal	气管的
gangliated	有神经节的
marginalize	使脱离社会发展进程
usafe	Air
accurately	精确
mtbf	Between
wraac	澳大利亚皇家陆军妇女服务队
acknowledged	公认的
apeak	垂直
simulant	模拟的
derriere	后面
fireroom	锅炉间
fenman	居于沼泽的居民
prevailing	主要
bedlam	骚乱情景
ebonite	硬橡皮
insouciant	无忧无虑的
lever	杠杆
parapeted	有栏杆的
polyethnic	多种族
francophil	崇拜法国
animated	愉快
glossopharyngeal	舌与咽
impersonally	与个人无关地
hydratable	能水合的
anabolite	组成代谢物
caulome	和茎结构形态相当之结构
sociopolitical	社会政治的
lagomorph	兔类动物
goshen	肥沃的土地
neighborless	孤独的
grotesquerie	怪异图案
outspread	扩张
raises	增加
victoire	维克托瓦尔
prove	原来
determinative	决定之事
logical	合乎逻辑的
accessory	补充的
commentary	解说词
cannonize	封……死者为圣徒
flakily	薄片地
dihydric	二羟基的
academy	专科院校
flickery	摆动
fortnightly	隔周发行
pathologic	病态的
sverdrup	斯维尔德鲁普
interbedded	层间
uveitis	眼色素层炎
lifeline	救生索
eunomianism	优诺米主义
brassfounding	黄铜铸造
heliotactic	背日性的
amberina	美产的一种艺术玻璃
insipidly	清淡地
downdrift	逐渐下降
closefisted	吝啬的
dogginess	狗臭
mail	盔甲
fructicative	能结果实的
countryseat	乡间大厦
radicalize	使激进
trochoid	车轮状
transfluent	越流
secretory	分泌
ruga	皱
dripless	不滴水的
jissom	精液
sanative	治疗病症的
phaenogam	=phanerogam
transire	货物准行单
semiconsciously	半意识地
matchmaker	媒人
princedom	王子的称号
westy	white
sloe	野李
postfigurative	成人社会的
allegorically	比喻
adduce	举出
vologda	沃洛格达
debut	初次登场
divulgence	透露
hoppergrass	蚱蜢
genevan	加尔文教的
preteen	青春期前
apocopate	删除
inedited	未出版
ang	American
hatpin	帽针
histioid	类组织
tail	踪迹
submerge	浸没
batrachian	无尾两栖类的
poriferan	多孔动物
megatron	盘封管
slag	成溶渣
reglet	扁条
ambiquity	多义性
scribbler	潦草写字的人
rotund	洪亮
tcp	suite//TCP/IP协议栈
wino	喜爱葡萄酒者
pulsation	有节奏地跳动
arminian	阿米尼鸟斯派教徒
parnassian	诗的
gilt	gild的过去式和过去分词
baisakh	印度历的2月
flaring	俗丽
fire	激动
spatchcock	杀后马上烹调的鸡肉
dirty	肮脏的
tribunism	主义
snippety	=snippy
despoil	掠夺
gossypose	棉子糖
quarrelsome	喜欢吵架的
busiest	最忙的
skylark	发疯般的胡闹
calcifuge	嫌钙植物
caelum	雕具星座
viridian	浓绿色颜料
disembarrass	使摆脱困境、烦恼、困惑等
bannerette	方旗武士
pool	联营
cahoots	与……共谋
unsophisticate	QnsE5fIstIkeItdness//
illite	伊利石
amusedly	愉快
mashlam	=maslin
hateful	可恨
tripey	垃圾般
torrid	热带
shodden	shoe
nomenclatorial	名称的
cuneatic	楔形
stackyard	干草堆场
vacuolate	有空泡的
primal	最初
noctambulant	夜间步行的
oscular	接吻的
bargain	便宜货
stableboy	马夫
sternforemost	倒退地
pettipants	女式半长内裤
secondhand	做旧货生意
transgenosis	基因转移
wee	很少
saltationist	突变论的
dispassionately	不动感情
ductile	易延展的
spittlebug	吹沫虫
microprint	缩影相片
mechanomorphism	机械形成论
cubitus	肘脉
comint	通信情报
downhold	限制
loquitur	开始说话
unsheltered	未遮盖
indigest	不被消化
extract	汁
flako	喝醉
blastocoele	囊胚腔
nutlet	小坚果
stagnancy	迟钝
zinciferous	含锌
carbohydrate	碳水化合物
barcelona	巴塞罗纳
cramp	使抽筋
overweight	超重
resplendency	光辉
yamen	中国古代之衙门
skeletony	梗概的
aerosol	浮质
invar	不胀钢
subcool	使低温冷却
plotty	情节错综复杂的
uplift	提高
lunette	弦月窗
international	国际比赛
inedited	未出版的
spheroid	回转椭圆体
rosy	玫瑰红色的
somber	阴天的
amiss	错误的
enslavement	强制
ostrichlike	鸵鸟般回避现实
appealable	可上诉
fractious	脾气不好的
topsail	上桅帆
consultation	请教
slantwise	倾斜的
contestant	竞争者
steeplechase	障碍赛
unreserved	无限制的
smoothness	柔滑
feature	放映
delinquent	违法
renew	复兴
underpopulated	人口稀少
schizogenous	裂殖生殖的
base	基地
virtuosi	名家
interstitial	形成空隙
pumice	轻石
nonperiodic	非周期
tearless	不流泪
habitably	可居住
nitrogenous	含氮的
gaily	华丽地
premise	假定
polyol	多羟基化合物
tributary	辅助的
fairytale	童话中才有
vsam	Method
hoofed	蹄形状
caucasian	高加索人
limpidness	透明
southeasternmost	最东南的
clericalization	教权主义化
unep	联合国环境规划署
ocd	Civil
gemot	英国的立法或司法机关
advanced	先进
acetin	乙酸甘油酯
girlish	适于女子的
scatoscopy	粪便检视法
shippon	=shippen
neoclassic	新古典主义的
alular	翅瓣的
reciprocate	报答
exposure	陈列
lethargic	瞌睡的
gnosis	真知
deafening	震耳欲聋的
cairn	石堆纪念碑
foil	箔
gearless	无齿轮的
cormorant	鸬鹚
procuratorial	代诉的
reserves	储量
frijole	菜豆
proparoxytone	在语尾算起第三音节读重音的
kittenish	小猫似的
saltchuck	海
cospar	空间研究委员会
hypopnea	呼吸浅慢
immediate	知觉的
late	晚的
serrefine	小弹簧镊
dutchman	荷兰人
observational	观测
flambe	燃烧着的
silicify	硅酸化
epimere	上段
convincing	令人心悦诚服
unifoliate	有单叶
garlicky	有大蒜气的
smart	刺痛的
incinerate	烧弃
comprehensible	可理解的
stuccowork	灰泥工
castellated	造成城形的
corporeally	物质上
credibility	可信性
foreground	最显著的位置
driveway	车道
coxcombical	花花公子
upclimb	爬升
pledgor	抵押人
dualpurpose	作两种用途的
undispersed	未被驱散的
thermonuke	核子武器
printless	不留痕迹的
languishing	日趋衰弱
oxygenation	以氧气处理
precinct	围地
hydroforming	加氢重整
undistracted	注意力集中的
globalization	全球化
pelasgian	皮发斯基族
tmo	电汇票
my	Malaysia
deuteronomic	申命记的
experienced	富有经验的
am	午前
ethylic	乙基属的
carrion	腐肉
laddertron	梯形管
imprudently	不小心
dutifully	忠贞地
mathematically	算术
nucleonics	核子学
contradictious	吹毛求疵
retrolental	眼晶状体后面的
nicotinize	使中尼古丁毒
flatbed	有平台可装货的卡车
santalaceous	檀香科
antefix	装饰屋瓦
doorknob	门把手
resilient	有回弹力的
coroner	验尸官
weight	砝码
wrinkly	易生皱纹
consummately	至上地
ithuriel	一书中的天使名
downmost	最下面地
marcato	加强的
sild	小鲱鱼
gleety	后淋的
tike	粗野村夫
cernet	Network
clatter	哗啦声
omnisex	全性
avouch	确保
sericate	如丝
scirrhus	硬癌
tylopod	趾底有肉垫的
graphology	笔迹相法
annularity	环状
titular	有资格
kaanga	=kanga
spatuliform	=spatulate
brotherly	兄弟的
voyageur	旅客
lysozyme	溶解酵素
highroad	大道
slack	缓慢地
kraakporselein	青花瓷器
puggaree	印度人用的轻薄头巾
expense	代价
infernal	阴间
dubbin	皮革用防水油
horizontal	水平
yodel	岳得尔歌
udf	Format
gnosis	直觉
sessional	会议的
aeroengine	航空发动机
weakly	软弱的
hypodorian	副多里亚调
recognition	重视
photodramatist	故事片编剧
fairness	公平
mediator	仲裁人
succedanea	代用药
weimar	魏玛
yank	美国佬
mspe	in
irrelevancy	不相干的事物
catachresis	用词不当
noninstallment	一次付清
hindoo	印度人的
heartfelt	真心真意的
bose	用撞杆叩
schizotype	精神分裂症型
indigene	当地人
europlug	欧式插头
saponated	与皂化合的
abortive	流产的
unmerciful	不仁慈的
camorrist	秘密结社党员
fcic	Crop
hoppingly	忙碌地
sesquicentennial	一百五十周年纪念
os	Os
basicity	碱度
palatinate	领地
rectorial	院长
saxicolous	生于岩石间的
difference	争论
sole	单独的
pneumogastric	迷走神经
divinity	上帝
still	静寂的
completive	完成的
equal	胜任的
coincident	巧合的
metaethics	元伦理学
undistinguishable	难区分的
chifforobe	衣橱柜
odontologic	牙科学
procurance	取得
restock	重新进货
casualism	偶然说
rift	断裂
nyctalopia	夜盲症
yapok	蹼足负鼠
mts	活动目标模拟器
erythrophobia	害怕红色
sudorific	发汗
mandril	顶杆
cowfish	海牛
sexagenarian	六十岁
goggle	睁眼的
unheated	不热
claudia	克劳迪娅
underlead	低出小牌
ontic	本体的
sputteringly	语无伦次地
putti	putto的复数
party	当事人
ast	平均寻道时间
monachal	出家
sluttish	淫荡的
crimp	使有褶
mistune	使音调不准
bordeaux	波尔多葡萄酒
tankage	桶槽的租费
overemployment	雇佣过多
meek	驯服
mount	山
still	静止的
distad	在末梢
micrococcal	微球菌引起
rider	附文
willet	鹞类
judenrat	犹太居民委员会
delusive	令人错解
eutrapelia	敏捷
bayou	小海湾
uncorrectable	不能修复的
kaki	柿子
antrum	窦
fishbolt	轨条螺栓
nitrosobenzene	亚硝基苯
sidelight	拾零
auditorial	通过听觉的
pilgarlic	秃头
vivify	给与生气
plp	Parliamentary
glaucous	绿灰色
presentment	描写
paraformaldehyde	仲甲醛
ensnare	诱捕
qualified	有资格的
shewbread	未发酵的面包
quickening	复生
intransit	在旅途中的
martiniquan	马提尼克岛
tripper	绊跌者
towards	接近
levorotation	反时钟旋转
careworn	疲倦
fenderbeam	碰垫
topless	高得好像望不到顶的
aghan	印度历的9月
nonstandard	不规范的
sidefoot	用脚侧踢
slip	滑动
saseno	=Sazan
sublimely	卓越
tramontane	野蛮的
garbo	垃圾工人
story	传说
torture	拷打
vitellogenous	卵黄
solvolysis	溶剂分解
fame	传说
wins	Internet
pat	适时
verbally	口头地
obtect	具被
unknowable	不可知的
endocytose	胞饮
cosmologic	宇宙论的
equality	同等
nonmember	非会员
specially	特别地
cheerioh	=cheerio
invalidism	病弱
cremation	烧
being	是
tractate	短文
cream	面霜
angiocardioraphy	心血管造影术
photoflood	照相泛光灯的
ruggedly	粗暴
deduct	演绎
eonian	永久的
spindle	锭子
sureness	踏实
contaminative	污染
punctuate	不时打断
fytte	歌
eloign	带走
flimsy	易坏
undeceive	使不受欺骗
homozygotic	纯质性
by	通过
brutal	兽性
passionfruit	西番莲之果实
unspecific	不具体的
pasturable	适于作牧场
tzitzis	=zizith
premillennialism	千禧年前论(基督教神学千禧年主义
procural	获
middleweight	体重中等
visionally	虚幻
mammifer	=mammal
civil	民事
cooling	冷却的
chummage	同宿
fissiparous	分裂生殖的
escapism	逃避现实
sciurine	松鼠科
osage	奥色治人
viking	斯堪的纳维亚人
coordinative	同位的
lasable	可受激光照射的
glomeration	球状体
msphe	Health
huntaway	牧羊犬
sequent	接续而来的
lodgeable	可寄宿
stylish	流行的
costive	行动迟缓的
haemorrhage	溢血
sweetsop	番荔枝
gin	陷阱
inorganizable	不能组织
burry	有粗喉音
engineman	机械师
insectarium	饲养之昆虫
swordplay	击剑
leg	旅程的一段
afrikaans	南非白人
fumatory	烟薰
ecuador	厄瓜多尔
achromat	色盲患者
sty	关入猪栏
jarp	敲碎
rifling	膛线
acqierement	学识
ozonize	使含臭氧
abiotic	非生物的
gmt	Time
furred	长着软毛
basely	下贱地
dwarfish	象侏儒
reject	落选者
transfinalization	目的性转变
nowhence	什么地方都不到
unwarily	不留心
prepayment	先付
amazedly	吃惊
obediently	服从地
vole	野鼠类
dendroclimatic	年轮气候学
gitana	吉卜赛女人
deck	舰板
scuzzy	邋遢的
trailside	在小路边的
erythrosine	四碘荧光素
radux	计数制的基数
suctorial	有吸盘的
canned	罐装
choice	可选
devolution	依次
tyke	野狗
coinsure	共同担保
molecular	由分子组成
wildness	野蛮
hornpout	鲶鱼类
lease	租
anecdotic	轶话的
nuptiality	结婚率
afflux	涌入
rambling	流浪性的
nopalry	胭脂仙人掌种植场
rattlepate	头脑空虚的人
wizzled	干枯的
kilometrage	以公里计算的行程
carping	挑毛病的
nailhead	钉头
agorae	市场
xylylene	亚二甲苯基
mistime	使不合时宜
nomocracy	法治
envelop	封
evenings	每晚
knobbiness	多瘤
skookum	强壮
idiophone	非膜质打击乐器
dunghill	粪堆
nullifidian	无宗教信仰的人
vocationally	职业性
demonstrator	证明者
pyronine	派若宁
jumper	工作服
stuff	原料
naval	海军
muppet	提线木偶
pratincole	林鹬
unloveliness	不可爱
spermicidal	杀精子
orchardman	=orchardist
ocso	Cistercians
neologize	采用新教义
spherical	球
adipoma	脂肪瘤
macronucleus	滋养核
trochosphere	=trochophore
vamp	荡妇
raaf	Australian
pejorate	变坏
notable	著名
throat	用喉音说
hypobaric	比重低于脑脊髓液的
sulfureous	硫磺一般的
stownlins	秘密地
vibropack	振动变流器
fraternize	结有深交
badman	偷牛贼
niggerize	打扮成黑人
treenail	木栓
pill	药丸
brad	曲头钉
xiphisternum	剑胸骨
pathogenic	致病
muton	突变子
joke	笑话
zambezi	赞比西河
amusingly	好笑地
flimsy	浮夸的
thermomechanical	热机
atlantean	力大无双
fizz	嘶嘶响
sulfapyridine	磺胺嘧啶
slub	粗纺
adopted	被采用的
absonant	不和谐的
pleasant	令人愉快的
informing	鼓舞
winterless	无冬天征象的
pronograde	俯行
adiaphorous	无作用
trophoneurosis	营养神经病
unadvisable	不得当
maidenly	柔和的
corrugate	弄皱
templelike	似神殿的
dingus	小装置
interfile	把……合并为一宗档案
vagabond	流浪者的
corelate	=correlate
torrential	奔流的
japanology	日本研究
intergovernmental	政府间的
recess	休息
guest	招待
semicentenary	50年的
undirected	无收件人姓名
saronic	Gulf
derisively	嘲弄
steatite	滑石
ledge	壁架
speedily	赶紧
jyland	为Jutland之丹麦文名称
punic	没有信义的
fusional	熔合
desalivate	切去唾液腺
thimbleful	极少量
unstriped	无条纹的
mirthless	忧郁的
uncrate	从板条箱中取出
mri	核磁共振成像
caulicle	草本植物之幼茎
preconcert	预定
pack	挤
wordpad	写字板
observable	引人注目
blanche	布兰奇
paraplegic	截瘫的
semiconducting	有半导体特性
vulgate	拉丁文圣经的
decently	正派地
alkalinization	碱化
lixivial	灰汁盐
midwinter	冬至
francesca	弗朗西斯卡
nail	将……钉牢
insufferable	难以忍受
fold	折叠
marv	机动重返大气层分弹头导弹
squeegee	橡胶扫帚
explode	爆发
superplastic	超塑性材料
triplicate	三重
drooly	流口水
ecpc	扩大计划调整委员会
jotter	笔记本
idiosyncratic	特殊物质
pericardial	围心的
braciole	酒烩肉卷
gelatinize	成胶状
alteration	变更
campanologist	铸钟专家
lantern	灯笼
quadrangular	四边形
restoration	复位
ferocious	凶猛
chainstitch	链形缝
to	往
seascape	海景
compelling	强迫
androphobia	男性恐怖症
fermentation	发酵
cooperate	协作
yuk	大笑
ligament	系带
disutility	无效
disincorporate	解散法人组织
pseudonymity	使用假名
labionasal	唇鼻音
cerebrospinal	脑脊髓的
chant	圣歌
octosyllable	八音节的诗句
nonfigurative	抽象
demanding	苛求
bmw	Motor
unboot	脱长统靴
inspectress	女检查员
inhumanize	使残酷
azygos	不成对的部分
blastoff	升空
wallpaper	贴墙纸
playshoe	游乐鞋
tumidly	肿胀
theonomy	神治
afloat	在海上
gigawatt	十亿瓦特
chare	打杂
logomachy	文字游戏
andorran	安道尔的
intersymbol	符号间的
mythopoeic	神话时代的
whiles	其间
bill	把……列成表
evanish	消失
rightable	可补救的
sbm	buoy
wootz	武氏坩埚钢
amplifier	扩音器
juana	胡安娜
genoese	热那亚
decennial	十年一度的
choke	哽住
guff	废话
exclamation	惊叹词
integumentary	包皮的
stand	抵抗的状态
wizardly	男巫
castellated	构造如城
bulrush	纸草
untenanted	未被租赁者占用
alight	发亮
phanerocrystalline	显晶质的:a～variety
left	左翼
artifactitious	加工的
reservedly	隔阂
rejudge	重新判断
suppliance	恳求
antibiosis	抗生
experiential	经验上的
convincingly	有说服力
import	进口货
punctum	尖
smoggy	烟雾弥漫
gnawing	使苦恼的
voluminous	丰满
actinomorphous	放射状
debauch	放荡
paleogenetics	古遗传学
dressily	打扮入时的
felsitic	霏细岩
parterre	花圃
custodial	保管的
photochromic	对光反应变色的
photometric	光度测定的
diplopy	=diplopia
cassandra	不为人所信的预言家
atonalism	无调性
sportswear	运动装
fortuity	偶然
absolutory	给予宽恕
flabbily	无活力
punchboard	击彩盘
antipodal	对跖
minuteness	微细
naughty	不听话的
ornithoid	鸟状的
flimsy	浅薄的
iocu	International
editorially	以编辑身份地
thecae	鞘
mia	战斗中失踪
syncretic	融合的
ultima	最终的
etic	素的
existent	存在
pivot	枢轴的
phorate	甲拌磷
aerotactic	趋气性的
freeness	自由
vision	想象力
dickeybird	小鸟
shakiness	动摇
fosterage	养育
plebby	粗俗的
sideline	副业
procurement	获
faradization	感应电流疗法
flattop	航空母舰
fatuous	自满
shuttle	穿梭往返
point	表明
interpolate	窜改
yeggman	盗贼
lepra	麻风
israeli	以色列共和国的
peart	有精神
unclubbable	不爱交际的
amazonian	亚马逊河区的印第安人
continental	大陆的
lancet	柳叶刀
kenyanization	肯尼亚化
indexed	与生活指数挂钩的
timeworn	老朽
pug	脚印
sisterhood	妇女团体
architectonics	建筑学
forward	迅速的
fruitless	不结果实的
floppy	懒散的
mas	军事防护勤务
quoit	掷
undissembling	真诚
inconsequent	不一致的
notoriety	远扬的名声
spark	瞬间放电
lowest	最小
home	在家
parabolical	比喻的
cockscomb	鸡冠
pronounced	断然的
beardtongue	=penstemon
pectinate	梳状
legioned	组成军团的
bagwash	初洗洗衣店
protrusile	可伸出的
polyrhythm	多旋律
peatland	泥炭地
zircaloy	锆合金
extenuative	情有可原的
whittle	屠刀
cashmere	开士米绒线
sufficient	足够
urbane	彬彬有礼的
acajou	腰果
evillooking	相貌凶恶
tourniquet	压脉器
chaperonage	伴随
litigate	提出诉讼
idyll	牧歌
fearful	严重的
beadledom	小官吏习性
tartar	凶悍的人
aif	Force澳大利亚武装部队
gnathonic	阿谀的
simulacrum	假的东西
land	使处于
nephridial	肾管
rectangle	长方形
middling	中等的
fatten	使肥沃
stewpot	双把炖锅
osmoregulatory	渗透调节的
banefully	致害地
carnalism	纵欲主义
scent	香水
appeasable	劝解得了
coalesce	接合
valetta	=Valletta
gi	GI''s
felicitous	可喜
herbaceous	草本
litteratim	=literatim
hyperalgesia	痛觉过敏
nasology	鼻学
purr	发出喉音
tervalent	三价
pachydermatous	迟钝
footwork	步法
neuralgic	神经痛的
exvoto	为了还愿
explicitly	明白
petticoat	衬裙
conductibility	传导性
godless	不信神的
juicehead	嗜饮烈酒的人
obscene	淫秽
equalization	同等化
univallate	围有单层防护土墙的
expugnable	可攻克的
bank	岸
instantiate	例示
rente	岁收
banjax	压倒
unexpectedly	想不到
intrepidly	无畏地
martagon	头巾百合
mistakenly	错误
ailment	疾病
hackbuteer	火绳枪射手
interventionism	干涉主义
manageability	驯服
disadvantaged	贫穷
aquarist	水族馆管理人
antienzymatic	抗酵素的
coleoptera	甲虫类
kluck	喀喀声
stinginess	小气
unjoined	未结合的
octu	Unit军官学校学员训练队
buoyancy	轻快
manner	样式
uninjured	未受伤害的
vinylbenzene	乙烯基苯
overland	通过陆路
hydrotropically	向水性地
righteousness	正当
actualization	实现
enneastyle	前面有九柱
bally	非常地
troubleproof	不生故障
ephemerality	短命
dictaphone	口授留声机
tonight	今夜
outcast	被遗弃的
vexillary	军旗的
hypostases	沉淀
rdo	Data
freshness	刚
irrespective	不顾
fortifier	使坚固的东西
naggish	有点爱唠叨
stocky	矮壮
contraorbital	与正常轨道反向的
taurus	金牛座
millidegree	毫度
russety	红褐色
achaetous	无刚毛的
gyri	的复数
lactescent	分泌乳液的
stymie	从中作梗
lenitive	轻泻的
interstrain	不同品系间的
deviously	弯曲地
demoid	某地质层组特有的
thermoset	热固塑料
cutter	切割机
whiten	刷白
estrogenic	雌激素的
blandish	奉承
aerofoil	翼剖面
gravity	重力
applaud	拍手喝彩
impendent	即将发生
fossilify	使变成化石
easygoing	不严肃
megafog	浓雾警报器
maternity	母道
sling	用悬带吊卦
jumpily	跳跃地
waste	荒地
drogue	风向指示筒
zoom	陡直上升
accommodator	调解人
morose	乖僻的
geographic	地理的
testaceology	介类学
unmerited	不当的
decline	拒绝
lowness	低下
contradictious	异议多
dyschizia	大便疼痛
astrogator	宇航员
rehabilitative	复职
influence	改变
chainman	司链员
perspective	看法
joss	偶像
laggardly	缓慢的
overweening	自负
lecithoid	蛋黄素
account	得分
catilinarian	参与喀提林阴谋者
larine	鸥亚目的
transcurrent	横亘
likewise	同样地
hypopiesis	血压过低
dispossessed	无依无靠的
frizzy	卷曲
avirulent	无致病力的
moronity	鲁钝
oxbridge	牛津与剑桥大学
colonelcy	陆军上校的身份或地位
tensile	可拉长的
timbre	音质
fingersmith	扒手
cherubic	天真无邪的
spermalege	受精储精器官
sponsorial	教父的
archer	人马星座
hellbroth	地狱羹
scotograph	射线照片
myotic	促成瞳孔缩小的
resource	办法
phenomenological	现象学的
transmigrator	移居者
argosy	大商船
aggregation	集合体
puny	弱的
icebound	被冰封冻着的
chattily	爱讲闲话
scarlet	深红
terroristic	暴力主义的
supervenient	随后发生的
poort	山口
rowdyish	粗暴
standstill	停止
severally	各自地
neurotropism	神经亲和力
phenetol	苯乙醚
regelate	重新结冰
excite	激动
scrappy	碎屑的
mahomet	穆罕默德
unformed	未成形
orthoepic	发音正确
otalgic	耳痛的
appall	使惊骇
alphanumeric	文字数字
vmi	Virginia
dignified	有品格
caravan	大篷车
faculative	容许
getparms	获取参数
unscrupulous	无道德的
overcame	overcome的过去式
rebuttable	可辩解的
pacemaker	带头人
haunting	常浮现于脑海中的
advanced	高级
ruminant	沉思的
compilatory	编辑
eosin	曙红
dilatory	拖拉
hypertonic	高渗的
forsworn	不守誓言
posttonic	重读音节后
loophole	枪眼
mineralold	准矿物
apathetic	缺乏兴趣的
raggedness	粗糙
aeneid	Virgil
partridgeberry	其果实
brachydactylic	短指的
wherewith	用什么
borderland	迷糊含混之情境
curriery	鞣皮场
somnolency	想睡
nwa	西北航空公司
psid	differential
rigorous	严厉的
breezily	活泼轻松
nark	密探
pacemaking	当标兵
garry	oak奥里根白栎
praiseworthily	值得称许
termitary	白蚁窝
halberdier	戟兵
internuncio	罗马教宗的代理使节
weathermost	最迎风
gazebo	露台
aesthetics	美学
preprimer	低幼读物
ptv	public
dendritic	树枝状
macabre	恐怖
semisecret	半秘密的
albinism	白化病
chopfallen	垂头丧气的
tapadera	踏镫革片
gerentocratic	管理者
hairdresser	美容师
grundyism	因袭主义
underwater	在水下
medicable	有疗效
slider	滑冰者
reckon	总计
pedimental	山花的
laotian	老挝
asynapsis	不联会
dicom	Communications
coinsure	共同保险
subtetanic	轻度强直
outfield	边境
discourteously	粗鲁地
lymphoblastic	成淋巴细胞的
inhomogenous	杂拼的
metamorphose	使变成
frambesia	印度痘
hexahydroxy	六元
astriction	限制
kinfolks	亲属
iberian	伊比利亚人的
guildhall	市政厅
ptyalism	涎分泌过多
walloon	瓦龙人的
unanswerable	无可辩驳
dryest	为dry之最高级之一的
euphemistical	委婉说法的
denominative	有名称
semimoist	半潮的
nonenzymic	非酶的
lunarian	月球居民
holophone	全息录音机
dwarfism	矮态
troop	军队
argentous	银的
betacism	b
supervenient	随后发生
ground	使搁浅
picomole	百亿分之一摩尔
simple	简单的
conglomeracy	联合大企业的形成
reason	原因
rageful	盛怒
giraffe	长颈鹿
half	相当
world	世故
reload	再装
strip	带
perfectionism	十全十美主义
clausal	分句
eradicative	根除的
rebekah	=Rebecca
corrodent	腐蚀
lepidopterous	鳞翅类
toot	吹喇叭
shift	手段
asperity	刻薄
unenclosed	不在修道院受管束的
perissad	奇价的
flitter	飞来飞去
affray	打架
seethe	沸腾
potentate	当权者
cagey	精明的
vigilant	警醒的
streptomycin	链霉素
reviviscence	精力恢复
untrue	不正确的
serous	如水
hemoglobin	血色素
gingerly	慎重
habilatory	衣服
appealing	恳求似的
unpaired	不成双
grotesquery	怪诞
cypress	柏木属植物
benet	用网捕捉
color	歪曲
gentilism	非犹太教
bundu	荒野
friend	赞助者
recumbently	躺着
relucent	明亮的
exedra	开敞式有座谈话间
glutamine	谷氨酸盐
penetrative	深刻的
royal	王室
briefness	简单
ribbing	棱条配置
salopian	Shropshire人或居民
dichroitic	二色
tumefy	肿大
notary	公证人
fibster	惯撒小谎者
explicandum	在待解释的术语或陈述
quirkish	讥讽
keltic	凯尔特人的
setoff	抵消
movable	变动
tonal	音调
salivarian	通过唾液传播
tharm	肠子
turn	转动
flexible	能变形
reflect	反映
rsgb	Britain
ocam	非洲与马尔加什共同组织
instanter	马上
innate	天生的
responder	回答者
klipdas	蹄兔
make	被处理
erratic	不稳定
flinty	严峻
serpulid	龙介属动物
legally	合法地
marzipan	杏仁蛋白软糖
laurestinus	=laurustinus
chooser	选择者
overleap	越过
pignut	山胡桃果
prostyle	前柱式
msts	军事海运局
tetraphonic	四声道立体声的
hystrichosphere	刺球藻
attributive	归因的
igg	=ig
aapss	of
upswing	向上摆动
gluey	粘着的
nicole	尼科尔
findable	可找到
putter	轻击棒
lichenology	青苔类植物学
hyalograph	玻璃蚀刻器
skatol	粪臭素
wrongfully	不妥地
shinleaf	椭圆叶鹿蹄草
nabob	印度莫卧儿帝国的地方长官
osteological	学
pitcher	投手
spindling	细长
dangly	悬摆
clapt	clap的过去式及过去分词
crepitation	捻发音
fall	落下
graver	雕刻师
extol	赞美
picescent	黑色的
unfaithful	不忠实
cutworm	夜蛾科
rhizocarpous	多年生草本植物的
decompose	腐烂
theocratic	神权的
receptivity	接受能力
cms	Society
phyle	宗族
underrun	跑过……下面
incised	雕刻
gemmule	小芽
homologate	确认
relapse	旧病复发
fixer	定影剂
ulotrichous	鬈发人种
idle	停顿
baae	Engineering
disruption	瓦解
subcontrary	小反对关系的
neurotrophic	神经营养的
preatmospheric	大气形成前的
espadrille	帆布便鞋
cribriform	筛状
voguey	时髦的
caespitose	丛生
miscalculate	误算
sandhurst	英国陆军官校所在地
sheba	示巴女王
clarification	净化
drowse	瞌睡
disunity	不统一
diatessaron	四福音合参
ululant	哀鸣的
hal	Henry的昵称
benthoal	湖底
stiletto	打孔
photodegradable	可光降解的
pram	参数RAM
oath	誓言
rvsvp	repondez
supersonic	超音波
smart	精确
absorbable	可吸收的
incompetent	不胜任的
oneness	唯一
plodding	单调乏味
aerarian	财政
grubstreet	文丐
ilex	冬青属
gluey	胶质
expenditure	花费
cainozoic	新生界的
alteration	改造
incretion	内分泌
lettic	列托族
appropriation	据为己有
copycutter	报馆检稿员
unreactive	不起化学反应的
smudgy	脏污的
algal	海藻
carneous	似肉
japanophobe	憎恨日本的人
afterwards	后来地
racketeer	诈骗钱财
refold	再打摺
custard	奶油冻
replicable	能复现
dendroclimatic	树木气候学
ferrel	金属箍
bigeminal	二联
classic	名著
tuberculocele	睾丸结核
spherulite	球粒
unwound	松散的
favorable	赞成
hedger	种植树篱者
pugilistic	拳击
johns	约翰斯
comedist	喜剧作家
thundrous	=thunderous
underrepresentation	未被充表名额不足
fetch	引出
skinny	小的
mgd	百万加仑[日
expansible	会膨胀的
gillyflower	紫罗兰花
vergilian	似弗吉尔之诗
usafe	Force
acerola	金虎尾
photoelectromotive	光电动
dehydrate	脱水
ironbound	包铁
carrion	吃腐肉的
beat	拍子
seeing	看见
unhappy	不幸的
manteltree	壁炉过梁
representable	可被代表
electrowinning	电积金属法
nanaimo	纳奈莫
interleave	插入纸
pye	form表示"肾盂"
cumuli	累积
imperfect	减弱的
zootechny	动物饲养学
unfading	不凋萎
abandon	放任
hornless	无角的
indiscriminating	无差别地
batten	木条
repletion	充满
nosh	小吃
mellowness	成熟
invidious	不公平的
passkey	总钥匙
recommended	被推荐
synarthrodial	不动关节的
jimberjawed	下颌突出
neglected	被忽视
granuliform	具颗粒状结构
doddery	衰老的
scutch	棉等的纤维打散
atkins	=Tommy
entirely	全然
formation	形成
mean	简陋
teleconferencing	电信会议
carbolated	浸以石碳酸
cowslip	黄花九轮草
dogmatical	武断
concoctive	调合的
vinny	文尼
stupefactive	麻醉性
boastful	喜夸耀
trepan	欺骗
wondrous	令人惊奇的
whiffy	发臭气
veterinary	兽医的
torpedo	破坏
cytogenetical	细胞遗传学
barbaric	毫无约束
exoteric	外面
liable	易……的
hid	Home
shit	狗屁!
roul	roulette
sporeling	孢苗
amyloid	淀粉食物
yore	往昔
chronological	按年代顺序排列
agamospermy	不完全无配生殖
durability	经久
rabbinical	希伯莱语
marginal	记在页边
book	书
lour	阴沉
blewits	青紫色食用伞菌
cpsu	Party
yellow	黄色
tease	奚落
burst	脉冲
centner	合五十公斤
unfitting	不相称
gastrulate	处于原肠胚阶段
ruly	有秩序
amniotic	羊膜的
warve	=wharve
jacques	雅克
speak	表示意见
tinkly	叮当响
suprathermal	具有的能量超过热激发能量
lactescent	乳汁状
acronichal	日落时发生
autoregulatory	自动调整
aviarist	飞禽饲养家
custom	承接定做活的
saloonist	=saloonkeeper
unresponsive	无同情心的
floppy	邋遢的
snakelike	蛇一般的
embourgeoisement	资产阶级化
ruling	占统治地位
beauty	美好的东西
female	女性
hammerblow	类似的冲击
pleasant	舒适
supergranule	超米粒
prostitution	滥用
christianly	如基督徒地
umt	Military
hyetal	雨量
agitational	煽动性的
landward	近陆
entoptic	内视的
aneurismal	动脉瘤的
brahminism	婆罗门教
suberic	软木
fluently	流利
gynarchy	女人当政
natively	天然地
spectacle	奇观
set	一副
eviscerate	取出内脏
indeterministic	非定命论者的
emotion	感情
felted	黏结起来
laith	厌恶
spadework	费力的基础工作
netted	网状的
homosexual	同性恋的
haunch	臀部
sachet	香料袋
vacuum	空间
chink	叮当声
smileless	没有笑容
rhinolalia	鼻语
shlub	=schlub
reinspect	再考察
downtrodden	被践踏
toxicologically	毒理学地
falsification	伪造
largo	庄严地
drupel	小核果
lixivium	碱汁
uropygium	尾臀
piggish	猪一般的
obligee	债权人
ploy	工作
vpd	Product
piratical	海盗的
fletcherite	实行细嚼慢咽健康法的人
perpendicular	垂直的
gammadia	万字形
mistle	獬鸫
pannikin	小锅
stencil	蜡纸
boater	硬草帽
otiose	怠惰
sheriffwick	=shrievalty
set	固定的
gnomic	含格言的
rhinopharyngeal	鼻咽
isopropyl	异丙基
evolutive	发展
keratometry	角膜弯度计
irreformable	不可改造的
letterhead	印有抬头的信笺
landowning	有关土地所有权的
gripe	使苦恼
raised	凸起的
fag	使劳累
corrosively	侵蚀
chophouse	小餐馆
extended	长期的
strophulus	婴儿苔藓
direction	指导
manitu	=manitou
lavish	浪费
industrialized	工业化
accessible	可到达的
dungy	令人作呕
atherosclerotic	动脉粥样硬化患者
doughy	面团
ulterior	较远的
crossbar	横木
verboten	禁止的
lazar	恶疾患者
skite	突然的一击
swag	赃物
curb	路边
authenticator	认证者
aerial	航空的
bodily	肉体上
disharmonic	奇形怪状的
aptness	才能
samos	system
fulgurating	突然剧烈发作
unentangled	未缠住的
britannic	大不列颠的
molucan	摩鹿加语的
jackfield	=Jackfield
helophyte	沼生植物
unfix	拔去
polydirectional	多方向的
inappositely	不适合
chessel	干酪桶
legatine	使者的
miesian	密斯式建筑的爱好者
outward	周围世界
redeemer	耶稣基督
liquefactive	引起液化
weeping	哭泣
kinematography	=cinematography
derealization	现实感丧失
wingmanship	飞行技术
paleoflora	古植物群
neosalvarsan	新胂凡纳明
unreceptive	反应不快的
disbennifit	不利
cense	焚香
papaveraceous	罂粟科的
queerish	古怪
undistracted	心神不烦乱
customable	可征关税
subcrustal	壳下
supersonic	超声波
wretch	不幸的人
milksop	懦弱的人
headcheese	头肉香肠
costly	昂贵
commentary	注释
abstemiously	适度地
radioprotector	辐射防护药物
castigatory	惩罚的
ferrophosphorous	铁磷合金
technics	学术语
quaquversal	向四方倾斜的
chromophil	易染的
fluid	流动性
shrilly	尖锐地
cryptological	密码术的
cardiotachometer	心动计数器
fuliginous	煤烟色的
felicitousness	适合
acock	边翻卷
odal	=udal
stepwise	楼梯式的
ordinate	纵座标
depletive	减少血液的
tauri	的所有格
jut	伸出
glycosylate	使糖基化
wisecrack	俏皮地说
aplastic	无形
merohedral	缺面对称
cypress	柏科树
tupelo	多花紫树
goy	非犹太人
calculated	有计划
useless	无价值的
unpresented	未呈递的
amebic	阿米巴
malicious	怀恶意的
phonebooth	公用电话亭
guggle	水流的潺潺声
anecdotage	逸事集
afl	美国劳工联合会
simplism	单纯化主义
ethnologic	人种学
drammock	用冷水调和的燕麦粉
sick	渴望的
riverbank	河堤
ruminant	反刍动物
elastically	伸缩自如
coliphage	大肠杆菌噬菌体
forestall	用先发制人的方法预防
illicitly	违法地
protest	断言
scarab	圣甲虫形宝石
matroclinous	=matriclinous
molybdenian	钼的
vibrancy	振动性
unprincely	非王侯的
mussily	混乱
spread	伸展
ravage	劫掠后的痕迹
ostinato	固定音型
loanee	借入者
conclude	议定
anuric	无尿症的
tenemental	出租
ucky	黏乎乎的
plafond	装饰的天花板
sensationalize	以耸人听闻的手法处理
dependency	属
nibble	一点一点地咬
conformably	一致地
aweary	疲倦
pierrot	走江湖的丑角
visla	=Wisla
pop	砰地
superterrestrial	天上的
innocent	无罪
immunopathology	免疫病理学
aglet	金属饰物
carnauba	巴西棕榈
bimillennium	两千年
rockaby	乖乖睡
mahogany	红褐色
forcibly	用力
ft	金融时报
metrics	韵律学
exhaustive	无遗漏
superette	小型超级市场
tritheist	三神论者
inosculate	使吻合
martyr	杀害
qualification	条件
phosphoglyceraldehyde	甘油醛磷岣视退嵫
congoese	=Congolese
compound	复合
sociality	社会性
tapestry	织锦
eccrine	外分泌腺的
actorish	不受演技优劣影响的
excentral	中心以外的
dance	舞曲
lung	肺
gripe	把手
rubbidy	=rubbedy
minable	可开采
cleansing	使清洁的人或物
cardindex	将……制成卡片索引
energetic	积极
reeded	有凹槽
obeisance	服从
tumefy	浮华的
committal	委托
misleading	令人误解
apomict	单性繁殖的生物
hexad	六个一组
semiparasite	半寄生
lisping	口齿不清的发音
msee	电机工程学硕士
antisexist	反对性别歧视的
faddish	风行
lengthy	过分的
hma	高端内存区
frumenty	牛奶麦粥
galactopoiesis	生乳
plasmatron	等离子体发生器
adjutantship	副官职位
taffrail	船尾上部
motorist	乘汽车者
autotelegraph	电报传真机
overlook	耸出
fistuliform	管状
grumbler	发牢骚的人
aperiodic	不定期的
christmasy	有圣诞节气氛
floridly	华丽地
antideuteron	反氘核
striated	有线纹的
ventilate	给……装通风设备
lynch	中伤
koradji	巫师
field	野外的
remarkable	值得注意的
usts	United
poignant	刺激的、辛辣的
compilation	编辑
foreclose	排除在外
gummatous	梅毒瘤
unassimilable	不可同化
pedagogic	教授法的
chloropromazine	=chlorpromazine
undercut	廉价出售
fst	Flat
puree	浓汤
sanguine	满怀希望
brawn	腌制好的野猪肉
makeshift	权宜之计的
aire	亚耳河
bndd	of
outdoorsy	适用于户外的
introduction	绪论
aarp	Address
photosensitivity	感光灵敏度
placoderm	盾皮鱼
dead	绝对的
colorblind	色盲的
greenlandic	格陵兰的
aeolotropy	有方向性
parang	帕兰刀
minister	大臣
glazed	光滑的
consentient	无异议
ellis	埃利斯
regardlessly	毫无价值
accommodable	可适合
fiacre	小型出租马车
bottlekhana	餐具室
phocine	海豹的
pants	短裤
eternal	永恒的
squirarchy	=squirearchy
underdoctored	医生不足的
auntie	伯母
nantz	白兰地酒
normoblast	正常红细胞
elector	竞选人
sheila	希拉
proteolytic	蛋白水解的
multigerm	多胚芽
radioactive	有辐射能
incombustible	不燃性
ohmmeter	欧姆计
dartle	突进
harassed	疲倦的
semirevolution	半旋转
transit	运输
metatarsal	跖骨
unleavened	未受激发
tersanctus	=Sanctus
homolog	相当或相同的事物
fair	清楚地
run	奔跑
muscarine	蕈毒碱
isophyllous	等叶的
pycnogonid	皆足虫
undermost	最低
boisterous	狂暴
stipple	点彩
constipated	患便秘症的
fungoid	真菌样的
extract	选粹
ablaze	激动
spirivalve	螺状
thoroughwax	圆叶柴胡
caliginous	昏暗
inapposite	不合适的
heard	hear的过去式和过去分词
hemagglutinate	使红血球凝聚
tap	熄灯号
immy	=immie
sway	摇摆
dibasic	二盐基的
firebrand	火把
swimmy	眩晕
runout	逃开
landaulet	形的小型车
calculous	微积分
lentiginous	雀斑
underproductive	生产不足的`tIvEtI/
planification	计划化
mattress	床垫
animalistic	兽性说
vichyssoise	奶油浓汤
wamus	开襟绒线衫
meliorable	可改良的
homoerotism	同性恋
lmbc	Margaret
swink	使工作过度
eggshell	蛋壳
sisterly	姐妹一般的
legateship	使节的职权
sforzato	加强地
standard	军旗
aborative	煞费苦心的
censorable	须受检查的
trimotored	有三个引擎的
condolatory	慰问
multicentric	多发源点
gummiferous	产树胶
redoubted	可怕
crucify	十字架上钉死
sloganeer	大量使用标语口号
uninspected	未经检查的
sculptural	雕刻般
logos	圣子
sanguification	血液化
braggart	自夸
superstruct	把……建为上层建筑
cloudscape	云的风致
tardigrade	缓步类动物
scotticise	=Scotticize
mesentery	肠系膜
mercilessly	残忍
bey	州长
peart	聪明的
tarantula	鸟蛛
aftershaft	后羽
kindly	温和的
sought	seek的过去式和过去分词
vacuum	利用真空
blarney	阿谀
disallowable	可否决的
slobbery	过于伤感
regalvanize	再给…………通电
benignantly	有益地
wassail	祝酒时用的酒
photophilous	适光
rhyme	韵律和谐
elliptical	椭圆
timer	记时员
arundinaceous	芦苇
homozygous	同型结合的
federative	联邦的
respecting	关系
uxoriously	疼爱妻子地
wuzzle	搞混
kumgang	Mountains
uncase	除套
personal	身体
branch	出现分歧
brassily	似黄铜地
ip	Internet
camper	露营者
atmospherically	气压上
goosy	愚蠢的
ruffly	起皱的
nenadkevite	硅钙铅铀矿
baldness	枯燥
massless	无质量的
zi	interior后方地带
presuppose	预示
informative	提供情报
quicksandy	多流沙的
pinocytized	被细胞摄入
brier	荆棘
scarlet	猩红
reason	推论
undimmed	不模糊
jwb	Jewish
mineralold	类矿物
depreciation	减价
indoor	室内的
silverback	银背大猩猩
bitterweed	含有苦素的植物
impar	不成对的
unplantable	不可种植的
mace	肉豆蔻
verneuk	欺骗
forebode	预感
ecstatically	心醉神迷
rodent	啮齿目的
cowheel	炖蹄筋
inamorato	情人
negabinary	负二进制数的
placentology	胎盘学
windward	上风面
uaa	United
determinative	决定
shawwal	10月
ccco	for
stylish	时髦
yellowy	略带黄色的
duorail	两轨铁路
nanny	Ann
epitaph	碑文
mdap	Program
suffocatingly	令人窒息地
perispore	孢子周壁
chute	瀑布
dragonesque	龙状的
favorer	爱顾者
coincide	符合
slatter	使溅出
digital	手指的
agedness	老年
unpracticed	不熟练
dotard	年老昏愦之人
polisher	磨光器
dprk	of
legalist	法律学家
iroquoian	易洛魁族人
ruly	有秩序的
unearned	不劳而获的
pseudology	捏造
conflicting	不一致
retiary	结网的
thunderhead	雷暴云砧
ecocline	生态倾差
spearhead	充当先锋
average	一般的
outshoot	旬曲线球
everyday	平凡的
bastardly	假冒的
tarnishproof	不变色
xiphias	剑座
measureless	不可量
traditionist	传统主义者
unsaturated	不饱和的
inductile	没有延性
tetraxial	有四个轴的
son	圣子
noserag	手帕
contractible	缩小
theandric	神人两性结合的
johnson	詹森
inapplicability	不适用
snobbish	势利的
decussate	交叉着的
doohickey	小玩意
waver	踌躇
commiseration	同情
miscue	失误
abuliding	酝酿中
supracrustal	上地壳的
silverberry	银果胡颓子
bastardly	庶生的
pierage	码头费
suborder	亚目
adhere	坚持
cancer	癌
contrariant	反对
courtroom	法庭
rivalry	竞赛
come	开始
kowtow	叩头
aristocratic	贵族化
quinidine	奎纳定
serenely	沉着地
drily	干巴巴的
raised	凸起
diseur	单口相声演员
desperately	失望
cantal	法国硬干酪
pout	板脸
cleocin	氯林可霉素
boblet	双人雪橇
unimpeachably	无可指责
macroeconomic	整体经济
therewithal	随其
phenocryst	斑晶
undersurface	水面下的
wisha	哦
zonally	带
subsume	包容
sheugh	沟渠
scoticism	=Scotticism
golden	黄金的
delectus	选萃
columelliform	似小柱
from	从
raja	首长
ultrared	红外的
paracentesis	穿刺术
hematozoal	血寄生的
summarily	概略
decreasingly	渐渐减少
premium	贴水
hitter	击球员
choralist	赞美诗歌唱者
compulsionist	主张采取强迫手段的人
handled	有把柄的
bmj	Journal
birthstone	诞生石
interstitial	裂缝
unartificial	非人工的
inclip	围住
mahogany	桃花心木
cretin	白痴病患者
limejuicer	英国水手
condolatory	吊唁的
dehumanize	使失掉人性
choosing	选择
firmness	稳固
banausic	实用的
stub	断株
rattlebrained	愚蠢多嘴的
undisturbed	没受到干扰
westward	西部
crop	种植
fleetingly	疾驰地
skinny	似皮
vamper	即席伴奏者
personality	个性
comminjute	分割财产
dry	干
logbook	飞机航程表
nurseling	养子
iran	伊朗
spodumene	锂辉石
canniness	精明
veil	假托
looper	作线环的装置
zoroastrianism	火袄教
saltant	跳跃
forestry	林学
badian	=Barbadian
hummer	发嗡嗡声的东西
unnecessary	不必要的
verecund	害羞的
frequency	频率
iterance	复述
course	流动
oscan	欧斯干人
wizard	有魔力的
actual	实际的
letterweight	镇纸
ruffled	有褶饰边的
taking	捕获
dolorology	痛学
autoptical	实地考察
vapor	水蒸气
pogonip	冻雾
inconducive	无益
wifely	妻的
seminar	研究会
ceramic	陶瓷制品
unpresented	未提出的
carton	硬纸盒
deb	初上舞台的人
jaunce	策马腾跃
downy	丘原的
minty	有薄荷香的
wakefully	提高警觉地
phyllary	叶状苞
msie	Industrial
fixedness	稳固
guesthouse	上等旅社
mithraistic	=Mithraic
jauntily	高兴
hpv	human
fledging	羽毛初长的雏鸟
lorn	孤单的
carefree	不负责
microporosity	微孔率
dysplasia	发育不良
backbiting	中伤
uniaxial	单轴的
duckling	小鸭子
harvesttime	收获季节
dampish	稍湿
exchangeable	可交的
postulate	基本原理
parenthetical	插句的
leptonic	轻子
randomicity	任意性
saturate	使充满
seti	search
truelove	轮叶王孙
templet	样板
libyan	代利比亚语的
fidget	烦躁
expertize	任专家
prosody	韵律学
disquiet	不安
compoundanimal	群体动物
postirradiation	辐照后的
pugwash	conferences帕格沃什会议
malfeasant	贪官污吏
curse	祸根
atheistical	无神论的
cartoner	纸板包装机
mountain	山
vertical	竖向
horntail	树蜂科动物
chance	偶然
jade	绿色
rmb	Renminbi
microsporangiate	小孢子囊
servomechanism	跟踪器
ironmongery	铁器类
amply	详细地
plump	使鼓起
restively	倔强地
diphtheritic	患白喉的
multirole	多作用
plainclothesman	侦探
wham	重打声
orchidaceous	兰花般的
gooky	粘的
aloetic	芦荟制的
precedency	领先
eristic	好争论的
aquiver	兴奋
clausal	分项的
augustan	奥古斯都时代
second	第二者
showroom	陈列室
template	模板
reclassification	重新分类
zeugma	轭式修饰法
mover	行动者
saturnian	土星
twelvefold	十二倍的
unquestioning	不问是非的
unvalued	未评价过
unerringly	正确地
zapu	African
aglare	耀眼
distressful	不幸的
provable	可证明的
sitzmark	滑雪者向后摔倒又坐起后留在雪地上的凹坑
archaize	使具古风
locoplant	洛苛草
britannic	大不列颠
fiery	火
turnstile	十字转门
antiphlogistin	消炎膏
denaturation	改变本性
caulome	茎的结构
ostensible	可公开得
avp	抗病毒程序
bum	乞讨
crispate	卷缩状的
seawater	海水
yh	youth
pruth	=Prut
unimpugned	未受怀疑的
phanerogamous	开花的
divinely	庄严
gearless	无传动装置
war	作战
barbiturism	因过度使用巴比妥酸类药品而引起的慢性中毒
foliate	覆有叶
annealing	退火
unaccountably	不可解释
prohibitor	阻止者
melodious	音调优美的
paraphrasis	变换措辞
sound	合理的
telltale	搬弄是非的
unweary	不疲倦
tricrotic	三重搏的
dissociably	不调和
competitory	竞争的
gdynia	格丁尼亚
episode	插曲
egesta	排泄物
digitate	有趾
aspca	for
benzocaine	苯坐卡因
westernmost	极西的
yhwh	耶和华
nationwide	全国性
factory	制造厂
hatbox	帽盒
nicker	马嘶
exceptant	例外
phosphorolytic	磷酸解
tawse	皮鞭的一种
throwback	大倒退
nonperiodic	非周期的
uneventfully	太平无事地
lacerant	折磨人
pike	矛
designing	有计划
berme	崖径
inconvertibility	不能兑换
phrenetic	精神错乱的
aic	Chemists
lhd	Litterarum
determinatum	被定体
experiential	根据经验的
rarefied	纯净的
choking	窒息
burglarproof	防盗
arsenic	砒霜
luxuriously	奢侈
assamese	阿萨姆
jubilize	欢庆
embosom	围绕
hartshorn	鹿角精
ligate	绑
undereducated	未受良好教育的
crumb	少许
omnisex	包括男性与女性
moorish	摩尔人风格的
overcome	胜过
jerk	肌肉抽搐
mend	加快
pent	被关闭
fond	多情的
distinction	显赫
haustellum	吸器
uncontested	没有人争的
fogfruit	石苋
culpable	有罪
western	西的
blodge	斑点
reflect	反射
gloss	上光于
pliers	老虎钳
margarita	玛格丽塔
yva	Valley
vrm	CPU电压调节组件
hoodlum	阿飞
whirlabout	旋转的
intervallic	音程
nomarch	州长
cool	凉爽
foremost	首要
wader	跋涉者
postcranial	颅下的
pillular	=pilular
uninquiring	缺乏好奇心
antenuptial	结婚前
parallel	并联
cheek	厚颜
astrolater	天体崇拜者
amaryllidaceous	属石蒜科
inextricably	逃不掉地
retroverted	倒退的
reclama	申请复议
disjunct	分离的
impavid	无畏的
zenithward	向天顶
embalm	涂香油于
sphygmoscope	脉膊检视器
respective	各自
undermost	最低的
capsize	倾覆
imagist	意象派
strongpoint	战略要点
flocculi	小叶
trillium	延龄草
brainless	愚笨的
osmidrosis	腋臭
aristocratic	贵族
brand	商标
geomantic	风水
meek	温顺
cosey	安逸
cylindraceous	圆筒状
eccentrically	离开中心
gumptious	机灵的
flagellate	有鞭毛的
radiator	电暖炉
forepaw	前蹄
rga	Artillery
snook	嗅
flavorful	可口
scanty	稀疏的
dalliance	调戏
prow	勇敢的
philippic	痛斥
screeve	告地状
dexter	幸运的
echinoid	海胆属的
fascine	柴捆
thyrsoid	聚伞圆锥花序状的
park	停放
ilk	同类
reinsurance	再保险
pyelonephritis	肾盂肾炎
gravitate	倾向
hebetic	青春期发生的
traitoress	=traitress
crinite	有长软毛的
grandaunt	姑婆
tractate	论文
autotrophic	自给营养的
autecious	=autoecious
featheriness	羽毛状
asyllabic	不成音节的
afl	Federation
petard	爆竹
gruffly	粗暴地
trematode	吸虫
scalar	分等级的
antienzymatic	抗酵素
embryectomy	胚胎切除术
reunify	再联合
umbilici	种脐
bill	给……开帐单
dogmatical	教义
approbate	许可
warrantee	被担保人
vieta	维也塔环形山
bey	土耳其对要人的尊称
hydrofracturing	水力压裂
hypothetical	爱猜想
cocarboxylase	焦磷酸硫胺素
vectorscope	矢量显示器
spiritualist	巫师
cast	一瞥
surgy	大浪翻腾的
aconitic	乌头
helmsman	舵手
pluviose	雨量多
dicky	恶劣的
syriac	叙利亚
circumspective	慎重
deadsville	沉闷的
macaroon	蛋白杏仁饼干
nonrepresentational	抽象的
nuciform	核子状
inimitable	无比的
fense	墙
podzolise	=podzolize
lambent	闪烁的
outlander	外地人
microevolution	微进化
dampish	含湿气
angel	完善可爱的人
mach	一种UNIX操作系统
insurgence	起义
unabiding	不持久的
enquiry	询问
bibliotherapy	读书疗法
jow	钟声
brotherly	亲切的
heliotropin	胡椒醛
microfungus	微直菌
crooknecked	曲颈的
hardenable	可硬化
mignonne	娇小可爱
freely	直率地
venire	陪审员召集令
excussion	依法索取
moneyman	金融家
angular	有角
ostentation	风头主义
average	平均数
niggard	吝啬
mesoblast	中胚层
mussily	混乱地
lur	Underground
safeguard	保护
lotion	洗剂
cautious	谨慎的
judgment	判断
exarate	足翅不贴着在身体上的
henhearted	怯懦
blastula	囊胚
pleasurable	合意
equalization	均等
linden	菩提树
beastly	令人不快
subthreshold	不足以引起反应
arenic	竞技场
poise	镇静
truant	逃避
lobsterman	捕龙虾的渔夫
internality	内在
mnas	the
chromogen	色原体
marked	有记号的
citron	圆佛手柑
uglifier	破坏美观者
chowderhead	傻瓜
hardtop	室内电影院
retiral	退却
reciprocitarian	互惠的
dexter	右边的
gussy	装饰
fiann	芬尼亚勇士团团员
eoka	为塞浦路斯而斗争全国组织"
louche	品德有问题的
castiron	健康
unascertainable	不能确定
basso	低音部
lipotropic	抗脂肪肝的
undimmed	不暗淡的
eared	有把
admonish	训诫
optometer	视力检定装置
tapioca	木薯
cpaffc	Friendship
deceleration	减速
sociopath	不爱社交的人
fictitious	虚伪
enclisis	连读
railing	栏杆
saceur	Europe
catamount	山猫
irrepleviable	不准具保领回
ever	永远
eozoic	始生代
plutonism	地壳火成说
pronounced	讲出来的
sulfonyl	=sulphonyl
trepan	环锯
carbohydrase	糖酶
substantialize	实体化
meadowsweet	绣线菊草属的草
intrepid	勇猛
rsn	即将发生
sunlit	阳光照射的
unsccur	Resources
aarnet	Academic
concerted	协调的
mirth	欢笑
einsteinian	爱因斯坦理论的
coxitis	髋关节炎
prolific	丰富
sloughy	蜕皮
abrader	磨石
nodular	小节
nonnasally	非鼻地
permanence	永久
lame	使成残废
suety	牛脂一样的
mercuric	含水银的
abusive	辱骂的
retroflexion	反曲
lampad	灯
plop	使掉下
laughingly	笑着地
gastrovascular	消化与循环两用的
overdrive	驱使过度
specific	特效
cutout	挖剪图画
aye	投赞成票者
compages	组合
muggins	一种牌戏
peck	啄痕
concupiscence	强烈的邪欲
rubble	碎石
seer	幻想家
preventible	可阻止的
clavated	棍棒状
extrusion	喷出
fabrication	伪造物
freeborn	自由民的
nostrum	秘方
noted	著名
europanet	欧罗巴网
nccw	National
condensative	易凝缩
sudaria	擦脸巾
override	奔越过
fermentative	促起发酵
ribby	多肋骨状物的
whammy	剧烈的打击
skeletony	骨骼似
prothoracic	前胸的
genappe	烧毛毛纱
style	称呼
comedones	黑头粉刺
outfit	装备
oxeye	大眼睛
engineer	火车司机
patronizing	俨然以恩人态度
hydrosulphuric	/氢硫酸
fibrid	纤条体
imperceivable	=imperceptible
countryseat	郡政府所在
jostler	推挤的人
aerotrain	飞行式气垫列车
photomechanical	照相工艺
keratose	角质的
takingly	迷人
lipogenous	产生脂肪
seminiferous	产生精液的
set	调整
deuteronomic	劝人行善
jejune	无兴趣的
backlash	后座
pigmentize	获得
screwball	怪僻的
zygodactylous	前后有双趾
maranta	竹竽
turnkey	监狱的看守
traprock	=trap
degustation	品尝
numerous	许多
cowgrass	瓜槌草
leninism	列宁主义
sanctified	批准
stuff	材料
frock	工装
nicer	良好
trichloronitromethane	=chloropicrin
couchant	抬头伏卧状的
fluxional	微分的
trickster	魔术师
abstemious	节约
xylocaine	木卡因
transversal	截线
embarrassingly	使人为难
undissembled	不加掩盖的
condenses	浓缩
riksdag	瑞典之国会
entente	有协定关系的各国
howdy	您好
malicious	恶毒的
mediocrity	平常
chilitis	=cheilitis
goober	落花生
sinter	使烧结
throughway	快速道路
nummular	硬币形
nccw	Women
insectile	昆虫
unsuspecting	信任的
malanga	暗绿叶黄体芋
madid	泪汪汪
loo	厕所
ckd	完全分解
undistinguished	未经区分的
victor	胜利者
phenylephrine	苯肾上腺素
pectinated	栉状的
spc	南太平洋委员会
beetling	突出
parenthood	亲子关系
inhumane	残忍
plp	议会工党
study	试图
naad	=nada
construable	可做……解释的
scarcely	几乎不
disaccharid	二醣类
unspecific	非特定的
elapse	过去
fenestral	如窗
fretful	焦躁的
silvern	银一般
tympano	tympani的单数
elevatory	向上举的
capable	可以……
duplation	双倍
yond	那边
cohesion	结合
controllable	可管理的
oligarch	寡头政治执政者
flagging	下垂的
klischograph	电子刻版机
alum	矾
multinuclear	=multinucleate
heartquake	惊心动魄
rpq	for
enquirer	追究者
simple	简易
ineloquent	不传达表情的
paratactic	并列
agitational	鼓动性
incisal	切的
toilworn	憔悴
unidentifiable	无法鉴定
crabbed	潦草
gavot	加伏特舞
lobe	圆形突出部
alkahest	万能溶剂
romance	渲染
shoji	障子
evolvement	发展
modernism	现代思想
arthrotropic	致关节疾病
dissimilarity	不同
misfile	归错文挡
dauber	涂抹工具
tumblerful	杯子
addressable	可设定地址的
cocky	自大的
antidiphtheritic	抗白喉的
mortagage	抵押
fine	杰出
joyously	快活
stum	未发酵的葡萄汁
caltech	加利福尼亚理工学院
depletive	使干涸
unhand	将……放掉
semiagricultural	半农业的
diseaseful	不健康
reticulum	网状组织
suited	匹配
nutriment	营养品
postiche	画蛇添足
attune	使合调
podded	有荚
psro	职业标准审查组织
usha	Housing
flory	temperature弗洛里温度
asbestoidal	似石棉
brushland	矮灌丛
put	放
alvar	矮化植被
aspectual	体
plumbiferous	含铅
diphyletic	二源的
riffle	使起涟漪
fisk	国库
flutter	飘动
typesetting	排字
uninvoked	未被祈求
wsj	Street
hectic	脸上发红
bronchi	bronchus的复数
repellency	抵抗性
knighthead	支撑杆
punctulated	有凹陷
nibble	啃
micrometeoroid	微流星体
nationality	国家
hack	砍
attentat	犯罪企图
defensive	防御
sweepstakes	赌金独得赛马
sanguicolous	栖血
labyrinthine	迷宫的
nailsick	因多次钉过后而不结实
cloistral	修道院的
psychoactivity	影响心理状态
handwrite	亲手写
adjunction	附加
wsj	Wall
ardor	激情
rightward	向右
hutch	茅屋
hyperion	亥伯龙神
hex	妖法
godliness	虔诚
hurtless	不会受伤
foliose	叶子覆盖
disfigurement	缺陷
degression	下降
causeless	偶然
zimbabwean	津巴布韦的
bargee	驳船船员
stylistic	体裁上
petting	爱抚
being	有
flockpaper	毛面纸
undynamic	无活力
dualhead	双头显示技术
hoodoo	使倒霉
ldc	Country
provable	可查明
far	很晚地
orifice	口
japonic	日本的
charmingly	愉悦地
slender	微薄的
toughly	坚强地
peremptory	强制
sanga	=sangar
opster	视幻艺术家
fair	晴朗
arbo	虫媒的
syndicalism	工团主义
slimming	使苗条的
rdx	三次甲基三硝基胺
savourily	有味道地
lacune	洼
liar	说谎者
lytic	细胞溶解酶的
agitational	煽动性
mammock	碎片
zygospore	接合孢子
magnalium	镁铝
iconograph	图示
chinoperl	Chinese
disoriented	分不清方向或目标的
fernery	蕨类栽培地
stargaze	凝视
vhf	甚高频
damoclean	危险临头的
madeleine	玛德琳蛋糕
time	时间的
swat	猛击
schizogonia	=schizogony
meat	肉类
authentically	确实地
syntechnic	异种趋同的
bagpiper	吹风笛的人
cheerleading	带领啦啦队
jealous	妒忌的
foreignism	外来语
tarnation	讨厌
secretaryship	任期或职权
chide	斥责
hydracid	氢酸
servicing	维修
lmbc	Boat
iab	Architectrue
obliterate	删除
erotology	色情文艺
glycolate	乙醇酸盐
obtuse	愚蠢的
flub	把……搞得一团糟
pustule	脓疱
substratal	基础
transcribe	转录
houseman	男仆
botheration	麻烦
subaqueous	水下用的
kilter	顺利
brassiness	低廉而华丽
tito	提托
golden	金黄色
expectability	能预期
blindstory	暗楼
housewife	主妇
canorous	音乐般
wiredrawing	拖长
feverish	发烧
spinet	小型立式钢琴
tranquillizer	使镇定的人或物
fit	健康
cryptanalyst	密码专家
prank	打扮得漂亮
startling	令人吃惊
undebatable	无可争辩的
pettifog	做讼棍
mobile	可移动
waif	飘流物
evergreen	常绿树
supersubstantial	超实体
beetleheaded	笨的
eared	有耳
gang	群
swipes	味道平淡的低级啤酒
knowledgable	=knowledgeable
fractious	脾气不好
palsy	瘫痪
weta	沙螽
supertransuranic	超重
katatonia	紧张性精神分裂症
benorth	在……之北
nailsick	因多次钉过后而不结实的
prioress	大女修道院副院长
thoughtfulness	慎重
authentic	可信
delighted	欣喜
ordinant	规定
filmic	电影
cuspidated	有尖端
royal	王室的
clavecinist	大键琴演奏者
transmission	转播
polyembryony	多胎
terai	特赖帽
antique	过时
straitness	狭隘
heartache	悲叹
nectar	任何美味的饮料
geoponics	农业
wateriness	平淡
iht	Herald
pinocytized	被胞饮
parosmia	嗅觉倒错
mauley	拳头
kickup	舞会
muscoid	苔藓状
decinormal	分当量的
omnicompetent	有全权的
bali	巴厘岛
tribal	部落
uranide	铀系元素
aesthetic	审美
haler	赫勒
iktas	物品
circumvolant	环绕飞行
defeat	挫折
gallop	飞驰
log	园木
teleputer	电视电脑
presidiary	驻防地的
pisa	比萨
riffle	洗牌动作
nanhai	南海
unseemly	不体面
cleaver	切肉刀
wfd	Deaf世界聋人联合会
electrotaxis	向电性
flighty	反复无常的
coder	编码装置
curtal	切短的
insusceptible	不为所动
expressional	表情的
rickets	佝偻病
bewitch	施魔法于
gadgety	小发明
crop	平头
ligamentary	韧带
lordly	贵族般地
orbicular	球形的
outright	立刻地
guide	支配
mec	机械工
outfield	外场
exponential	幂数
chinaberry	楝树
musketeer	步兵
comity	礼仪
cantiga	短抒情诗
literalness	表面意义上
dropout	辍学学生
theretofore	在那以前
remigrant	再迁移动物
microanalyzer	微量分析仪
pimpmobile	豪华型定制轿车
solvability	解决之可能性
bowdlerize	修订
voodoo	一种图形加速芯片
asciferous	=ascigerous
caitiff	卑劣
polycarpous	多心皮
falsehearted	虚情假意的
renature	复性
convenable	可召唤
exsuccous	干
watering	排水沟
tatty	褴褛
nc	数字计算机控制
pater	父亲
karakalpak	卡拉卡尔帕克语
understandable	可懂
acting	代理的
collet	夹头
ue	Workers
grizzle	灰色物
foliate	有叶的
passible	易动情
treetop	树稍
idle	使空转
lapse	过失
understrength	人员不足的
gravelly	铺有碎石的
ccd	Charge
perceivable	可知觉
raec	Army
boondocks	荒野
trigonometer	三角测量者
ordinary	普通
resolution	坚定
floriferous	有花的
osteopathist	接骨医生
uaa	Airlines
nec	是世界五大电脑制造商之一
lallation	音发成
scherzando	诙谐地
reliquidate	重新调整
deniable	可否定的
staphylococcal	由葡萄球菌引起
elevon	升降舵补助翼
thinnish	较细的
gargoyle	怪兽状滴水嘴
cia	中央情报局
milch	生乳
factious	好捣乱
negligee	随便的衣着
disbelieving	怀疑
valuable	颇有价值
definite	一定的
overdaring	鲁莽的
tristesse	沉闷
offramp	驶出坡道
fledging	刚会飞的幼鸟
faint	变得微弱
asphyxial	窒息
parenthetic	插句
zenist	禅宗信徒
whinger	短剑
drafty	有缝隙风吹入的
umber	棕色
inshore	近海岸
vlsi	超大规模集成电路
shaoxing	绍兴
rambunctiously	粗暴
masterdom	支配
transiency	顷刻
actinomorphous	放射状的
literatus	学者
craniectomize	进行颅骨切除术
winnow	扬谷
treatise	论述
fanciness	花俏
anyone	任何一个
statistical	统计的
ndea	National
medicament	药剂
caponata	碎茄子和什锦蔬菜制成的调味品
doubtfully	含糊地
trichopteran	有毛翅的
infinite	无穷大
bluesy	布鲁斯乐的
typewriting	打字工作
unadvised	欠思虑
belay	把绳索拴在系绳栓上
fiduciary	受信托
grueling	重罚
snubbingly	厉声制止
directorial	指挥
ascendency	优势
remotely	遥远
oracle	神谕处
stop	风琴的音栓
dicty	极好的
scud	小阵雨
digastric	二腹的
homburg	洪堡软毡帽
bmta	英国汽车同业公会
gestagen	促孕激素
paster	贴纸
doglegged	弯曲如狗后腿的
gasolier	=gaselier
paperweight	书镇
cureless	无法医好
apa	Austrian
mass	大量
salesian	教徒
direct	指导
dilatory	拖拉的
tripos	文学士荣誉学位考试
flicker	使闪烁
unplausible	=implausible
lydian	吕底亚语的
opencut	=opencast
jeton	投币电话筹码
narcotic	镇静剂
befool	糟蹋
glaucous	覆有白粉
ludditish	反对机械化自动化的
tied	系
unversed	不熟练
undercroft	圆顶地下室
cloud	阴沉
rework	重做
dishonorably	不名誉地
nervine	神经
excommunicate	被逐出教会
debeak	切去的嘴尖
dead	突然
constringe	使收敛
spiccato	跳弓演奏
myocardiograph	心肌运动描记器
labyrinthitis	迷路炎
disarm	放下武器
riot	骚乱
setback	逆流
nescient	无学的
contemporaneous	同时期
hysteric	过度狂燥的
towardly	和蔼可亲的
conduit	沟渠
fatten	养肥
rail	扶手
unshakeable	不可动摇的
bardian	个性的
duodenary	十二倍的
articular	关节
antennate	具触角
feterita	非洲芦粟
aneroid	无液气压计
overfeeding	过量食物
dover	英国东南部的港口
robust	精力充沛的
regard	关心
townlet	小城镇
crappie	刺盖太阳鱼属鱼
tabby	平纹
sunburnt	起晒斑
lanceted	有尖拱
masturbatory	手淫的
uninhabited	无人居住的
polt	密谋
woodsy	树林多
plasticine	塑像用粘土
honestly	公正
reprofile	装修……的外表
sanguinivorous	=sanguivorous
mineralold	似矿物
luthern	window
combine	联合企业
disorient	使失去方向感
dumbartonshire	=Dunbartonshire
aluminiferous	含铝
lithiasis	结石病
anesthetic	麻醉的
hutch	小舍
cosey	安逸的
overmaster	压倒
cragsman	攀岩者
topographical	地形学的
tabby	使起波纹
agog	热切
intercessory	调解
combatant	战斗员
locomobile	自力推动的
adolesce	进入青春期
tetraplegia	=quadriplegia
krakatoa	喀拉喀托火山
tlo	loss
aglare	闪耀的
mna	护理管理学硕士
reparatory	=reparative
bfr	Buffer
electrogalvanize	在……上电镀锌
interbrain	间脑
ashram	嬉皮群居村
ichthyophagy	食鱼
inflammatory	煽动性
greaves	脂渣
bosket	丛林
residential	住宅的
cub	不懂规矩的年轻人
neoanthropic	新人
closer	靠近
ivied	常春藤遮盖着
cella	内殿
twisty	不直接说明的
back	支持
unwalkable	不能行走的
unreserved	无限制
inobservantly	怠慢
pathogen	病原体
dsrv	深潜救助艇
inexcitable	冷静
freehand	凭手画
embark	从事
culminating	终极的
multiflash	使用多个闪光灯拍摄
broadband	宽带
angelino	洛杉矶人
forest	植树于
sterile	不结果的
twinkling	荧荧的
endlong	直立
glum	阴郁的
sedimentology	沉积学
stopcock	活栓
alienist	精神病学家
panmictic	随机交配群体的
forfeitable	可没收
gingery	姜味
tropaeoline	金莲橙
comfortlessly	孤单
cooptative	由原任委员投票的
duplicate	两倍
divinize	偶像化
roughly	概略地
rickety	驼背
pagination	分页
preantiseptic	抗菌法采用前
narrowcast	小范围播送
wive	娶
suppose	猜想
recommendable	值得推荐
pedestrian	步行者
bareback	无鞍的
pinole	甜炒玉米粉
stirabout	活动分子
myoneural	肌神经
bicornuate	双角的
lunanaut	=lunarnaut
cpff	cost
flavourful	可口
psaltery	古代弦乐器
follow	从事
rotary	旋转
intersect	交叉
illume	点亮
immurement	禁闭
festive	喜庆
prosify	使平庸化
isogon	等角多边形
procural	获得
tuum	你的
snooty	鄙视别人的
rebarbative	令人讨厌的
invulnerability	刀枪不入
helplessly	无望
walty	易横倾
teen	使烦恼
sotted	麻木迟钝的
terraalba	白土
dryly	干燥地
distortion	扭曲
pharmacology	药理学
hypersonic	远超过音速的
dolldom	娃娃世界
envionment	Java环境
emaciation	憔悴
aerosphere	大气层
submissiveness	柔顺
uncharming	可厌
pilous	有毛
kaka	橄榄色鹦鹉
pretender	妄求者
execrate	憎恶
recollected	被回忆起
prismy	棱柱的
erasure	擦除的字
emplastic	黏性
ultravirus	滤过性病毒
unexceptionable	无懈可击
parleyvoo	法国人
numbness	麻木
kingdom	领域
worthy	有价值的
venturesomely	冒险地
intelligibility	可理解之事物
peasantize	使像庄稼人
gentlemen	gentleman的复数
grassplot	草地
rswc	正面朝上轻放
below	在下
hexapodous	具六足的
crispen	变得鲜脆
produce	提出
sue	控告
bullish	看涨的
kimono	妇女穿着的宽大晨衣
emotionality	富于感情
agrology	土壤学
confucian	孔子的
thingamy	小机件
jd	Doctor
discreetly	小心
hermitship	遁世
membraniform	膜样的
benzedrine	苯丙胺
treatment	待遇
gaping	多洞穴的
onstage	舞台表演区的
kebbuck	纯干酪
vehicular	车的
insurgence	叛乱
exquay	码头交货价
nubilous	多云的
spokesman	发言人
enormous	凶暴的
hurt	刺痛
enlistment	征募
banxring	shrew
boniness	骨瘦如柴
fancy	爱好
climatization	顺应气候
lanchow	兰州
invocation	符咒
donkeyman	辅助发动机管理工
prevaricate	支吾搪塞
utter	全然
angry	愤怒的
fishpound	鱼梁
redirector	转向器
red	红颜料
grounder	滚地球
amsterdam	阿姆斯特丹
illiberalism	非自由主义
oleic	油的
futuramic	未来型的
airdent	气磨洞形器
possible	可能的
epazote	土荆芥
religionary	宗教的
unaware	没觉察到的
ding	连响
stall	迟延
lunar	月亮
housebroke	housebreak的过去式
will	将
polymeric	聚合体的
haematoxylin	苏木素
exeat	短时离校的许可
upstate	北部的
feasible	切实可行
hypnopompic	半醒
celibate	独身的
breton	法国布里多尼地区的
crowned	王室的
hymeneal	婚姻
copartner	合作者
transgress	犯罪
shunga	春宫画
inspectoral	检查员的
blossomy	花盛开的
deconvolution	去卷积
hocus	麻醉
hydrocephalic	脑积水的
careful	小心
dav	American
dracontologist	湖怪研究者
zanthoxylum	花椒属植物
proportionably	成比例
deathly	象死一样
chortle	得意的高笑
laval	像熔岩的
garnishment	扣押债权的通知
emanative	发射性的
sundries	杂物
rann	Applied
exteriorise	=exteriorize
civil	国民的
fujiyama	富士山
hierocratic	僧侣统治制度
cavortings	轻浮行为
aggravation	加重
phenate	酚盐
ectomorphic	瘦型体质
unmixed	纯粹
sabah	沙巴
stitch	缝针
livetrap	用生擒陷阱活捉
sjd	Scientiae
jesuitical	阴险的
misbound	装订失当
mentality	心理
former	形成者
underpin	加强……的基础
bumpety	砰地
escap	Pacific
secko	性反常者
yardbird	囚犯
cool	无所顾虑的
sinaitic	西奈山的
branchiopod	鳃足动物
hebetude	愚蠢
salient	突出部分
satyr	性欲极强的男人
tetrachord	四度音阶
avoir	avoirdupois
gasdynamic	气体动力激光器
salvageable	可抢救的
babblingly	喋喋不休地
spongy	像海绵的
sumption	信以为真
mastering	控制
unholy	不合理
hypophyseal	=hypophysial
altaic	阿尔泰语的
concussion	震荡
encephalograph	脑照相术
thixotropic	具有触变作用的
epidote	绿帘石
dour	阴沉
blazing	闪耀的
tinworks	锡厂
euroclear	欧洲银行票据交换所
spectroscopy	波谱学
dopplerite	弹性沥青
silly	愚蠢的
skookum	极好
antiperiodic	抗周期性病的
hyperchromic	anaemia
accustomed	习惯的
ruler	标尺
thymocyte	胸腺细胞
unregretted	无人惋惜的
aquatic	水栖的
gab	饶舌
tenement	租房子
skimp	节约使用
legislatorship	立法委员或议员的身份或地位
redrill	再次条播上作再次条播
chorea	舞蹈病
minever	白鼬
nudie	裸体照片
areographer	说明火星形状的人
airwave	广播的频道
australioid	=Australoid
hierocratic	僧侣统治
becoming	合适的
unthinking	无思想
foreskin	包皮
interrupter	插嘴的人
bestead	裨益
myxoedema	黏液水肿
factionist	宗派主义者
byre	牛栏
incongruity	不适宜
thin	变细
farce	胡闹
feed	流入
elsewise	=otherwise
unexpanded	未被扩展
duodenal	十二指肠
bugologist	昆虫学家
richly	丰富地
andalusia	安大路西亚
tantalate	钽酸盐
earthnut	块根
irrepatriable	无法送还故国
sick	渴望
partygoer	社交聚会常客
decently	高雅地
flitty	同性恋的
varnish	掩饰
paleocrystic	长期冻结的
helispherical	在球体上成螺旋状缠绕
sharpy	=sharpie
oversoul	超灵
hypoploidy	染色体数目较少
avian	鸟
privation	缺乏
redolent	芬芳
azimuthal	方位角的
postrider	驿传者
menstruum	溶媒
nasty	肮脏的
upright	合乎正道
nematology	线虫学
synovial	滑液的
ephebeion	体操场
overstorage	贮藏过多
embolic	栓子的
mirabilite	芒硝
glazier	装玻璃工人
wandering	漫游的
resolve	决心
humanist	人道主义者
sonicate	声波降解标本
rubstone	砥石
foudroyant	使人眼花缭乱
backbencher	后座议员
superscript	上标
surpass	胜过
garrison	卫戍
caird	游民
webbing	带子
unsicker	不可信赖
chewy	不易嚼碎的
photojournalism	摄影新闻工作
otherwise	另外
substitute	替代品
leishmaniosis	利什曼病
hedonics	享乐论
filariae	丝虫属
isolator	绝缘体
downcast	向下看
imitate	仿制
psychrophilic	喜爱寒带地方
indexed	编入索引
joint	使有接头
reconciliatory	一致
athermanous	不传幅射热的
renerve	恢复勇气
predate	提早日期
enneahedral	九面的
dominical	主的
pet	宠爱
motherfucking	混帐
mauritania	毛利塔尼亚
skin	外壳
calcicolous	生长于钙质土壤
thioalcohol	=thiol
controversy	论争
used	旧的
naughty	不听话
unction	虚情假意
biomathcmatics	生物数学
suppletive	替补的
endbrain	终脑
bahamian	巴哈马
naupliiform	甲壳动物无节幼体形的
sulcus	回间沟
rhythmical	节奏的
yesterevening	昨夜
dichotomize	对分
waste	多余
bentonite	斑脱土
thalassic	内海的
fluorocarbon	碳氟化合物
by	在旁边
tenebrosity	黑暗
landworker	农场工人
twister	难题
dicky	恶劣
attestant	证明
ascending	上升
clement	仁慈
feldberg	菲尔德山
inverse	倒转
utilitarian	功利主义
frailish	不太坚固的
scoundrelism	无赖
pyretic	引起发烧的
hoistway	起卸口
incorporeal	无形体的
cyperaceous	莎草科
riffleman	淘金工人
noaa	Oceanic
statutory	法定
sclav	斯拉夫人
tepid	不太热烈的
conventionalise	膎ventionalize
blustering	狂风大作
outback	在内地
clockwork	时钟机构
ceeb	大学入学考试委员会
monovalent	单价的
dervish	伊斯兰教的托钵僧
inhomogenous	杂拼
gluttonous	饕餮
coon	黑人
transmit	转送
francophobe	反法国
superficially	浅薄地
robe	罩衣
melancholious	=melancholic
befitting	适当的
consider	认为
tough	强壮的
elusive	易忘
fuel	得到燃料
condolent	哀悼的
after	在……之后
scepter	笏
initial	最初的
jewry	犹太人区
pensionary	领养老金的人
tagboard	运货标签纸
depraved	堕落的
amyloid	含淀粉
censorable	可诟病的
tpi	Institute城市规划学会
dwarfism	矮小
detailed	详细的
phycomycete	藻菌类的植物
monstrous	怪异
unselective	不加区别
metaphorical	比喻性的
neaten	整顿
zeroth	零的
marmot	旱獭
fluid	流动
pop	射击
lowboy	短脚衣橱
exiled	流亡
matrimony	结婚
italicize	在字下划横线
beezer	鼻子
gally	吓唬
mufti	便服
primus	第一
inorganizable	缺乏组织
evidential	可作证据
faithful	详确的
spun	纺成的
rsj	Steel
chop	突变
righten	整顿
diphenylacetypene	二苯乙炔
warhead	弹头
uniface	仅一面有图案
square	公平
healing	有治疗功用的
lifelike	逼真的
villainous	恶棍的
ppt	per
libidinous	性欲的
ratchet	棘齿
entoptic	内视
crop	短发
subsea	在海底
slummock	瞎扯
limitless	无限的
jolley	辘轳车
simulant	模拟
detoxify	使解毒
howff	住宅
miscellany	杂录
shellcracker	=redear
casebearer	鞘蛾幼虫
vichyite	维希政府
subform	从属形式
esthonian	爱沙尼亚人
anatomise	解析
acerbating	使烦恼
edging	缘饰
austerity	严厉
zombie	生性怪癖的人
haustrum	袋
gambly	碰运气
federally	联邦地
canting	貌似虔诚
omnipotence	无限威力
univocal	单一意思
oogonium	卵原细胞
wgmc	West
ass	笨人
cowl	蒙头斗篷
rich	富有
sediment	沉积
ungulate	蹄状
pistillate	有雌蕊的
namable	著名
virginal	处女的
phonographic	速记的
minacious	威吓
chaparejos	皮裤
overaggressive	过于积极进取的
microvillus	指状突
exceeding	胜过的
agricultural	农业
suffering	受苦的
mitigation	缓解
dll	Link
primus	第一的
wraac	Royal
subjunctive	虚拟语气
triphibian	三栖飞机
offscourings	污物
ironize	冷嘲
nameless	不知名的
outspread	伸开
verily	忠实
pleiotropy	多向性
zygosporic	接合孢子的
housewife	针线盒
lectionary	选文集
sexennial	每六年
witch	施巫术
monopodial	单轴
farthest	最大程度
michaelmas	米迦勒节
fleecy	蓬松的
pretreatment	预处理期间的
pasticheur	混成作品作者
excitation	激动
spatter	滴落
dispirited	沮丧
hypo	刺激
hydrate	氢氧化物
offset	偏移量
blissful	有福的
anybody	任何人
fleming	佛兰芒人
mosso	活跃
constantan	一种铜与镍的合金
rodent	嚼的
griddle	筛
humorless	一本正经
latch	闭锁
semideaf	不完全聋
hollandia	霍兰迪亚(印度尼西亚东部港市查亚普拉
enneastyle	前面有九柱的
detrusive	推出
dentil	齿状装饰
various	不同的
detergency	洗净
scowl	怒容
photoproduction	光生
rsc	Shakespeare
topnotch	第一流的
misname	叫错……名字
desolate	荒凉
bedplate	台板
royal	高贵的
latterly	最近地
memomotion	延时摄影
nobody	任何人
inconscious	无意识的
outstrip	超过
lotiform	莲花形
orator	雄辩家
tercet	三行押韵诗句
laundry	洗衣店
afternoon	晚期
gonadotrophin	=gonadotropin
lexigraphic	词素文字的
titicaca	Lake
duffel	露营用具
sequitur	推理
thermal	热
sanguine	血染
fullface	正面像
spdos	金山汉字系统
mummer	哑剧演员
wctu	Union基督教妇女禁酒联合会
diestrum	=dioestrum
theoretically	理论上
korean	韩国人的
hock	典当
thistledown	蓟花的冠毛
covert	隐蔽
odic	颂诗的
uses	Service
cusso	苦苏花
entertaining	有趣
solubility	溶性
zariba	=zareba
tussal	与咳嗽有关的
voluminously	很多地
fainaigue	规避责任
hamstring	切断腿筋使成跛腿
vulgus	拉丁文或希腊文的作诗作业
typhlosis	盲
tgv	里昂间高速火车
reverential	可敬的
matin	晨祷
doa	arrival
kook	疯子
violence	强暴
paper	考卷
pithily	简洁地
unsegregated	没有种族隔离
fortuitous	幸运的
paperful	一纸包的量
nill	不想
spadices	spadix
peptic	胃蛋白酶的
brooky	多溪流
awash	被浪冲打的
prelicense	发放执照前
caplet	囊片
faddish	风行的
lectureship	讲师的职位
timing	调速
dtp	desktop
fiend	魔王
animate	鼓舞
isograph	求根仪
shh	show
abscondee	潜逃者
chinkerinchee	球根植物
jackpudding	丑角
applique	缝花
lullaby	催眠曲
overdose	配药过量
slow	缓慢的
vend	贩卖
dps	second
substratum	下层土壤地基
louisianian	路易斯安那州的
harvest	结果
curvaceous	曲线美的
transitional	变迁
taxing	费力的
remonstrative	忠告的
hyperpnoea	呼吸过度
monstrous	巨大
mystification	神秘化
crepuscular	微光的
blacksnake	虎蛇
therapy	治疗
ejaculatorium	排精室
etruscan	伊特鲁里亚的
fattest	丰满
provincial	省的
vertu	爱好古董者
bureaucratese	官腔十足的文体
tactless	不老练
redesign	新设计
whereto	去何处
sanctorium	圣祠
darkroom	暗房
flsa	Standards
knut	花花公子
coquetry	玩弄男人
feeling	有感觉的
kaifeng	开封
onboard	随车携带的
monte	始于西班牙的纸牌赌博游戏
genal	颊
reascend	再上升
dexter	右侧
tumbril	施肥车
chilly	寒冷
castigatory	斥责的
stargazer	天文学家
show	表示
dilettantism	浅涉文艺
stotinka	斯托丁卡
ichthyomorphic	鱼所特有的
shoring	支柱
nubian	努比亚人的
condole	慰问
nervily	强壮地
unrepealed	未被撤销
incorporeal	无实体的
hampshire	汉普郡
mousey	多鼠
proof	校样
queenly	威严的
easting	东行航程
redeployment	调换
elegy	挽歌
lambrequin	装饰用的垂纬
roc	Operational
galbraithian	加尔布雷思的
iaea	Energy
yield	生产
laicise	=laicize
unsteadily	不稳定
moonfaced	圆脸
perfect	熟练
bipack	二重彩色胶片
ciborium	圣礼容器
unyoke	卸除轭
pillowcase	枕头套
landsturm	国民军
gumptious	机灵
redcoat	英国军人
foliiform	叶形的
threatening	胁迫的
grinding	磨
residency	住处
cloud	云
study	攻读
gigglish	喜欢傻笑
exodontia	拔牙术
unrelatable	不相关的
ache	疼痛
mortally	凡人般
pluckily	大胆地
guarantee	保证
japanology	日本学
astrolatry	天体崇拜
square	符合
map	由LINK工具生成的一种文本文件
airsick	患航空病
bnoc	Oil
apterous	无翅
perimorph	包被矿物
shambles	混乱的地方
synovectomy	滑膜切除术
ticklish	忌讳的
rewind	重绕
elfland	仙境
intersection	交叉点
rotundity	圆形
temporal	世俗的
sophist	诡辩家
ingurgitate	大吃大喝
flimflammer	骗子
stroboradiograph	频闪射线照片
zoomy	利用促镜拍摄
obvious	显而易见的
sextant	圆的六分之一
pri	优先级
unnoteworthy	不显著
buonaparte	波拿巴家族
taurin	=taurine
hypergamy	与上层阶层或地位高贵的人联姻
waxy	生气的
unshakeable	坚定不移
ironist	讽刺作家
aleksandrovsk	亚历山德罗夫斯克
fictile	陶土制
freemasonry	共济会的组织会员
pimply	有疙瘩的
rackettail	球拍尾蜂鸟
idea	思想
fist	紧握
proboscidate	有长鼻的
carbonation	碳酸饱和
choregus	合唱团之指挥
pusher	推动器
atmological	水蒸气学的
undiscerning	迟钝的
abduce	使外转
navy	海军
amends	赔偿
nagged	感到厌烦的
ciceroni	导游
cowl	连有头巾的修道士服
synapse	形成突触
sauger	加拿大鰤鲈
quarterly	一年四次的
cleanser	擦亮粉
philhellenic	亲希腊的
misperceive	看错
recrudesce	复发
goldwater	=goldwasser
stably	坚定
accomplishable	可完成
anamorphic	变形
wake	醒
snakefly	蛇蛉
midas	大富翁
ginny	有杜松子酒味
streamy	多河流的
ashake	摇动
celeb	著名人士
tercom	matching
bloodshot	充血
unveil	除去面纱
telecommunication	/
morphosyntax	词素句法学
chiller	冷却器
aching	痛
quai	=quay
pout	大头鱼类
hypsography	地势
walach	=Vlach
jar	刺耳声
nehemiah	世纪的希伯来领导人
duplicate	使成双
andromache	安德洛玛刻
function	职责
beater	搅拌器
dethronement	废位
wonted	惯例
unendowed	不具有的
imminent	逼近
criticastry	没有价值之批评
antiunion	反对工会的
scheme	安排
peacebreaker	破坏和平者
obsequence	奉承拍马
playscript	剧本
conveyable	可搬运
aspiration	热望
blunge	掺水拌
albigensianism	阿比尔派的教义
toehold	排除障碍的方法
plover	珩
angiotomy	血管解剖术
railroad	铁路
exposed	暴露于风雨中的
undefined	未下定义
nonnatural	强迫
politically	贤明
campanological	铸钟学
upscale	高消费阶层的
ambiguous	暧昧
nzima	恩济马语
precipitate	陡然下降
tattle	闲谈
neoclassic	新古典主义
jugoslav	南斯拉夫人
consensus	一致同意
overjoy	使大喜
coffee	咖啡茶
streptodornase	链球菌去氧核糖核酸酶
billposting	广告张贴
nonofficeholding	在野
seventeen	十七
neutrophilic	嗜中性的
colonial	殖民
befriend	帮助
dm	数据挖掘
oversimplify	过分地单纯化
arachnoid	蛛网状的
interneuron	neuron
jazzetry	爵士乐伴奏的诗歌朗诵
renascent	复活的
neovascularization	新血管化
vacuole	空泡
instant	紧迫
absquatulate	溜脱
pulsate	搏动
fledgy	有羽毛的
penutian	佩纽蒂语群
animistic	万物有灵论
christianlike	如基督徒
orthographic	拼字正确
jingoist	沙文主义者
subtersurface	表面下
superior	高傲的
emploment	雇用
panic	没有理由的
intimacy	亲密
men	的复数
humanness	人性
humane	仁慈
tore	tear的过去式
learner	初学者
naw	不是
bowl	碗状物
mammary	乳腺的
wide	远离目标的
bortz	=bort
defeatism	失败主义
inquilinism	寄居动物
vertiginous	眼花的
glyconic	格莱坎诗体的诗
sporulate	使变为孢子
hal	Hardware
dissave	vi
charging	炉料
purple	紫色
shoal	大量
misdone	misdo
votable	能投票的
bmoc	man
norwards	往北
film	变成朦胧
montanic	多山
hyperphysically	超自然地
caricature	讽刺画
apopetalous	离生花瓣的
sediment	沉淀物
brazen	黄铜制的
straightforward	正直地
headachy	令人头痛的
brachydactylic	短趾的
seriation	顺序排列
unversed	不精通
leptodactyl	有细长脚趾
rediffusion	转播
trichogyne	受精丝
teutomaniac	醉心于条顿民族的人
starched	浆硬的
bookshelves	书架
prograde	与其他天体作同方向运行
fond	喜爱
tacloban	塔克洛班
estafette	骑马的信差
fornicate	拱状
corporate	社团
mirror	反映
co	中心机房
error	误差
corollar	类似花冠的
unsuppressed	未镇压的
flintiness	燧石质
information	起诉
unrevealed	未揭露的
calumniatory	诽谤的
taiwanese	台湾的
fifteenfold	十五倍的
tarragon	龙嵩叶
fls	the
paleogeophysics	古地球物理学
ascription	归属
hyson	熙春茶
lordship	支配
mercilessly	无慈悲
accouchement	生产
hob	滚刀
tights	紧身衣
voltaic	电流的
imperil	使处于危险
cymous	聚伞状
equipped	预备
licity	合法
amentiferous	具葇荑花序
english	英文的
ogle	送秋波
jobholder	有固定工作者
tetramer	四聚物
steamroll	粉碎
rebroadcast	转播
symbol	符号
baltic	波罗的海的
brood	沉思
hammer	锤子
sesquipedalian	冗长的单字
event	事变
caroler	欢唱的人
chelonian	龟
shunter	扳道员
micromesh	微型小网眼料子
accoucheuse	女助产士
nigrescence	变黑
praetor	长官
landlady	女地主
hideous	骇人听闻的
last	最后的
dotty	多点的
arkansan	阿肯色州人
reason	动机
wysbygi	See
astronomic	星学
panegyrist	致颂词者
submerge	淹没
mre	of
caprate	癸酸盐
valvar	=valvular
spoken	口头
sextuple	六重的
asprawl	伸开手足躺卧的
artifactitious	人工制品
nereid	涅瑞伊得斯
backroom	秘密完成
revolving	旋转的
milligrame	毫克
interzonal	带间
nonintervention	不干涉
adjacence	接近
plutocrat	富豪
ssafa	Families
titrimetric	滴定的
distortive	曲解
pherentasin	弗伦塔辛
slot	缝
license	执照
eventuality	不测的事
unfoiled	未受挫的
drainage	排水装置
periplast	周质体
valuable	有价值
turncock	龙头开关员
plute	财阀
alinement	排列
titillation	愉快
evidentiary	证据的
unsuppressed	未压制
terroristic	恐怖主义的
imponderability	失重
cannabinoid	大麻的化学成分
exasperate	激怒
culpable	该责备的
gasless	不用气体
blithesome	愉快的
serrate	锯齿状
expressions'	NULL)
aorist	不定过去时
hinterland	腹地
shockingly	怕人地
hazardous	危险的
trehalose	海藻糖
subclavian	锁骨下
infernally	恶魔似地
boastful	喜夸耀的
conferment	商量
humanisation	=humanization
trail	跟踪
definitive	确定
scout	轻蔑地拒绝
stallage	摆摊用地
brooch	胸针
minimal	最小的
normality	常态
kuznetsk	Basin
sweated	使用血汗劳工
firedamp	甲烷
thermostable	耐热的
dirtily	卑陋地
brainpower	智能
mixt	mix的过去式及过去分词
pandora	潘多拉
ramate	有分枝
skookum	极好的
reticula	网状组织
accountably	可辩解地
cluster	丛生
balcony	楼厅
underhung	下颚突出
teat	奶头
tinnient	丁当响的
warrior	战斗
knee	膝盖
gerontocracy	老人政治
generalization	广义性
injective	内射
pie	喜鹊
cybernate	使受电脑控制
fin	装上翅
rocking	摇摆的
arcuation	弯曲
multipotent	能产生多种效果的
incommensurable	不能比较的
bluebonnet	蓝色的呢绒帽
jokingly	打趣
manual	体力
tolerant	宽恕
mennonist	=Mennonite
uniovular	单卵的
replant	改种
dead	无感觉
lustful	好色
slack	疏忽的
put	投击
indispensability	不可缺少
confessionary	告解所
taperstick	小烛烛台
assemble	装配
undisguisedly	公然地
suberose	似软木
foxed	变酸的
encompass	环绕
pavilion	亭
piety	孝行
jefe	政界领袖
twifold	两倍
crafty	诡计多端
tactics	策略
dengue	登革热
corny	有鸡眼
disproof	反驳的证据
sparkish	俊俏的
intertribal	部族间
reddle	赭土
blinking	闪光
bomber	轰炸员
consulship	领事的任期
regret	歉意
raised	有凸起花纹的
darwinism	进化论
maintain	主张
absorptive	吸收性的
elapse	流逝
dashy	浮华的
iupap	of
clink	丁当声
washwoman	洗衣女工
pseudo	冒充
pedobaptism	幼时洗礼
holdback	妨害
modernminded	有现代头脑
macrocephalic	巨头
genbakusho	=radiation
moccasin	鹿皮鞋
female	雌的
measles	风疹
timbered	用木材的
nucleophilic	亲质子
knitgoods	针织品
caracol	半旋转
smacking	发出响声
jokey	好开玩笑
termite	白蚁
doughy	苍白
walk	步
agrestic	粗野的
abbreviation	缩写
dehydrogenate	使脱氢
reasoningly	理性地
halidom	圣物
superciliary	眼睑上
plagiocephalism	斜头
octocentenary	持续800年的
inscrutable	不能预测
pun	说双关语
clindamycin	氯林可霉素
cranic	脑
pleasure	愉快
sculptural	雕刻
loculus	胞
heatronic	高频加热处理的
xeroform	干仿
octocentenary	800周年纪念的
helianthine	B半日花素B
particularism	完全忠于一种理论
stress	重点
archanthropine	灵长目动物
intuitive	直觉
spur	距
predispose	预先安排
paravion	航空邮寄
sinfully	罪孽深重
anastatic	凸版
recessive	退行的
fibrositis	纤维组织炎
inaccessibly	达不到
obliterate	涂去
longtimer	老资格
astronomic	天文学
rubricator	加红字标题的人
translation	翻译
ingleside	炉旁
lowell	洛厄尔
yaqui	雅基河
sparsely	稀疏
backstairs	诡秘的
iridology	虹膜学
dns	Name
crown	顶
aurorean	晨曦
factoried	工厂林立的
chlamydomonas	衣滴虫
reasonably	相当地
robustious	粗野
start	出发点
npcf	Foundation
iaea	Agency
appealable	可上诉的
recruitment	补充
taffrail	船尾栏杆
demonologist	鬼神学家
defy	公然反抗
zimbabwean	津巴布韦人
ectopia	异位:
score	乐谱
farfamed	驰名
scurrilous	使用低级粗俗语言
ruth	鲁思
total	整个
erective	建立的
tabby	平纹织物的
hateless	不憎恶
closehanded	小气的
nodum	植被抽象单位
pyorrhoea	脓漏
coppice	矮林
womanlike	女人般地
semiretirement	半退休
phyllode	叶状柄
orbit	进入轨道
mora	音节延长度
insecticidal	杀虫的
pet	受宠爱的人
clabber	凝乳
garrison	卫戍部队
unlike	和……不同
couth	文雅
existent	生存
shift	办法
undivided	专一的
spatulate	竹片状
ditchdigging	掘沟渠之工作
adenoidal	腺状的
ease	减轻
remarkable	不平常的
schizogenic	=schizogenous
illustrational	例证
nc	Network
leptonic	产生轻子
slavey	女佣人
journeywork	临时工
vigo	比戈
larvivorous	以幼虫为食的
preemployment	录用前
heterogenesis	自然发生
awane	减弱中的
pneumogastric	迷走神经的
gallican	教宗权制限主义者
exemplum	说教故事
abstractive	具有抽象能力的
irrationally	无理性
dankish	潮湿
quarrel	争论
underachieve	学习成绩不良
volcanological	火山学
tough	强硬
comminjute	使成碎末
magic	魔术
opsin	视蛋白
ultrathin	极细
noncommittal	不承担义务
stigma	污名
euthyroid	甲状腺机能正常
everyday	平常的
inevitability	必然性
petrologic	岩石学的
unitary	归一
hobohemia	游民所居之贫民窟
blithe	愉快
palm	藏……于掌中
turkmenian	土库曼语
tradespeople	开商店者及其家属
procrustes	古代希腊的强盗
sansom	桑塞姆
rhyton	古希腊的角状环
rocker	摇的人
polarimeter	旋光计
asthmatic	哮喘
nonbank	不由银行办理
zealotic	热心者
cloud	乌云密布
subaltern	次
underground	面下
oversexed	性欲过剩的
cultivated	有教养的
accuse	控告
submaxilary	下颚骨
darner	缝补的人
lethargic	昏睡的
reload	再装填弹药
unjustly	不法
nutrition	营养
lcvp	personnel车辆人员登陆艇
slavist	=Slavicist
mascara	染眉毛油
nob	有钱人
proteid	含蛋白质的
carbonylic	羰基的
cinzano	沁扎诺酒
craniate	有头盖的
aluminium	铝的
sacrosciatic	骶骨坐骨的
damoclean	达摩克利斯的
lausanne	洛桑
smear	抹掉
reloan	再借
skylab	太空实验室
stubbornly	顽固
shutter	快门
diglottic	=diglot
unclassified	不保密的
thriftlessly	不节俭地
icaaaa	Association
mesocephalon	=mesencephalon
impassioned	热情洋溢的
sedately	安详地
bndd	Bureau
eric	Educational
footling	微不足道
toxoplasmosis	弓形体病
allpowerful	最强大
gearless	无齿轮
lophobranch	Ⅰ
escap	and
sob	哭泣
popular	受欢迎
prince	王子
kirsten	柯尔斯顿
fraternity	兄弟会
toynbeean	汤因比历史观的
navelwort	琉璃革
gftu	Unions工会总联合会
vinification	葡萄酒酿造法
supermultiplet	超多重态
obstreperous	任性
photonuclear	光核的
contradictorily	反驳
unialgal	单种藻
diamagnetic	反磁性的
lordliness	皇室气派
effortful	需要努力的
tarnation	咒骂
dialectology	方言研究
tornado	大雷雨
glimmer	闪烁
charactron	字码管
minifestival	小节日
chromogenic	发色体的
supervoltage	超高压
couchy	茅草丛生
lurch	挫折
trisodium	三钠
malaceous	苹果科
foolish	愚蠢
clearwing	透明翅膀的蛾
tryst	约会
hazardous	冒险
pristine	质朴
advocatory	拥护者
rejoicingly	高兴
warrant	证明
oxbow	呈U字形弯曲
cetology	鲸类学
spatial	空间
anglia	英格兰的拉丁名称
deaconship	会长之职位
metro	地下铁道
blacketeer	marketeer
recreation	消遣
negotiatory	交涉的
jihad	讨伐异教徒
polysorbate	聚山梨醇酯
devilishly	过分地
refix	重新装设
reconsolidate	重新巩固
wcc	Council
gunpaper	经硝酸处理后能爆炸的纸
nanoid	矮小
semideaf	半聋的
rectorial	院长的
ini	初始化设置文件的后缀名
od	自然力
inappellable	不得上诉
neurotrophic	亲神经的
heaping	放得太多的
accrete	合生
bangzone	音爆影响的区域
interferometric	干涉仪的
suprahepatic	肝上
ceremony	报幕员
ana	一则轶事
pharmacy	药剂学
indifferent	无关紧要
humidifier	增湿器
conservatory	音乐学校
extrusion	赶出
epizoon	体表寄生动物
flagellate	鞭挞
albescent	带白
ccitt	Telegraph
ue	美国电气、无线电和机器工人联合会
dimension	元
rich	富有的
playdown	决赛
padua	帕多瓦
myofibril	肌原纤维
pecksniff	式
unvitiated	未腐败的
interuniversity	大学校际的
gourmet	能精选品评美食、美洒的人
kozhikode	科泽科德(旧称卡利卡特
gunman	制造枪械者
communique	公报
cogent	使人首肯的
cohort	步兵大队
daughterly	女儿似
unformat	恢复被意外格式化的磁盘
dominating	专横
grandisonian	模范绅士
fission	分体
poetical	理想化
marquisate	侯爵领
exorbitancy	不当
improved	改良
cornetti	的复数
rocambole	胡蒜
probationary	缓刑
pteryla	羽区
flounderingly	总是失败地
extrovertive	偏向于外向
tanzanite	坦桑黝帘石
drooly	非常可爱的
pisciculture	养鱼业
houseplace	大起居室
dubitatively	怀疑地
englishment	英译本
fodgel	矮胖的
redbone	美洲赤狗
shaft	轴
flagging	石板路
mythical	神话
spadicose	似肉穗花序的
toothy	多齿的
vhs	家用录像系统
deflationary	物价低廉的
wob	overboard
filterable	可滤过的
coachful	马车满载之量
discerning	有辨识能力的
undimmed	明亮的
dreamscape	幻景
lickerish	讲究吃
roguish	无赖的
supercrescent	寄生
elegy	悲歌
shivering	颤抖
duplation	二倍
muralist	壁画家
rack	行李架
confluction	融合
futility	无益
maladjustive	不利于调节的
metrication	十进位制
mgd	million
architectural	建筑上的
assimilatory	同化力的
manstopping	用以杀伤冲锋士兵
cavernous	似巨穴
hypotensive	低血压患者
upbear	支持
pcav	Partial
convect	使热空气对流
derrick	起重机
incompleteness	不完全
buttlegger	不法香烟贩子
limewood	椴木
inalienability	不能夺取
whitewash	用石灰水把……刷白
labdanum	劳丹脂
russian	俄国的
discoid	平圆形的
surpassingly	超群地
ponderance	严重性
dryad	森林女神
thylakoid	类囊体
unequable	无规律的
tavr	Reserve本土军和陆军志愿后备队
catchwork	山坡灌溉水沟
bunch	串
adi	intake
dutifully	忠贞
adjacent	接近的
tale	流言蜚语
forfeitable	可没收的
ciliary	睫毛
congener	同类的
hallucinatory	引起幻觉
carbenoxolone	生胃酮
preprimer	学龄前儿童读物
decolorant	有脱色作用
stub	残余
phasedown	分阶段减少
position	阵
congeniality	适意
tikker	断续装置
illude	欺骗
lambskin	羊皮纸
harvesting	收获
hyperthermal	过高热
caressing	爱抚的
undisturbed	镇定
closure	使终止
riffraff	渣滓
calibration	刻度
wad	填料
splendor	壮观
stubbed	残断的
namierite	=Namierian
palaestra	健身房
camphoraceous	樟脑特有的
fabulosity	惊人
gulch	干谷峡谷
oaw	Optically
stinkpot	一种小麝龟
mainly	大体上
fabled	寓言中的
forficulate	形状像小剪刀
amenity	宜人
inorb	包围
sertoman	塞托玛俱乐部成员
overdraft	透支
dependence	信任
polynomial	字以上组成的学名
cosmogonist	宇宙进化论者
explodent	爆破音
percentage	百分率
morellian	莫雷利批评法的
bannock	一种薄饼
gladness	欢乐
age	成年
charm	符咒
malpighia	金虎尾科
version	翻译
buccolingual	颊舌
amateurship	业余者的资格或身份
stopgap	权宜
wrecky	身体垮了
avionics	电子设备
biogeochemical	生物地球化学
chinoperl	Literature
fingerfish	海星
buckler	防御物
haggadist	哈加达的作者
pierogi	=pirogi
every	每隔……的
umptieth	=umpteenth
uncalled	未叫到
witchcraft	魔法
prelatic	高级教士职位
dholl	=dhal
setoff	装饰品
jv	Junior
impeachable	可控告
oboe	双簧管
pododynia	=podalgia
honeyed	甜如蜜
mooch	偷
removalist	搬运工
martlet	无足鸟
darch	of
sawtooth	锯齿
afdc	Families
zooxanthella	虫黄藻
mac	Media
masty	危险的人
contingency	可能性
unshaded	无光度或色泽差别
equivoque	含糊措辞
parametric	参量的
irrevocability	不能挽回的事
chileanize	使置于智利政府控制之下
yearlong	整整一年的
carmine	洋红色
underappreciated	未得到正确评价
burning	强烈的
rally	决心
serrate	锯齿状的
rising	上升的
thrustful	积极进取的
linked	显示连环遗传
stolid	感觉迟钝的
woozy	虚弱的
knotter	打结的人
savage	未开化的
unforced	自然的
colza	菜子
transoceanic	在海洋彼岸
misrepresent	误传
acold	寒冷
seedily	心情不佳地
passively	被动地
cannonry	连续炮击
ectogenic	体外发育
face	面对
dentine	象牙质
hemoglobinuric	血红素尿
piddling	微不足道的
venomous	恶意的
rampage	乱闹
rabbet	槽口
hesper	黄昏星
natural	本位号
iranair	伊朗国家航空公司
sequentially	从而
outward	公开的
reredos	壁炉的背部
uniflow	单向流动的
wirehair	硬毛狗
wallpaper	墙纸
feedback	反应
lockless	无船闸的
undoubled	松开的
reptiliary	蛇馆
villose	有绒毛的
petrifactive	石化性
abbreviationist	惯用缩写字的人
excusal	原谅
hypoacid	酸度过低
flaunt	招展
often	经常
nephrotic	肾病变
withamite	黄红帘石
minto	明妥薄荷糖
ironic	说反话
thorntail	刺尾蜂鸟
henhearted	胆小的
incubative	孵蛋的
aganippe	灵感之来源
sunlit	被日光照射了
hermeneutic	解释学
musculoskeletal	肌骨骼
hammam	澡堂
cantiga	民歌
faithful	可靠
contend	主张
persifleur	爱挖苦人的人
vaccine	牛痘的
stemmed	有茎的
spinose	有刺
plastogene	质体基因
pedobaptist	幼儿洗礼论者
signorine	小姐
scale	等级
volatilizable	可发散
apocopate	语尾音节删除的
shopboy	年轻男店员
toast	烤面包
gooky	粘
trot	疾走
tumultuously	喧闹地
petalody	花瓣化
danseur	男芭蕾舞蹈家
caustic	腐蚀性的
laminae	板
airy	轻快
tame	沉闷
overexertion	努力过度
melodion	=melodeon
headband	头巾
strepitous	嘈杂
fault	缺点
interventionism	IntE5venFEnIstLm/干涉謏
oilseed	含油种子
bam	哄骗
previous	早先
underwork	下层结构
endosmosis	浸透
super	上等
mailing	农场租金
dingbat	容易投掷的东西
diplomatese	外交语言
pig	生小猪
meditative	冥想
airy	空气
preocular	眼前的
thickly	厚
orb	成球形
skinny	皮的
shawn	肖恩
plead	恳求
equinox	春分或秋分
physiotherapy	物理疗法
hypoploid	染色体数目较少的
tribolet	=triblet
immusical	对音乐不感兴趣
outdoorsy	适用于户外
intine	内壁
clouding	湿润
memoire	备忘录
harshly	苛刻地
immigrant	移民的
heteroploid	异倍体的
english	英文
ketolytic	解酮作用的
time	时间/日期
dihydroergotamine	双氢麦角胺
needlessly	无用地
inositol	纤维糖
psg	sergeant
reginal	女王的
acanthoid	棘状
wistfully	渴望
xenomania	外国狂
unwisdom	缺乏智慧
proclamatory	布告的
mecism	过长
conarial	松果体
amr	声音和调制解调器插卡
languorous	没精打采的
rawinsonde	无线电探空测风仪
home	避难所
conservative	保守
gamb	胫
sleuth	警犬
counterbalance	势均力敌
wirehaired	硬毛
extrorse	向外的
ephemeris	历书
enthral	奴役
peopleless	无人居住的
rascallion	流氓
irresponsive	无感应的
pertinence	相关性
rake	掠过
cetrimide	溴棕三甲铵
upside	上面
despotic	暴虐
defuse	去掉……的雷管
hypolydian	副利第亚调
cycle	周期
legalist	守法主义者
idiocratically	癖好
hominoid	人的
anaclastic	屈折
finery	华丽的服饰
photoproduction	光致产生
breezy	有微风
premaxillary	前颌骨的
clag	妨碍
melinda	梅林达
stretch	伸展
shadowy	多荫
logged	笨拙
radiance	光辉
cosmography	宇宙学
rageful	盛怒的
package	包裹
jcl	control
discontentedly	不平地
laguna	小湖
current	流通的
gerard	杰勒德
absoluteness	绝对
offhand	无准备
asean	Nations
dispersedly	散开地
bile	愤怒
accrete	使连接
polyidrosis	=polyhidrosis
preovulatory	排卵期前
kent	的过去式和过去分词
bricolage	利用手头东西制成的物品
hydrophily	水媒
apothecial	子囊盘
undetected	未被发现的
vitiation	损害
bleareye	睑缘炎
deloul	单峰骆驼
stragglingly	脱离队伍
various	各种各样的
bouncing	活泼
fire	开枪
guianese	圭亚那地区
kazakh	哈萨克人
gonocyte	性原细胞
ditch	沟
semiconscious	半意识的
asthmatoid	气喘性的
tautochronism	等时性
hoariness	老年
batter	猛击
schizo	精神分裂症
repleviable	可发还的
shaddock	文旦
spiculum	骨针
neighbouring	毗邻的
ossuarium	=ossuary
liable	有责任
crake	秧鸡的叫声
varioloid	类似天花
eurhythmic	音乐舞蹈体操的
ensorcel	蛊惑
kona	storm
monopolizer	独占的人
alaska	阿拉斯加州
grozing	iron用于烫平铅管接头的烙铁
mithraic	密特拉教的
exteriorly	表面上
prowess	威力
sherbet	冰冻果子露
such	这种
rhenic	含铼
dephlegmator	提聚器
armonica	玻璃口琴
snugly	贴身地
terrorism	恐怖主义
daunomycin	道诺霉素
take	拿走
netsuke	坠子
fulsome	过分的
fluidify	使流体化
impermanent	暂时的
spiritedly	活泼
speechcraft	口才
appeasement	缓和
jar	冲突
fortune	给……以大宗财富
maladjustive	引起失调的
vaporization	蒸馏器
consulship	领事的职位
level	对准
palm	棕榈
antipyrotic	消炎的
ruthenic	四价钌的
frcp	Royal
villainy	罪恶
chondrule	陨石球粒
seed	精液
embedded	内含
halophile	喜盐生物
winglike	翼状的
fratricide	杀兄弟的行为
sahelian	萨赫勒地区
substantialism	本体论
brownette	棕发女人
pushcart	手推车
paperbacked	纸面
artistically	有艺术
appreciatory	欣赏力的
fitch	臭猫皮
ionophone	离子扬声器
momentous	重要的
crinoline	四周鼓出的裙
ambulatory	流动
viscoidal	有黏性
louvered	装有百叶窗板的
decree	法令
imbibition	吸入
trabeated	横梁式的
trabeate	横梁式
methane	甲烷
precontract	预约
callipash	=calipash
fart	放屁
penetralia	密室
airy	空中的
defluent	向下流的
desired	想得到的
romaic	现代希腊语的
depancreatize	切除胰脏
powerword	金山词霸
unlooked	未经检查
commend	表扬
pedicel	蒂
cyke	弧形背景幕
projective	投射
gorilla	歹徒
flee	逃走
mounting	衬托纸
airmanship	导航技术
downstairs	下楼
brushy	如毛刷
inchoation	发端
hawaiian	夏威夷的
physiological	生理学的
lignitize	使变为褐煤
leporine	野兔的
questioner	质问者
bung	桶等的塞子
frivolously	愚昧地
ramate	分枝
seasonal	周期性
preemployment	雇用前
halfling	半成年人
dishonour	拒收
semiskilled	半熟练
unevenness	不均衡
caudillo	元首
turd	粪
ornithomancy	鸟占术
indigenize	使本地化
crustless	没有外壳的
staghead	上部树枝枯萎病
aniseed	八角
umbral	阴暗的
emendation	校正
hidalgo	西班牙的绅士
hypochondriacal	忧郁症的
abusive	滥用的
blagueur	说大话者
deltoid	字形的
unscramble	整理
thracian	色雷斯的
subcellar	地下室的第二层
copemate	伙伴
carioca	卡里奥克舞
infirmary	医院
carsickness	晕车
autoboat	机动艇
fishfag	渔妇
jady	如玉的
irrespective	无关
adjacency	邻接
donnish	装模作样
freeborn	适于自由民的
foziness	肥胖
disennoble	使低贱
lhc	High
ogbomosho	奥格博莫朔
detruncation	截短
woozy	糊涂
piezometric	压力计
delir	说胡话
mshe	Economics
cardinal	主要
unfortunate	使人遗憾
electronical	电子
gfwc	of
roadeo	卡车司机车技表演比赛会
epithet	绰号
above	超出
knapper	碎石槌
antimeric	体辐
netfs	Television
oxpecker	黄嘴牛椋鸟
message	差使
chitinous	壳质的
apostleship	使徒之身份
augmentation	增加
finality	结尾
refashion	再做
unreligious	世俗的
sprawl	四肢伸开的躺卧姿势
schwartza	=schvartze
haunted	闹鬼
praedial	耕
prohibitory	禁止的
distant	关系远
colluvial	塌积
severely	激烈
hostile	敌方
hurtless	无害
cuttlebone	海螵蛸
anthropological	人类学
sigil	魔诀
diseuse	单口相声演员
materialise	=materialize
grasping	贪婪的
physiocracy	重农主义
slan	loco
in	Intelligent
iniquitious	极不公正的
gastrectasia	胃胀
handstand	手倒立
rowdyish	粗野的
machinator	策划者
say	表示
fact	真相
apricot	杏树
flowing	流动
draft	设计
humanity	仁慈
interdigitate	互相交叉
rented	租用
illegibly	难读地
rabbet	开槽口于
airy	轻快的
subtractive	负
downhearted	闷闷不乐的
saturnian	农神
condensed	浓缩
meanly	吝啬
lochial	恶露的
thornbush	山楂林
stockroom	仓库
prestissimo	最快的
lamprophyre	煌斑岩
rsc	英国皇家莎士比亚剧团
hyperbatic	倒装法的
decemvirate	十大官之职位
axillary	叶腋
blithely	愉快
crossbeam	横梁
uniface	单面的
univalve	单壳软体动物
galvanoplasty	电铸法
episcopate	主教
goby	虾虎鱼
moslemic	穆斯林
tunnage	总吨数
irradiation	放射
abstruse	奥妙
furious	极为激烈
quatercentennial	400周年的
plebeianize	使粗俗
backhouse	后面的小屋
morphinize	用吗啡治疗
karyosystematics	染色体组型分类学
doctrine	教条
sizzle	咝咝声
tanning	制革法
hashery	经济餐馆
octonarius	八音步诗
neronian	暴虐
gleamingly	若隐若现
craterlet	小火山口
antennal	触角的
mcm	1900
flitch	大比目鱼的肉片
suffering	患病的
tutenag	一种白铜
megalithic	巨石造成的
lentoid	透镜状结构
crises	紧要关头
fludrocortisone	氟氢可的松
monastical	僧院
subequal	近似相等
apia	阿皮亚
unchristian	非基督教的
ectoenzym	外酶
nonresidential	非居住
rubblework	表面粗糙的石头建筑
korean	朝鲜人的
sacerdotalism	僧侣政治
calix	圣餐杯
unalienated	未转让的
rescue	营救
fraction	分数
caritas	博爱
couturier	女服设计师
obfuscate	使迷乱
sweated	低工资
argentine	银的
regain	重新夺得
enrollment	登记
obtainable	能得到
upscale	质优价高
graciously	优雅地
eclectic	折衷学派
elfin	淘气鬼
concentricity	同心
come	出现
unimplemented	未执行
facility	简易
pebbly	有卵石花纹的
precis	大纲
gratitude	感谢的心情
liposarcoma	脂肪肉瘤
spectrofluorimeter	分光荧光计
untenanted	无人租赁的
harmonistic	悦耳
interleaved'	NULL)
titular	有名无实的
pochismo	夹杂英语词汇的西班牙语
vestibule	门廊
nameless	无名
hyperventilation	强力呼吸
patronize	资助
resurrective	使死者复活
uplift	升起
boldfaced	粗体字
apulian	阿普利亚区
thermoform	热力塑型
tough	凶恶的
undeviating	不离正道的
ric	Royal
dissolutely	荒淫地
basque	一种妇人用短上衣
araucaria	南洋杉属树
quick	快的
ganoid	珐琅质的
dextral	右侧
gray	阴沉的
fluctuant	波动
imaginabale	可能
presbyope	老花眼者
subvariety	从属品种
briefly	简要地
slammer	监狱
experientialism	经验论者
dispersal	散布
overeat	使吃过量
corrigenda	勘误表
numinosum	对神既敬畏又向往的感情交织
morcellate	分碎
laotian	老挝的
intuitionism	直觉说
juliet	朱丽叶
superincumbent	在上面
photoionization	光致电离
wound	伤
convert	转换……
untruthful	爱说谎
paunch	剖腹
pecorino	佩科里诺干酪
new	更新的
merogony	卵片发育
despumation	取去浮泡
vauntingly	吹嘘
pedometer	步数计
departmentalise	分成部门//departmentalize
gozzan	=gossan
wristwork	手腕动作
projective	投影
practicum	实习科目
braille	盲人用点字法
commonplace	平凡
keratoderma	角皮病
discursive	散漫
stuma	不安
skeptical	好怀疑
palpable	可触知
dunbarton	丹巴顿郡
meatpacking	肉类加工业
unclarity	不清晰
darkling	令人可怕
porket	乳猪
inauthoritative	非权威
circumplanetary	围绕行星
lah	长音阶的第
metepa	甲基涕巴
cuetrack	轨
almacantar	=almucantar
integrate	求……的积分
choice	上等
hydrothorax	水胸
interocular	两眼间
armour	装甲钢板
baptismally	洗礼地
omnimane	每天早晨
whys	理由
spirit	鼓舞
daintily	难以取悦
comous	多毛的
pietistic	虔信派的
bicker	口角
parenthood	父母身份
expressive	有表现力
vibrancy	振动
differentiate	区别
awny	有芒的
jake	满意的
cupping	拔火罐
exposure	揭发
roughhewn	草率
basion	底穴
inauthenticity	伪造
maximum	最多
whipstock	鞭柄
cherry	如樱桃的鲜红色
aggrieve	侵害
struggle	使劲移动
foliose	多叶的
capacity	容量
debater	讨论者
aerolith	陨石
treasonous	不忠的
manual	手册
abstruse	深奥的
misplug	误塞
mythopoeic	神话时代
salchow	后内结环一周跳
nucleophilic	亲质子的
coleopterous	鞘翅类
pliably	圆滑
myob	business
entophytic	内生植物
religion	信仰
transmit	传达
rubrical	仪式指示的
quadrifid	四分裂的
sphacelous	患脱疽
msbc	in
furor	激怒
hemophilioid	类似血友病
unfurl	展开
bleak	荒凉
enormously	非常
tripodal	三脚架
herbescent	草本
ultralight	超轻型
lapse	丧失
unpitying	无恻隐之心
adjournal	=adjournment
mudslide	徐缓黏滞泥流
pubic	阴毛的
brusquely	粗率
accelerate	加速
joyuce	James
trilithon	巨石牌坊
suprahuman	=superhuman
laches	懈怠
elk	麋鹿
without	要没有
phenolic	石碳酸的
embodiment	化身
commute	整流
competently	胜任地
subeditor	副主编
refill	新补充物
azedarach	楝皮
gerontophil	亲老人癖的
upright	正直的
saltire	X形十字
turn	旋转
chubby	圆胖的
alterability	可变更性
featherless	无羽毛的
leze	majesty=lese
pickerelweed	一种多年生植物
windless	喘不过气
paraphrastic	说明性
skidproof	防滑的
billposter	受雇张贴广告者
it	意大利
transphosphorylation	转磷酸
lordling	大人
shadowed	附有阴影
malone	即
drencher	倾盆大雨
underpaid	所得报酬过低的
coattail	燕尾
unaccompanied	无随从的
felix	费利克斯
matelot	水手
incunabula	摇篮期
political	政治
outmarry	使在婚姻上高攀
benefit	好处
arhat	永入涅槃再受生死果报的僧人
equitably	公正地
unmortise	使脱榫
jo	爱人
milimeter	千米
nonagricultural	非农业的
battlement	防卫墙
distractingly	发狂似
cachinnatoria	放声大笑的
endodontist	牙髓学
adipose	肥胖
suckle	养育
uniform	统一的
paleocrystic	长期冻结
begrimed	污秽的
demiurge	造物主
adhesive	粘合剂
yarnsmith	作家
laudatory	赞赏的
synodal	教会会议的
rebarbarize	使回到野蛮时代
dst	Drive
triliteral	三字母
themselves	他们亲自
vanuatuan	瓦努阿图
amphitheater	古罗马的圆形剧场
betrothal	订婚礼
gk97	金山游侠
khalifate	哈里发的职位
paracetaldehyde	=paraldehyde
amelioration	改进
park	炮场
vacuum	真空吸尘器
typhonic	台风的
patripotestal	以父系亲属委员会为权威的
huxley	贺胥黎
daily	日常地
piscator	捕鱼人
invariable	永恒
seriously	真诚地
unforgiving	不可宽恕的
indonesian	印度尼西亚人
abominable	讨厌的
dud	衣服
clavicular	锁骨
heliology	太阳学
telemetric	遥感勘测
exhibition	展览会
hypostasis	本质
mercantilist	重商主义者
accordable	可一致
unfamiliar	没有经验
carlish	卑下的
remember	纪念
plesser	敲诊槌
taphouse	酒馆
jugula	jugulum的复数
specific	特殊的
parasang	古代波斯的距离单位
humourless	一本正经
discomfiture	崩溃
infinitesimal	无限小
fodgel	丰满健美的
melancholia	精神忧郁症
wont	惯于
bailsman	保释保证人
leakiness	易漏
commercioganic	吸引力
panthalassa	泛古洋
cytogenetical	细胞遗传学的
delicate	精致
aboil	沸腾
multipartite	分成多部份的
graduate	毕业
overfreight	超载
nitre	硝石
trimness	整理
racquetball	手球式墙球
acidfast	抗酸
sphenographic	楔形文字的
diminishable	可缩减的
rameses	拉美西斯
atman	生命的本源
unreachable	不能达到
subdividable	可再分
rann	National
twitch	抽动
rounding	环绕
din	喧闹
deepwater	海洋上
assaultable	可袭击的
swank	炫耀
vespers	晚课
bytecode'	NULL)
attestant	连署人
atlanta	亚特兰大
