colophony	松香
missourian	密苏里州的
criticaster	无价值的批评家
parietal	顶骨
thankless	不感谢
unhappy	不适当的
motile	显示活力
frank	免费邮寄
mnas	of
scalar	梯状
criminologist	刑事学家
alanine	丙胺酸
waikiki	怀基基海滩
adipsia	渴感缺乏
harmonic	谐波
lollapalooza	非常出色的人
chloroplast	叶绿体
fractionalism	分裂倾向
cinerea	灰质
hillside	山腹
lacquerer	漆匠
irredeemable	不可救药的
froggish	像蛙的
nonenzyme	不涉及酶作用的
flatwork	可用机器或电熨烫的床单
msee	in
doggery	象狗一样的行为
prise	奖赏
josue	约书亚
couch	表达
concoction	调合
untaa	Technical
sugar	食糖
alien	外国的
lane	小路
callboy	仆役
great	大师
pushful	有精力
dimensionality	广延
parade	列队行进
interactional	相互作用的
venial	可宽恕的
arbitrational	关于公断的
smacking	掴
hear	审理
wscf	World''s
sm	Masochism
vertices	头顶
diphthongal	连字的
puffy	自大
ensilage	保藏于地窖中的未干秣草
lease	租得
congener	同种的物
contrasuggestible	反暗示
ethnocide	种族文化灭绝
diuresis	利尿
damnedest	最大的努力
enquiring	寻问
hyphenated	带有连字符号的
reversional	继承
intropunitive	自责型的
plenteous	充足的
influential	有影响的
depigmentation	脱色
flurry	小雪
crown	加冕
spill	溢出量
riskiness	危险重重
extractible	可引出的
loving	钟情
beverly	贝弗莉
blackfoot	北美印地安人中的一种族
notoriety	丑名
neorealism	新现实主义
byroad	侧道
precipitator	沉淀剂
informing	提供情报
syndic	市政官
pochard	潜鸭
antifreezing	防冻的
satyarahi	不合作主义者
outmarry	族外结亲
tragical	悲剧
readable	易读
plasmolyse	=plasmolyze
widespread	分布广泛的
iba	Broadcasting
gaily	华丽
handle	柄
demoniacal	着魔之人
tauromorphic	牛形
zoantharian	海葵
unfixed	没确定
unfatherly	有失父亲身份的
arenose	多沙的
neoanthropic	新人的
greenhorn	生手
inferable	能推论的
anarchy	无政府状态
magnetic	磁
exeter	埃克塞特
pinto	杂色的
cardiac	心脏
ethnarch	民族
venene	=venin
nepaulese	=Nepalese
ungroup	取消组
develop	生长
rate	等级
anaphylactic	过敏的
paynim	异教国
gleba	产孢组织
assumptive	傲慢的
hyperalimentation	静脉输入营养液
patrimony	祖传的财物
schistorrhachis	脊柱裂
hectic	兴奋
reemployment	重新雇用
telltruth	坦率诚实的人
dissension	纠纷
distillatory	蒸馏器
anaesthesia	麻醉
oust	取代
tepefaction	微热
foci	焦距
ruminator	好思考的人
playbroker	agent
smart	厉害的
passionate	充满热情的
contubernal	一起生活的
shrewdness	机灵
spicily	香地
vermouth	味美斯酒
kindly	好意
schematise	=schematize
tearaway	阿飞
screamer	尖声叫喊的人
untaught	没有受教育
unpregnant	不恰当
deeply	深深
watering	流泪
semicentury	50年
filariid	血丝虫的
title	标题
garcon	侍者
attic	阁楼
hydrogenase	氢化酶
thereinto	在那里面
saponify	使皂化
pashalic	pasha
footbath	洗脚
wordy	唠叨的
seram	=Ceram
gore	三角形布
flatten	打倒
tenor	进程
living	现存的
spirit	鼓励
fujitsu	日本富士通公司
grained	有木纹
coachwhip	鸣鞭鸟
sniffable	可吸入的
ameliorate	改善
petropower	富油国
voltage	伏特数
tivy	向前冲
unwarily	不留心的
schoolgirl	女学生
incendijel	易燃胶体
portability	轻便
diametrically	直接地
towardly	有指望地
unprophetic	非预示
lordliness	贵族式
defang	拔去……的尖牙
vagotropic	作用于迷走神经
allegorical	讽喻
bedsonia	贝宗体属微生物
dioestrous	有间情期的
guilder	盾
grainy	多粒的
csma	/Carrier
vram	视频存储器
hopcalite	一氧化碳消灭剂
unoiled	未加油的
methoxamine	美速克新命
ac	`eIsi:`di:si:/交直流两用
yearn	怀念
trifling	不重要的
screwball	怪人
wafer	圣饼
subscript	写在下方的
unforensic	不适于法庭
insectivore	食虫动物
spanking	疾行的
contingently	偶发
videorecord	把……录在录像带上
barbette	炮塔
gunlock	板机
disengaged	空闲的
urban	城市的
distinguishability	可区别性
ream	铰大
fornication	通奸
raunchy	邋遢
immerge	浸入
fighting	战斗的
reinstall	使从新正式就职
dccc	800
dace	一种鱼
claytonia	春美草属植物
manual	手工
specilization	专门化
immalleable	不能适应
matted	暗淡
darshan	得福
whatso	pro
banausic	机械式的
oup	Oxford
striate	有细槽
extrovertish	外向者的
quadrangular	四边形的
farmy	有田
intuitionalist	=intuitionist
gorgonian	如蛇发女怪
flareback	后曳的火焰
diomed	=Diomedes
cedarbird	雪松太平鸟
pavlovism	巴甫洛夫学说
lamish	有点瘸
sinew	赋予力量
chieftain	首领
circs	事件
overturn	破灭
utter	全然的
excellent	极好
tautosyllabic	同音节
petrosal	岩石
tantivy	快
fastigiate	平安
bricolage	使用手头现成工具摆弄修理
northern	北部
hepatopathy	肝病
remodify	改造
signature	信号
bacciferous	结浆果
scarify	切割或软化
whipcord	拉紧
modillion	飞檐托饰
unsmirched	未弄脏的
inoperable	不宜动手术
septipartite	七个部分组成
tubbish	桶状
flop	恰巧
rapturous	欢天喜
farrandly	愉快
mock	挫败
stonework	石雕工艺
imagination	想象
gentian	龙胆根
lazurite	青金石
araroba	柯桠树
walloping	巨大
insect	虫
ainu	阿伊努语
behaviouristic	行动主义的
mia	missing
myanmar	缅甸
polyglandular	多腺
calcareously	钙质地
soberminded	头脑清醒
engrammic	印象的
inebriated	酒醉
amid	在……中
cuso	Overseas
rheotactic	微生物在水流中之行动的
denizen	居民
lcf	lowest
mysterioso	神秘
westbound	向西进行
scant	将近
snowswept	大雪纷飞的
unweighted	未加权的
elements	基础
orient	使适应
chickabiddy	鸡宝宝
mycophilic	食蘑菇的
cheater	背叛者
strigillose	覆盖着糙伏毛的
incurvate	向内弯曲
bibulosity	酒癖
complier	依从者
sludgeworm	正颤蚓
ferrel	套圈
disillusionize	使觉醒
sound	充分地
yokelish	乡土的
salted	有经验
wops	胡蜂
goad	刺棒
unstriated	无横纹
inartistic	非艺术的
apocopate	语尾音节删除
mischievous	恶作剧的
vestiary	衣帽间
spencerian	斯宾塞哲学体系
doodlebug	狮蚁
intact	未经阉割的
exercitorial	船主
pettifogger	骗人的律师
sniffable	可嗅的
usmcr	Corps
mim	假正经
aseptic	无菌的
tanglewrack	=tangle
hop	跳跃
aleak	漏水的
incontinent	失禁
abiogenetic	无生源说的
impercipient	无知觉的
namable	可指名
intercommunity	共同性
polymorphous	多形态的
homocyclic	同素环状
planner	计划者
equal	相等的
terminal	每学期
colonize	拓殖
litho	石版印刷
memcon	谈话备忘录
pump	泵
journalistic	新闻事业的
hmcs	HerMajesty''s
bircher	伯奇主义分子
unconsolidated	非层状的
choice	挑三拣四的
mossiness	陈腐
thwack	打
coatee	紧身短上衣
quoter	估价者
hereunto	迄今
bitch	母狗
for	因为
another	同类的东西
notgeld	代用货币
prongy	有叉尖
frad	帧中继访问设备
symptomatic	症状的
gingerly	小心翼翼
feebleminded	无决断力的
urgence	=urgency
tetroxide	四氧化物
vesa	Association
piperaceous	胡椒科
unhitch	解开绳子
edacity	狼吞虎咽
cariole	小型马车
parc	Center
unseemly	不体面的
metamorphism	变质作用
hyposensitive	敏感度减弱的
lentiginous	有斑点
rheologic	流变学
ravel	使混乱
thinker	思想者
supplementarity	增补
odious	讨厌的
hommock	冰丘
fzs	Society动物学学会会员
colorless	无色
franklinite	锌铁矿
polywater	聚合水
duralumin	硬铝
heavy	重物
hormone	荷尔蒙
nobleness	高尚
supersell	特畅销
muzzle	口套
palmer	游方僧
unabated	不衰退的
turkophile	亲土耳其者
ingenuous	自然
pothook	书法潦草
aps	Photo
parlous	不易对付的
deep	深入地
regalvanize	再激励
sex	引起……的性欲
driveller	淌口水的人
slumberland	梦乡
gunner	带枪猎人
comanchean	卡曼奇纪的
morbid	恐怖的
pervious	能被通过的
tripey	低劣
unsized	未上胶水
fanfold	复写簿
belgrade	贝尔格莱德
epistle	书信
taurean	出生于金牛座时段的人
yardman	庭院打杂工人
ammonic	铵的
conqueringly	得意洋洋地
calque	译借
shelly	壳的
technology	科技
pergola	藤架
papal	罗马教皇的
scrapheap	废物堆
grindingly	苛刻
chrysoberyl	金绿玉
posttreatment	治疗后
pricket	烛台
bowl	木球
impetigo	脓疱病
acquiescent	默从
figuline	陶制的
daftly	愚蠢
selected	挑选的
over	从头到尾
cinerama	全息电影系统
heimisch	朴实
metalloid	非金属
parpen	贯石
glossal	舌
duograph	=duotone
pseudorandom	伪随机
indurate	坚硬
voluptuary	耽于酒色
dogsleep	打盹
sadhe	希伯来语的第十八个字母
partner	组成一对
regurgitant	回流的
aeruginous	铜绿色
authenticity	确实性
unascertainable	无法查明
charge	装料
hippish	有点忧郁的
hymenopteran	属于膜翅目的
gravisphere	引力层
defray	支付
chronology	年表
gq	general
netman	网前球员
charioteer	战车的御者
unpatterned	无图案装饰的
undyed	天然色
discomfit	扰乱
imprese	=impresa
somber	忧郁的
thinnest	薄
horsefaced	脸长而难看
cryoprobe	冷冻探针
dried	dry
contravention	违背
warszawa	=Warsaw
fudge	胡说八道!
yakka	沉重的活计
chebec	=least
magnify	有放大能力
foe	反对者
sas	Service
netiquette	网络礼节
postulate	假定
unsmart	不聪明的
alarming	使人惊动的
convenient	方便的
rigidness	劲直
celery	旱芹
neutral	不确定
nonenzymic	不涉及酶作用
substitutional	代理
ipm	inches
plantaginaceous	车前科
mithraic	崇拜密特拉神
mechanochemistry	机械化学现象
prohibitory	很昂贵的
semicontinuous	断断续续
proof	不能透入的
salivation	流涎症
encephaloid	脑样
surrenderor	让与者
homoeothermic	恒温的
scalar	标量的
brumaire	雾月
cnaa	National
beneficial	有益
space	余地
contumely	无礼
skip	遗漏
dawk	邮政
sinistral	左旋的
spadices	的复数
banister	楼梯的扶栏
slavikite	菱镁铁矾
poseuse	装腔作势的女人
trainable	可训练的
counterweigh	使平衡
think	认为
asarh	印度历的4月
classy	漂亮
sashless	无窗框的
thermel	热电温度计
immigrant	移来
frutescose	灌木
yangtse	长江
massy	厚重
primely	最初
tartarian	鞑靼
trend	伸向
avulsion	扯开
incorrect	不正确的
technocomplex	工艺文化丛
escharotic	生焦痂性
sound	彻底地
hartbeest	麋羊
orally	口头上地
hdcd	High
fleshy	肉的
crotchet	怪想
unmarriageable	不适于结婚
denuclearize	撤除核武器
interfacial	界面
reflex	反作用
voe	小海湾
pizazzy	潇洒的
silvicolous	居住在森林中
sql	Query
inappositely	不贴切的
outbound	开往外国的
hypogenous	在下着生
suspensibility	可悬挂
anticrop	破坏作物
refusal	拒绝
tubbish	桶状的
amygdalaceous	蔷薇科李属植物
ultracytochemistry	超显微生物化学
haemolyze	发生溶血
conversable	谈得来
secondhand	旧
beethovenian	贝多芬音乐作品的
rickety	摇摆
osp	Processor
unsleeping	警觉
inquiet	焦急
depository	存放处
attenuator	衰减器
remittor	汇款人
stream	川
sciuroid	松鼠的
mistiness	不清楚
anthrosphere	人类生命层
ochlocratic	暴民统治
ironhanded	铁腕的
gridding	网格
rfz	加强
pyramidwise	成角锥形
cardiac	强胃剂
ball	尽情地玩
moonlight	月夜的
contaminator	污染物
cartographer	地图制作者
hid	家庭信息显示器
eleoptene	挥发油精
exodontist	拔牙专家
unwound	未卷绕的
apple	苹果
voluminousness	广博
barytone	男中音歌者
ameer	埃米尔
biogeocenose	生态系统
bronchia	支气管
defend	作……的辩护律师
defier	对抗者
counterfort	突击处
frenzy	狂暴
adaptor	编剧者
ripe	时机成熟
verdant	生疏
liquidambar	胶皮糖香树
illicitly	不正
ravine	峡谷
jazzily	奔放地
bittersweet	苦乐参半的
homonymous	双关
chairman	主席
viet	越南
ring	响
simulacre	=simulacrum
encephalomyelitis	脑脊髓炎
mirthless	忧郁
petiolate	有柄的
dynamograph	动力描记器
pursuable	可追赶的
deckle	定纸框
divisive	不和的
barge	驳船
inhomogenous	不均一
violet	紫罗兰色的
hili	hilus
inertialess	无惯性的
lubricity	狡猾
advice	通知
planify	编制……的计划
multicell	多单元
delible	可抹掉的
dantean	但丁的
nominatum	指称
greatest	最伟大的
pinecone	松果
umbones	umbo的复数形式
cursive	连接的
indestructibility	不灭
natheless	虽然如此
mshe	in
work	手工
atmospherically	气压所致地
quadricentennial	400岁的
tolerance	公差
concupiscent	贪欲的
barbola	堆绣
capsular	蒴状的
rachilla	小花轴
marijuana	大麻
autoeroticism	自体性行为
denudation	剥下
algebrist	代数学家
deperm	使消磁
cystocarp	藻实
remarkably	非常
skin	皮肤
wane	月亏期
similitude	外表
daf	of
tease	逗恼
rhizomorphous	根状
article	论文
clipper	大剪刀
explicitly	明确地
reproachable	应责备
contortion	扭歪
passimeter	栅门
unquestionable	毫无疑问
emiocytosis	排出
phobic	病态性恐惧的
capot	全胜
lightly	轻轻
treat	协商
sacculate	袋状的
recommendable	可取
summing	做加法的
discourteous	失礼
menses	月经来潮
evenminded	镇定的
waxy	柔软的
unkennel	揭露
arm	装备
chapman	小贩
table	工作台
soulful	高尚的
disimprove	使变得更坏
hogger	木材切碎机
canalside	在运河边上
reference	参考书目
diabase	辉绿岩
vainness	无益
notional	概念的
lienteric	不消化性腹泻
microclimatology	微气象学
preproinsulin	前胰岛素原
multivalent	多化合价的
heterophony	衬腔式复调音乐
depredation	掠夺
babbler	胡说之人
europeanize	使具有欧洲风格
optical	视力
unimpressible	不可印的
famous	极好的
cussed	固执
ferule	教鞭
whichever	无论那一个
charitably	慈善
cabal	阴谋
overfeed	吃得太多
googolplex	古戈尔普勒克斯
fringlish	夹杂法语的英语
tawdry	非常华丽的
moggy	小牛
feat	武艺
easiest	容易
plump	使发胖坠落
supercolossal	巨大
overlight	使受强光照明
pushful	有精力的
bouncing	跳跃的
patina	绿锈
innervation	神经分布
insoluble	不能解决的
heathbird	黑琴鸡
argental	银的
escheat	归还
arrhythmia	心律失常
louche	品德有问题
perfunctory	马马虎虎
secretory	能分泌
bait	欺负
beltline	腰围
hurrier	催促者
overplaid	套格子花纹
velocipede	早期的脚踏两轮车
daintily	优美
borrow	借入
rape	掠夺
minicam	=miniature
fixer	固定器
guide	任向导
vermes	的复数
avariciously	贪婪地
turbulency	狂暴
repressive	压制
sabaism	拜星教
capercaillie	北欧产雷鸟之一种
baume	波美比浮计
preclusion	排除
antalkaline	抗碱的
dramatize	编写剧本
adverb	副词
infuse	浸渍
baptise	洗涤
straightaway	陆路上的直段
israelitish	希伯来人的
disfigure	损伤外貌
gaga	非常起劲的
redispose	重新布署
checkerbloom	野蜀葵北美紫花锦葵
fatiguesome	累人的
ferriferous	含有三价铁的
nauseant	引起呕吐
aicpa	of
misconduct	干坏事
cornish	康沃尔郡
velamen	根被
norward	向北
gilding	镀金
thornlike	象刺一样的
antinational	反国家的
quantometer	光量计
decamp	逃走
fatness	肥胖
presumptive	假定
prognathism	凸颌
subnormal	低于正常的
poker	戳的人
hopefully	有前途地
congruous	符合的
sapient	伶俐的
psalmodist	赞美诗作者
citadel	根据
psammophilous	适沙生物的
blower	吹制工
tenderly	体贴地
lively	活跃
lapidescent	石头似的
tentaculiform	触手状的
sternpost	艉柱
antsy	热锅上的蚂蚁般
grandfatherly	慈祥的
hornful	一角制杯的量
taxpayer	纳税人
atticism	雅典语法
trigger	触发
hoopoe	戴胜鸟
buster	小家伙
kilomega	千兆
platinotype	白金照相术
buyable	可买
bumpety	砰
unpaired	无对手
superior	长者
fade	凋谢
abaca	麻蕉
surgeon	外科医生
pressure	压
beztine	=bez
base	底部
desideratum	所愿望之物
cryogenic	低温学
maguey	龙舌兰
indefatigability	不屈不挠
nonsignificant	无意义
face	朝
criticise	吹毛求疵
mild	不含有害物质
militarize	军事化
renavigation	再导航
promoter	促进者
downbeat	强拍
underside	下面
argent	银色
lambda	希腊字母的第
hexachlorobenzene	六氯苯
vestiary	服装
gobble	贪食
semifitted	半紧身的
clothbound	布面精装的
supervene	接着发生
sartorite	脆硫砷铅矿
stratus	层云
eject	撵出
hamadryas	狒狒
ironmould	铁锈迹
cuddlesome	适于拥抱
traipse	漫步
homozygote	同质接合体
coition	性交
dank	潮湿的
cygnus	天鹅座
befell	降临
unreconstructible	不能重建的
cove	成拱形
explore	探测
ignoble	不光彩的
positive	原级
turgid	肿
station	位置
agendum	议程
belowstairs	在楼下的
precocity	早熟
hardcase	倍受艰苦锻炼的
regular	常备军的
fatigue	杂役
redistribute	重新分布
indubitability	明确无疑
watchmaker	钟表匠
elfish	如小精灵
vis	活力
logan	摇石
worktable	工作台
competently	胜任
noctiflorous	夜间开花
mentality	思想情况
term	期限
existence	生活
jarovization	春化作用
lumine	照亮
semirural	半农村
operational	运作的
waxy	柔软
broch	史前圆形石塔
aciculate	粗面
dumbstruck	被吓得目瞪口呆
carbonicacid	gas碳酸气
soberminded	严肃的
msa	of
tassel	穗
somnambulism	梦游病
ere	前于……
photocompose	照相排
baptism	浸洗
onlend	转贷
syllogism	推论法
indeliberately	无心地
gradual	逐步的
trental	30天追思弥撒
mats	Air
tacitly	沉默
rainbird	雨信鸟
assimilation	消化
unhallow	污渎
implausibility	难信
mor	粗腐殖质
newsheet	单张报纸
flycatcher	蝇虎
cyclostomate	圆口动物的
pachydermatous	厚皮类动物
zeroth	零
inoculation	接插芽
bestially	残忍
antismog	防烟雾污染
forelimb	前肢
reproacher	责难者
mlw	low
immalleable	非柔顺
reddish	微红
by	白俄罗斯
barbara	芭芭拉
sanitation	卫生设施
exceptionable	可反对
uncontainable	难以克制的
tinkly	叮当响的
punk	无用的
wysbygi	Before
portulacaceous	马齿苋属植物的
affective	情感的
kinaesthesia	运动感觉
pillowy	柔软的
parulis	龈脓肿
constringency	收缩
neoantigen	新抗原
killing	赚得的一笔大钱
rook	赌棍
febrific	产热
definite	明确的
enfranchise	给予自治权
plaint	感叹
blowmobile	雪撬
preelection	选举前的
shiftless	偷懒
falseness	不忠实
soilborne	土壤带有的
prebiotic	生命起源以前的
yalung	雅龙江
upbind	系
slim	不足取
inure	使习惯
dekastere	十立方公尺
horseshoe	装蹄铁于
sophisticator	搀假者
communize	使为社会公有
certain	无疑
wushu	武术
sweepstakes	独得的赌金
advanced	年老的
trifurcate	三叉
fissility	可裂变性
prepotent	优势的
panelling	格子
smarmy	令人厌烦的
fripper	买卖旧衣者
acrid	辛辣的
mhw	平均高水位
apb	全境通告
preharvest	收获前
practicing	在工作
epigram	讽刺短诗
heronry	苍鹭抱蛋处
riproaring	喧嚣的
uninhabited	杳无人迹
cistern	水塔
maturity	成熟
yarn	故事
exegete	评注家
wpm	字[分
afterschool	课外
tragical	悲剧的
flinders	破片
unimplemented	未执行的
stockade	栅栏
seepage	渗流
ditch	壕沟
gusset	接以三角片
guesswork	凭猜测所作之工作
mirthless	不快乐的
unexaminable	无法测定的
refrigerate	使冷却
advance	预付
vertical	垂直
bid	出价
dissentious	争吵
silvical	森林学的
slubbing	头道粗纱
guatemala	危地马拉
abrim	充满着
bunko	诈骗的输赢
ceraunograph	雷电计
uncaused	自存的
plunder	抢劫
scurrilously	粗野无礼
metrological	度量衡学的
ssfdc	固态软盘卡
con	反对论
fibroblast	纤维原细胞
hydration	水合
snooper	刺探者
qualification	限定
rabbiteye	越橘
tumid	肿大的
opendoc	开放式文档接口
granita	格兰尼它冰糕
ley	草
promiscuously	杂乱
epact	岁首月龄
funster	喜剧演员
prefixion	前缀
appetizing	美味可口
deficiently	不充分
flaked	失去知觉
coquille	用贝壳或贝壳状容器盛的菜
ato	Organization
concordia	肯考迪娅
admit	接纳
groenendael	比利时牧羊狗
scuttle	凿沉
unpitying	无同情心的
paedomorphism	幼稚形态
cicisbeo	情夫
polyglot	数种语言的
yawing	偏航
fsf	Software
venom	毒液
rankle	发炎
obscene	淫秽的
matins	天主教之子夜或黎明之祈祷
chord	弦
drowsily	懒洋洋
proviso	附带条件
verkrampte	保守分子
nitrification	氮化合
succussatory	猛摇的
enveil	掩盖
wins	Name
nannie	奶妈
niobic	铌的
inspectoral	检查员
unfix	使不稳定
flush	惊鸟
flagellated	生有鞭毛
rancho	大牧场工人住的棚屋
radicular	根的
duodena	的复数
abecedarium	初级读物
favonian	温和
smorzando	渐次消失
graviton	引力子
fit	一阵
delinquent	有过失
casteless	不属于任何阶级的
mulct	罚金
lop	垂下的
fool	受骗者
profitable	有利可图的
dishy	有魅力的
article	项目
orientalia	东方文物
mamillated	有乳头
lunilogical	与月球研究有关的
fixedness	不变
peacemonger	和平贩子
haematogenous	造血的
plater	铁甲工
rhinestone	人造钻石
waldensian	韦尔多教派的人
numberless	无数
spawny	似鱼卵的
transworld	世界范围
metonymic	转喻
microminiature	微小型
obtuse	迟钝
lumping	重大
versemonger	拙劣诗人
homonymous	同音异义
detached	分开的
atonalistic	不成调
abstinency	自制
subvariety	亚变种
mole	防波堤
submarine	潜艇
mum	别说话!
stannous	含二价锡的
slam	猛力抨击
burning	极严重
freak	反常的
multienzyme	多酶
entire	全部
heartrending	伤心
leonore	利奥诺
apostatic	背教
deconcentration	排除集中
ebullition	冒泡
poudrette	混合肥料
haeju	海州
nonaddict	无瘾吸毒者
imprecatory	诅咒的
colourfast	不掉色
terebinth	松节油
marrowsky	斯本内现象
quintain	枪靶
disconsolate	孤独的
seasonal	周期性的
spanking	显著
sken	斜眼看
pierian	皮埃里亚
pecksniff	伪善人
liquor	溶液
convincing	令人信服的
proselytism	劝诱
disimprove	变得更坏
fuzz	细毛
plebiscite	平民制定法
international	国际的
vertiginous	旋转
arisen	出现的
aphrodisiac	壮阳剂
hindmost	最后部的
undistributed	未分配
kylix	基里克斯陶杯
fadge	适合
minuscule	草写小字
awake	警觉
putrefactive	易腐败
tessie	泰茜
sulfarsphenamine	硫阿斯凡纳明
wobbly	摆动
gyri	gyrus
whine	哀诉
respirable	可呼吸
emasculate	使柔弱
monastery	僧侣
workable	可使用
outwinter	放牧放在舍外越冬
quadrille	四对方舞
countermortar	反迫
diphtheritic	白喉
cannabis	大麻雌花顶部
auric	含金
manyat	村塞
australian	澳大利亚
polystyle	多柱式建筑物
atmology	水蒸气学
teleoperator	远距离操纵器
momently	片刻地
acidic	酸
commit	把……交托给
edc	Community欧洲防务集团
crossbar	球门的横木
unbusinesslike	无组织
diastema	间隙裂
ring	鸣
gumptious	精明
gaoleress	监狱女看守
blivit	恼人的事物
spheroidal	类似球体
bta	Authority
above	过于
pleiotropy	基因多效性
state	典礼用
reliever	救济者
acidic	酸性的
hodge	典型的英国农业工人
lubra	土著女人
nomenclative	命名的
road	公路
sumptuosity	昂贵
specific	详细而精确
cernet	中国教育与科研计算机网
gutta	水滴
contradictory	反驳的
nice	美好的
prediction	预言
bonny	漂亮
anticoagulant	抗凝血剂
numismatician	奖章收藏家
inductively	归纳地
triassic	三叠纪岩石的
varietal	品种的
makeshift	凑合
fingertip	指尖
abruptly	突然
stereograph	立体画
gest	故事诗
quilled	羽毛状的
uncomfortable	不合意的
windburn	吹风引起的皮肤炎
sopor	昏睡
sarmentum	纤匐茎
autoindex	自动变址
adscititious	外加
symbiotic	共生的
inmesh	使……绊住
flurry	激动
expansion	开展
phonofilm	有声电影
gamely	不屈
trisodium	三钠的
joypopper	偶一为之的吸毒者
hypersomnia	嗜睡
temperature	温度
trouser	裤子的
backwood	=backwoods
quiveringly	震动地
wit	才智
superaddition	追加
declinable	格变化
stodge	贪婪地吃
tactician	战术家
whaleback	如鲸背状的东西
rectifiable	可矫正
gray	灰白的
bitterbrush	蔷薇科淡灰色灌木
neurogenesis	神经发生
cut	切切削
department	部
interiorly	在内
catholic	天主教徒
complacence	沾沾自喜的
patronizing	俨然以恩人态度的
alternation	间隔
inquisitorial	好询问的
ruritania	浪漫国
lindy	林迪舞
anaplastic	整形术的
telergy	心灵感应力
lecithoid	蛋黄素的
reduplicate	重复
delightedly	快乐地
iatric	医师
inscriptionless	无题字的
ah	Attack
vainglorious	虚荣的
exotic	外来
roundlet	小圆形体
hundredweight	英
untoward	麻烦
separate	个别的
nomenclative	术语的
lepidote	覆有鳞片的
highbinder	美国华人区黑社会中的党羽
egret	白鹭
unfathomable	无底的
oneiromancy	圆梦
barbarianize	使野蛮化
bophuthatswana	博普塔茨瓦纳
damocles	达摩克利斯
domineering	作威作福
caloyer	东正教之僧侣
aquaculture	水产业
geographic	地理学的
grille	格子窗
injured	受伤的
latter	后面
serriform	锯齿形的
underbuild	加强……的基础
heady	性急的
electrophysiological	I`lektrEJ9fI9fIzIE`lCdVIkLl/zI`ClEdVI/
sturdiness	强健
airscape	鸟瞰图
jointly	共同
allround	多方面的
oogamete	雌配子
prestige	声望
fin	切除鳍
arcover	闪络
microdot	微粒
nematodiriasis	细颈线虫病
exsanguine	失血
pompon	大丽花
vietnamize	使越南化
gdi	Graphical
lord	上帝
farrier	骑兵中管理马匹的下士
electrovalent	电价的
valuta	币值
rustily	锈蚀
acrr	美国种族关系理事会
recognizant	意识
amused	愉快的
photogeology	摄影地质学
overmountain	位于山上
sedentary	久坐
elation	兴高采烈
strictness	严密
beamish	春风得意
unadulterated	没有搀杂
stouthearted	刚毅
lowest	最低的
flaunt	挥动
delphian	神谕
oracle	圣贤
santalin	紫檀色素
byronic	拜伦风格
bent	倾向
rivalry	敌对状态
pore	沉思
lapis	石
improperly	不适当
unprinted	未付印
absolutory	给予赦免
anime	芳香树脂
fugue	谱赋格曲
luculent	透明
embayment	湾状之物
underwrite	经营保险业
neuroanatomical	神经解剖学
inveracity	不诚实
lallation	l
tatou	犰狳
scintillate	闪耀光芒
rediscount	重新贴现
blackguard	流氓
amphitheatric	圆剧场
denehole	白垩洞穴
immie	彩色玻璃弹子
function	典礼
waterishlogged	进水的
wandering	蜿蜒的
fauvist	野兽派的
principled	原则性强的
rotational	轮流的
filter	渗入
calculus	结石
rheidity	流变现象
caseation	干酪样变
root	确立
virginal	无瑕
essential	基本的
matriclinous	偏母性状的
calque	直译语
frisian	Friesland人的
glottal	声门的
urbanologist	都市问题专家
zi	美国本土
statedly	壮观
sackcloth	麻袋布
clubbed	棒状
vespertilionine	蝙蝠科
desalination	脱盐作用
nyctalgia	夜痛
owlish	象猫头鹰
analysable	可被分解
pentastich	五行诗诗节
gomeral	愚人
mixologist	善调制鸡尾酒的酒吧调酒生
clean	打扫
mucic	黏酸的
limbless	无肢的
coasting	海岸线
decastyle	十柱式
xanthous	黄色的
mammula	乳头突
msph	公共卫生学硕士
diastatic	淀粉酵素的
vagabondize	漂泊
frictionize	使受摩擦
heighten	提高
pixie	小仙子
allogamy	异体受精
carrion	死肉
leaden	沉闷
quatercentenary	400周年纪念
heavyweight	特别重的人
telecobalt	远距离钴疗
acyclic	无环的
bobsledding	乘大雪橇
dragsaw	下料电锯
radiotelephone	无线电话
kirghiz	吉尔吉斯人
jeopardousness	危险
calculational	计算的
infatuatedly	着迷
skillful	灵巧
microseism	微弱的震动
hyperboloidal	双曲面的
suojure	凭自身的权利
meshuga	发疯似
raughty	痛快的
histogenetic	组织发生的
dilettantish	一知半解的
associate	使发生联系
cod	delivery
draggy	拖拉
eximious	卓越
autofocus	自动对光的
kaapland	=Cape
calkin	蹄铁上的防滑尖铁
scholastic	学究的
spherics	球面几何学
crofting	小农场租期
delirifacient	引起精神错乱
windward	向风
treasurership	会计员的职位
squamaceous	有鳞
incest	血亲相奸
imparadise	使登天堂
trigamous	雌雄三种花
larger	大的
incarnate	人体化
tough	艰苦的
anthropophobia	人类恐怖症
pvc	Virtual
mete	给予
eclipse	超越
cyclopic	独眼巨人
gefuffle	=kerfuffle
scalding	烫伤
malleolar	踝的
micrograph	显微照片
doited	老朽的
micropackage	微组装
bespoke	显示
anatomical	解剖学
encompass	包围
gestaltist	完形心理学拥护者
backbench	后座议员
pentomic	五群制原子师
ghostdom	鬼魂世界
ministrant	辅佐者
trimeter	三音步的
whole	完整的
tetrastichous	四列的
sotted	醉得稀里胡涂
film	拍电影
downhearted	无精打采的
semantics	语义学
passably	尚可地
marathon	耐力的考验
piecewise	分段
foots	油滓
tee	T字形的
voltaism	流电学
drinkery	酒吧间
permease	透酶
aqua	水绿色
drainage	消耗
satyric	性好酒色的
repository	知识库
transit	通过
liable	易……
diagonal	斜
carangoid	参科鱼类
sawfly	锯蝇
elliptically	椭圆形地
turntail	逃跑者
uneducational	不推进教育
upper	上部的
cosmopolitan	世界性
polyandrous	一雌多雄的
chorizon	母质层
molucan	摩鹿加群岛
sporogonium	孢子体
cissy	有娘娘腔的
posy	花朵
pod	结荚
sulfury	硫磺
equus	马属
foundation	地基
facia	招牌
dichromic	重铬
widest	宽
ntfs	System
excusingly	辩辞地
statesmanlike	有政治家之身份
dedicated	献身的
unmerge	使分离
creesh	油脂
funny	奇异
scree	遍地小石的山的斜坡
cancha	牲口圈
metapolitics	空头政治学
conformity	一致
wake	激发
operable	可操作的
galago	狉
bhoodan	年代由
transmissible	可传送
modifier	修饰语
flop	笨拙地抛下
seagoing	适于远航
disazo	双偶氮的
digynian	二雌蕊
regulable	可调整
psalmist	诗篇作者
averment	断言
lordotic	弓背姿势
astronomic	星学的
banquette	驾驶后座
unparliamentary	不根据议会法的
quirk	遁词
whistleable	适合于用口哨吹
deracialize	使消除种族观念
clement	和蔼的
defendant	为自己辩护
hatless	不戴帽子
rabic	狂犬病
noisome	有害的
ovalbumin	卵白蛋白
smartly	刺痛
willowy	有弹性
matzoon	亚美尼亚酸奶
nsf	Foundation
humoral	温性的
dihedral	有两个平面的
teledrama	电视剧
waterworks	自来水厂
spiggoty	=spic
hirer	租借者
unloved	未被爱的
sequacious	盲从的
execution	执行
offal	尾
undissembled	非伪装的
impendent	迫近
brawly	好口角的
dangler	追逐女人的男人
archetypal	原型的
preclear	预先给……核发许可证
reseau	网状物
deflorate	过了开花期的
forbidding	可怕
durum	硬质小麦
foregone	过去
capitalintensive	需投入大量资本以增加生产力的
backstairs	秘密
pigout	过量的一顿
usual	平常的
derepressor	诱导物
scurviness	恶劣
buzz	嗡嗡声
rubelliform	似风疹
tersely	精练
ralline	秧鸡的
amiss	有毛病
truckle	屈从
trailing	被拖动的
borland	美国Borland公司
salty	有盐分的
unstress	非重读
creepage	漏电
catenulate	链状的
fishpond	鱼池
birman	缅甸猫
thankfully	感激
contain	包含
reversionary	继承
saurian	蜥蜴类
jagged	有凹口的
ponderability	有重
laudanum	鸦片酊
storyboard	情节串连图板
autocratic	专制的
nonhistone	非组蛋白的
nllst	National
thir	=these
argute	尖的
pseudoscorpion	拟蝎
wrong	道德不好的
physiognomy	相貌
infuscate	略带褐色
inciting	煽动的
wattage	瓦特数
monopolistic	独占的
exactitude	精密
neophilia	喜欢新奇
disconformity	假整合
ricochet	跳弹
polyhydric	多羟的
cylinder	圆筒
clergy	僧侣
abbreviator	缩写者
hurtless	不会受伤的
carlin	巫婆
mtu	最大传输单元
jingling	发叮当声的
wile	阴谋
vasoactive	影响血管的
alundum	人造刚玉的商标
slime	涂泥
crotcheteer	固守偏执的人
wuzzle	混杂
vesicular	有小泡的
baldness	率直
moffie	脂粉气的男人
oose	灰尘
glioma	神经胶质瘤
vast	巨额的
ingrowing	生进肉内
duplicability	可加倍
harrowing	悲惨
screech	尖着声音讲或喊
exclaim	呼喊
anglian	盎格鲁人
melezitose	松三糖
intransigency	不让步
dart	投掷
exploratory	探测
iowa	爱荷华州
swayless	不倾侧
crescentade	伊斯兰教军
tinkerly	拙劣的
cochromatograph	沧分析法
lull	麻痹
amiantus	石绒
caitiff	胆小
tenesmus	下坠
jag	一部分
fixedly	固定
lame	无说服力的
curragh	沼泽
frgs	Royal
agelong	久远的
deformalize	使非正式
pindaric	Pindar
allelic	等位基因
flocky	毛丛状的
alcaic	古希腊诗人
tackle	滑车
inequilateral	不等侧
monetarily	财政上
dryest	为dry之最高级之一
msie	in
carinate	有龙骨形
skidproof	防滑
megatanker	巨油船
passerine	雀形目的
apterygial	无肢
mouth	口
cumbrous	成负担的
carfax	交叉路口
yielding	柔顺的
dzho	=dzo
noncom	军士
peltate	盾状的
rebukeful	责骂性
shankaracharya	商羯罗查尔雅
migronaut	被迫流落异国者
violinmaker	小提琴制作家
shopsoiled	陈列久了
gallanilide	棓酚
electric	电的
frumpy	心地不良
evaluate	估计
dynastic	王朝的
spiracle	通气孔
proof	校对
lampless	无灯的
roumanian	罗马尼亚的
hurt	伤痛
cognisant	=cognizant
mallard	野鸭
quietive	止痛药
genome	基因组
cannery	罐头工厂
columnist	专栏作家
verdant	没有经验
quebracho	南美产漆树科乔木
hydrofluoric	含氢和氟
telluric	球
stratocracy	军人专政
laetare	大斋期的第四个星期日
omagh	奥马
feculence	渣滓
checkup	鉴定
princedom	王子的领土
founder	浸水
housebroken	经训练
reflow	流回
unpatterned	未成形的
microcosm	微观世界
mat	铺席子
source	水源
prudish	装正经
chemotactic	趋化现象的
caip	Over
heap	堆起
metabiosis	随从生活
iciness	冰冷
genette	=genet
renowned	有名
pathos	哀婉
imbrute	使沦为禽兽
quid	咀嚼物
nubbly	多瘤
encapsidate	使壳体化
evidence	证物
assaultive	好动武的
densify	使稠密
overcunning	过分狡猾
commando	突击队
nombles	=numbles
fls	Fellow
wordmongering	卖弄文字
sundae	圣代冰淇淋
degras	氧化鱼油
uncomely	不清秀
hesper	金星
awheel	骑脚踏车
aborative	煞费苦心
algraphy	老式套色印刷术
axseed	vetch
piteous	哀怨的
levy	征用
forcibly	强制
dribble	滴下
quiescent	静止
fslic	Corporation
irrepleviable	不准具保领回的
whorl	螺旋环
arabian	阿拉伯人
alphosis	皮肤色素缺乏症
carcinosarcoma	癌肉瘤
mucosa	=mucous
mmpi	Minnesota
uncovered	无盖
orthogon	长方形
desperately	拼命地
shit	欺骗
sanguiferous	运血
inceptive	开端的
wicket	小门
exercitorial	船主的
mim	假文静的
forecast	预兆
embody	使具体化
harmonization	融洽
mazurka	玛祖卡舞
manganous	锰
ensate	剑形
utricular	有小囊的
renter	租贷人
berme	城墙与外濠间之狭道
hardhearted	冷酷的
shelly	壳一般的
recremental	废物的
flowmeter	流量计
scaup	小潜鸭
tension	压力
batter	击球手
lawlike	似法律
sentinel	哨兵
midterm	中间
desolation	悲哀
brush	画笔
regional	方
bacteriolytic	溶菌的
glibly	流利
agonistic	论争
transaminase	转氨酶
pendency	悬而未决
digressive	枝节
lodger	寄宿者
sarcophagic	食肉的
impertinent	不相干
charge	费用
bunnia	商人
empyrean	九天
beloid	前窄后宽
enthalpy	焓
blundering	浮躁
undutiful	不顺从
leucocythemia	白血病
schvartze	黑人姑娘
uncorrectably	无法改正
angiomatous	血管肿的
ouster	驱逐
rhotic	辅音前的r全部读出的
heeled	带着钱
exercitorial	包船
overpassed	过去了的
extended	延长
necropolis	古代的埋葬
antoinette	安托瓦内特
vicinity	附近
unaffected	真挚
unprescribed	非限定
dilettantish	浅薄
deputation	代表团
reconfirm	再次确认
bobbly	跳动的
agrochemical	用农产品制得的化学品
half	部分地
closefisted	吝啬
erotical	=erotic
helminthiasis	肠虫病
verruca	疣
gain	财富的获取
piezoresistance	压电电阻
itt	International
eleusinian	市
quaint	做得很精巧
dupe	易受骗的人
subvertical	接近垂直
inversive	反逆的
tragicomedy	又悲又喜的事情
bacteriolytic	杀菌的
democritean	德谟克利特的
pragmatical	独断的
snubbingly	严厉斥责
ferity	野蛮
passe	已过盛年
intolerable	难耐的
castellated	有城的
hydroxyketone	羟基酮
mhw	平均高潮
unpitiful	不仁慈的
striking	打击的
bothnia	波的尼亚湾
inept	无能
triumphant	狂欢的
hieroglyph	图画文字
inbred	内在
nyse	Exchange
trust	希望
milon	麦伦
durham	一种产自该地的有短角肉牛
maladjustive	引起调节不良
moody	忧悒的
freshman	大学一年级学生
binary	二进位的
moat	护城河
trick	窍门
iraki	=Iraqi
gestic	与身体动作有关的的
manifesto	声明
serapis	塞拉皮斯
constabular	警察
pearlwort	漆姑草
ardent	热心的
annulment	废除
tugboatman	拖船船夫
antenuptial	结婚前的
emerge	浮现
invulnerable	不会受伤害的
pettifogging	骗人的
consistent	调和的
paunch	大肚子
learned	有学问
compressive	有压缩力
morbid	病的
unlighted	未被点燃
this	pro
hemolysis	溶血
pander	拉皮条
rational	推理
duplicable	可再发生
thurston	瑟斯顿
renogram	肾X光照片
footy	无足轻重
cyclopedic	百科辞典的
resist	抗
buzzsaw	圆锯
rejectamenta	排泄物海上漂浮物
sessional	法庭的
semidouble	半重瓣
nameless	匿名
astrogator	太空航行者
queenhood	女王身份
aleatory	侥幸
photoscan	光扫描图
smoky	烟熏味
testing	与试验有关
damfool	大傻瓜
repulse	拒绝
scenical	风景
glenurquhart	plaid
tintinnabulary	丁当响
emanant	发散的
tongueless	沉默的
hyphenate	以连字符号连接
frizzy	卷曲的
epicotyledonary	上胚轴
underground	在地下
seven	七个
backswordman	使用单刃刀者
sf	fiction科幻小说
osteocope	骨剧痛
trapshooting	飞靶射击
gastrologist	烹饪学者
semiformal	适于半正式场合的
bilocular	二格的
convenable	可召集
work	工作
hostelry	旅馆
rainbow	五彩缤纷
chut	啧!
everyplace	到处
propitiatory	安抚
tactful	得体的
cylindric	圆筒的
senior	年长
galactosan	半乳糖体
wrestler	摔跤选手
cobaltic	钴
chatelain	领主
adynamic	衰弱的
quince	温柏树
rhodesian	罗得西亚
dubitatively	半信半疑
marseilles	马赛
psychotherapy	精神疗法
colonelship	上校的身份或地位
shopworn	陈腐的
latency	潜伏
concertize	表演
nodose	有节的
interline	写在行间
qualificative	限定的
impartiality	不偏不倚
uncopiable	无法模仿
fixative	定色剂
labber	泼水
thereabout	在那附近
transmitter	转送者
gambado	马的跳跃
mime	Internet
travesty	使滑稽化
groundling	匍匐植物
weatherwise	至于天气
unsyllabic	不构成音节的
grume	凝块
minibike	小型机车
toxicologically	毒物学
pintle	舵栓
neuroplasm	神经浆
halma	哈尔马棋
ringworm	癣菌病
ruminant	反刍动物的
churchwoman	女信徒
barnstorm	到小城镇巡回演出
aggie	农校
nonpositive	负值的
acatalectic	音节数完整的
ideation	思维能力
cestus	腰带
littery	杂乱
grown	成年
offwhite	灰白色的
shareable	可分摊的
difficult	难相处
cardiotoxic	心脏中毒
metacenter	定倾中心
promote	提升
palmated	掌状的
maffick	狂欢庆祝
lingeringly	延迟地
grandiose	宏大
comake	上签字
transonic	接近音速
trusty	可信赖
gppm	Graphics
deep	远离中心的
romanza	叙事短诗
ares	阿瑞斯
hypertext	超文本
fixture	工作夹具
hear	听到
refundment	退还
guide	带领
sankara	商羯罗
unsullied	无污点
directoire	执政内阁
standard	旗
callous	冷淡
shoyu	酱油
umbral	阴暗
induce	劝诱
synch	=sync
luzon	吕宋岛
transferable	可转移
chantable	易唱
incomprehensibility	不可思议
conclude	决定
hast	have的第二人称单数现在式
stick	手杖
fst	Square
homebuilt	自制
skyport	直升机机场
solar	太阳的
edb	dibromide二溴化乙烯
cyclone	暴风
cirsotomy	曲张静脉切除术
bba	administration
unlucky	不幸的；不吉
beginning	开始
patternize	使符合一定型式
aquiline	弯曲的
gruffly	粗声地
agminate	成群的
shinto	1945年前为日本国教
niobium	铌
invisible	看不见
dinette	小餐室的餐桌和椅子
stopcock	管闩
xxix	29
lowlander	低地的人
spheric	球的
belly	胃
catoptric	反射
methoxybenzene	茴香醚
philabeg	=filibeg
rhomboidal	长斜方形的
ophthalmological	眼科
calipee	龟的腹肉
sauroid	蜥鱼亚目的鱼
firn	冰原
gabble	急促地说
hempen	大麻
telepathize	通灵
graininess	木纹状
miscreated	丑
abusive	辱骂
downy	柔和
leptophyllous	叶片狭长的
wholescale	大规模
superinduce	增添
muster	鼓起
glasswort	厚岸草
invective	恶言的
londonization	伦敦化
glowing	炽热的
seclusive	喜隐居的
safflower	红花
yuletime	圣诞季节
undeclined	无字尾变化
vibratiuncle	轻微震动
lenticellate	产皮孔的
muciferous	生黏液的
slow	减缓
transoceanic	在海洋彼岸的
yuan	元
engage	答应
gasdynamics	气体动力学
godet	用以显示褶纹
rising	增加
rantipole	顽童
adriatic	亚得里亚海沿岸居民的
goshen	肥沃的土
gratulation	祝贺
mend	修理部分
espanol	西班牙人
shaky	不安的
doggery	卑劣行为
handstaff	连枷柄
reactivate	恢复活动
meed	赏与
specific	种
imposturous	欺诈
ard	急性呼吸系统疾病
vaporous	蒸气多
revictualment	再供粮食
convincible	可使信服的
sorites	复合三段论
mellowness	芳醇
thresh	反复的打击
nizam	Hyderabad君主的称号
thumbnail	极短的
ghyll	溪流
pentagonese	美国国防部行话
sebe	east
antianxiety	防止精神不安的
established	已制定的
tonetics	声调学
praedial	不动产
alpine	阿尔卑斯山
deputy	代理人
peg	限制
arsenious	含砒素的
laminated	层积
unitar	United
steamy	蒸汽
crispen	使脆
initiatress	女创始者
staphylorrhaphy	腭裂缝术
cant	角落
etep	Trading
scuzzy	阴暗的
avariciously	贪婪
unbelieving	不信宗教
scraping	擦
embrave	激励
augean	Augeas王
concealment	隐蔽
modernistic	现代派的
expansionary	膨胀的
vocative	呼格的
unnumbered	数不清的
swagger	时髦
radiophony	利用辐射能发声的科学
appassionata	热情的
pluriglandular	多腺性
osteopathy	整骨疗法
synodal	会议的
folkloric	民俗
tripping	平稳地进行的
thermodynamic	使用热动力的
carabineer	卡宾枪手
phytogenesis	植物发生论
miseducate	给……错误
simplification	简化
lumpenproletarian	alI`teErIEt/
beakiron	砧
meaningful	意味深长的
rife	普遍的
bitterish	带苦味的
nerc	Research
whoremonger	嫖客
dominant	有统治权
imagery	比喻
intercross	杂交
front	前面
semiology	记号学
unbefriended	无朋友的
goldarn	=goddamn
scraggy	瘦弱的
luxuriant	丰产
natural	正常
tallyshop	赊销小商店
dispersion	离差
greenweed	染色用植物的一种
imitability	可仿制
crabbily	乖戾
arabian	阿拉伯
mortification	禁欲
maror	苦菜
unselected	非精选的
almsman	受救济者
dissentient	不赞成
foremastman	前樯水手
elimination	除去
tankstand	贮水柜架子
tamely	温顺地
scholastic	学究
surd	无道理
berime	以诗讽刺或祝贺
shang	商
broomball	类似曲棍球的球戏
uart	Asynchronous
soldierlike	雄纠纠
choush	官使
heterosexual	异性爱的
waltz	与……跳华尔兹舞
damned	使人憎厌的
synallagmatic	对双方具有约束力的
leukopenia	白血球减少症
beech	山毛榉树或其木材
amerciable	应罚款的
microcosmic	微观宇宙的
fermentor	发酵罐
mudskipper	跳跳鱼
receivability	可接纳
ufology	飞碟学
anytime	无论何时
columned	圆柱状的
reprehensibly	应受斥责地
monovalent	单价
mechanism	机械装置
colossal	庞大
nauseate	厌恶
engage	使忙碌
slip	有活结的
poona	浦那
chew	认真考虑
frequent	时常发生
mace	钉头
cotquean	忙家务活儿的男人
lingo	行话
homilist	说教者
extendable	=extensible
personal	私人的
mild	温和的
scholastic	学校
relatival	关系词的
preconvention	大会前
outlook	展望
anthropology	人类学
aerobe	需氧菌
inappreciative	不正确评价
rewire	再打电报
initial	词首大写字母
cryosorption	低温吸附
sexualize	使有性特征
quadrillion	千之五次方的
unaccustomed	奇怪的
paralegal	律师帮办
laudable	值得赞美
emulator	竞争者
geocentric	以地球为中心
propagandize	宣传
florin	弗罗林
pedology	儿科学
hawk	清嗓
infracostal	位于肋骨下面的
selenosis	硒中毒
glutton	暴食者
hypolydian	副利第亚调的
brownstone	上流社会
plush	长毛绒
monostrophic	单韵律的
tunicate	有被膜
soloistic	独唱的
tenrec	马岛猬
naderite	纳德主义者
octu	Cadets
vesuvian	火山的
moor	固定
ergocalciferol	=calciferol
filling	饼馅
fructosan	聚果糖
regerminate	重新发芽
ichthyologist	鱼类学者
can	装进罐中
repudiate	批判
shilka	石勒喀河
circumforaneous	冒牌
watchfully	警惕
oestrous	诱发发情的
projecting	伸出的
niobic	含铌
revolution	革命
naperville	内珀维尔
danseuse	女芭蕾舞演员
secondhand	间接获得的
aggravating	恼人的
anticlockwise	逆时针
coadjacent	互相连接
unconstrained	不做作的
panleucopenia	猫传染性粒细胞缺乏症
macroptic	视物显大症的
copious	很多
nandin	南天竹
cue	提示
unemployable	不能受雇
preadapted	预适应
admissibility	可容许
clotho	克洛索
force	精力
sustenance	支持
overrule	制服
mathematical	数学
aplastic	成长不全的
anapaest	抑抑扬格
extirpation	根除
goonda	打手
spiculate	由针状物覆盖的
proclaim	宣布
colloid	胶体
possession	领
ineloquent	不雄辩
constringe	使收缩
commanding	发号施令
mime	Extension
deck	装甲板
eldorado	理想中的黄金国
sunglow	日光
hardly	刚刚
variedly	改变
enrollment	入学
melanophore	载黑素细胞
fatten	使充实
latent	隐藏
giddy	眩晕
bialy	比亚利碎洋葱面包卷
homophonic	齐唱的
shandrydan	破旧的马车
basswood	椴木
spinnery	纺纱工厂
saltigrade	跳行型
teaspoonful	一茶匙的量
neutrodyne	中和接收法
greenhouse	花房
taiyuan	太原
jis	Standards
ostracize	排斥
uncensored	未经审查的
heliotropin	向日葵香精
bannister	栏干
dodgasted	被咒
muddily	污浊地
antimilitarism	反军国主义
semitropical	亚热带的
stupa	佛塔
nonfarm	非农业品的
cusp	尖端
hairline	极细的织物
panbroil	油煎
standing	直立
yvonne	伊冯
downplay	不予重视
ineligible	不合格
dmd	Micromirror
eelpout	粘鱼类
teruggite	水合钙镁砷硼酸盐
dovap	多瓦浦
metaxenia	后生异粉性
nonenzyme	非酶的
swabber	笨手笨脚的人
elegant	文雅
interline	插写进去
phantomlike	幽灵似
theban	底比斯
snaky	蛇一般
doglegged	弯曲如狗后腿
cuirassier	胸甲骑兵
pulseless	无生气的
jinrikisha	人力车
tough	吃苦耐劳的
unfearing	不畏惧
hent	目的
atrocious	凶恶的
intrenchingtool	挖壕工具
uncomplex	不复杂的
decontamination	排除污染
uncivilized	未开化的
firebrand	燃烧的木柴
incrust	生外皮
crus	后腿
gladiate	剑状
delivery	交货
learned	学术上的
retire	退休
flabbily	松弛
corresponsive	反应的
potassa	=potash
lacker	漆
brede	刺绣
labourious	费劲
directness	笔直
uncord	拆下……的绳子
backlist	列入重版目录
lobworm	沙蚕
organization	团体
sri	Sacrum
vacationer	度假者
stanch	止流
stoical	坚忍
newsroom	阅览室
reclosable	能重新盖紧的
waldensian	韦而多教派的
clannish	宗族排外
hochheimer	豪客海沫白葡萄酒
respect	考虑
nature	天性
hippocentaur	半人半马的怪物
neurotomy	神经解剖学
displeasing	令人发火的
sinapin	芥子酸胆碱
ultrasonic	超音速的
handedness	用右手或左手的习惯
dependent	依赖
usableness	使用方便
bland	冷漠的
zodiacal	黄道带的
sialidase	唾液酸酶
lunge	套马索
centromere	着丝点
subdual	抑制
downright	率直
miniature	缩小
sandy	沙的
cultivable	可耕种
dissemblance	伪装
mats	Service
rpq	request
ribosome	核糖体
setenant	连在一起面值不同
this	本
unfaltering	专心的
recidivous	经常犯罪的
trifilar	三点
ravel	散开
glaucous	覆有白粉的
color	脸红
gantry	桶架
chromite	亚铬酸盐
lane	狭窄的通道
halidom	圣地
uncorrupt	未堕落
forbearing	忍耐
xix	19
gutter	开沟于
nourishing	有营养
peppy	精神充沛
fissile	易分裂
courier	送快信的人
kidderminster	英国
polytonal	多调的
styli	唱针
fogdrop	雾滴
winterly	冷淡
tensor	张肌
unaccounted	未解释的
bewitching	迷人的
sneeze	喷嚏
unitary	单一
exceptional	异常
helpful	有益
emigratory	移民
ominous	预兆的
inwall	内墙
scrap	打架
rhesis	名句
cretan	克利特岛
tax	税金
angus	安格斯
cycle	循环
argillaceous	似粘土
banausic	物质
fact	实情
strictness	严重
temperateness	适度
niphablepsia	雪盲
unattended	未被注意的
beset	困扰
nullipennate	无飞行羽的
centimetre	厘米
classis	长老监督会
eastabout	向东
uninucleate	单核
persistent	持久稳固
productiveness	赢利性
grabbing	抓
amazing	令人惊异
msls	Library
indiction	古罗马每隔15年一次的财产评价公告
rcvs	皇家外科兽医协会
antiferroelectricity	反铁电现象
carbonicacid	二氧化碳
peachful	爱好和平
coralliferous	含珊瑚
phytogenous	=phytogenetic
rebukeful	充满责备
undistorted	未失真
muciferous	充满黏液
bacchic	醉
knopkierie	=knobkerrie
enscroll	慎重记载
mongoloid	象蒙古人
dna	deoxyribonucleic
ineptly	不适当地
backlash	后冲
saltmouth	大口瓶
salvoconducto	通行证
jackeroo	新手
stricture	责难
wyswyg	所见即所
zhdanov	日丹诺夫(1991年恢复使用旧称马里乌波尔
fuscin	暗褐菌素
slavophil	亲斯拉夫人的
ascomycetous	子囊菌类的
ionogram	电离图
insouciant	漠不关心
valuate	对……作评价
treasure	财产
dissector	解剖者
anthomania	酷爱花的人
alimentative	提供营养的
amiss	出差错
enormous	庞大
dna	分布式网络应用程序体系结构
eleanora	埃莉诺拉
devoid	缺乏的
plumpish	较丰满的
multiscreen	多银幕放映的
mandy	=Mandrax
mycenaean	希腊古代都市迈锡尼的
roundabout	兜圈子的话
migrate	移植
unfermented	没有发过酵的
braaivleis	烤肉野餐会
cissy	柔弱胆小的
monumental	纪念物的
submaster	副校长
bequeath	把……传下去
endite	=indite
enshroud	掩盖
upstream	溯流而上
lucerne	紫花苜蓿
esne	底层社会的人
rhythmizable	使有节奏的
globate	球状的
rejoicing	高兴
aspersion	中伤
salable	适于销售
pet	拥抱
biphenyl	联苯
mendable	可修理
amah	奶妈
ruefully	悲伤地
mint	铸造
regular	正规军
flammable	易燃的
proctorial	代诉人的
sudatory	发汗药
sclerometer	硬度计
disclaimatory	否认
nefandous	邪恶
armoric	阿莫里凯语
surplice	白色法衣
antimonial	含锑
interfinger	互相楔接
pedalo	脚踏船
burglarproof	防盗的
ephraim	以色列民族
clyde	老古板
yuk	引起大笑的趣事
bartend	当酒吧侍者
unwittingly	无意
onionskin	薄的半透明纸
chromophotograph	彩色照片
activation	激活
femora	腿节
heteropterous	半翅
ultimacy	根本性
transamination	转氨作用
mirthless	不快乐
adjure	命令
extended	伸出
snick	刻细痕于
grand	重大
demythologise	=demythologize
face	面容
cachexia	恶病质
quoit	金属环
trigoneutic	一年三抱
genital	生殖器
sphere	圈子
trinket	无关紧要的小事
inexplicable	无法说明
glottalize	把声门化
sara	萨拉族
bottom	到达底部
harlot	人尽可夫之女人
evidentiary	证据
opponency	对立
unsure	没有自信
windblown	被风吹斜的
easterly	向东方的
deactivate	使无效
crevasse	使有裂缝
puling	呜咽的
fastness	要塞
unbury	挖掘
succinct	压缩在小范围内
coalescence	联合
resiniferous	含树脂的
snooker	阻挠
trust	盼望
pedal	踏板
mephistophelean	险恶而狡猾
taper	锥形
demonstrant	示威者
skepsis	=scepsis
disvalue	贬值
thermotensile	热抗张强度的
chemosmotic	化学渗透现象
thorough	十分
yearlong	整整一年
wastrel	废物
paygrade	薪饷等级
cnut	克努特
goody	感伤的
gruntle	使满意
genoese	热那亚的
functionalism	机能主义
gunnybag	黄麻袋
lockfast	锁牢的
metathoracic	后胸
unlock	开启
weather	侵蚀
scandal	诽谤
twinborn	双胞胎的
mulch	覆盖树根
crabbed	易怒的
aspca	美国防止虐待动物协会
cornucopia	哺乳宙斯的羊角
identic	形式相同的
veronal	巴比妥
gab	瞎扯
affect	假装
observantly	敏锐
angst	焦虑
originate	发起
planetesimal	星子的
alfa	A
riot	挥霍
consuetudinary	惯例上的
biocidal	毁灭生命
dm	音乐博士
corequisite	并修课程
egghead	理论家
elevated	提高的
frostbitten	生冻疮
aerosiderolite	陨铁石
abnegate	放弃
notionate	充满幻想
uncivil	不文明的
vial	小瓶
unlovely	不漂亮
meek	谦恭
hydrographic	与水文地理有关
twelvemo	十二开
sacred	神的
aerotropic	向气性的
laggardly	行动缓慢地
crinum	文珠兰属
obligatory	必须
scratch	打草稿用的
bacterization	借细菌作用治疗或改变
gum	齿龈
mipafox	丙胺氟
croquis	草图
floriferous	花盛开的
irrespectively	无关地
archiepiscopate	大主教的职位
rasped	刺耳的
adi	acceptable
intervocalic	出现在两个元音间的元音间的
versatile	多面手的
mandatory	托管的
disinclination	厌恶
chimpanzee	黑猩猩
gastronomical	美食学
serviceability	适用性
orthodox	东正教
superfine	特级的
louver	屋顶窗
vacancy	空白
biennialy	每二年一次地
indusiate	幼虫膜
rounder	卫理公会牧师
exequies	殡仪
vomitus	呕吐
conducively	有助
marriageability	结婚适龄
proscript	被放逐的人
corespondent	共同被告
rheogoniometer	流变测角计
chlorid	漂白粉
aerocade	飞行队
ringing	响亮的
esfahan	=Isfahan
stagger	交错
fanon	臂巾
cutup	诙谐的人
fall	砍倒
pliancy	柔顺
slan	sine
allotmenteer	小块园地经营者
patrilocal	居住在男方的
consequentially	必然
pintle	枢轴
crafty	狡诈
remigial	飞羽
ethos	道义
dowery	=dowry
extractor	抽出器
flammulation	红色斑纹
costless	无须付出代价
enrollment	入会
ultramicrochemistry	超微量化学
apiece	每个
erythrosine	新品酸性红
unceremonious	随便的
stem	滋生
fructify	富有成果
biedermeier	稳健的
washy	浅
astir	骚动
you	pro
intercession	代为求情
miaul	猫的叫声
nonfeeding	不进食
justifier	辩护者
optoacoustic	光声
strait	苦恼的
negrillo	矮小的非洲黑人
pictograph	象形文字
hemodialyzer	人造肾脏
baguio	碧瑶
amps	高级移动电话服务
causerie	漫谈
evidential	可作证据的
cryptical	含义模糊
yaf	Young
trijugate	具三对小叶
gag	打诨
skulker	偷懒的人
wampus	开襟绒线衫
couture	服装设计或其服装店
repristinate	使复原
stump	砍成树桩
enthronement	就任主教的仪式
fine	精美
rhapsodical	狂想曲的
patter	轻快脚步声
senorita	小姐
burse	奖学金
dypass	侧路
hygeian	健康
crested	有冠毛的
avocation	业余爱好
extant	未毁
sophisticate	使变得世故
protogine	绿泥花岗岩
argot	暗语
wired	接有电线的
yeoman	自耕农
unsearched	没有寻找过
sullen	愠怒
astilbe	落新妇属植物
boorish	粗野的
bushtit	丛山雀
sgml	通用标记语言标准
swellish	漂亮的
supinate	仰转
engage	预定
mpm	minute
othin	=Odin
chibouk	土耳其长烟管
strangulation	勒杀
divot	草皮断片
emblazonry	纹章描画法
swabian	斯瓦比亚
countermovement	反向运动
kirschwasser	樱桃酒
phonology	语音体系
agminate	聚集
phytoflagellate	鞭毛藻
intendance	管理
superserviceable	极肯帮忙的
cephalopodous	头足类
videodisc	录像盘
graftabl'	NULL)
harshly	严厉地
jobbernowl	愚蠢的
strabismic	斜视
multimer	多聚体
diomedes	狄俄墨得斯
conspirator	反叛者
bill	法案
dionysos	狄厄尼索斯
giddy	眼花缭乱
integraph	积分器
ratissage	"回扒"
revelation	新发现
centricity	中心性
laywoman	layman
campanological	鸣钟术的
shad	美洲西鲱
mythological	神话学的
avirulent	无毒力的
bussbar	bar
ciscaucasian	内高加索
mongolian	先头愚型症的
cercopithecoid	猕猴科
acidly	不悦
unary	一元的
wmo	世界气象组织
supersedeas	停止控告的令状
festa	祝宴会
electrophotometer	光电计
osteological	骨学上的
abuttal	毗连
derivable	可引出的
milligrame	千分之一公分
gracilis	股薄肌
semiabstract	半抽象
doloroso	感伤
gleeful	愉快的
contraceptive	避孕品
client	客户
laciniate	有细长裂片
pigmentize	染色于
coronavirus	日冕形病毒
monobus	单总线
gestate	孕育
mosaicist	镶嵌细工师
vagina	叶鞘
psychologise	=psychologize
cureless	无法医治的
wider	宽
patchouli	广藿香油
atopic	遗传性过敏症的
manana	不久以后
absorbency	吸光率
laurentian	劳伦系
unvitiated	未被污染
antiarrhythmic	抗心律失常
tipsily	喝酒地
undersanded	含沙过少
corporeity	身体
running	运转
decolorant	漂白
adipose	脂肪
recumbently	靠着
wardership	看守人
stogie	笨重的长靴
cognovit	认债书
feudalize	使封建化
lawless	违法
vanishingly	消遁似
halogenoid	类卤基
pitchy	漆黑的
disinfest	驱除害虫和有害动物
vacationist	休假者
psychoneurotic	神经病的
cinematographic	电影
fastening	结扎工
hopelessly	绝望地
result	计算结果
reproacher	责备者
muskwood	麝香树
libidinous	淫荡
abortion	失败
pardonably	可宽恕地
cautiously	慎重地
angiotensin	血管紧缩素
disaccordit	撤销……的委派
backfall	将对方压制倒地背着垫子以取胜的手法
oink	呼噜声
residue	滤渣
crumby	柔软的
atavistic	隔代遗传
stampede	惊跑
lemma	论点
southpaw	左撇子
aeruginous	绿青色
posterior	较晚的
pentatonic	五音的
kinetoscope	活动电影放映机
unmerited	不当
mabe	Master
emulsin	杏仁酪
regroup	重组
responsible	可靠
swimming	游泳用的
cacophony	不协和音
prussian	普鲁士
en	字
boutique	专卖流行衣服的小商店
microsystem	微系统
epexegesis	补说
retrovert	向后弯曲
monistical	一元论的
nlrb	Relations
pummelo	=pomelo
gunmaker	枪炮制造商
exploder	爆炸装置
nutty	产坚果的
winchman	绞车手
arbour	藤架
slack	松弛
synoptically	概括性
sericate	丝
crackajack	杰出
feelinglessly	无知觉
permissive	许可的
bathtub	澡盆
recommendatory	劝告
madre	母亲
fondly	天真
geodynamic	球动力学
scrumptious	绝妙的
riverbank	河岸
sleight	诡计
reloader	自动输煤机
postpositive	后置的
sempiternity	永恒
ululate	悲泣
brimstony	似硫黄的
neutral	中性的
implantation	培植
magistrature	=magistracy
arouse	睡醒
fx	foreign
altimetry	高度测量法
vop	valued
wvf	Federation
refill	再装满
forehanded	得时机的
verdant	青翠
immobility	牢固
spread	散布
futilitarian	万事皆空论
iaru	Radio
primrose	樱草色的
aedicula	小型建筑物
worshipful	尊贵的
impish	顽童似
lankly	瘦地
temporary	临时性
unapprehended	未被理解的
unmediated	无中介的
ea	Electronics
tyrannic	暴虐
blubber	又哭又闹
odourless	无嗅的
anesthetize	麻痹
spunbonded	纺
hibernant	冬眠
commotion	暴乱
interdigitate	相间错杂
antipodes	澳大利亚和新西兰
clear	光亮的
lisping	咬舌
acquisitive	想获
scrag	瘦脊的人或动物
featured	作为号召物的
pantalettes	长裤
caseate	发生干酪样变
ruthenious	二价钌的
calligraphic	缮写的
nationwide	全国性的
journalistic	新闻事业
undemanding	要求不高的
leglen	牛奶桶
null	空
horseless	不用马的
cavalla	竹荚鱼科之鱼
alexis	亚历克西斯
unostentatious	/
infest	大批滋生
montage	蒙太奇
hominine	类人的
airproof	使不透气
ingratitude	忘恩
egged	被挑唆
whizz	子弹等在空中掠过的声音
preconquest	被征服以前
incendiarism	放火
chronoscope	极微时间测定器
trachea	螺旋纹管
esb	stimulation
fan	飘动
kirschsteinite	钙铁橄榄石
alkalimetry	碱量滴定法
facility	工具
kurbash	用皮鞭打
definable	可定义
isotach	等风速线
hazy	朦胧的
impregnate	怀孕
christianly	如基督徒的
fucoxanthin	墨角藻黄素
florilegium	作品集锦
fretful	起波纹的
setem	豹皮衣司祭
forced	强迫
yarmalke	=yarmulke
inducement	诱导
localism	地方观念
colon	冒号
banket	含金砾岩层
julienne	切成丝
piffle	废话
pinocytotic	胞饮的
oddfish	古怪的人
chuvash	楚瓦什人
experience	体验
masticatory	咀嚼用
sanely	心智健全地
befitting	合适的
leafed	有叶子
visuomotor	视觉眼肌运动的
alcoholism	酒精中毒
geophone	地音探听器
compulsorily	强制
corruption	腐败
wealthy	有钱人
distortive	曲解的
verus	正确的
derivatively	衍生
alchemistically	炼金术士地
chancellery	大臣
cisalpine	阿尔卑斯山这一边
pbx	专用分组交换机
indolent	懒惰的
diplogen	重氢
xql	Language
controversial	争论
fractional	分馏
carpetbagger	美国内战后利用南方不定局势谋利的人
histochemistry	组织化学
dryness	干
trivalent	三价
apocryphal	伪经的
undiscerning	无辨别力
interspace	留……的间隔
ovular	卵子
loose	松散
easytran	翻译用电子计算机
acidfast	耐酸的
jug	炖
fatheaded	愚钝的
harmonically	和声
meek	谦恭的
aja	ancestry
if	设想
prosper	使成功
jug	模仿夜莺叫
baric	钡的
msha	in
catalo	家牛与美洲野牛的杂交牛
ideologize	以意识形态解释
maladaptive	显示不适应
mercuric	水银
massless	无质量
overrun	泛滥
vouch	保证
mowing	一次收割量
tgv	Train
pgup	翻上页
beatle	小妞
derriere	臀部
amatively	恋爱地
pouch	烟草袋
unembellished	未装饰的
peckish	唠叨
eoka	埃奥卡(希腊语"
unlikely	不太可能的
redheaded	红头的
technicolored	五光十色
erumpent	裂出
cookshop	小菜馆
kuwaiti	科威特
outcrossing	异型杂交
iatric	医疗
cytochalasin	细胞分裂抑素
plateau	高
hippogriff	鹰头马身有翅怪兽
farthest	最大限度
lilliputian	侏儒
merohedrism	缺面对称
flighty	忽发奇想的
superabound	过剩
despoil	夺取
lifelike	逼真
gandhiism	不使用暴力的抵抗主义
pvc	永久虚电路
tautologize	重复使用同义字
nuque	项
sunkist	受阳光照射
wrb	Refugee
apophyge	柱身之凹
hypersonic	远超过音速
erode	逐渐消蚀掉
alkyl	烷基
trephination	环锯术
abysmal	深不可测
cetologist	鲸类学者
cycling	骑脚踏车消遣
junky	质量低劣
multifont	多字体
poke	袋子
mildly	适度
fiat	法令
brahma	宇宙最高的永恒的实体或精神
unlikely	不太可能
perfunctory	马马虎虎的
urinal	小便池
pyretic	热病的
globate	球状
blinking	闪光的
borax	硼砂
fast	绝食
conspectus	大纲
invective	非难的
eventless	平静无事的
eudipleural	左右对称
eversible	可翻转的
chargeable	可记在某项帐目上的
milemeter	里程计
stoep	门廊
pronghorn	叉角羚
mirable	令人惊叹
greenroom	演员休息室
longipennate	长羽的
laurentian	劳伦系岩石层
figurehead	破浪神
subversive	颠覆性
foreship	船的前部
fimbriate	有毛缘
scot	税赋
otherwise	其他方面的
swink	劳动
sonofabitch	of
ouagadougou	瓦加杜古
cyclonoscope	飓风中心测定仪
crimmer	克里亚卷毛羔皮
canthus	眼睛的两端
uncomforting	令人不舒服
reliquary	遗物箱
flowing	流畅
beefy	健壮
sick	有病的
harmoniously	调和地
slot	硬币投币口
cherubic	可爱的
condyle	骨节
chiricahua	奇里卡华人
touchingly	难以取悦
goofy	愚笨的
glibly	流利地
usability	可用性
digitation	指状突起
intestinal	侵袭肠
disparaging	蔑视
blowzy	红脸
archangelic	大天使的
brownstone	富有阶级
hemistich	不完全诗行
maribor	马里博尔
sawhorse	锯木架
unpledged	未许诺
unselfish	无欲的
shrub	灌木丛
schizophreniform	分裂样
subsection	小部分
anticlerical	反圣职者
empiric	经验主义者
audiometric	测听术的
jar	发刺耳声
superhigh	超高的
rambunctiously	粗暴地
urceolate	壶状
schottische	慢步
apostate	背教
sphere	范围
squawk	发出叫声
pilaster	半露柱
rush	冲进
hear	听说
gymkhana	竞技场
canvass	细究
counterproductive	反生产的
seizor	扣押者
incoming	引入
fideicommissary	遗嘱中将部分财产赠予第三者
iberian	伊比利亚的
implant	灌输
inelegance	粗俗
photoinduced	光感应
endlessly	无穷尽
ethnical	人种的
revolt	厌恶
symptomatology	征候学
brassy	厚脸皮的
shipboard	船
understrength	力量不足的
putrescible	会腐烂的物质
honeysuckle	金银花
catnap	小憩
smart	精确的
uses	United
loneness	孤寂
subcenter	次要中心
acred	拥有许多地产
ninety	九十
glandiferous	结坚果
gangliform	神经节状的
festally	愉快地
mucopurulent	黏脓性
humongous	其大无比的
hypnopaedic	睡眠教学法
kinematically	运动学上
afterdinner	正餐后
geriatric	老人
confound	把……搞混
adumbral	遮阳
dimension	维
direct	由西向东运行
nanoid	侏儒样的
polyspermy	多精入卵
rhythmical	合拍的
baccate	结浆果的
gym	体育馆
hemocytoblastic	原始血细胞
intermontane	亦作intermont或intermountain
fasciated	扁化
hydrotropically	向湿性
preproduction	试制的
available	有用
saphena	隐静脉
footway	人行道
furnisher	家具商
butterfly	蝶泳
misunderstanding	误解
mettlesome	精神饱满
above	上述
daze	使晕眩
holozoic	以摄取有机物为食的
closely	接近
dexterous	惯用右手
gipsydom	流浪生涯
smattering	略知
tap	选择
unhired	未雇用的
receipt	收到
patroness	女主顾
strophe	古希腊歌队唱的歌
threesome	三人一组
outright	直率
incongruity	不适宜的
redeemable	可收回的
isa	工业标准结构
pontifical	大祭司的
yelp	狗吠
sentence	宜判
colluvial	塌积的
flannelled	穿法兰绒衣服的
operatic	歌剧的
colloidal	胶质的
fastish	相当快速
ladder	阶梯
oxalidaceous	酢浆草科
helmet	钢盔
fidge	寝食难安者
thrive	兴旺
approvingly	赞许地
emprise	冒险
spode	斯波德式的
rearward	后面
tale	坏话
kloof	峡谷
melting	融化的
juma	伊斯兰教的安息日
veil	遮蔽物
archly	狡猾地
ipm	英寸[分
sacerdotal	祭司制度
camphoric	搀有樟脑
acceptance	接受
commonweal	公益
jazz	奏爵士乐
paillard	一块牛肉
overstability	极大的稳定性
numerary	数目的
rotc	Officers''
correct	改正
scenic	景色优美
poisoner	毒害者
pericardial	围心
hairsplitter	拘泥于琐事的人
gentleness	亲切
constant	坚决的
antianxity	抗焦虑
fifine	菲芬
fortepiano	钢琴
archaeological	考古学上
acquisitive	有获得可能性的
liberalistic	自由主义的
repent	后悔
duplicated	复制出
molina	即Tirso
pavement	人行道
alumnus	男校友
hetaera	名妓
preteen	青春期前的孩子
brawly	喧嚷
exquisitely	敏锐
harper	弹竖琴者
sponge	海绵
plantaginaceous	车前科的
serfage	农奴地位
shuddering	发抖的
chaussure	靴
perfect	理想
smart	懊恼
capacious	广阔
revolted	厌恶的
nbs	Standards
thermae	温泉
image	象征
undergone	undergo的过去分词
tawse	鞭打
unmeasurable	无限的
optically	视力地
natasha	娜塔莎
minsk	明斯克
sled	用摘棉机摘
eldest	年事最高
spermous	精液的
disputation	争论
tafferel	船尾上部
undecipherable	=indecipherable
girosol	=girasol
barbaric	粗野的
quaint	离奇有趣的
filiform	丝状
groundage	停泊费
underabundant	不够丰富
regionalist	地方主义作家
helper	助手
site	场所
remove	移动
longe	用练马绳训练马的各种步态
rockbound	顽固
dysteleology	无目的论
gyrovague	游方僧人
smack	带有……风味
nonpathogenic	不致病
gorgy	多峡谷的
usib	Intelligence
greco	El格列柯
alibi	辩解
syssarcosis	肌性骨联接
chekiang	浙江
numeration	读数法
judicially	公平地
rhizophilous	寄生于根上的
felonious	恶毒
rustically	乡土气地
perform	表演
plebby	普通的
subcapsular	囊下的
firedrake	火龙
quandary	窘境
neuridine	精液素
baor	the
plait	辫子
plated	镀金的
ruggedness	险峻
forkful	一叉的量
saxicolous	岩栖
fullmouthed	大声的
draughtboard	西洋棋盘
home	本国
waterhead	水源
lionhearted	勇猛
sheep	羊
seminude	半裸的
dullish	稍钝的
philosophical	哲学
impervious	不受影响的
ribonucleoprotein	核蛋白
rake	用耙子耙
pakistani	巴基斯坦的
bashful	害羞
umbellar	伞状花
visitatorial	有权检查
tumefacient	使肿胀
bebeerine	比比林
bimestrial	持续两个月
climacteric	转变期
darkminded	阴险
anectine	琥珀酰胆碱
eidetically	仍在眼前的
sacerdotal	祭司的
chimerism	嵌合现象
vision	视力
equivocal	模棱两可的
rosily	带玫瑰色
facilitate	使容易
throughother	混乱
pelagic	远洋
dasher	气宇轩昂的男子
holon	子整体
philtre	刺激
aloof	冷淡的
gript	grip的过去式及过去分词
bemusement	发呆
subsumption	包含
polynia	冰穴
shealing	=shieling
patter	喋喋快语
dab	比目鱼
alep	=Aleppo
boatage	小船运费
styliform	末端尖而细长
mmm	Mode
skice	匆匆而行
romanian	罗马尼亚的
sound	彻底
afdc	Aid
cavalvy	骑兵队
unflawed	无缺点的
precinct	选区
theopathetic	神意感应
depart	逝世
trenchplough	深耕犁
spoonbeak	琵嘴鸭
fixture	预定日期
preman	史前人
ruritania	鲁里坦尼亚王国
decrypt	译
pantological	百科全论
rathripe	=ratheripe
inveterate	成癖
wolfess	性行为如狼似虎的女人
fortress	堡垒
erring	错误
arraignment	责难
brim	注满
lever	杆
inkling	略知
saving	除……之外
loosely	宽松
manifestly	明白
devastatingly	破坏性地
disorder	混乱
frutex	灌木
quadrivial	四路交叉的
phlebology	静脉学
correctional	修正的
declutch	放空档
plough	费力穿过
unscrew	旋松
pruina	粉霜
corncob	玉米的穗轴
feature	特写
contemplative	冥想
vascar	Speed
duopoly	两家卖主垄断市场
crimp	卷曲
mnemosyne	摩涅莫辛涅
flavourless	无趣味
character	使具有特征
cybernetic	控制论
catecholaminergic	含有儿茶酚胺
hypochromia	血红蛋白过少
incohesive	无凝聚力
subliterate	略具阅读写作能力的
overpraise	过奖
resolve	溶解
moil	辛苦的工作
direct	命令
hungered	饥饿的
fetter	加脚镣
anergy	无力
spool	缠绕在线轴上
deviltry	恶行
liquor	浸水
sectionalism	地方主义
rhizanthous	从宿主根上开花的
archaize	仿古
buccaneerish	海盗似
tearproof	撕不破的
phratry	氏族
resplendent	灿烂的
radialized	辐射状的
lacunar	花格平顶的凹板
loot	抢劫
guerdon	报酬
neglect	疏忽
suiyuan	绥远
disrespectful	失礼
callus	老茧
battlesome	好斗的
liker	喜欢的人
ceroplastic	蜡塑
armigerous	有佩带徽章资格的
polarogram	极谱图
nokia	诺基亚公司
sensually	好色地
rattler	喋喋不休者
retrainee	接受再训练者
asonia	音盲
garbage	废物
flavourless	无味的
conversant	有交情的
inconsolable	无法安慰的
choose	选定
sayst	=sayest
embezzle	盗用
alcahest	万能溶剂
souse	盐汁
parajournalism	异常新闻
denominational	dI9nCmI`neIFize/dI9nCmI`neIF)l/
synod	宗教会议
expressionist	表现主义的
pmla	America
botany	植物学
delenda	被删去之部份
stagnation	停滞
blastosphere	囊胚
quibbler	吹毛求疵的人
beefburger	煎牛肉饼
reinsure	分保
synchronously	同步
tonometer	张力计
retribalize	使复归部落状态
trimming	清理焊缝
picrotoxin	苦味毒
saddlebill	凹嘴鹳
overfraught	超载
singly	个别地
clew	线团
joggle	轻摇
bidentate	有二齿
adversarial	敌手的
maximal	最大的
oceanological	海洋学的
recelebrate	再庆祝
sillimanite	硅线石
fasten	扣紧
antiarrhythmic	抗心律不齐
sequestered	扣押
universal	全体
piccalilli	辣腌菜
prolifically	丰富地
exemplary	警戒性的
warship	军舰
epinasty	偏上性
sheerhulk	人字起重架船
choke	阻气门
phonetic	语音学
hologynic	限雌遗传的
buonaparte	family
semeiology	症状学
horticultural	园艺的
floorboarding	将汽车油门踏到底
consentience	一致
isopterous	等翅目的
rubigo	过氧化铁
mechanistic	机械论学说的
scandent	攀缘
obscurity	隐匿
evocative	唤起的
systemless	无秩序
resigned	顺从
recultivate	再耕种
nephritic	肾脏
nonobjectivity	缺乏客观
myself	我本人
vibrissa	羽须
linked	连接的
gently	逐渐
queue	队列
converge	会聚
misesteem	不尊重
against	靠着
rebukeful	责骂性的
foreverness	永远
romany	吉普赛人之风俗习惯的
persona	人
deceased	死者
yankeefy	使美国化
taphonomy	埋葬学
unendowed	不具有
serbian	塞尔维亚人
disemplane	下飞机
ilk	相同
clausal	条款
with	有
copartner	合伙人
subtetanic	轻度抽搐
brace	奋起
angry	愤怒
baloney	胡扯
social	群居的
headlong	头向前
squalor	悲惨
revulsive	诱导
carbonation	碳酸化作用
hypoglycemic	血糖过低的
microcalorie	百万分之一卡
tantalization	使干着急
corroborator	确证者
aqueduct	导水管
mossiness	生苔
ironsmith	铁匠
scoutcraft	侦察活动
twaddle	讲废话
rann	Needs
lasher	鞭打者
obstetrician	产科医师
overdrifted	被吹积物覆盖
recremental	渣滓的
enterologic	肠病学
german	德国的
antennate	具触角的
leavisian	利维斯式的
sanguine	血红色的
optacon	奥普特康盲人电子阅读仪
finish	用完
come	来临
desiccator	干燥器
premium	保险费
yew	紫杉木
semitic	闪族
haemic	血性
grub	挖
quick	迅速
proofless	无证据的
edacity	贪吃
nonpolitical	非政治性
coiner	创造者
hohhot	呼和浩特
bayou	支流
ruddleman	红土商
de	Germany
fearful	吓人
msgm	of
conchiolin	贝壳硬朊
oaec	Organization
asme	of
pimping	微不足道
ironmongery	铁器店
expound	详细说明
hydrology	水文学
unconscious	未发觉的
cruel	悲惨的
literarycritical	文学批评
conqueringly	意洋洋
indissolubility	永续性
icosahedron	二十面体
substantialist	实体论者
charitably	慈善地
incaution	粗心大意
calculate	打算
galop	跳该舞
punctulate	有凹陷的
bristletail	蠹虫
unpitying	无同情心
connubially	婚姻上
intussuscept	吸收
ardent	热情洋溢的
subordinacy	下级地位
vugular	含晶簇
pice	印度铜币
lovable	惹人爱
ellipse	椭圆形
isohyet	等雨量线
timepleaser	=timeserver
judaeophil	善待犹太人
awake	醒的
outmarch	比……前进更快
electroplating	电镀术
transfiguration	变容
charm	使陶醉
confabulation	交谈
isoagglutinin	同族凝集素
tcp	传输控制协议
flush	萌芽
stoplight	红色尾灯
infuscate	被弄糊涂的
armourbearer	替骑士拿盔甲者
hyacinthine	风信子色
galvanization	通流电
halation	白色模糊影像
screed	刮板
diffusedly	散布地
jittery	抖动着
oo	面向对象
rafferty	完全不讲章法的
sloughy	脱落
agedly	老态龙钟地
astriction	便秘
anastomose	汇合
ductile	柔软
ebb	衰落
sapless	枯萎的
apocalyptic	天启
febrifuge	解热
magenta	红紫色
coloratura	花腔音地
plumate	似羽毛的
disconsolate	孤独
railery	玩笑
forget	忽略
fractional	小数
newsman	新闻记者
reeded	有凹槽的
blah	废话
salted	盐腌
cybernate	使电脑化
waxy	象蜡的
outward	外表的
characterless	不出众的
vigilantly	警觉
haemostatic	能够止血的
pesticidal	杀虫
telefoto	=telephoto
insectile	似昆虫
obligingly	亲切地
cavern	深处
orderless	不整齐
apostate	变节
frostwork	霜花纹装饰
canonic	轮唱的
make	进行
dissolutely	放荡地
standard	第一流的
pushing	急切的
upstate	北部
mockery	嘲笑
vrille	螺旋
extraordinaire	异常
negotiate	通过
cowled	带头巾的
calcareously	石灰地
inhomogenous	异成分的
inkyo	引退
tartary	鞑靼地方
subcuticular	表皮下
percentage	百分数
nedda	内达
nontelevised	电视上不播放的
portal	入口
title	加标题于
stress	重读
brandreth	铁三脚架
insomnia	失眠
nosewarmer	短烟斗
exchequer	财政部
radc	Corps皇家陆军牙医队
clincher	敲弯钉头的工具
epileptogenic	由癫痫引起的
conclude	终止
storefront	店头
delegable	可委托
natch	当然地
yoicks	唷克斯
rhinovirus	鼻病毒
dazzle	耀眼
unsoiled	未被破环
superfluid	超流体的
amphimictic	两性融合的
posteriorly	后来
scud	碎雨云
rentalsman	租金监督官
appreciate	涨价
stupe	温布
victorious	获胜的
slipcover	沙发套
hedgepig	刺猬弹
ahum	低唱的
promptive	推动的
tyro	新手
cardiotoxic	心脏中毒的
coprophobia	排粪恐怖
packthread	包裹绳
epidotized	形成绿帘石
avail	效用
throwaway	广告传单
dinch	掐灭
hostile	敌对的
duckstone	水漂石
freezing	严寒的
draught	拉
limnetic	淡水
feldspathoid	似长石
weltanschauung	世界观
feldspathic	由长石构成的
tim	瞬态失真
melancholic	忧郁的
bandit	强盗
intron	基因内区
allonymous	笔名的
salmonella	沙门氏菌
cloy	使厌腻
untwist	拆开
pneumatic	有气胎
baffle	阻碍
everything	每件事物
vegetal	动植物共通
dewdrop	露滴
mantic	预言的
caudiform	尾状
sympathizer	同感者
proprioceptor	固有感受器
qei	erat
citizenship	公民的职责和权力
pongee	茧绸的
corporative	法人的
exclusive	高级
forgivingly	慈悲
spastic	痉挛
ussr	苏联
rhq	团部
insufflation	注气法
epicurean	享乐主义
sinaitic	西奈半岛
liquefacient	液化
serious	严重
ketogenic	生酮的
snide	骗子
warner	华纳兄弟娱乐公司
caliga	士兵所穿的战靴
execution	破坏效果
miraculous	不可思议
wavelike	波浪般
communalistic	方自治主义
patulin	棒曲霉素
unsightly	不悦目
graduation	毕业
whole	整体
avventurina	缘其稀少难觅
ramp	使有斜面
dance	舞蹈艺术
spiel	演奏音乐
operation	军事行动
chief	主任
lowriding	驾驶低底盘汽车兜风
loaner	代替品
event	竞赛
rudely	粗暴地
bacciform	浆果状
hellespont	=Dardanelles
pmkd	postmarked
telemicroscope	望远显微镜
flatwork	毛巾等物
chrysalis	蛹
southdown	无角短毛羊肉
binocle	双眼望远镜
appetite	胃口
unmeditated	未预谋的
gusset	衣袖
ossian	奥西恩
hoot	轰赶
peopleless	无人居住
lie	说谎
explode	破除
consociation	联盟
drowsiness	睡意
rascallion	恶棍
newspaperwoman	女记者等
dantesque	庄重的
seric	中国
architectural	建筑学
scape	柄节
extended	广大
nowise	毫不
burghley	lst
par	票面的
metaphorical	比喻性
diverting	有趣
sulfatize	=sulphatise
corsage	女服的胸部或腰部
ethnomusicological	人种ist//
semilunar	半月形的
repp	一种条花织品
unfathomable	无底
linguaphone	其商标名
sociocentrism	社会中心论
breechloading	后膛装弹的
fluidity	流度
specialization	特化作用
sprig	图钉
troffer	凹形反光槽
bp	Pager
voluntary	志愿的
suramin	苏拉灭
ruminatively	沉思默想地
inventory	存货
radiate	发光
benzophenone	苯甲酮
chainless	无束缚的
exultancy	狂喜
sizer	大小分拣器
cyprian	淫荡的
consilience	符合
glaucomatous	绿内障的
unloose	放松
fmi	Mon
unreserved	不隐瞒的
dogmatical	武断的
basketry	篓编织品
pekoe	白毫
bushido	日本之武士道
lewis	吊楔
shaggymane	毛头卑伞
resplendently	耀眼地
galumph	意气扬扬地走
mannered	矫饰的
repellent	排斥的
fancied	虚构的
unpredictable	不可预知
spritsail	斜杠帆
feel	感觉
trichopteran	毛翅目
distinction	特性
tropeolin	=tropaeolin
extragovernmental	政府管辖之外的
rollout	首次展示
walloping	殴打
import	含……的意思
attachable	可逮捕的
somnambulary	梦游者
thug	凶手
containerize	用集装箱装
filamentous	如丝的
kiowa	基奥瓦人
wedel	作双板平行摆动转弯滑
stabilizer	安定装置
demon	魔鬼
abidingly	永久
days	在白天
comparison	比喻
ascensive	进步的
subterhuman	亚于人类
conciliative	安慰的
saloniki	=Salonika
generalist	通才
disneyland	迪斯尼乐园
nupe	of
himyaritic	希米亚里特人的
chance	冒……的险
unsccur	Nations
hostility	不友善
mercury	水银
bathymetric	深测术
furious	狂怒的
racially	人种上
artificial	人造的
underseas	海底地
ductule	小管道
ferry	渡运
antiserum	抗血清
evenings	在晚上
salable	适于销售的
tinnily	含锡
denaturalization	变性
thanatophoric	导致死亡的侏儒症的
serpentinous	蛇纹石
haematozoon	血内寄生虫
pose	姿势
aquiver	兴奋的
imbolden	使……壮胆
aicpa	Accountants美国会计师协会
variably	易变
sextupole	六极的
significant	重要的
circumpolar	拱极
hiver	养蜂人
astriction	束缚
unhasty	不匆忙
sunbreaker	遮阳板
disannul	使无效
cristate	有冠毛
poor	乏味的
ajiva	与生命动力相反的物质
discourteous	无礼貌的
legitimatize	使合法化
apyrexia	发热间歇期
farci	有馅
multiparty	包含多党党员
hammerblow	锤打
recruit	新会员
wizened	消瘦
osmotic	渗透性的
billionth	十亿分之一
hoydenish	淘气
headsquare	=headscarf
petrologist	岩石学家
cribber	剽窃者
dotty	精神不定的
restiform	索状
acidity	酸度
tailing	残渣
inexcitable	难以激动
mens	精神
isohume	等水分线
mediaevalist	=medievalist
consort	使配对
publishable	可出版的
lanceted	矛尖状装饰
doughty	勇敢
brilliantly	辉煌地
axilla	腋窝
perjured	伪证
avaricious	贪婪
atmologist	水蒸气学者
synod	会议
gracie	格雷西
photoflood	使用照相泛光灯的
marla	玛勒
resupinate	向上翻转的
citic	中国国际信托投资公司
vinca	长春花
grieve	伤心
counterblow	反击
reloan	再贷款
anginal	咽炎
tideway	感潮段
jazzily	奔放
quick	生物
lotic	激流
burman	缅甸人
bespangled	以发光之金属片装饰的
rumpus	吵闹
paramedic	伞兵军医
waylay	埋伏
flintily	冷酷
biggish	颇大
pantheism	泛神论
ocean	大海
americanist	亲美派
proboscidate	有长鼻
rummy	甜酒的
prelimit	事先限定
founder	失败
dpn	nucleotide
uncorrectable	无法改正
conflagration	大火
qp	后前兵
insurgently	造反地
seton	泄液线
merger	归并
styptical	收敛
quassia	由苦木科植物采取的苦味液
extension	客观现实
heteropterous	半翅的
amused	好玩的
livid	青紫色
turning	转弯处
zincic	锌
unrifled	滑膛
elusive	难懂的
cubic	立方体的
internuncial	联络
inhomogenous	多相的
renascent	复兴的
eruptive	喷火
astringently	压缩地
antechapel	教堂的门厅
efate	埃法特岛
linguaphone	灵格风
septuagenarian	七十岁
shoppe	商店
grivet	黑长尾猴
isa	Standard
substance	物
flunky	小人
cancerate	使成为癌
compromise	折衷
ribbed	有棱纹的
overfulfilment	超越预定计划
flushing	使人脸红
opisthenar	手背
inconvenient	有困难的
recruit	新兵
zygoid	合子的
inveracious	虚假的
samel	半烧的
crankily	摇晃不定
enflurane	安氟醚
kolkhoz	苏联的集体农庄
downcast	气馁的
coloury	色泽良好的
fictitious	假装的
pedestrian	通俗的
outroar	吼叫得比……响
home	国内的
grungy	蹩脚
instrumentarium	特组器械
hypothenar	小鱼际
vancouver	范库弗峰
emperor	皇帝
sjaa	Association圣约翰救护协会
ruthful	悲哀的
endogeny	内源
abuttal	邻接
nitrosylsulphuric	亚硝基硫酸
backstairs	诡秘
unapparent	模糊
lurcher	小偷
morphologic	形态学
tawny	茶色的
gerontophobia	恐老
ctol	常规起落飞机
toilworn	工作疲劳的
swift	大滚筒
heterocharge	异号电荷
styron	肉桂塑料
forehanded	时机
cinnamene	苯乙烯
croquet	槌球戏
puffball	马勃
alborg	奥尔堡
headachy	头痛的
cardioid	具有心脏形状
slinkskin	早产仔畜皮革
caprifig	野生无花果的一种
telltale	搬弄是非者
olympian	庄严的
obstetrical	产科
begad	天哪
igneous	火
cryoscopy	冰点测定学
acknowledge	报偿
raa	of
pentecost	圣灵降临节
drumstick	鼓槌形物体
preteen	接近青春期
unroyal	非国王
exhortative	劝勉的
interlingua	中间语言
uraemic	尿毒症
reversion	返祖
entomological	昆虫学的
criminality	犯罪行为
batt	棉絮
unintelligible	难解的
rider	骑马的人
derivatively	衍生地
decohere	散屑
bat	Armor
dimethylmethane	二甲基甲烷
biangular	双角的
acgb	Britain
sensitive	灵敏的
neoclassicism	新古典主义
tearless	无泪的
grill	烧
raptor	肉食鸟
tif	Tagged
systyle	两径间排柱式
churchism	墨守教会仪式
endocytose	内吞
manipulation	被操纵
esol	Languages
glandulous	有腺
gambade	马的跳跃
melodeon	手风琴之一种
pentastyle	五柱式建筑
seducer	诱惑者
fissirostral	宽而深裂的
iad	Decade
carefully	谨慎
equilibrator	平衡装置
synostosis	骨结合
draftable	可征召入伍的
seminary	发源地
diesohol	柴油乙醇混合燃料
ble	火车司机兄弟会
filo	=phyllo
cryptorchidism	隐睾病
typification	典型化
entropion	睑内翻
sound	充分
whop	打击声
gam	社交
account	总计有
antipathetic	格格不入
azonic	非地方性
complication	复杂化
swingeing	激烈
beach	海滩
vernalize	施以春化处理
disappointing	令人失望
counterpart	副本
collectively	共同
disfavor	不赞成
quarrel	反目
disintegrator	分解者
milestone	里程标
weak	无力的
apocarpy	离心皮
stealthy	秘密
skylark	云雀
labourious	需要劳力的
biferous	一年开花或结实两次
resegregate	对……重新实行种族隔离
unitarian	一神派
twu	America
septuplicate	一式七份
univalve	单瓣的
sassenach	撒克逊人的
converse	谈话
octad	八价元素
perfunctorily	马马虎虎
algerine	阿尔及利亚人
dog	坏蛋
director	导演
greenstone	绿玉
befell	落到
seel	障人眼目
objurgatory	非难
lordly	有气派地
erythrophyll	叶红质
infinitely	无穷地
idiophonic	非膜质打击乐器的
boomerang	飞去来器
shade	图案阴影
frenzied	狂乱的
neckpiece	皮围巾
caterwaul	猫叫春声
rss	Societatis
whitebeard	老翁
kymograph	波动曲线记录仪
cdma2000	Access2000
suprarenal	肾上腺的
inflect	弯曲
immelmann	半斤斗翻转(德国飞行员殷麦曼
petrel	海燕类
hexenbesen	扫帚病
armer	武装者
sidetone	侧音
dicotyl	=dicotyledon
plumb	铅弹
sooty	乌黑
sniveler	假哭的人
hominoid	似人猿的
vagabond	浪子
verminous	虫害的
untaught	没有学问
onto	在……之上
contest	争夺
ravenous	贪婪的
melanesia	美拉尼西亚
camerist	摄影师
standardbearer	领袖
mpls	Switching
platinotype	白金照相版
prolative	补足谓语的
duster	防尘长外衣
jade	疲倦
hurtling	疾驰
bunraku	文乐木偶戏
rachet	=ratchet
hakka	客家语
vop	估价如原保险单所载
unbolted	未上栓
bogeyman	妖怪
freightage	货运
confusedly	混乱
unadvised	轻率的
aerotactic	趋气性
intended	有意的
googol	巨大的数字
expertise	专门技术
fizzle	嘶嘶声
macedoine	混杂物
daysman	调解人
hydrometeorological	水l/
somber	阴森的
cheliform	螯状
ladderlike	梯式前进的
fragment	断片
holophotal	全光反射的
westy	=West
lymphatolysis	淋巴组织溶解
unimpressionable	不易受感动的
frailty	过失
undivested	未被脱去
leftward	在左方的
insufflation	喷射
kaon	中介子
seedbed	发源地
worth	财产
chimb	凸边
ebulliometer	酒精测量器
overdose	使服药过量
contemptuously	轻蔑地
precessional	岁差
nonsignificant	不重要的
liberative	释放
rational	理性的
duckpins	鸭柱球中所用的短柱
guicowar	=Gaekwar
parking	停车的
score	二十
slowpoke	行动迟缓的人
corollaceous	象花冠的
candid	坦白
dehydratase	脱水酶
controvertible	可争论
degradative	使下降的
great	顺利
zinky	含锌的
medicine	药
afreet	恶魔
beefy	结实
pristane	姥鲛烷
constitutive	制定
ophthalmology	眼科学
dardan	特洛伊人
sagittate	箭头形的
trebuchet	投石机
accusatorial	控告者
coring	地层中取出之圆形岩石样品
do	Dominican
sensualise	=sensualize
branchial	鳃
inelegance	不雅
semidigested	半消化的
cesspool	污水坑
autumnal	已过中年
hotblood	易激动者
uncustomed	未付关税
pds	处理器直接插槽
pleadingly	诉愿地
stratoscope	同温层观测镜
desolate	荒凉的
unexpiated	未补偿
sidetrack	旁轨
magnifico	高官
decumulation	积聚物的处理
confounded	糊涂的
ungodly	不虔诚
fingerprint	采指纹
sperrylite	砷铂矿
drugola	以毒品形式付给的贿赂
metempsychosis	转生
eyepit	眼眶
biostatics	生物静力学
arizona	亚利桑那州
stash	隐藏处
cultivable	可耕种的
downsman	草原居民
rimous	龟裂的
gaolbird	囚犯
wolf	大吃
uranic	星学的
multifilament	多纤丝
disutility	无用
producer	生产者
expostulatory	训诫
pungent	尖锐的
implosive	闭塞
swim	游泳时穿戴的
twu	of
futtock	复肋材
assessable	可估价
cervine	鹿一样
lilied	纯洁的
angolese	安哥拉土人
hemosiderotic	血铁质
whaler	捕鲸船
busyness	忙碌
ruelle	小巷
hexapodous	昆虫
oeillade	秋波
queasily	令人恶心地
antiutopian	具有反面乌托邦特征
fault	过错
finitary	有限性
aeroallergen	气源性致敏原
blanketflower	=gaillardia
basehearted	性情卑鄙的
oxygenation	氧化
transplanter	移植者
fistfight	互殴
keister	小提包
prizewinner	得奖人
reclusive	隐居
rtl	Transistor
pregnant	富有意义
unbelieving	不相信
nonrecoverable	无法收回的
visibility	可见度
unwarmed	未温热过的
unscale	除去……的鳞片
peptize	使成胶体溶液
amie	爱人
omniscience	上帝
nonart	反传统的艺术作品
sulfonic	磺酸基的
spiteful	恶意
trichinous	患旋毛虫病
federative	联邦性
ineffectively	无用地
hippic	赛马
dependency	从属
psychedelicatessen	迷幻品商店
airflow	气流
suasion	劝告
heaves	马慢性肺气肿
dominating	主要
acellular	非细胞组成
kitbag	背包
skunk	臭鼬皮
gnn	Global
inadmissibility	不许可的事
sponge	海绵状物
markworthy	=noteworthy
supertonic	音阶第二音
immediate	紧靠
carlist	拥护卡洛斯争取西班牙王位者
obtrusively	冒失地
manned	有人操纵
musing	沉思
counterdrain	副阴沟
hunt	猎获
sillibub	=sillabub
smsa	Area
scum	泡沫
client	客户机程序
morpheme	形态素
braceleted	戴手镯的
mongoloid	蒙古人种的
chinoperl	Oral
war	打仗
bathybic	深海底
after	与……一致
upsweep	拢上去的头发
incidence	入射
inflammable	易怒
scent	发出气味
propitiatory	和解
craps	双骰儿赌博
halachist	哈拉卡权威
oos	缺货
kobold	小鬼
limbless	无翼的
lamelliform	薄片形
marshall	马歇尔
prescientific	近代科学以前的
unaverage	突出
cantate	圣经旧约诗篇第98
debility	无活力
maths	数学
sess	捐
zi	of
glider	滑行
therewithal	于是
overaggressive	过于放肆
subdue	征服
rhapsodize	狂热地描述
bimorph	双压电晶片元件
fleshy	肉质
poky	迟钝
consuetudinary	习俗
unfailingly	可靠
sacrament	沉默
voltmeter	伏特计
posthouse	驿馆
obtruncate	砍去头部
deciliter	1/10公升
meromorphic	亚纯的
boubou	宽大长袍
teleonomy	目的性
genevese	日内瓦
overceiling	超过最高限度
faulty	有缺点
fondly	溺爱
poltroon	胆怯的
mime	Mail
sib	亲戚
woof	纬线
lifeguard	救生员
symptomatic	有症状的
snippet	不知天高地厚的年轻人
summons	传唤到法院
catarrh	粘膜炎
roed	腹内充满卵
crista	脊
wardian	case
permanent	永久的
tastemaker	创造时髦风尚的人
phototropism	向光性
haymaking	割晒牧草
cutdown	缩小
pyroelectric	焦热电的
lopsided	不平衡的
suppurative	吸脓药
labourer	劳工
inject	注入
opsimath	晚年开始学习的人
scrumptious	极为愉快
girondist	党员
rondel	十四行的短诗
sagaman	萨迦叙述者
exhalable	可蒸发的
lassalleanism	拉萨尔主义
warty	似疣的
ute	轻型货车
ecotage	污染源破坏演示
nonpolluting	不会引起污染的
nobly	崇高
unswerving	不偏离的
penitential	赎罪规则书
sequentially	继续
fearless	勇敢
moonlet	小卫星
villager	村民
refutatory	反驳
loliginid	枪乌贼科
adagietto	更缓慢地
accountancy	会计师之职
sputter	咕哝
unissued	未发行的
import	有关系
renomination	再提名
curial	元老院的
used	用旧了的
swapo	African
inegalitarian	不平等
chaffingly	嘲笑
embolize	栓塞
felv	virus猫白血病毒
pixel	像素
indication	迹象
print	照片
belligerent	交战的
orb	圆形物
anglocentric	以英格兰为中心的
callus	愈合组织
hesvan	=Heshvan
dohc	camshaft
hawfinch	蜡嘴鸟
outgo	消耗
tyrannically	残暴地
rummy	酒鬼
thalamium	内室
upbringing	抚育
bridie	肉馅饼
caterer	指备办宴会者
mel	蜂蜜
viborg	=Vyborg
humdrum	单调的
palatably	美味
decamethonium	十甲季铵
decimal	小数的
anaesthesia	麻木
phanerophyte	高位芽植物
punic	没有信义
stearin	硬脂酸甘油油酯
brickdust	砖屑
confounded	讨厌的
homeward	向家地
torc	金属颈环
bicorporeal	有两个主要部分
break	破裂
proconsular	方总督
optima	光体字体
rite	惯例
inadmissible	不许可的
biparental	来自双亲
intrusive	打扰
whipper	似用鞭子抽打者
endowment	捐赠
negrophilism	亲近黑人
threat	恐吓
fossa	小窝
exhaustible	被竭尽的
diastole	心脏舒张期
browse	吃草
bfa	美术学士
tasmania	塔斯马尼亚岛
seropositive	血清反应阳性
jejune	不成熟
mirky	阴郁地的
unstuffed	不拥挤
belong	属于
troubleshooter	纷争解决者
statutable	法规的
incoherent	语无伦次的
dishonorably	不名誉
hemimetabolic	半变态的
impicture	以图表现
peewit	田凫的鸣声
fungi	由真菌引起
americologue	研究美国社会的学者
pragmatistic	实用主义
monomaniacal	偏执狂
maybe	疑虑
thrust	戳
payload	有效载荷
mace	权杖
excudit	]
kummel	烈性甜酒
hifi	高保真
agitato	兴奋地
unapprehensive	理解力差
heft	重达
imaginably	想象得出
mercery	绸布业
jewfish	海鲈
financing	筹集资金
metho	卫理公会教徒
popedom	罗马教宗的职位
photog	=photographer
virion	病毒体
unprecise	=imprecise
tinkler	小铃
slob	笨蛋
hyposensitive	弱敏
zif	Zero
cop	抓住
saltus	逻辑的飞跃
auc	condita(=in
fun	娱乐
darter	飞奔者
tritanopia	蓝盲
hornet	难缠的人物
curettage	刮除术
turtledove	斑鸠
migrate	随季节而移居
ownerless	无主的
grouch	发牢骚
literature	文艺
woolgathering	空想的
smoke	烟尘
courageous	有胆量的
liber	书籍
endothermic	吸热
statement	声明
able	能够的
pendent	未定
windblown	风飘型的
hopeful	有希望
unlike	不同
noser	强烈逆风
very	特别的
millionth	第一百万
mdccclxxxviii	罗马数字
immethodical	无次序
fatheaded	愚钝
glaum	一瞥
orientalize	东方化
coprolite	粪化石
untold	未说过
bedsock	睡时穿的保暖袜子
leisurable	悠闲
clivers	尤指猪殃殃
ruffian	无法无天的
kickshaw	无价值的饰物
chalklike	似白垩
doomed	命定的
centrilobular	小叶中心
stopgap	暂时的
holden	hold的过去分词
sjaa	Ambulance
ivanovo	伊凡诺沃
gallop	疾驰
interseptal	隔间
endostracum	壳内层
telomer	调聚物
snuffle	用鼻音讲
plagiarist	剽窃者
geographic	理
nationality	民族性
pacesetting	领头
inunction	涂油
truest	确实的
tacitean	简洁且多警句的
wash	流过
strategical	战略
pedlary	廉价品
religionism	宗教狂
pollucite	铯榴石
bemused	困惑的
external	客观
stria	细沟
rotund	圆形
granitiform	花岗岩状
unrounded	非圆唇
snowbreak	雪之融化
newish	稍新的
bp	呼机
welldoing	德行
amply	充足地
pereiopod	胸部附器
deliberation	从容
racialism	种族主义
bavarian	巴伐利亚人
resolution	决心
terminative	限定的
glitzy	眩目
ac	交流
paint	描绘
rheologist	流变学家
pedlary	沿街叫卖
cryptographic	关于暗号的
trinitrophenol	=picric
it	Information
obduct	将挤压至另一板块之上
caramelize	加熔熔化而变成焦糖
moistureless	干燥的
direct	顺行的
eidetically	仍在眼前
suprathermal	超热
alba	Duke
outsung	outsing
imprinter	压印机
gammy	跛足
stypticity	止血
cavity	空穴
cloverleaf	四叶苜蓿形的立体道路交叉点
lawfully	守法地
vendee	买主
vlcc	carrier
effective	被实施的
insatiably	贪得无厌地
flsa	Act公平劳动标准法
calash	篷形女用头巾
negligent	粗心大意
mozetta	带兜帽短斗篷
lemnaceous	水萍科植物
mshe	Home
rainbird	绿啄木鸟
exsufflate	呼出
amyloid	淀粉质
c	字母C
fine	罚款
undefendable	不可辩解的
comedo	粉刺
uneven	不平均
defy	挑衅
lumber	隆隆声
movement	运转
pastorally	牧歌般地
demos	古希腊城邦平民
trochoid	次摆线
stodge	油腻的食物
murmur	低沉连续的声音
birchen	桦树的
couturier	女裁缝师
glassworker	玻璃工人
calcimine	刷墙粉于
scrapbasket	废纸篓
planetologist	行星学家
fretted	附有弦马
confounded	糊涂
irreproducible	不能复制的
parvis	天井
reflexological	反射论
fugacity	不安定
solitaire	单人跳棋
vlsm	masks
postcommunion	领受圣餐后的祈祷
export	出口商品
waygoing	离开
jamesonite	脆硫锑铅矿
semiconscious	半意识
conscientious	尽责的
virginiamycin	威里霉素
fuck	与……性交
ineptly	不适当
amniote	脊椎动物
wetly	有湿气
bedlamite	疯狂
spumescent	泡沫状
umc	台湾联华电子公司
desultory	断断续续的
neolite	新石
spiculate	尖锐的
fecal	排泄物的
slush	烂泥
steep	险峻的
matchstick	火柴杆似的东西
merchandising	商品之广告推销
trichinous	旋毛虫病的
ocellated	单眼的昆虫
citify	使都市化
berth	卧铺职业
acerate	一端尖的
doughy	面团的
inscrutable	不能预测的
damaraland	达马拉兰
druidical	督伊德教的
vesical	椭圆形的
hydrophilic	吸水的
unveil	揭幕
infractor	破坏
comtism	实证哲学
cinemactress	电影女演员
inspectorate	视察员
notchboard	梯级搁板
iis	Internet
quartersaw	把原木锯成四块
oligosaccharide	寡糖
erosive	侵蚀性
rpq	quotation
alimental	富有养分的
undiluted	未搀水
ethnobiology	人种生物学
annihilation	灭绝
enwrap	围绕
philanthropic	博爱
yugoslavic	南斯拉夫的
acronym	只取首字母的缩写词
markhoor	捻角山羊
inchoate	早期的
impeller	推进者
derivative	系出
discomfiture	挫折
surge	使汹涌奔腾
scale	天平
faldstool	祈祷用小案
privation	被剥夺了某物的状态
pharos	航标灯
transconfessional	教派间的
impinge	撞击
movement	乐章
latten	镀锡铁板
openmouthed	惊讶的
fleshpots	奢侈的生活
groovelike	墨守成规的
aut	Teachers大学教师协会
burthen	负担
shoshonean	肖肖尼语的
moll	的昵称
unerringly	正确
ceroplastic	蜡塑的
kabul	喀布尔
hectogram	一百公克
exsert	使伸出
equal	合适的
exchangeable	可兑交
churchwoman	女教友
uncaused	非外因引起
cassegrain	卡塞格伦望远镜
xylophagous	蚀木的
irrefutable	不能反驳
authoritative	有权威
absently	心不在焉地
allocate	分配
whoop	喘息声
cyclopaedic	百科辞典的
braise	蒸
blossomy	花盛开
march	步伐
sulfureous	硫磺的
larrigan	上油高统皮靴
affiliation	从属关系
backfire	逆火
vhf	特高频
souari	油桃木
cocoa	可可粉
coulee	深谷
ignore	不理睬
elaborate	精细
siglos	西格劳斯
attitudinarian	装模作样者
pluto	阴间之神
final	决赛
floor	难倒
grand	极重要的
cerebrotonia	气质孤僻
chucker	投掷者
wive	与……结婚
subjunctive	虚拟的
lade	装载舀出
rate	鉴定等级
passkey	万能钥匙
titmouse	山雀
tomahawk	钺
remedially	治疗
clothesman	旧衣商
below	在……下面
pending	未决
slack	漏水
communicate	感染
imbower	憩于树荫
ensilage	新鲜秣草之保藏
stillborn	死产的
monopolistic	垄断的
eniac	电子数字积分计算机
servitude	使用权
inbuilt	内藏
venal	贪污
histopathologic	组理学说
liminal	阈限的
oni	Office
somatogamy	体细胞配合
autofit	最适合的行高
caitiff	卑劣的
unrepealed	未被撤销的
confessingly	像忏悔者一般
agglutinin	凝集素
warpwise	经向地
catarrhal	卡他
herd	成群
redintegration	复旧
lapm	Modem
crotchety	有怪想的
hawaiian	夏威夷语
whereabouts	所在
bastinado	杖笞
misanthrope	不愿与人来往者
knowable	可知的
surgent	汹涌的
gymkhana	比赛
liverleaf	獐耳细辛
shakiness	不稳定
rbe	relative
refresh	更新
stigmatize	打烙印
retroflex	翻转
communalize	归市
unswathe	拆开
seamanlike	海员般
strut	大摇大摆地走
quarte	四张同花顺
beat	敲打
metaboly	新陈代谢
inbeing	内在
symmetry	对称
posttraumatic	外伤后
transportation	/
luetically	梅毒地
huzza	欢呼等的声音
vlcc	crude
shmegegge	=schmegeggy
dispersible	可分散的
rasped	刺耳
hulled	有船身
aps	Advanced
dryly	枯躁无味地
cosey	舒适
intervention	干涉
transmitter	发射机
tombola	一种彩券
delightedly	快乐
acantha	刺
idea	想法
underclass	一、二年级学生
ido	伊多语
clary	鼠尾草属的植物
oppressively	沉重地
idea	意见
opiumize	用鸦片处理
fjp	Philanthropies
hepatica	獐耳细辛
heterotrophically	不是自养
madonna	圣母像
photocinesis	=photokinesis
hyposulfite	硫代硫酸钠
am	Amplitude
ichthyophagist	以鱼为主食的人
falconry	猎鹰训练术
undertake	许诺
ochlocrat	暴民政治家
contracture	挛缩
joint	贴合
reduce	减少
tungstic	六价钨
spinage	菠菜
eisa	Standard
alternant	交互
rivage	海岸
legislation	法律的制定
putrefactive	腐败
north	在北方
heraclid	自称为大力神赫拉克勒斯后裔的人
retractive	缩进
engraft	灌输
vanish	弱化音
fuck	利用
derangement	扰乱
headwaiter	服务生领班
hiplength	长至臀部
fallage	伐木
gibberish	快速而不清说的言语
becrawl	往……上爬
falangist	长枪党党员
undertrump	将牌低吃
gutty	挑动性的
psychotoxic	有害
arabella	阿拉贝拉
roi	Institute
distributively	分配
chromogen	媒染染料的一种
parametrical	参量的
aldermanry	市府议员或参事之职位
sternness	严格
epoxy	环氧的
stanch	不透水
remarkable	不平常
lapactic	泻药
remonstrator	提出异议的人
dimethylaniline	二甲基苯胺
cleome	醉蝶花属
stem	茎干
roughwrought	粗制
lacunose	凹陷
diatonicism	全音阶
concept	概念
axonometric	轴测法
hakea	哈克木属植物
fallacious	不合理
unsuitable	不适合的
engorge	大吃
apostatize	放弃信仰
kith	亲戚知己
miniaturise	=miniaturize
tacmar	战术多功能相控阵雷达
polymeric	聚合
furcation	叉形
lexemic	词位学
accelerate	促进
cockleshell	海扇
morality	道德的
unadaptable	不能适应的
subcutaneous	皮下的
rendition	翻译
parenthetic	附加说明的
insatiable	贪求无厌的
foreland	前沿地
rounceval	大豌豆
cinquecento	此时期意大利艺术风格
warbler	用颤音歌唱的人
uncannily	危险地
musicomania	音乐狂
living	活的
separative	有分离倾向的
blunder	犯大错
wharfie	装卸工人
antimeric	对称部分的
emulatory	好胜
trashery	废物
this	这
dichasial	歧聚伞花序
acerous	无触须的
detraction	诽谤
crackbrained	颠狂
separate	分开
swirl	涡状形
pother	烦恼
drearily	可怕地
preteen	13岁以下
lrl	laboratory
omniphibious	全能着陆
hydropathic	水疗法的
burladero	木防护板
midsection	中央部分
sputter	发劈啪声
buckthorn	人心果科属树
stochastics	推测学
tumblerful	一杯的量
dewy	露湿的
elective	选任
dedicatory	奉献
uncongeal	融化
howbeit	然而
backroom	暗中
homocercality	正尾
lab	实验室
downrange	发射中心和沿着试验航向地
replicative	复制的
natatorial	游泳的
discontinuance	废止
glost	铅釉药
denunciator	指责者
governable	可支配
cuboid	三次方
electromigration	电迁移
glutton	酷爱……的人
titer	滴定量
radiation	放射物
neva	涅瓦河
carucage	每一卡勒凯特的土地税
fcis	Institute
imaginal	想象的
detergent	去垢剂
polyandric	一妻多夫
fairly	公正地
proceeding	会议录
avulse	撕脱
scillism	海葱中毒
woody	多树木
zoot	=zoot
dragonesque	似龙的
screed	泥水匠用的匀泥尺
backstair	间接
benzaldehyde	安息香醛
sumless	无数的
sillily	糊涂地
band	乐队
footstone	基石
bratty	不服从
last	最近的
saceur	Allied
philippians	腓力比书
wring	扭动
pfda	Administration
ennoble	使高贵
felonious	极恶
beatrice	比阿特丽斯
before	在……之前
incident	附带的
cut	伤口
undemanding	容易
reappraisal	重新估计
sputteringly	气急败坏
defend	防护
morphogenic	=morphogenetic
undescribable	难以笔墨形容
arfvedsonite	钠角闪石
delate	弹劾
stretch	伸长
saliferous	含盐的
delinquent	拖欠债务
summon	鼓起
liable	很有可能的
earthling	世人
pilus	菌毛
ctol	conventional
isotonic	等张
tenia	头带
hydrotaxis	趋水性
epee	重剑术
smoothie	善于讨好女人的男子
possibilist	可能主义者
wolfram	钨
ludditish	勒德主义的
velveret	粗天鹅绒
oxycalcium	由氧钙产生
jodie	征兵不录
accentuation	强调
circulate	传播
principled	有原则
deduction	减除
trigoneutic	一年三化
mastiff	獒
gourde	海地的货币单位
rockfish	岩鱼
lustreless	无光彩
glossarial	词汇的
handraulic	手力
pad	加上衬垫
garp	Research
thunderation	究竟
baae	Aeronautical
tongueless	无舌头
sixpenny	便宜
tipnet	网
oxyhydrogen	氢氧的
roar	吼叫
undevout	不虔诚
frondescence	叶丛
metonymical	转喻的
threescore	六十岁
iad	国际天体物理十年
showup	暴露
rodingitize	使变为异剥钙榴岩
vive	有生气
hermit	隐士
intransitivize	使不及物化
expedition	探险队
ebu	Union
folly	耗费巨大而又无益的事
unadulterated	没有搀杂的
supertransuranic	超重的
reviler	辱骂者
reprocess	再加工
ladin	说拉汀语的人
bodiless	无形的
smallwares	女人用化妆品
aegeus	埃勾斯
dormer	老虎窗
nematocystic	刺细胞
lentiform	小扁豆似的
sciuroid	松鼠尾巴的
hesitatingly	踌躇
outcamp	偏远的营
pine	渴慕
dole	失业救济金
reprehensible	应该谴责
unpoetic	无想象力的
sernyl	苯环己哌啶
stereotype	陈腔滥调
sensuality	感觉性
glumpy	闷闷不乐的
microelectronics	微电子学
unsolicitous	不关怀
streptolysin	链球菌溶血素
regular	规则的
amerindian	美国印地安人或爱斯基摩人
juvie	失足青年
mailable	可邮寄
idiotropic	内向
boundlessly	无穷地
life	生命
pyloric	幽门
adurol	一种显像剂
lapp	拉普兰语
otherworldly	修来世的
unaverage	杰出的
vmi	Institute
kittredge	基特里奇
uncorrected	未调整
indiscriminating	/
headachy	头痛
lealty	信实
vera	维拉
plant	庄稼
betrothed	订婚了
winterless	没有冬天
riffy	连复段过多的
intrant	加入
fan	风扇
whist	无声地
rio	Reusable
doghouse	狗窝
idealistic	唯心论的
conduplicate	折合状
captive	被俘
outbrave	在勇气上超过
jdisplay	J
zoom	图象电子放大
corotate	作同速旋转
threadlike	线状的
sequestrum	死骨片
unclos	Conference
gaywings	少叶远志
dictation	口述
woefully	悲伤
rankle	怨恨
crunode	叉点
sun	美国Sun公司
delectus	拉丁或希腊文选
msbc	Master
pedicular	虱子的
learner	学习者
identical	同样的
calking	塞缝
fop	花花公子
tracery	花饰窗格
cuttlefish	乌贼
abcd	Delivery
autonomy	自治
hobbler	跛行之人或动物
retentiveness	保持力
aristo	贵族
inp	Index
formulate	明确地表达
disfiguration	=disfigurement
curmudgeonly	小气的
venezuelan	委内瑞拉
degradand	被降职者
fenestral	具透明点的
chewy	不易嚼碎
koniology	微尘学
robin	Robin
dialectal	方言的
rosamund	罗莎蒙德
grind	折磨
intertwine	缠绕
cinc	in
multipliable	可乘
littlish	较小的
gneissic	有片麻岩石性质
mughal	=Mogul
septuagenarian	七十岁的
triphyllous	具三叶的
navarin	洋葱马铃薯炖羊肉
unreserved	不隐瞒
heaping	放得太多
ambrosial	特别美味的
griseous	珍珠灰
oppositionist	反对派成员
envelop	包裹
oyes	静听
imputation	污名
kidd	基德
reinforcement	加强
received	被一般承认
skimeister	职业滑雪运动员
areocentric	以火星为中心
revoltingly	叛乱
rishon	里肖恩
onflow	洪湍
forsworn	不守誓言的
esol	操其他语种者的英语课程
skibob	连橇
dislikable	可憎的
nonacceptance	拒绝接受支票
snaky	弯弯曲曲的
cracow	=Krakow
feeblish	较弱
official	官方
displode	=explode
jbs	Birch
russellite	钨铋矿
muscovy	俄国
lippy	爱顶嘴
wecht	=weight
insipidly	没有味道
constate	证实
skice	迅速奔跑
literalism	拘泥于字句
jacinthe	淡橙色
shapelessly	无定形地
pinda	花生果
visitatorial	有权检查的
confounded	困惑的
flattery	恭维话
enunciative	发音清晰
atone	弥补
bubal	狷羚
dsp	数字信号处理
accrete	附着
crossgrained	固执
suspectable	有嫌疑
pasteurellosis	巴斯德菌病
saccharide	糖类
regenerate	新生
over	上面的
hiplength	盖住臀部
equitableness	正当
unimpeached	无可指摘
aggressive	好斗
restatement	重述
dishing	凹陷
unsackable	不可解雇的
eternally	永恒地
equipotential	有相等潜力
blastie	丑陋的矮人
correct	告诫
chowmatistic	理财的
cariocan	里约热内卢之居民
superfecundation	同期复孕
peck	啄食
improvisatorial	即兴的
tangent	接触
transmontane	野蛮的
segregative	分离
mannered	守规矩的
webbed	有蹼的
dialogist	问答者
ifps	交互式财务计划系统
corsican	科西嘉方言的
periodic	定期
cracknel	脆煎肉片
maven	专家
hydraulician	水力学家
field	田赛
dilate	膨胀
carmine	深红色
sigmate	S形
jibe	与……一致
undesirous	不存想望的
punctum	点
clwyd	克卢伊达郡
ocherous	含赭石的
hardcore	赤裸裸描写性行为
spiel	演说
unreckonable	难预测
fix	贿赂
miraculous	奇迹的
flexibility	挠性
accredited	质量合格的
thriftily	节俭
stylistic	格式上的
screwhead	螺丝头
pellicular	薄皮
dialytically	用渗析法
technologic	工艺的
cater	投合
pluriglandular	多腺性的
maukin	=malkin
jadish	毫无价值的
bioclimatic	有关生物与气候的
roper	用索套捕牲口的牧人
livestock	牲畜
pursual	追赶
balkhash	巴尔喀什湖
polyimide	聚酰亚胺
anzac	2澳新军团
potboy	酒馆的侍者
minus	减
norland	北部地方
joint	接合
hiron	工字梁
aspect	方面
ogle	媚眼
suspectable	可疑
clause	条款
marbleize	作成大理石状
paragenesis	:
cutis	皮肤
tedious	单调乏味的
landlordly	房东的
indent	缩排
migration	移民
aspca	Animals
pingpong	桌球
finery	漂亮
accurst	被咒的
scrubby	多短硬毛的
subsidise	下沉
unitarianism	集权制
sponsor	发起人
transporter	输送人
chatty	饶舌的
nhra	National
tedder	翻晒者
graphomaniac	书写狂者
kinghood	国王的王位
breechloading	后膛装弹
bimestrial	每两个月发生一次
tryst	幽会
sixern	苏格兰长型六桨渔船
wire	金属丝
nonenzymatic	非酶
unsubstantial	无实质
tuft	一蔟
radiophonics	无线电发出的声音
dotty	精神不定
space	空地
erivan	埃里温
epaxially	轴后地
cellarer	衣食住管理员
vixen	泼妇
gambol	欢跳
cutlet	炸肉排
spanking	强烈
chapbook	廉价的小册子
classy	上等
uniterm	单元词
lethal	致命
fiery	火焰
turista	旅游者腹泻
stockily	一本正经
kcps	kilocycles
educe	得出
remnant	残余
cameralistic	财政或经济的
rotisserie	电转烤肉架
mean	意谓
remissive	宽恕
custodial	保管人的
hetero	异性恋
supersell	超级推销
pathologic	病理的
skite	一拳
demonologically	鬼神学地
underlet	廉价出租
bucketful	一桶之量
brittonic	=Brythonic
undivested	未被剥夺的
magnesic	镁的
anuretic	尿闭
caricature	漫画
counsel	商议
stirabout	吵闹
ingroup	派系
siquis	圣职人选公告
parure	全套首饰
eristic	论客
arisen	兴起
starting	开始
smooch	接吻
bouncing	巨大
diminutively	仅仅
platte	普拉特河
withering	进行干燥处理的
spicknel	伞形科植物
elegance	优雅
vasculitis	血管炎
sirian	天狼星
jurassic	侏罗纪的
vinegarroon	大形蝎子之一种
ganof	扒手
rollered	装在滑轮上
half	半时
asymmetric	不均匀
irremediable	不能挽回
actinomycotic	放射菌病的
early	早
archenteric	原肠之消化道的
antiwhite	反对人的
creephole	躲藏之洞穴
plastid	质体
laches	疏忽
windsail	帆布制的通风筒
hypsometer	测高计
zigzag	锯齿形的
simulacrum	像
activex	微软倡导的ActiveX
ultraclean	特净
far	遥远地
unapproved	未经同意的
bureaucratise	=bureaucratize
mycenaean	迈锡尼文明的
overeaten	overeat的过去分词
thetatron	角向收缩
integral	完整
accidentalist	偶然论
natsopa	and
camlet	羽纱
rhemish	Rhemish
cystine	双硫丙氨酸
unnecessarily	未必
inscrutable	难以了解的
premiership	首相之职位与任期
priest	牧师
neomorphic	新变体
flaxen	亚麻的
ring	成环形
aristocratic	贵族的
mitt	拳击手套
bearish	粗暴的
hybridist	杂种繁殖者
theory	推测
munificence	宽宏大量
title	扉页
august	August
albumin	清蛋白
smear	抹去
dressing	装饰
cms	颜色管理系统
bento	盒饭或饭盒
chronotron	瞬间计时器
stridulate	吱吱叫鸣
twig	了解
idea	主意
carob	长豆角
wally	第一流的
tisza	蒂萨河
closestool	马桶
leukopoietic	白血球形成
hernial	脱肠
hent	目
rammish	淫荡的
bingle	短发
fulgid	灿烂
virulent	充满敌意
roadable	适于在路面行驶的
chiloe	智鲁岛
nephroid	肾形
equator	赤道
sphacelous	患坏疽的
apprehensible	可理解
nonpeak	非高峰
furioso	强有力地
source	源
inimitable	无比
misknow	误解
martially	好战地
countercharge	反击
economic	经济的
thematic	词干
bani	恶骂
subtle	稀薄的
housemasterly	男舍监式
fimbriate	有须毛为缘
venomous	有毒的
pompom	大型机关枪之一种
recirculation	再通行
shuttle	梭子
mobilize	动员
supplementation	追加
add	计算……总和
saffron	藏红花
calced	穿鞋的
monothematic	单主题
woof	低音
sagittate	箭头形
muddily	下流
phalera	金属圆牌
lindgrenite	钼铜矿
drupaceous	核果性的
transmural	透壁
ammunition	弹药
airy	通风的
sextuple	六倍
local	当地的
outwardly	外观上地
astringency	严酷
left	左侧
customization	定制
sorehead	落魄的
crosshatch	以交叉线作出阴影
bellwaver	徘徊不已
mm	缅甸
functionary	机能
mercuric	水银的
holily	神圣地
odt	Defense
gospel	福音书
armenian	亚美尼亚
hag	丑婆
circumspectly	留心地
subtotal	几乎全部
immortalisation	不朽
private	士兵
zoolatry	动物崇拜
and	及
hastiness	火急
unchangeable	不变的
ort	剩菜
gwyn	Eleanor
vesicatory	起泡
supereminent	极为出色的
language	术语
comitragedy	喜悲剧
sorbose	山梨糖
downcourt	前场篮下方向的
blm	of
arcuation	弓曲
scaglia	亚平宁页岩
equipment	设备
scraggly	凸凹不平的
hvar	机载高速火箭
anthropotomy	人体解剖学
jut	突击
fortalice	小堡垒
corsican	科西嘉人的
magnify	赞美
muckhill	=muckheap
schizoid	精神分裂症的
acrogenous	顶生的
tackle	用具
suplex	后拉抱
earnest	认真的
thrustful	劲头十足的
overparted	分配担任力不胜任的角色的
trendy	流行的
channel	海峡
foamflower	泡沫花
glandered	患鼻疽病
korean	韩国语的
financing	理财
repossession	恢复
guidance	指导
hubris	骄傲
moonshiner	烈酒私酿者
at	在……方面
chloridize	涂氯化银
oaten	燕麦的
aspect	样子
anlage	倾向
will	意向
electrolyte	电解
vmd	Medicinae
mao	monoamine
nomenclative	术语
loneliness	孤独
bmw	德国宝马汽车公司
unspent	仍有效的
coppery	铜制的
venomous	狠毒的
bouquetin	北山羊
wane	衰退期
boshbok	=bushbuck
succedaneous	替代的
uniplanar	单面延展
pyrotechnical	烟火装置
scenic	景色优美的
rvsvp	vite
poesy	作诗法
denunciator	非难者
propagandistic	宣传的
orthographic	正字法
zincous	阳极
sweeping	垃圾
anthropological	人类学上/人类学上
goodman	男人敬称
bir	of
dissimulation	虚伪
diametric	正相反的
retort	曲颈瓶
jsd	Doctor法学博士
hideous	可怕的
superfluid	超流体
unquelled	未被镇压的
striated	有线纹
resolutely	毅然
myxoid	黏液样的
ulterior	在那边的
somerville	萨默维尔
cultivated	有教养
unabroken	完整的
eyeblack	黑色眼睑膏
shift	改变
arborescent	树木状的
prearrange	预先安排
spook	鬼怪般地出没于
cent	分币
menispermaceous	防己科
saturnic	铅毒
chasmophyte	在石缝中生长的植物
slimly	微弱
dayle	黛尔
ofris	Old
gruesome	可憎的
bassist	低音乐器的演奏者
echo	回音
conclusive	确实的
toddle	蹒跚学步
posnet	金属锅
analysable	可以分析的
pastorale	田园曲
antilyssic	预防狂犬病的
rau	自动装置组合单元
undermeaning	隐藏的意义
callisection	麻醉动物解剖
maturity	完备
entomic	昆虫
crabwise	横斜地
wolfy	似狼的
eschew	避开
snallygaster	斯纳利加斯特
zoroastrianism	火教
exserviee	退伍的
inextirpable	无法根除
salmanazar	大酒瓶
dopehead	常用鸦片者
undrape	揭幕
lewisson	吊楔
hydromedusan	水螅水母的
viceroyship	职权或辖区
eurithermophile	适广温细菌(fIlIk/
playbox	个人玩具用品箱
ballistic	弹道学
austere	严峻的
ralline	秧鸡科的
underkeeper	助理管理员
dino	流浪汉
stud	散布
blundering	易犯错
html	Markup
flit	迁徙
cern	physics
reservedly	客气
thersitical	谩骂
glossolalia	语意不清
blackfish	黑鲸
routh	大量
extant	突出的
short	矮
eudiometric	空气纯度测定管的
mustardy	有芥末味
homoousion	本体同一论
piquant	顽皮
jesuitical	虚伪的
onus	责任
riotous	暴动
catwalk	狭小通道
cribellum	辅助吐丝器官
repartee	巧妙的应答
pluvian	下雨
quadriad	四个一组
aid	帮助
ritually	仪式上地
discomposure	不安
washday	洗衣日
upgrade	使升级
santour	=santir
glutaraldehyde	戊二醛
annullable	取消
tenor	大意
firry	冷杉木制
unredeemable	不能收回
gentilesse	温柔
tramp	重步行走
estate	状态
insectual	小虫子似的
unverifiable	无法核实
geologic	地质上的
beaufort	波弗特海
rhyme	押韵的词
hearthstone	砌炉的石块
break	超过
monostomous	具单口
distinguished	卓著
racketeer	获取不正当钱财的人
forestall	阻碍
artistically	有艺术地
suprathermal	超热的
calcicolous	钙生的
minutiose	关心小事
acetylcholinesterase	乙酰胆碱酯酶
allopatrically	在不同地区发生地
tetrabranchiate	四鳃的
devotement	虔诚
slickness	光滑
alterative	变质剂
indigen	本地人
polonize	使成波兰风格
spud	马铃薯
enterpriser	工商业投机家
uncharming	缺少魅力
thoro	彻底
regreet	回敬
audiology	听力学
improvvisatrice	女即兴创作者
hatful	很多
goodwife	女主人
gotha	哥达
activism	触动论
wassermann	test
bant	节食减肥法
daintily	难以取悦地
sprout	苗芽
vernalize	以人工方法促进发育
corruptible	易腐败的
con	反面
unwarned	未受警告的
tabasco	塔巴斯哥
unconsolidated	松散的
capsular	蒴
contoid	像辅音的声音
afs	Auxiliary
villainy	邪恶
pathogenic	病原
interspace	空隙
conchologist	贝壳学者
religionise	=religionize
scoundrel	无赖
tartarous	酒石似
unfaithful	不诚实的
logaoedic	由混合韵律组成
expanding	扩大
beniseed	=benniseed
erasion	消除
silklike	丝状
froggy	蛙
honorable	荣誉的
blazing	强烈的
mas	for
disgust	厌恶
decently	正派
aok	极好的
breeding	教养
munnion	=mullion
multilane	多车道
minamata	水俣病
antifederalism	反联邦制度
introducing	介绍
schoolyard	校园
austere	严峻
stale	不新鲜
teleprompter	读稿机
zoanthropy	变兽妄想
hyperkeratosis	眼角膜细胞增多
feign	假装
slouchy	没精打采的
disembarrassment	使免于困窘
slipslop	乏味的酒
capriciously	任性
oenology	酒类研究
inclip	紧握
fend	保护
borrowed	伪造的
teletypesetter	电报排字机
perimorph	被壳矿物
omega	最后
intramural	校内的
