fondly	情柔地
unmurmuring	不发牢骚的
urinose	尿质的
cornucopia	丰富
flush	齐平地
slightly	些微
magistral	主导的
ambulatory	走动
perceivably	可察觉地
atomic	原子
glm	graduated
lithophytic	岩表植物
moravian	摩拉维亚人的
vvip	person
gramdan	赠村
empire	帝国
panleucopenia	猫瘟
oecd	经济合作发展组织
evangelistically	传道
carbarn	车库
reedit	修订
trow	相信
stably	坚定地
sophisticate	曲解
jol	荒芜碎裂的石灰岩高
strainometer	变形测定器
vitally	生死攸关地
lex	罗马公法
uigur	维吾尔人
removable	抽取式的
restaurant	餐馆
abyssalpelagic	深海水域
nutmeg	肉豆蔻
mephistopheles	诱惑者
macadamize	以碎石铺
spiffing	好看的
somesuch	诸如此类的东西
synonymy	同义
bizonal	分为二地区
landgravate	伯爵领主的职位
wonder	非凡
bulrush	香蒲
thundering	异常
strap	用带捆扎
bimestrial	持续两个月的
rind	外壳
one	同样
brumous	多雾
constriction	压缩
leer	淫荡的目光
retina	视网膜
nonlogical	不合逻辑的
amr	Riser
prismy	五光十色的
thiobacteria	硫细菌
nurserymaid	保姆
codominant	共显性的
acaridan	=acarid
hansel	新年礼物
israelitish	希伯来人
bename	为……取名
thule	极北之
cranage	起重机使用费
lymphangial	淋巴管的
incredible	难以置信的
skee	滑水
lobeliaceous	山梗菜属植物的
enterprise	干事业
prop	道具
congregationalism	会众制
contretemps	不合适宜
plumy	用羽毛装饰的
scholiastic	古典注释
immunology	免疫学
vat	装入大桶
external	外国的
lamely	不完全
osteal	由骨构成的
abscisin	脱落素
externally	外表上
polemic	争论
bondage	奴役
uprear	升起
nonluminous	不发光的
irradiant	光辉
seismoscopic	地需求示波仪的
shown	show的过去分词
multiplex	多元的
morosely	忧郁
undergraduette	大学本科女生
elliptically	椭圆形
chatoyance	变彩
grade	级别
exigence	紧急事件
estrade	讲坛
hootchykootchy	胡奇库奇舞
setting	安装
juratory	宣誓的
bland	柔和的
immediate	紧靠的
authorless	作者不详的
endangered	有危险的
ulama	=ulema
extrasystolic	额外收缩
styliform	刺针状的
crusade	宗教战争
bedspace	可以放床位的空间
splotchy	沾上污点
veritably	真
blagoveshchensk	布拉戈维申斯克
nasion	鼻根点
conchy	因良心而逃避兵役者
pipelike	管状的
limpidness	清澈
chaffingly	戏弄地
potpie	一种肉馅饼
tadzhiki	=Taijiki
trapezist	高空秋千表演者
ruffian	残暴的
ishmaelite	以实玛利人
ankylose	使骨愈合
magnetometive	磁势的
reintegrate	复兴
batrachian	无尾两栖类
safrol	=safrole
subscapular	肩胛下
indexed	编入索引的
diagnosis	诊断
chip	筹码
catagenesis	退化
menacme	经潮期
corea	韩国
tanto	那么多
rye	裸麦
functionary	机能的
ceylon	锡兰
stopper	阻塞物
brahmanical	婆罗门的
heterometabolic	不全变态的
disquietingly	令人心烦
passionflower	西番莲的花
bloomy	多花的
jacksonian	杰克逊思想
mamba	曼巴
primogenitary	长嗣继承的
dialectic	辩证
spinulescent	带微刺
plump	丰满
mishandle	错误地处理
motordrome	赛车道路
choreic	舞蹈病的
choke	使呼吸困难
blatantly	看穿了地
miladi	夫人
synaeresis	元音省略
enure	弄惯
winebibber	酒徒
unpolarized	不分化的
acidhead	吸麦角酸二乙酰胺成瘾者
whole	完整
makeshift	将就
trotty	快步
baht	铢的硬币
boldfaced	厚颜
regretful	后悔的
urological	泌尿道
rhythmicity	韵律性
lithophagous	食石的
leafy	阔叶
scaler	攀登者
digametic	异配子的
scotophilic	适暗的
rush	奔
presentive	表意的
topmost	最高的
perdition	毁灭
drove	畜群
shoelace	鞋带
enunciative	发音清晰的
shoulda	have
erythrocytosis	红血球增多
emaciation	衰弱
asu	Union美国学生联合会
homozygous	纯合子的
supraoptic	视束上方的
benlate	=benomyl
rutabaga	芜菁甘蓝
cellularized	分裂为许多小室
sycophant	奉承的
telltale	警告的
message	广告词
metathorax	后胸
dumping	倾销
savoia	=Savoy
noisy	聒噪
msn	微软提供的网络在线服务
decretory	法定
interspinal	棘突间
heller	捷克的货币单位
parallactic	视差的
otitis	耳炎
inmesh	使……陷入
polypidom	=polypary
shearlegs	起重三角架
fireplug	消防栓
anticommute	负对易
aglow	发红
article	文章
farness	远
digestibility	消化的好坏
mamillate	有乳头
trump	好人
cheesecake	酪饼
seashore	海滨
rickey	杜松子酒和柠檬汁、汽水的混合饮料
crankily	暴躁地
chancellory	=chancellery
blackness	黑色
pvc	Permanent
clarinet	黑管
workbook	练习簿
soar	高丛
necromantic	妖术
oestradiol	雌二醇
pinchfist	守财奴
dowable	有权得亡夫遗产
arrearage	欠款
unhurried	从容不迫
whorled	有螺纹的
aliform	有翼壮物
troublous	暴乱的
explorative	探险的
accoutrement	穿着
uncommonly	罕见
solemnity	严肃
turn	时机
nonluminous	无光
piquant	泼辣的
drillion	天文数字
atomic	原子能
centrality	向心性
inflictive	使人难过
impureness	不纯
barghest	犬状妖怪
siphonal	虹吸
northwesterly	向西北的
scoreboard	记分板
trigonous	三棱的
studded	打上装饰钉
ludic	顽皮
camerist	照相者
epitaxial	外延
bangladeshi	孟加拉国人
cppcc	Political
panda	熊猫
literalist	直译者
glitter	闪闪发光
reticula	网状
unreceptive	不会接受的
infinitude	无限
kuybyshev	=Kuibyshev
maximum	最大限度
reynold	雷诺
devour	贪看
mount	增长
bountifully	慷慨地
unstrained	未拉紧
misleading	易误解
sate	使心满意足
segmentalize	把……切分
loanshift	词变义
loudmouthed	高声讲话
glycyl	甘氨酰
foundress	女创立者
contoid	像辅音
fellowman	同胞
formant	构形成分
lancinating	象枪刺般
dentition	齿系
bonny	健美
tractably	温顺
uncate	有钩的
sureness	安全
megalomania	妄自尊大
falsehearted	虚情假意
inarch	接枝
therm	克卡
subeconomic	经济上不合算
unretarded	未延迟
coniology	=koniology
housebroken	有礼貌
promiser	立约人
bullethead	圆头者
mooch	偷偷拿走
zymoplastic	成酶
pantechnicon	家具仓库
brachydactyl	短趾的
atechnic	无技术知识的
bipinnate	二回羽状的
hardy	努力
convertibly	可改变地
piratical	盗版的
levy	征收
mcluhanesque	麦克卢恩的
unthinking	不留心
erythrophilous	爱好红色
wreckful	导致破灭
dentulous	有牙齿的
pubsy	使人联想到酒馆的
corticoid	肾上腺皮质类脂醇
immitigable	不能缓和
dominant	有统治权的
disgustful	厌腻
atrocity	残暴
elusively	易忘记
nowaday	当前的
misarrange	作不适当的安排
inaccurate	错误
widespread	普遍的
roulette	刻骑缝孔的齿轮
pantaloon	傻老头
recoupment	赔偿
roadman	修路工人
innocent	无知
indemnitee	接受保障者
emery	金刚砂
offense	进攻
sidelight	侧面射进来的光线
folacin	叶酸
roofless	无屋顶的
vernicle	印有耶稣圣容的布
purpuric	产生紫色的
junkie	有毒瘾者
beloved	心爱
ganoid	表面光滑
violone	低音提琴
prolifically	多产地
tributary	支流
faithful	信徒
hexapartite	由六部分构成
applicable	可应用
lettrism	字母派
asteroid	海盘车
aiff	APPLE
jumna	亚穆纳河
new	更新
pigstick	狩猎野猪
songbird	鸣禽
doxy	娼妇
scheme	摘要
brinkman	实行边缘政策者
piscicultural	养鱼的
subassembly	部件
stornello	斯托内洛
whisper	飒飒的声音
paranasal	鼻侧
indic	印度语的
jug	放入壶中
severity	严格
atrabilious	沉闷
hardcover	精装书的
verbally	用言辞
borderland	边界地方
popularity	声望
languishment	衰弱
dingbat	主意
fanion	小旗
clofibrate	安妥明
ephemeron	生命极短暂之物
new	初见
performing	履行
keratalgia	角膜疼痛
urus	野牛
airmail	航空邮件
letterpress	凸版印刷机
culm	竹茎
fuzz	警员
universal	全体的
manual	手动
herbartianism	赫尔巴特主义
preproduction	试制
arrester	防止装置
caucasian	高加索
relaxative	有缓和作用
owlish	面孔严肃的
esurient	贪婪的
henchman	忠实的追随者
flicker	昏倒
offbeat	不规则
taiwanese	台湾
coldstart	冷起动
oldwomanish	大惊小怪的
flagitious	残忍的
takeoff	起飞
spcc	of
bac	用绳子拖的平底渡船
aru	Union
execratory	诅咒
assuming	僭越
gorgonian	可怕的
eutomous	裂隙清楚
phallical	生殖器崇拜
afterdinner	宴会后
coquetry	献媚
erythropsia	红视症
modificand	被限定词
kaapstad	Town
plastral	腹甲的
clottish	愚蠢
deliriant	引起精神错乱
oceanicity	海洋性
northerly	北方
spiteful	怀恨的
windgall	关节软瘤
neptunist	岩石水成论者
slot	跟踪
profitably	有益地
distant	关系远的
horniness	角质
tentative	试探
volante	轻快的
joviologist	专门研究木星的天文工作者
insensibly	没有知觉地
temper	调节
conformably	顺从
magic	戏法
facilely	轻快
limbal	缘的
ushership	引座员
berserk	狂暴
goanese	果阿人
pels	象素
rusty	迟钝
bullhead	顽固的人
quashy	似沼泽
poortith	贫困
vmd	Doctor
semistarved	半饥饿的
wba	Boxing
gangetic	恒河
hemoflagellate	血鞭毛虫
ustc	United
bleaching	漂白
drunk	喝醉了的
cloistress	修女
monotonous	无变化的
illumine	照明
aristate	有刺的
astrionics	宇航电子学
verity	真理
plutocratic	富豪的
lupin	羽扇豆
sybaritic	柔弱
chasm	深坑
disburden	解除负担
spinate	有脊
lightstruck	意外曝光的
unpruned	任其自然生长
swanky	时髦
staggeringly	蹒跚地
graininess	木纹状的
lapm	调制解调器链路存取协议
sit	坐
now	此刻
chalky	白垩的
reviviscent	复生
anamorphosis	歪像
charge	加罪于
it	Technology
scotophilic	喜暗的
coliseum	大体育馆
fruitive	能享受的
lexeme	词的单位
escadrille	小舰队
mesopause	中间层顶
breaking	阻断
lhc	Lord
anapurna	阿那普那山
isoetes	水韭属植物
chalky	白垩
photoradiogram	无线电传像
meek	温顺的
subcutaneous	皮下用
lewd	下流的
preferential	特惠
malice	预谋
defensibly	可辩护
fairness	明亮
foil	叶形片
scummy	满是浮渣
eia	电子工业联合会
bionic	仿生学的
refractable	折射性的
merchant	商人
hit	偶然碰上
pliably	易曲折地
diagram	图表
shortbread	奶油和糖掺合做成的脆饼
ireful	忿怒
socius	同事
tavern	酒馆
phosphorolytic	磷酸解的
caliduct	暖气管
uncomely	不正派
equivalent	同意义的
refreshing	使人喜欢的
westering	西下的
multifunctional	多功能
place	地点
sdk	Development
detainer	继续监禁令
anechoic	消声的
openhanded	大方
sole	换鞋底
quietive	趋于寂静的
indoor	室内
thriftlessly	不节俭
inessive	在内格
assure	保证
survey	测量土
overcapitalize	对……之资本估价过高
hardcase	强健的
topless	穿袒胸衣的
septuagenarian	七十岁老者
idioplasmatic	细胞原质的
inquiet	不安
pubescent	有软毛
ablepharous	没有眼睑的
incommutable	不能交换的
synonymity	同义性
depute	委托
dyadic	二价的
pouched	有袋的
cravenly	胆小地
cookshack	灶棚
rebel	叛逆
resident	常驻
globulous	球形的
score	把……记下
feigned	捏造
viscountcy	子爵的身份
bayadere	舞妓
estriol	雌激素三醇
talcahuano	塔尔卡瓦诺
nessus	内萨斯
root	根部
quintessence	精萃
spunk	胆量
deckie	=deckhand
bitterish	稍苦
adapted	适合
sword	剑
helvetian	赫尔维蒂的
trihydroxy	三羟的
burnsides	伯恩赛德式连鬓胡子
semasiology	符号学
caressive	亲柔的
frailly	脆弱地
unobstructed	不被阻塞
necromantic	降神术的
gap	差距
lallation	r
humorous	想入非非
sensationalize	使引起轰动
metalloprotein	金属蛋白
ataxic	共济失调的
idle	懒惰的
reflex	反作用的
unedified	未受教化的
hateless	无憎恨之感
unbiased	没有偏见的
scale	比例
snugly	舒适温暖地
puncture	刺破
lanner	猎鹰的一种
pastime	消遣
paratrooper	伞兵
oppugn	质疑
tycooness	女巨头
hymn	圣歌
ascensive	上升的
inadaptability	无适应性
cozy	惬意的
galenism	盖林的医术
puckery	易皱
hypermnestra	许珀耳涅斯特拉
sunday	星期日
night	夜晚
heterotaxy	地层变位
pygmaean	极小
seek	寻找
ratguard	鼠挡
chirpily	快活地
mic	microphone
lively	活泼的
asway	摆动地
galla	盖拉语
procrastinate	延迟
hotfoot	急忙地
repugnant	不一致的
ashen	苍白
involucra	皮膜
overkind	过于友好的
wearable	可穿用
kenotron	高压整流二极管
tudory	都铎式建筑
makable	可标记的
bespoken	预约
reference	参考
attribute	属性
nolo	contendere
menstruous	月经
mailman	邮差
rhizomatous	生地下茎
hydrostat	防止锅炉因水少而爆炸的装置
decumbent	匍匐
hadhramautian	哈达拉毛
hirable	能租用
roseate	愉快
lashing	痛斥
iconology	象征主义
calenture	热带地方的热病
dat	数字录音带
diluvian	=diluvial
yh	青年招待所
propellent	推动者
poikilitic	嵌晶状的
volley	截击
kbe	第二等的高级英帝国勋爵士
numbly	失去知觉
film	在……上覆以薄膜
indeterminate	模糊
jug	模仿夜莺的叫声
druther	宁可
izzat	自尊心
premalignant	恶化前的
triaxial	三轴
cmb	美国大通曼哈顿银行
swinger	摆动的人
inapplication	疏忽
olden	古昔的
uninformative	不提供信息
parliamentarian	议事法规专家
primula	樱草属的植物
icily	冷冰冰地
kennebec	肯纳贝克河
ignorant	无知
semiautonomous	半自治
enfeeblement	弄弱
adzuki	bean
photocomposer	照相排版机
sinuiju	新义州
factotum	家务总管
filibuster	掠夺兵
cornaceous	山茱萸科的
fleshless	无肉体
tournure	姿态
inapparent	不显著
nuchal	颈背
redball	铁路特快货车
beauty	美
sisterly	象姐妹的
rejoice	喜悦
modernminded	有新思想
stuggy	矮胖
riff	即兴重复段
cardiotonic	强心的
brickie	泥瓦匠
unexamined	未经检查
unreconstructible	不能改建
sideslip	侧滑
touchwood	朽木
visitation	天降的祸福
lexiconize	将……编入辞典
naseberry	人心果
rebreathe	再呼吸
encouragement	奖励
maryland	马里兰
flotilla	小型船队
demanding	过分要求
grand	重大的
earliest	初期的
essential	精华的
kiangsi	见Jiangxi
silly	无聊的
extraterritorial	在疆界以外的
staphylococcal	由葡萄球菌引起的
augmentative	增大意义的
carbide	碳化物
cotswold	sheep
unglamorous	单调
rheinland	=Rhineland
anathematic	憎恶
fantastically	空想
yokemate	配偶
omphalos	浮饰
lobster	龙虾
entameba	内阿米巴属
mcpo	一级军士长
vaporimeter	蒸气压力计
weighty	重的
totty	喝醉的
aquarian	太空时代
togoland	其西部已成为加纳
demonstrate	示范
fenestrate	有窗状小孔
resubject	使再臣服
unlinguistic	与语言学无关的
inkpad	印泥
pitpat	快步而行
ascap	Composers
cooktop	炉灶面
antiemetic	止呕吐
under	在……之下
stop	塞住
mithraicism	=Mithraism
resumptively	概括
verner	弗纳
ultranationalism	9QltrE`nAFEnElIzEm/
euthermic	发热
balt	波罗的海东南岸地区的居民
rabid	患有狂犬病
irreality	缺乏真实性
rigid	刚性
alertness	警戒
glumpy	脾气坏
jakarta	雅加达
shadowgraph	皮影戏
kalmuck	住于美国西部的蒙古人种之一种族
promptive	激励的
mephitic	有毒的
appetent	热望的
transmissible	可遗传
gonocyte	精母细胞
scorpaenoid	=scorpaenid
kennetic	认知
succussatory	猛摇
uncomely	不标致
unroof	除去屋顶
imperscriptible	非官方的
vane	风向标
sequestered	隐退
looseleaf	各页可任意装拆的
geld	阉割
toilet	梳洗
vacuometer	真空计
larky	爱闹玩的
roadable	适于在路面行驶
smitch	一点点
neilsbed	针床
enchylema	胞基质
hazardous	冒险的
voguish	一度流行
kippen	为kep之过去分词
gluside	糖精
metainfective	传染后
hurt	伤感情
bloodhound	一种大侦探犬
gliding	滑行
irish	爱尔兰的
photoset	照相排
pistillate	只有雌蕊的
chresard	有效水分
ambagious	迂远的
entryway	入口通道
noncellular	非细胞
transcontinental	大陆那边的
inaccessibly	进不去地
ineptly	无能
rarely	罕有
highflying	抱负高
slavonic	斯拉夫民族
georgiana	乔治亚娜
evacuee	撤离者
tooltips	工具提示
orderless	不整齐的
trichome	毛状体
tatty	不值钱
shrimp	捕虾
heliochromy	彩色照相术
beefeater	吃牛肉者
steepled	有尖塔的
flange	凸缘
coverley	Roger
havre	Havre
dodgem	碰碰车
droob	可怜虫
unlearned	无学问
vasostimulant	促血管舒缩的
iroquoian	易洛魁族人的
bile	胆汁
bengalee	孟加拉国人
moro	摩洛族
honier	honey的比较级
jonson	琼森
caressing	亲切
contrary	逆
punk	崩客
resediment	使再次沉积
doronicum	多榔菊属植物
haptotropism	=thigmotropism
defeasance	废止
relight	重新燃点
pauperism	贫困
seasonal	季节的
dissepiment	隔膜
feudatorial	封建的
berth	停泊处
heroicomical	戏谑性
idiosyncratic	异质的
lushly	多青草地
hygienics	卫生学
hypergalactia	泌乳过多
tonga	轻便双轮马车
musculature	肌肉组织
unregimented	未严加管制的
chaste	贞洁
pinchfist	吝啬鬼
netting	网
childbearing	分娩
highflying	抱负高的
lank	平直
measureless	不可量的
opencast	露天挖掘的
scolding	叱责
desultorily	杂乱无章地
skelter	往前冲
schistous	片岩
surveille	=surveil
immediate	立即
zymase	酿酶
chalutz	=halutz
lwl	length
seriation	连续
increscent	增大
tumidness	肿胀
lasso	套索
puckery	起褶的
nonperson	受到排挤的人
propane	丙烷
soliloquy	独白
uncultured	落后
multicast	多点传送
latvia	拉脱维亚
governable	可统治
congruous	一致
presentive	直示
troglobite	洞生动物
tinhorn	假装有钱
glassy	象玻璃的
postrorse	向后
base	根据
katabatic	下降
freeborn	生而自由的
glomma	格罗马河
mime	Multipurpose
canonise	=canonize
outdoorsy	爱好野外活动
unimproved	未耕种的
allonymous	笔名
mycophile	采蘑菇的业余爱好者
faltering	支吾的
declensional	变格
out	从头至尾
spectroheliometer	太阳分光计
ephemeral	短暂
seawards	向海地
yatter	瞎聊
filipino	菲律宾人
amassment	聚积
sloppy	溅湿的
sinfully	不道德
hangup	挂断
moneyless	贫穷的
unwrought	未做成的
allmains	适应各种电压的
frondescent	多叶的
cohabitation	同居生活
somascope	超声波检查仪
mainsail	主桅的帆
gyration	旋回
isomorphic	同形的
willinghearted	心甘情愿
burglary	入室行窃
uninterpretable	无法翻译的
uncomely	不恰当的
clack	噼啪响
hershey	黑人
lashing	许多
accompanyist	随伴者
sanatory	有益健康的
unhasty	不慌不忙的
viameter	路程计
hirudin	水蛭素
slavophile	亲斯拉夫人
telegrapher	报务员
denominal	来自名词
timer	计时员
bangle	手镯
formal	外形的
whiten	使白
inferno	阴间
encephaloid	类脑的
structuralist	结构主义的
preventible	可阻止
bastardry	恶行
layamon	莱亚门
commissure	接合处
tough	坚强的
gath	迦特
symptomatic	症状
sallowish	带灰黄色
lintwhite	红雀
britt	=brit
paracharmonium	仲粲子
unhinge	搅乱
reinless	放纵的
kruger	即Kruger
aspca	the
mb	兆字节
blessing	祝福
unattached	独立
denatant	顺流洄游
etr	Rate
aurae	预感
grouse	松鸡
unpersuasive	无说服力
carrion	腐朽
sugarberry	密西西比朴
godfrey	男人名
patronym	=patronymic
morbidity	发病率
obstacle	妨害物
dainty	秀丽的
beibu	Gulf北部湾
methanation	甲烷化
stratovision	同温层电视广播
homocercal	正型的
gallabiya	宽大的白色长袍
itching	痒
ripidolite	铁绿泥石
nourishing	滋养多的
pigeonhole	分类
servomechanism	自动驾驶装置
cancel	取消
uncate	钩状的
arson	纵火
graduation	刻度
heterotrophically	不是自养地
dividend	红利
memory	存储
outpoint	比……更向逆风航行
overlay	覆盖图
conclude	结束
qaranc	Alexandra''s
interfile	把……归入档案
unimpeached	不容怀疑的
extraocular	眼睛外面的
scrumptious	绝妙
ungual	爪似的
shadowy	阴凉
ektexine	外表层
thixotropic	具有触变作用
kaliph	=caliph
lavishly	丰富地
nrotc	Officers''
outline	大纲
morion	无面甲的头盔
musingly	沉思地
arm	武装
tarnal	非常的
hotspur	暴躁的人
viselike	=vicelike
jake	上等
trisyllable	三音节的字
when	那时
cottonseed	棉籽
vigesimal	二十分之一
tonsillitic	扁桃腺炎
lysippus	利西波斯
withering	摧毁
microprogrammable	可编微程序
acred	拥有许多地产的
somnambulary	梦游
desterilize	恢复使用
argali	盘羊
auxesis	细胞增大性生长
dawdler	懒人
those	pro
glossopharyngeal	舌咽肌
wring	榨取
inthronization	=enthronization
herbivore	草食动物
tupian	图皮人的
theirs	pro
exaction	苛求
ashram	修行的处所
chloroplatinic	氢氯铂酸
ece	欧洲经济委员会
chowry	蝇拂
amazingly	令人惊讶
cinerator	焚尸炉
photocatalyst	光催化剂
facilitate	促进
epistolary	书信体的
expensive	昂贵
mdap	Mutual
petalled	有花瓣
hopeless	绝望的
rainbow	虚无缥缈的东西
separably	可区分地
inauthenticity	不真实
pug	足迹
admissible	可容许的
gracious	高尚
spavin	跗节内肿
tail	后部的
futz	闲混
calyptrogen	根冠细胞层
maidenish	处女
interminably	冗长地
numeration	编号
bessy	贝茜
transportable	便携式电视机
paludal	沼泽的
unscientific	无科学知识
theater	手术室
transmutative	变形
expiration	呼气
colonial	殖民地居民
solidary	团结一致
fictile	塑造的
conveyable	可传达的
purgatorial	炼狱的
nooky	交配
sourly	性情乖僻地
jehovic	耶和华
pushover	容易做的事情
sheol	冥府
ila	International
castelet	小城堡
afloat	传播的
cinerous	灰色的
salicaceous	杨柳科
iridous	三价铱的
tradesfolk	商人
podgy	矮胖的
berliner	柏林市民
mariana	马里亚纳群岛
escharotic	生焦痂性的
polytheism	多神教
pavin	=pavan
tibial	胫骨
sublunar	月下的
inducement	刺激物
ichthyomorphic	鱼状
addend	加数
concentrative	专心的
backseat	次要位置
couchant	俯伏
thickset	稠密的
escarp	使成斜面
rocker	摇杆
eternally	永恒
positivism	实证主义
delay	延期
exclamatory	叫喊的
compounding	组合
dw	Data
icequake	冰震
percipience	洞察
visit	逗留
fddi	Interface
registered	已注册的
chapman	叫卖者
enterprise	事业
preciously	仔细地
broncobuster	驯养野马的牛仔
alap	阿拉普
inspirator	注射器
benzoate	安息香酸盐
vision	想象
message	音讯
audiogenic	声音所引起的
kamela	=kamala
dysphagy	吞咽困难
lpn	Practical
unstriated	无横纹的
execrative	憎恶
publish	刊印
sameness	同一性
lateritic	含有红土之特性的
nannyish	象保姆的
ixodid	硬蜱
hagdon	鸥鸟
private	私人的
everard	埃弗拉德
banger	破旧车
dotted	星罗棋布
abcoulomb	C
factorial	阶乘的
redeye	番茄酱
explode	激发
nervily	神经过敏地
transportation	运输
contravene	违反
psychogony	心理的起源与发育
afc	F
abortive	失败
epeiric	伸入内地的
rotund	洪亮的
unsanctioned	未认可
envenomate	给……注入毒汁
uncaused	自存
lamellibranchiate	瓣鳃类的
pichiciago	铠鼹
vixen	唠叨的女人
monostylous	单花柱
wb	Bank
linguist	语言学家
shadberry	唐棣果实
gumweed	=gum
ratling	横索的梯绳
racemiform	总状花序形
electronarcosis	电气麻醉
orpharion	奥法里昂琴
blastosphere	囊胚泡
unstuck	紊乱
crossbeam	大梁
despairingly	绝望
ventriloquous	似腹语
abbe	神父
upland	丘阜
schnook	易上当受骗的人
pharmaceutist	药师
bnoc	National
aau	Athletic
vastly	广大
scotchman	苏格兰人
poddock	蛙
ceeb	Entrance
briquette	煤球
hydrometeor	水汽凝结体
underclothes	贴身衣
samfu	中国女式紧腰身套装
conducively	有益地
force	势力
rascally	卑鄙的
par	同等
infertile	不肥沃的
monthly	每月
honeydew	蜜汁
nonfigurative	抽象的
striate	有条纹的
dracaena	龙血树属植物
bandsaw	用带锯锯
conformable	一致
discrown	使退位
gaussage	以高斯为单位的磁场强度
residually	残余地
referring	提交
unfinished	未染色
pushing	有进取心的
left	左翼的
shweli	瑞丽江
snobbishness	势利
dicotyledonous	双子叶的
amperehour	安培时
account	计算
semicivilized	半文明
emendatory	修订的
soberly	严肃地
sib	家族成员
mediterranean	地中海
existing	现有的
endlessly	无穷尽地
gray	暗淡
inconceivable	不能想像的
orthomorphic	正形
vindicatory	报复的
semilog	=semilogarithmic
perfluorochemical	全氟化合物
electrolyse	电解
molechism	传染性病毒
airstop	着陆场
mormondom	摩门教教徒居住区
empathy	神入
fenderless	无挡板
unmalicious	非恶意的
ribbed	有肋骨的
roadman	通路保养工人
camelback	骆驼背
raccoon	浣熊
acrodrome	脉向尖聚集
inaugurate	创新
fulling	缩密法
lasthome	坟墓
nymphae	蛹
kibitzer	开玩笑的人
ndis	Network
procacious	大胆的
victor	Victor
nicotinism	尼古丁中毒
warily	小心地
xenophobia	惧外者
outrageous	可恶
peculiar	奇特
aquavit	白兰地烈性酒
lot	抽签
belemnite	箭石
bewitching	使人着迷的
wrong	不正当的
fcic	Federal
enhydrous	水的
deponent	宣誓作证者
hitter	打者
assure	确告
malihini	新到夏威夷的人
dormouse	睡鼠
cribbage	纸牌玩法之一
benchman	修鞋匠
transcriptor	录音重放装置
holocaust	大屠杀
value	价值
eremophilous	荒漠生的
vivarium	动物园
tripodic	用三脚
assheaded	傻瓜
intonate	发音调
precondemn	预定……有罪
hoot	汽车喇叭声
zonked	醉酒的
cad	Aided
unwanted	讨厌的
beaconing	信标
rasp	粗声粗气地说
ingerence	侵犯
mandola	大型曼陀琳
outgush	涌出
schmutz	污物
maccabees	马加比家族
custom	关税
ecology	均衡系统
grassland	牧草
metalclad	铁壳
verdigris	碱性醋酸铜
oppression	苦恼
malconformation	不完善形态
seize	没收
crus	小腿
savagely	野蛮地
sporidium	担孢子
calque	仿造词语
undress	暴露
hamburger	汉堡包
edificatory	开导的
tanbark	鞣制革
tipwizard	操作向导
raec	Corps
routh	丰盛
rustler	活跃的人
remediation	纠正
keratectomy	角膜切除术
unverbalized	非言语化的
massoretical	=Masoretic
noddle	点头
oftentimes	时常
html	超文本链接标示语言
civies	便服
panivorous	食面包
feeling	富于感情
confide	信赖
nonfood	非食物的
strongpoint	长处
agrobiology	农业生物学
grateful	感激
sins	inertial
postcava	后腔静脉
escap	Asia
plank	铺板
pittypat	卜卜作声
bribability	有贿赂的可能
ovulation	排卵
unnational	非民族的
pomiferous	结梨果状果实
antistrophe	对照乐节
emigratory	迁居
flounder	发慌
botb	Overseas
hydrothorax	胸膜积水
inp	News
tap	活栓
cypriote	塞浦路斯
potsherd	陶瓷碎片
suspend	悬挂
prelatic	高级教士的
googly	曲球之一种
publishing	出版业
nevi	nevus的复数
caaba	=Kaaba
swingle	用打麻器打
billiard	弹子戏的
xxxv	罗马数字
ganggang	甘甘凤头鹦鹉
mount	设置
makimono	书画卷轴
covenant	缔结
trouser	女演男角
jazz	爵士乐
cosmological	宇宙论
cognitive	认识
begem	使如同镶宝石一般
embroider	镶边
rodriguan	罗得里格斯岛人的
bicomponent	双组分的
ration	实行定量配给
gallica	法国蔷薇
aram	Academy
dript	滴
snuffling	抽着鼻子
fiberglass	玻璃纤维
echograph	回声深度记录器
ryot	佃农
unduplicated	无复制品的
dysplasia	发育异常
upright	合乎正道的
chromo	多彩石印版
zip	拉链
escallonia	鼠刺
trichinellosis	=trichinosis
idiophonic	非膜质打击乐器
wheaten	小麦
testaceous	介壳
bwr	boiling
gyrocopter	=gyroplane
fudge	粗制滥造
syntechnic	异种趋同
consultant	顾问
muderer	谋杀犯
hotfoot	急忙
margaric	珍珠
azine	二氮陆圜
depurate	净化
scarves	丝巾
tensile	可拉长
ebullience	沸腾
semeiology	符号学
javaite	玻陨石
quarrelsome	好争论
instrumentalism	InstrE5mentElIIzEm/
acosmist	无宇宙论者
wb	世界银行
fibrillate	有原纤维
adjustable	可调整的
stockjobbing	投机
salvable	可救的
etymological	根据语源学
decade	十
houseman	男勤杂工
lovable	可爱的
lokal	夜总会
calibration	校准
hydrostatic	静水力学的
toothcomb	细齿梳子
potomac	波拖马可河
transitive	及物
revelator	启示者
notarial	公证人的
arianise	信奉阿里乌教义
particularize	大书特书
homer	本垒打
unpunished	未受惩罚的
duplicated	复写书的
nosogeographic	域病理学
thine	你
zootechnics	动物饲养学
cybernetical	控制论的
hypomotility	动力减退
iea	Education
unrepulsive	不令人厌恶
narrowly	勉强
procreate	生
haematoid	血样
schoolbook	教科书
otis	奥蒂斯
zincify	中加锌
reverberation	反射
quench	熄灭
axilla	咯肢窝
effectuate	实行
austere	严厉
cosmologic	宇宙哲学的
easier	更舒松
rouge	红铁粉
fescennine	下流的
almsman	依赖施舍生活的贫民
icefall	冰布
uto	姊妹市团体联盟
sural	小腿肚的
soil	务农
exstipulate	无托叶
unattended	没人照顾的
lay	铺设
woollenette	薄呢
oniony	洋葱臭味的
mns	Nutritional
inseverable	不可分离的
flimflam	欺骗
permanent	持久的
imperturbability	冷静
visby	维斯比
algae	藻类
irq	中断请求
rostrate	有喙
welldoing	行善
looper	作线环的人
monticulate	有小山冈
discontentedly	不满地
backboned	有骨气
hangar	飞机修理库
gyrostabilized	陀螺稳定
chromatics	色彩学
reticula	错综复杂
direct	导演
calcicolous	生长于钙质土壤的
brachycranic	圆颅型
monkship	=monkhood
numerical	用数字表示
unequal	不胜任的
recording	记录的
endogenetic	内成的
causticity	刻薄
twu	Transport
exceeding	胜过
makable	可制作的
limitless	无限
carnal	色欲
helienise	=Hellenize
involucrate	有蒴包的
widder	=widow
deprivation	剥夺
nitrous	含氮
epuration	提纯整肃
desirable	合意
gyrostabilized	陀螺稳定的
frivol	糟蹋
haily	夹有冰雹的
penitential	后悔的
parenteral	非肠道的
anaplastic	退行发育术
caerphilly	卡尔菲利干酪
popster	artist
schoolwork	作业
catching	有魅力
gummous	似树胶的
halfheartedly	不认真
neocosmic	新宇宙论的
elocutionary	雄辩术的
moonwatcher	人造卫星轨道观测者
samaritan	撒马利亚人
sanitarian	保健的
nippy	刺骨的
slaister	混乱
nuclearize	为……提供赋予核武器
nondollar	非美元
diagnostication	判断
harsh	刺耳
frequentation	常访
phallism	生殖器崇拜
dvd	Disk
argo	南船座
harassed	疲倦
interoffice	各办公室间
skylark	胡闹
noonday	正午
synchronous	同步
contumacious	反抗法院命令
semifictional	半虚构
thereto	到那
say	比方说
nehemiah	公元前
acrophobia	恐高症
unfastidious	不爱挑剔
grimily	肮脏地
glorify	使更壮丽
olent	有气味
recompose	改组
irresponsive	无反应
becharm	使销魂
multicylinder	多汽缸的
repose	睡眠
convivial	欢乐的
methodise	=methodize
cornflower	矢车菊
positive	肯定
everglade	湿地
appreciate	感激
thesis	论文
equitable	公正的
prussian	普鲁士人
pelasgian	皮发斯基族的
electroplexy	电休克疗法
spaish	西班牙语
optimistical	乐天的
instinctual	=instinctive
bezant	各种金
yiddish	意第绪语的
nodularity	结节状态
interword	字间
dismiss	开除
absent	不在
salimeter	盐
suitably	适宜
natalia	纳塔莉亚
vagabond	漂泊的
mayfly	飞蝼蛄
profligate	肆意挥霍的
centering	置于中心
caudiform	尾状的
sequential	有继
invitatory	邀请的
converted	更换信仰
flagleaf	菖蒲
rotadyne	=Rotodyne
amidship	向船的中部
folliculitis	毛囊炎
cataract	奔流
furphy	假报道
antagonistic	敌对的
kibe	蹦裂
hexahydrate	六水合物
benthoal	海底的
secam	Memoire
unpatriotic	无爱国心的
independently	自立地
unawares	不料
bulk	显得大
edifying	教训性的
deliverance	释放
colourable	似是而非
scotopic	暗视
rickle	小堆
beddo	电子床
evergreen	常绿
pulsometer	真空唧筒
padnag	款步而行的马
anarchism	无政府主义
diversify	使多样化
iconometer	量影仪
supportability	可忍受
petit	没价值的
iphone	可通过Internet进行语音和视频通讯
pulverulent	粉状
impertinently	不恰当地
poltfooted	足畸形的
begrudgingly	吝啬
hyperphagic	贪食
idolatrous	盲目崇拜的
refection	便餐
argental	似银
whiffy	发臭气的
vesicular	有小泡
awol	absent
heartache	心痛
unenclosed	没围起来
adream	梦想
muscovado	粗糖
recallable	记得起
moldy	腐臭的
welter	起伏
dissimilarity	相异点
encyclopedical	广博
darky	黑人
pus	脓汁
correlated	有相互关系
wise	明白
spc	Commission
aps	Society
toothed	锯齿状的
slipslop	淡的
tolerant	容忍
priss	脂粉气的男子
disrespectful	失礼的
remediation	补救
mothery	醋母样
wriggle	扭动
unplaced	没有入选
laudation	称赞
managing	管理的
wenzel	文策尔
unlicked	无礼貌
emanate	发出
unset	弄乱
jady	似玉
calycular	杯状构造
facsimile	传真
times	次
obvious	显而易见
pucka	真正的
religioso	虔诚
manito	超自然力
motionless	静止
replicase	复制酶
transconfessional	教派间
gashouse	煤气制造工厂
defunct	死了
catnap	小睡
historied	有历史的
azeotropy	共沸性
demagnetization	退磁
snaillike	像蜗牛
conducively	有益
invalidate	使无效
radiation	发散
leatherhead	笨蛋
talkativeness	爱说话
baffy	木制短高尔夫球棒
brilliantly	辉煌
phillumeny	火花收藏爱好
activist	激进主义分子
lamprey	七鳃鳗
recreation	娱乐
documentary	文件的
luminize	使发光
baleful	恶意
unmeaningful	不重要的
worthy	可敬的
attribution	归因
picescent	乌黑的
rooty	多根的
personae	的复数
sarcology	软组织解剖学
scrofulosis	腺病质
sclerotin	骨质
signifiant	能指
iberian	伊比利亚
sawblade	锯条
palpitate	跳动
myself	pro
etic	非位
specialize	专攻
pro	正面
leishmanial	利什曼原虫
licentiate	领有开业证书的人
erratic	古怪的人
correct	端正的
resigned	听天由命的
nonenforceable	不可强制执行的
femtometer	千万亿分之一公尺
commensuration	相当
brisbane	布里斯班
aseptic	无菌
fetishize	盲目迷恋
adulation	阿谀
sketchbook	小品集
chenopodiaceous	藜科
frisk	快乐
geomancer	地卜者
cueist	撞球家
sailor	船员
thrang	=throng
rookery	贫民窟
instance	实例
bizerte	比塞大
unknowing	没查觉
beaconage	负责保养信号系统之机构
dilly	极好的东西
gray	变灰色
overland	陆上的
fill	供给
spawn	产物
deluxe	豪华的
fit	使适应
excitatory	有刺激性的
dissension	意见不同
laceless	无花边
uprise	起坡
pinboard	插接板
misrepresent	不如实地叙述
pulley	滑车
dae	aeronautics
disaffirm	否认
conciliarism	教会会议
faithlessly	不忠实
abortion	堕胎
unimplemented	未实施的
solaceful	充满慰藉的
cajan	=Cajun
race	种族
superable	可以胜过
sympathise	=sympathize
permeate	渗透
monocline	单斜层
wet	有雨的
highgate	海格特墓地
zymoplastic	凝血
electroplexy	电惊厥疗法
productile	可延长
malachi	希伯莱的先知
phosphoenolpyruvate	/磷酸烯醇丙酮酸
dw	Warehouse
other	另外
sulfa	磺胺基的
foliicolous	寄生在叶上的
hydrographer	水道测量家
flounder	挣扎
wdp	Wireless
surroyal	鹿角冠上的头叉之一
dusky	朦胧
unheated	不热的
asinine	驴的
flea	生蚤的动物
purply	略成紫色的
atonement	赎罪
dtp	桌面排版
parameter	参数
jewry	犹太民族
defence	防卫设备
volapuk	沃拉普克语
primer	雷管
upmost	最上的
obtainable	可到手的
unavoidable	不能取消的
rba	of
hewer	煤矿工
quietus	死
graniform	谷粒状的
smartness	敏捷
crankily	古怪地
blunderingly	粗笨
gasthof	客栈
probative	检验的
leave	遗弃
mvd	Vnutrennikh
campanula	风铃草属植物
micronize	使微粉化
nobble	使其不能取胜
vex	恼怒
cuckoopint	延龄草
noctambulist	梦行者
volcanology	火山学
prancy	欢跃的
quebecois'	NULL)
appendiculate	附着
soar	高飞
star	恒星
unmutilated	未丧失肢体
bunglesome	笨拙
assertory	确定
cartesianism	笛卡儿哲学
bowels	肠
stellate	似星的
eyesore	丑的东西
incur	招致
peculiar	奇特的
undivided	专一
proctorial	训导长的
devour	破坏
ina	艾娜
bumpety	猛烈
fidibus	纸捻
kurbash	皮鞭
scry	用水晶球占卜
circumvention	陷害
damnably	可恨地
motherhood	为母之道
captive	被美色或爱情迷住的人
knifesmith	刀匠
affine	姻亲
carbamic	氨基甲酸的
overpersuade	强行说服
producing	生产
mophead	拖把头
bookcase	书柜
spasmodic	间歇性
playlet	小戏
demo	样本唱片
lode	斜成矿
unaired	潮湿的
lamentable	不快的
monteverdian	蒙特威尔地的
mediterranean	中海民族
prooflike	表面光亮似新铸样币
ovoid	卵形
rocking	摇动
biggish	较大
pandit	博学家
x	X级
sandhog	隧道挖掘工人
severalfold	几倍
citing	引用
oxaloacetic	草酰乙酸
wfd	the
ccd	Coupled
scribal	抄写员的
scarlet	猩红色
faintness	微弱
tousy	权宜的
navigation	领航
homonuclear	共核的
despondence	悲观
metallurgic	冶金学的
celestially	神地
quaquversal	穹状物
puddingheaded	愚蠢
spontaneity	自发性
else	另外
unbidden	未受邀请
goy	异邦人
scrummage	参与争球
traditionary	传统的
poleax	屠斧
ethnic	种族
flippantly	轻率
allo	紧密相联的
recollected	镇定
arsenicate	用砒处理
corncake	玉米饼
fluorimetry	=fluorometry
fiat	许可
seed	成熟
aminotransferase	转氨酶
rule	章程
vliw	instruction
shaving	削
hyperphysical	与肉体分开
disappointing	使人失望的
distortive	事实的
fiberglas	玻璃纤维
wbo	Boxing
prestidigitation	变戏法
paravent	挡风屏障
destructionist	毁坏主义者
semidesert	半荒漠
worm	慢慢前进
gaud	华丽而俗气的东西
specular	镜子
recolonize	开拓殖民地
uppermost	最高的
tanghan	=tangun
slab	混凝土路面
subclass	亚纲
ioc	International
skylarker	疯狂玩乐的人
cerebrovascular	脑血管的
watchman	巡夜者
raspy	刺耳
dramatize	戏剧地表现
brushwork	绘画
topnotch	最高质量的
vehicle	交通工具
frad	Access
dechlorinate	除去……的氯
cahoot	同伙
fidget	使不安
hammerblow	撞击
resumable	可恢复的
bochum	波鸿
noust	船只停泊处
tufa	石灰华
dolmus	合租车
socket	穴
piddling	不重要的
otherness	另一物
adiaphorous	不偏不倚的
incarnate	化身的
confusedly	混乱地
chlorotrianisene	三对甲氧苯氯乙烯
setter	排字工人
command	司令部
intoxicate	使陶醉
jetted	用黑色大理石装饰的
era	时代
inlier	内围层
barky	含有树皮
thromboembolism	血栓栓塞
concretion	凝固
fore	以前
overelaborate	述说过于详细
laguey	极端的
bp	俗称BB机
complacence	沾沾自喜
condignly	应受地
title	字幕
overfall	湍流
erect	直立
grutten	greet的过去分词
racemulose	小串状花序的
harvardian	哈佛大学
monostable	单稳
customization	专用化
tridentate	有三齿
apnea	无呼吸
institute	开始
simoom	西蒙风
micr	Magnetic
impermeable	不渗透性
usefully	有效地
banting	减肥疗法
carry	支撑
nongraduate	本科生
fan	狂热者
bookcraft	文学技巧
swellheaded	自大
cooper	制桶工人
disorientate	使迷惑
underslept	undersleep
fair	美丽
tcb	照顾事业
cachinnate	大声笑
granulocyte	粒细胞
nonrecoverable	无法收回
waster	废品
egis	维护
skirting	壁脚板
thoracopagus	胸部联胎
brassily	黄铜
testicle	睾丸
marijuana	大麻干叶和花
iadl	Lawyers
raptorial	猛禽类的
fronton	山墙
spermogonium	=spermagonium
discoid	铁饼状的
hidrotic	发汗剂
mutt	杂种狗
misesteem	误估
interpleader	交互诉讼
bottom	建立基础
lurch	徘徊
deflocculant	抗絮凝剂
quanta	量子
collectively	全体
trumeau	间壁或间柱
accessory	同谋
inhere	存在
bathhouse	澡堂
westering	西下
archduchess	大公妃
somesthetic	体觉的
simple	朴素
bangladeshi	孟加拉国
source	消息来源
strangeness	不可思议
engage	从事
polysynaptic	多突触
gunnery	枪炮操作
galtonian	高尔顿优生学说的
limbo	地狱的边境
reedy	芦苇状
being	本质
cysteine	巯基丙氨酸
deoxidation	去氧
qaranc	Corps
salina	盐水湖
secularity	凡俗之心
ritzy	时髦的
posttranslational	遗传翻译后的
affliction	痛苦
apagogical	反证法的
suggestion	暗示
purpura	紫癜
masochism	性受虐狂
pathetic	可怜
consilience	一致
ektexine	外壁
neighbourless	无邻居的
overijssel	上艾瑟尔省
rapscallion	恶棍
muscatel	葡萄酒的一种
porkbutcher	杀猪屠夫
ionise	=ionize
pop	流行
whiskey	威士忌酒
sputum	唾液
discordancy	不和
painty	用涂料弄脏
anglophone	母语是英语者
electropositive	带阳电
locomotory	移动
temerarious	极大胆的
petaled	有花瓣
yokelish	乡下人的
afterwards	后来
underofficer	使官员配备不足
ploughhead	犁辕牵引铁
ecstatically	入神地
coarctate	身体包在干壳中
repower	为装上新发动机
separate	分离
radiophosphorus	放射磷
inquiet	焦急的
blast	损害
polyspermia	精液过多
sailor	水手
vidette	骑马哨兵
lithotomize	做膀胱切石手术
leewardmost	最下风的
perception	理解
plc	Limited
phalanx	密集人群
hastiness	性急
compassable	可绕
penitentiary	监狱
decarbonate	除去碳酸
habakkuk	哈巴谷书
synchronal	同时
fine	妙
cattail	柔夷花序之花
puffiness	虚胖
pstn	公共交换电话网络
prescient	预见
sarcostyle	肌原纤维
damask	缎子
restfully	平安
malfeasant	犯罪者
weave	使迂回前进
rollway	原木堆
aquicultural	溶液培养的
catechetical	问答式教学法
upbeat	上升
paganism	异教信仰
skunkery	臭鼬饲养场
earliest	初期
antirheumatic	治疗风湿药剂
pussyfoot	偷偷走路
unaccented	无重音的
ent	throat
adscititious	外加的
brassily	似黄铜
asway	摇摆
unbailable	不能保释
sinuous	蜿蜒的
intercalate	插入
monacan	摩纳哥
kitchenmaid	烧饭女佣
withe	藤条
ransack	洗劫
secondary	第二的
analemma	地球仪8字曲线
quintessence	典范
decompose	分解
homegrown	自家种植的
pleiocene	上新世
question	询问
comical	滑稽的
shrewd	精明
unheroic	给人印象不深
unendued	未给予
antalgic	止痛的
nds	Novell目录服务
rime	结晶
festucine	稻草色的
aliyah	登台读经文
nabobess	女富婆
leasehold	租赁权
strange	奇异的
rhinogenic	鼻性的
misgotten	不正当获得的
dankly	透水地
chewie	口香糖
isoagglutinogen	同种凝集原
patagonian	巴塔哥尼亚人的
xcviii	罗马数字
casse	变质
stairs	楼梯
sonorization	浊音化
teen	悲哀
limenian	利马人
monomaniacal	对一事狂热的
intourist	前苏联国际旅行社
niffy	散发恶臭
lush	味美的
implicit	绝对
corvet	木帆海防舰
qnp	后翼马前兵
supposition	推想
cried	的过去式及过去分词
gantline	通于桅顶滑车之索
sullage	污水
hirple	跛行
redraft	改写的草稿
handiwork	手工
involucrate	有花被的
oviferous	产卵的
anachronous	时代错误
prevailing	主要的
hathpace	平台
aliturgical	禁仪日
duster	掸子
usefully	有用地
haytian	海地的
unprizable	不值得评价的
lullaby	轻柔的声音
semicylindric	半柱面形
coquet	卖弄风情的
racecard	比赛程序单
ihram	伊斯兰教朝圣服
pilferage	行窃
everlasting	无止境
chromeplate	镀铬
abortion	早产
synarthrosis	不动关节
ceratin	"角状
soddish	糟糕
cmos	互补金属氧化物半导体
alloantibody	同种抗体
noogenic	心理圈的
flattering	比真容更美丽
dicker	易货
enepidermic	对皮肤用药
pipelaying	为达到某种目的之计划
profusion	丰富
tanglement	纠结
cutoff	运河
bullyrag	欺凌
spermicidal	杀精子的
outcamp	偏远的营地
suppletive	替补
truncheon	职杖
complaint	诉苦
dispense	分配
fatherhood	父性
yearningly	思慕
poltava	波尔塔瓦
piscatorial	渔民的
axenic	无异种生物混杂
proverbialist	谚语作者
dour	顽强的
crackbrained	不谨慎
distortion	曲解
homorganic	以同一器官发出
carronade	舰炮之一种
ontogenetic	个体发生的
undissembling	坦率
flashboard	闸板
irresoluble	不能解决
mns	营养学硕士
attendance	出席
menstruate	月经
atomarium	原子物理展览馆
scowl	愁容
monecious	=monoecious
rob	抢掠
monadic	单细胞生物
tumtum	鼓所发出的声音
undreaded	不被惧怕的
beatific	快乐的
magical	不可思议
x	X形的
feirie	健壮
depraved	颓废
distributively	分配地
messaline	柔软丝织品
horsing	乘马之供应
opaque	不透明的
viscountship	子爵的身份
rebellious	难于对付
nonconducting	不传导的
alarming	令人担忧
hullo	喂声
fluidonics	流体学
semibarbaric	半野蛮
peeler	警察
authentic	可信的
documentarian	记实小说作者
liberatress	为liberator之阴性词
aquiline	鹰
electret	电介体
overdrifted	被吹积物覆盖的
epitomize	摘要
chronogram	纪年铭
snath	大镰刀的柄
soil	粪便
frostwork	霜花花纹
ocs	School
intervene	介于其间
reinforcement	援军
triones	大熊座
remedial	补救
passementerie	衣服的金银饰带
inactively	无用地
lateral	侧面
acquiescent	默许的
volutin	迂回体
condor	秃鹫
fastidiously	非常讲究
pri	Primary
nanny	的昵称
lambkin	乖乖
pluriaxial	在次生枝上开花的
cyrenaica	昔兰尼加
pondokkie	芦棚
lyrate	竖琴状
assr	Autonomous
unpitied	没人同情的
highlows	有带的皮鞋
weathercock	随风倒的人
affiance	婚约
gelidity	极冷
hopple	脚栓
overwash	冲刷过
ultracritical	吹毛求疵的
provide	供应
funkia	玉簪
homoeologous	部分同源
wrangle	争吵
monomaniac	偏执狂者
incurable	不能治愈
ingestible	可吸收的
eda	电子设计自动化
refrigerate	使变冷
recast	重做的事物
hazily	模糊地
transgression	犯罪
postpositive	后置
bibliofilm	图书缩摄胶片
nonsked	不定期
revile	辱骂
quaky	震动的
tricoloured	三色
parlance	用法
irrigable	可灌溉
row	行
aciculate	有刺的
hardtack	硬面饼
medlar	欧楂属植物
oculomotor	眼球运动
compartmentalization	区分
vizcacha	=viscacha
pepperidge	gum
composure	沉着
avertible	可防止
endsville	最好的
gks	Kernel
screwball	怪僻
poke	刺探
leze	majesty
prartition'	NULL)
complacent	意
dryly	干燥
gain	收获
outward	向外
killjoy	煞风景
installation	就职
yaunde	=Yaounde
origin	出身
funipendulous	悬在绳上的
phanerogamous	有花的
retractile	缩回
subdolous	有点狡猾
hypopsychosis	=hyponoia
unwanted	不必要的
ionogen	离子原
batuque	巴突克舞
temporal	世间万物
merited	应得的
neon	氖
arborescence	树质
apractic	精神性失用症
strengthen	加强
minnie	追击炮
photonovel	摄影小说
allpowerful	有无上权力
reconstructed	重建的
quits	对等的
cranky	怪僻的
underwork	秘密工作
excessively	非常地
heavy	笨重
speciously	像是真实
pekinese	北京
floating	移动的
instreaming	内流的
flares	喇叭裤
shred	少量剩余
autocritical	自我评定的
conjuncture	危机
chubbiness	丰满
pish	嫌恶而发的声音
unassailed	未受攻击
gutturonasal	软颚鼻
embracive	无所不包的
logy	呆呆
disagreement	不调和
colossal	巨大
superduper	极出色的
older	年长
terceira	特尔赛拉岛
carnal	淫荡
cirrhotic	肝脏硬化症的
actuary	保险计算员
desmosine	锁链素
coca	古柯
tularaemia	兔热菌
dementia	痴呆
scrofulous	淋巴结核的
arboreal	乔木的
intramural	内部的
cynicism	犬儒主义
reliable	可靠的
puerperal	分娩的
gay	欢迎
incarcerate	监禁
unitive	统一的
sphingolipid	鞘脂类
unattended	无人出席
recruit	征募
decimal	十进制
hbms	英国皇家海军舰艇
nonofficeholding	下台
francophobe	讨厌法国
countertendency	反倾向
stalagmite	石笋
moorage	系泊处
eupneic	平静呼吸
ringlet	卷发
deposable	可供证
intercourse	交流
muskone	=muscone
gramineous	禾本科的
salesgirl	女店员
norn	司命运的三女神之一
poolroom	收赌注处
presentational	表象
exceptant	例外者
kumamoto	熊本
calycoid	似杯状小体的
slim	苗条的
assyrian	亚述人
trophy	用战利品装饰
osteologic	学的
inductively	诱导
battik	蜡染法
expensively	昂贵地
durance	监禁
pedlary	小商贩的货物
violence	猛烈
teapoy	茶几
exsertile	可突出
revibration	再震动
tintinnabulary	铃的
inexplicable	无法说明的
pulseless	无生气
gimmick	使暗机关
mobilise	赋予可动性
rga	Garrison
unscramble	译出密码
outriggered	装有舷外支架的
base	低级的
fade	乏味的
clear	扫除
hilac	heavy
serendipitous	偶然发现
hyperchlorhydria	胃酸过多症
www	Web
receving	收到
unorderly	混乱的
scarlet	猩红的
war	战争
wise	狡猾的
obtusely	钝
bitten	咬
consubstantiate	信奉圣体共在论
with	和……一致
pupillary	瞳孔的
multicolor	多色
churchilliana	丘吉尔的名言
theosophy	见神论
yawey	雅司病的
boughpot	花束
boorish	粗野
wolfkin	狼崽
utter	发表
palpitation	心悸
dhoti	腰布
enactive	法律制定的
trellis	装设格子架或格子棚
repairer	修理工人
runic	古代北欧文字
critic	批评家
isolation	离析
socius	会员
wnp	Party
savvy	悟性
electrophoresis	现象
universal	世界的
underclothed	穿得单薄
headstrong	刚愎的
logarithm	对数
underfocus	弱焦点
pimping	无足轻重
drumfish	石首鱼
anthropomorphic	AnWrEpEJ5mC:fst//
unimpeached	不容怀疑
fluviatic	河川
fox	狐狸
balding	成为秃头的
essentialism	实在说
bytom	比托姆
methotrexate	氨甲叶酸
nonstandard	非标准
botch	修补
terminative	终结的
metis	混血儿
assonant	类韵的
nishinomiya	西宫
update	更新
clinical	病房用
upheave	举起
ruffed	有环状羽毛
electrometry	测电术
dhow	独桅帆船的一种
hemotoxin	血毒素
moralism	道德教育
duskily	微黑
parajournalism	非常规新闻写作
poetize	有诗意地描写
amyloid	含淀粉的
usableness	可用
hyperbaton	倒装法
muzzle	喷嘴
supraoptic	视上的
general	将军
retry	再试
bedding	基床
kvass	淡啤酒
iil	injection
cosmogony	宇宙的产生
thereabout	大约
uba	of
adscititious	补充的
raised	有凸起花纹
faxes	传真
impala	黑斑羚
playa	沙漠中的盆地
shakable	可震动的
clavate	一端膨大
overplus	剩余
palaeanthropic	古人
gadgety	小玩意的
monitorship	级长或学生纠查的职务
electrokinetic	动电etIks/
erotogenic	动情
scum	糖渣
gimp	嵌心狭辫带
zulu	祖鲁族人
annoying	讨厌
drongo	燕卷尾
levy	征税
houseless	无家的
bier	棺材
circumforaneous	冒牌的
testudo	龟甲形大盾
wimple	妇女头巾
serif	截线
arctic	北极区
cosmochemistry	宇宙化学
semifluid	半流质
groom	新郎
ceilinged	有天花板
pasture	吃草
nook	隐蔽处
mock	嘲弄
curette	耳匙
septenarius	的诗行
strait	窘迫的
platypus	鸭嘴兽
rigidification	硬化
lot	抓阄
diddicoy	=didicoi
information	情报
loot	战利品
trinity	三位一体
set	提出
solvent	解决方法
tidal	潮汐的
inflorescent	开花
befell	发生
rake	放荡者
interesting	有趣味
hocus	欺骗
dentulous	齿状的
refract	使折射
gni	national
hamstring	使残废
basnet	=basinet
selflessly	忘我
biochip	生物芯片
wandering	漫游
vegetal	生长的
practised	熟练的
trisomic	三染色体
brassie	木制高尔夫球杆的一种
undertread	底胎面
rhythm	韵律
metalled	碎石铺面
ruttish	交尾热的
kos	科斯
scuff	磨损之处
online	联机
incomprehensibility	费解地
conduplicate	双折的
carful	一车之量
bigoted	执迷
inappreciation	不正确评价
pityingly	同情
handless	赤手空拳
feirie	灵活
brace	支持
impersonalize	使不具人格
erda	Energy
amity	亲善关系
sainthood	圣徒
burst	炸破
hurdle	跨栏
baculiform	棒状的
carnapper	专偷汽车的贼
protest	主张
depreciate	贬低
tapette	脂粉气的男人
preparative	预备的
termly	每一期
pinteresque	品特派戏剧的
naeb	Association
outplay	胜过
cardioactive	作用于心脏
carrion	令人作呕的
bemuse	使发呆
deepness	深度
dyscrasite	锑银矿
polybasite	硫锑铜银矿
vulcanize	热补
undiscerning	无眼力
deltoid	三角形的
patrilineage	父系家族
atactic	不规则
odontoid	齿状的
lariat	套索
kelp	海藻
hurdle	用篱笆围住
kurgan	坟头
consummative	最后完成
ansate	有把手的
superluminal	超光速的
wwf	Fund
upcountry	向内
vasoligate	结扎的输精管
abed	卧病在床
vast	巨大的
supine	掌心向上
zincograph	锌板
ced	Economic
orthopterology	直翅目昆虫论文
isogenic	同基因的
narceine	罂粟碱
surnominal	姓的
acephalous	群龙无首的
hypoglycemic	低血糖症
nab	抢夺
strive	斗争
advertise	登广告
wisp	纤细的东西
cavalier	武士
humped	有肉峰的
confirmatory	证实
inverse	反转的
osteometrical	骨测量法
tubulate	管状
kowtow	磕头
psychoactive	影响心理状态的
farcied	患有马皮疽的
revisable	可修改的
bailiff	法庭监守
piquancy	辣味
odourless	无嗅
prickly	多刺
lay	lie的过去式
overweening	骄傲的
apperceive	感知
unfastidious	不苛求
gastrojejunostomy	胃空肠吻合术
pestilence	瘟疫
surgent	澎湃
foursquare	直爽
cheetah	印度豹
nightmarish	恶梦似的
piping	平静
harbourless	无避难所
entomic	昆虫的
glengarry	苏格兰高地人戴用的无檐帽子
puppyish	小狗天性的
vastitude	广度
handwriting	笔势
putlock	脚手架跳板横木
stage	活动场所
terrorism	恐怖统治
dextrocularity	右眼优于左眼
clementina	克莱门蒂娜
thereafter	从那时以后
slack	减弱
slate	含板岩
ephelis	雀斑
sumless	无数量
possibilistic	可能主义
taboo	忌讳的
gawky	迟钝的
mousebird	鼠鸟
misknow	认错
recognizably	可辨别地
motherlike	母亲似
hausa	豪撒族
postiche	硬加的
turbosupercharged	9t\:bEJ`sjU:pEtFB:dVd/
bazzoka	反坦克火箭筒
lubricative	有润滑作用的
monition	传票
gag	塞物于……的口中
telosyndesis	=telosynapsis
exorbitant	昂贵的
oozie	驯象人
hearty	丰盛
mettle	勇气
led	发光二极管
annularly	环状
restively	难以驾御
standing	站立
pigmentize	染
autorotation	自动旋转
prank	开玩笑
set	使
delaminate	将……分层
repossession	取回
aegyptus	埃古普托斯
relabel	重新贴标签于
smd	Doctor
irrelevancy	离题
clamant	急迫
mollescent	易软化的
phenomenism	=phenomenalism
coordinator	协调者
polytonalism	多调理论
geminal	偕
tania	芋类
shivery	颤抖的
bolton	可用螺栓固定的
hydropathic	水疗院
gastrointestinal	胃与肠
rhizotomist	草药师
muchly	几乎
glamorize	使有魔力
morning	早晨
nongrammatical	不合乎文法
solitudinarian	遁世者
interfaith	不同宗教信仰者的
bivariate	二变量的
specifiable	可指明的
sinter	熔渣
flaringly	摇曳燃烧
fair	转晴
dentilabial	唇齿音
enchondrosis	内生软骨瘤
macrocell	宏单元
salade	=sallet
division	公司
courteously	亲切
storewide	包括店内全部商品的
rosiness	有希望
anepigraphic	没有刻字的的
unfortunate	使人遗憾的
associationism	观念联合论
pathbreaker	闯将
rhyme	作诗
fetial	外交
insincerely	不诚实地
slow	慢
kofta	肉丸
flabbergast	使目瞪口呆
asiadollar	亚洲美元
lungan	=longan
dvi	数码视像接口
cyclitol	环多醇
brush	掸
loveliness	漂亮
artwork	艺术品
ropeyarn	Sunday
aspersion	诽谤
rigid	刚性的
sarcosome	肌粒
etep	电子贸易系统
volley	(网球
scandalmonger	到处传播丑闻的人
inaccessibly	达不到地
gammy	跛足的
fidgety	烦燥的
wattless	无功率的
experiential	根据经验
breathless	停止呼吸的
dihydrochloride	二盐酸化物
lodgment	贮存
rightly	恰当
pustulate	生脓疱
conciliatory	调和
eunomic	良好
kauai	考艾岛
galtonian	高尔顿著作
spiky	尖刻的
levo	左旋的
cretonne	印花棉布
form	外形
agrotechny	农产品加工学
chawbacon	土佬儿
darkish	浅黑
desirable	悦人心意的
unsicker	不安全
dubitant	半信半疑者
renitent	抵抗压力
ameloblast	成釉细胞
par	平价的
rebunk	恢复……的名誉
gotama	=Gautama
denunciate	公开指责
equalizer	均衡器
bathtub	浴缸
power	权力
unit	最小的整数
elevatory	升高的
hydrastine	白毛莨碱
rosolite	玫瑰色柘榴石
prosoma	前体
fittest	胜任的
feculent	肮脏
vitativeness	热爱生命
peachful	安详
geniculation	膝状部分
greenwich	格林威治
rack	架
hypothetically	假设地
measles	包虫病
let	让……进入被承包
regimentation	管辖
unvalued	未曾估价
dissepiment	隔壁
murk	黑暗
riouw	Archipelago=Riau
drably	单调乏味
suspense	焦虑
redpoll	金翅鸟
sutler	军中小贩
rechauffe	回锅的菜肴
above	在……上方
radiculitis	脊神经根炎
xxv	25
mean	惭愧的
pack	背包
swat	Special
unintelligent	没有智能力
thrump	连续的重击声
democratism	民主主义
provoking	激怒
doorway	门口
difficult	困难
succise	截断状的
parthenogenesis	孤雌生殖
unhurried	从容不迫的
shaef	Supreme
douppioni	双宫丝
value	价格
byzantinesque	拜占庭风格
saltimbanque	江湖骗子
judaeophil	对犹太人友善的
matin	早课
equalizer	使相等的东西
gloss	假象
unenlightened	不文明
personal	亲自
ovulatory	产卵的
falsification	歪曲
kcb	Commander
eliminate	排除
verse	诗句
alchemic	炼金术
zoroastrian	索罗亚斯德教的教徒
haver	胡说八道
sevenfold	七重
sacerdotal	僧侣
eldo	Development
tabour	敲单面小鼓
bionic	仿生学
asean	Association
submaxilary	颚下腺
overfulfilment	在限期前完成
thereof	在其中
ralline	似秧鸡
paye	Earn
coincidental	巧合
brasserie	啤酒店
incunabula	古版本
gluey	粘着
handmaiden	侍女
trirectangular	三直角
eisegetical	肆意诠释的
clamant	吵闹的
ncaa	Collegiate
inkling	模糊概念
bans	结婚预告
wheezily	气喘地
urokinase	尿激酶
unapproachable	不可亲
lungful	两肺的容量
rifle	掠夺
cutcha	晒干
sticking	粘
seafarer	船员
blm	Land
volatilization	挥发
tutsi	图西人
shindy	大宴会
rawhead	妖怪
educationalist	教育家
astutely	伶俐地
allot	分配
liberia	利比里亚
oniony	洋葱似的
fascicule	束
phytocidal	杀死植物
isolator	隔音装置
very	十足的
scurrilous	嘴损
bakelite	电木
psalmody	唱赞美诗
franchisor	授予特许者
bohai	渤海
xerantic	使干燥
taxonomy	分类法
paced	步调的
atonalistic	无调性
backbench	后座议员席
sheathy	紧身的
billiard	台球
warring	敌对
tempt	试探
postpone	延迟
autogenesis	无生源说
doubtful	可疑的
platinocyanid	氰亚铂酸盐
retiree	退休人员
lewisson	鸠尾起重机
avouchment	断言
cpsu	Communist
woundy	极度的
plumbing	铅管品制造
pentateuch	摩西五书
pageboy	小听差
flippantly	没礼貌地
bled	流血
benny	安非他明药片
redo	再做
yellowbird	金翅雀
noncontent	英国上议院中投反对票的议员
rcaf	Air
fallway	朝上的坑口
disedge	使无生气
searchless	无法探究
upper	上面的
spheriform	球形的
disputably	有讨论余地
chevrotain	麝香鹿
processionist	走在队伍里的人
clad	在金属外覆以另一种金属
gelidity	严寒
steam	蒸汽
rascaldom	流氓行径
piezometric	压力的
incipience	起初
paronychia	甲沟炎
characterful	表现性格的
georgic	农业
nymphaeaceous	莲科植物的
beclomethasone	氯地米松
syrtic	流沙
reticulated	网状
cyclical	轮转
alkalimeter	碱浓度测量器
bailable	可交保
dangler	吊着晃来晃去之物
plexiglass	树脂玻璃
trencher	挖沟者
diphtheroid	类白喉
razorjob	恶毒攻击
southpaw	用左手的
vapidness	没有生气
incompatible	不调和
adventurous	充满危险的
felv	leukemia
dinkey	小型电车
cupric	二价铜的
reedy	细长
bba	工商管理学学士
plutocratical	富豪政治
aries	白羊宫
ncte	English
pickerel	小梭鱼
rigid	严格的
demiurge	物质世界创造者
synanthropic	生态上与人类关联的
larch	落叶松属植物
word	诺言
politely	客气地
pedigree	家谱
peke	哈巴狗
handwork	手工艺
juicer	酒鬼
straight	整齐
usis	美国新闻处
kalimantan	加里曼丹
unbloody	未流血
transcendency	超然性
diplococcus	双球菌
lifeless	无生命
toolroom	工具间
snakey	=snaky
appalachia	阿巴拉契亚
hapsburg	哈布斯堡王朝
puncta	punctum的复数
riboflavin	核黄素
infringement	违反
semiautonomous	半自治的
shaker	摇动者
vagus	迷走神经
whistly	似口哨
marl	泥灰砖
mitsein	同在
healthy	健壮的
cheeringly	兴高采烈
grizzled	灰色
levee	码头
dower	给以嫁妆
uncorrectable	不能补救
electrostatic	静电
corticated	有树皮
sandbluestem	美洲须芒草
xylonite	假象牙
emulational	仿真
aseismatic	抗震的
nuclear	原子能
colidar	激光雷达
rational	有理数
udal	土地自由保有权
rogallist	悬挂式滑翔机运动员
autopsy	验尸
nonferrous	非铁
writable	可写下
provocation	挑拨
rubefacient	使发红
conidial	分生孢子的
nanna	保姆
arret	判决
trichord	三弦乐器
spongioblast	无轴索细胞
eucharistic	圣体的
tail	在后面
sarajevo	萨拉热窝
winningness	动人
insolence	傲慢
extravasation	溢出
coronetted	戴冠的
ichor	败液
twaddle	废话
atomy	微粒
rarp	Protocol
exculpatory	辩明无罪的
talisman	辟邪物
verification	作证
immature	不成熟的
remarque	印版边上的标记
pisgah	毗斯迦山
smalti	smalto
sclerosis	硬化
antiviral	抗滤过性病原体的
pyriform	梨形的
contoid	像辅音的
curculio	象鼻虫
turgescence	肿胀
holophrase	表句词
destination	目的单元格
doubly	二倍地
canalage	运河
maidless	没有侍女的
bluestone	硫酸铜
doughty	刚强的
beekeeping	养蜂
abstinent	禁欲
flamboyancy	浮华
jump	使跳跃
dainty	美味
microeconomics	微观经济学
cacumen	物体之顶端
maltworm	酒徒
excess	剩于
olive	橄榄色
downdrift	往下漂流
glaciologist	冰河学家
cutey	可爱之女孩
instantaneous	瞬间的
blues	抑郁
dominant	支配的
beggarweed	山蚂蝗
button	按钮
sea	许多
infibulate	夹住
touse	粗暴对待
lueshite	钠铌矿
abuzz	嘁嘁喳喳
stipulation	约束
ptomaine	尸碱
nooky	多角隅
gloriously	辉煌地
docent	讲师
planting	装备
infected	被感染的
unworldly	非尘世
tcb	of
dronish	懒惰
inequable	不一样
measureless	无限的
granitic	由花岗岩形成
prolative	补足谓语
quaggy	沼
invulnerability	不会受伤害
theism	有神论
surpliced	穿着白色法袍的
dupery	诈欺
sesquicentennial	一百五十年
ungraceful	无礼貌的
usv	Volunteers
callous	冷淡的
reciprocator	报答者
takeoff	卸除的
liberte	自由、平等、博爱
platonize	依从柏拉图哲学解释
azonic	不限于一地方
emblazon	盛饰
uno	Organization
fragmentized	破碎的
whitehanded	诚实的
spherical	球的
serpiginous	匐行
spherics	球面三角学
subception	perception
splenius	夹肌
anthophagous	食花的
sweathog	流大汗的苦学生
erythrosin	赤藓红
lur	Railway伦敦地下铁道
exuberant	华而不实的
ketolic	有酮醇官能团的
plowland	可耕
stockroom	商品储藏室
opaquely	不透明地
recalcitrance	反抗
unkink	使变直
demivolt	半跃
computative	喜欢计算
agonizing	苦恼
visiting	拜访
reliance	信心
rounding	环绕的
crowned	有王冠
drugpusher	贩毒者
quarterback	担任四分卫
poculiform	杯状的
raising	高
alpine	高山的
quip	讽刺
presentive	直接表示概念的
process	作用
hygeian	健康女神的
tagrag	乌合之众
paragoge	语尾加音
mandatory	命令的
edaphic	土壤的
expellant	有驱逐力
engarland	戴以花圈
caucus	核心小组会议
stagger	蹒跚
simple	易受骗的
rid	使去掉
permissibility	允许
thin	使稀少
circumpolar	极地附近
displease	使不快
hassle	争论
asc	altered
softback	平装书
dead	完全
aspi	Programming
vdc	志愿保卫队
hedgy	多灌木树篱的
multifarious	种种
waterproof	防水
unimposing	没有威信的
setback	退步
musk	能发出麝香的各种各样的植物
comous	多毛
etherealize	使灵妙
raid	袭击
impeccable	没有缺点的
subsea	海底
mutter	咕哝
spud	用小锄锄
vaticanism	梵蒂冈主义
cpo	chief
thio	含硫的
unmelodious	不入调
debe	听头
hereinbefore	以上
sublunar	地上的
extraatmospheric	大气层外
quarter	方向
spent	精疲力尽
querist	询问者
chrysanthemum	菊花
chelonian	海龟
nonsolvency	非溶剂
sheltery	遮蔽的
yate	桉树的木材
limp	易曲的
pitchman	商品宣传员
enactory	制定法律的
anemochore	由风散布种子的植物
birdbrain	愚蠢
obtuse	钝
consequence	推理
hydroformer	加氢重整装置
study	努力
stray	偶遇的
desolately	荒凉
thermophil	嗜热生物
homogametic	同
holocaust	大毁灭
anthophilous	虫媒
areolet	昆虫翅脉之间隙
thereout	从那里
votive	奉献的
bum	免费得到
downfall	大雨
habilatory	服饰的
reindict	再控告
grizzly	略灰色的
arenaceous	多沙的
wartwort	grass
ebb	退潮
pubes	阴毛
grace	雅致
albumen	胚乳
plagiotropic	斜向的
communicatee	交流对象
comber	卷浪
recivilize	使恢复文明
caginess	小心
nonpathogenic	不致病的
ate	Automatic
couchant	俯伏的
blob	一滴
distention	延伸
infectivity	传染性
lampless	无灯
bgp	边界网关协议
abcd	加快收寄投递系统
dictograph	侦听器
andirons	铁制柴架
ontogenetic	个体发育的
leporid	兔科的
rheotaxis	趋流性
rejective	拒绝
chocolaty	如巧克力般的
tractive	曳引的
haemodynamic	血液动力学的
zirconate	锆酸盐
funereal	适合葬礼的
gateman	收票员
monition	警告
foreboding	预感的
primary	原来
coital	性交的
vlbi	甚长底线干涉量度法
bilobate	二裂片的
stygian	阴黑
inamorato	情郎
interfere	干预
faltboat	一种可折叠的帆布艇
comecon	Economic
contradictory	抗辩
industrialist	实业家
insectual	昆虫似
demoded	过时的
trifilar	三点的
glutethimide	苯乙哌啶酮
conenose	吸血昆虫之一种
unhorse	推翻
kneed	有节的
calculably	可预料
amandine	含有杏仁的
wardmote	区市民会议
iatrogenic	因医生的治疗而引起的
phenacetin	非那西汀
turgid	浮夸的
gun	用枪射击
chordamesoderm	脊索中胚层
telescopically	望远镜
subpolar	靠近北极或南极
hypognathous	下口式的
rallyingly	嘲笑
prejudice	损害
squish	压扁
hallali	吹号声
vacancy	空闲
largo	庄严
scurvily	下流地
overall	全部
exenterate	取出……的内脏器官
backmarker	不享有让分优待的参赛者
coco	椰子树
pronounced	明确的
www	万维网
shiv	剃刀
jingoish	好战主义的
tungstate	钨酸盐
diffusionist	传播论者
prithee	求求你
prepositional	前置词
presidial	省区
alcoholize	醇化
frisk	搜身
antlion	蚁狮
seaboard	海岸
amnesia	健忘症
fibre	构造
amputee	受切断手术的人
aggregative	集团的
snell	精明的
codominant	等显性的
episterna	上胸骨
approvingly	满意
euhedral	自形的
graveclothes	寿衣
aga	将军
photochromic	对光反应变色
chirography	书法
square	结清
sexennial	每六年的
tramontana	干冷北风
eventual	可能的
herculean	巨大
catchy	易记住的
arenicolous	生活在沙中
sic	原文如此
christianly	如基督徒
hexahedral	六面体
torpefy	使麻痹
having	所有
slow	不活跃
terret	供穿缰绳的环
sizz	嘶嘶声
volume	卷
treasure	财宝
germanic	日尔曼语言
lippie	口红
weak	不耐用
hairdressing	美容
syncretize	融合
cowish	胆小的
stand	立
stowp	=stoup
pyretic	发烧的
arundinaceous	芦苇的
polyhidrosis	多汗
yawper	吵闹者
cofferdam	围堰
unbelievably	不可信地
portulaca	马齿苋属的植物
smirch	污迹
diversion	解闷
pulpify	使柔软
imputation	归咎
spicy	出产香料
flute	笛状物
southeastern	东南方
originate	引起
bushland	未开垦森林地带
emporia	商业中心
charmed	喜悦
vambrace	前臂铠甲
placentography	胎盘造影术
greenwing	巴鸭
extant	现存的
style	风格
faint	虚落
shvartzer	=schvartze
amused	开心
discutient	消散的
simper	痴笑
dichloromethane	二氯甲
berliozian	柏辽兹乐曲研究者
doghole	狗窝
inferno	地狱
meatman	肉商
hell	训斥
atrocious	残暴
esculent	可食用物
zaire	扎伊尔
flogging	鞭打
ramshorn	鹦鹉螺
dodecagon	十二角形
ouachita	沃希托河
heptavalent	七价的
tcd	College
plastron	胸饰
somatoplasm	体细胞原生质
phyllodium	=phyllode
unsized	未上浆的
replacement	补充兵员
preferences	参数选择
regenerator	交流换热器
foremost	最初
macrophyllous	具长叶的
setting	底座
amphichroic	两性反应
distichous	二分
infold	抱
gallery	走廊、戏院、教堂等中最高的楼座
sanguine	有望的
contadina	农妇
dlitt	doctor
upbraidingly	谴责
electrometallurgy	电冶金学
antitoxic	抗毒素的
squamaceous	多鳞
indomitably	不屈服地
pleading	恳求的
mirable	极好
aslope	成斜坡
glittery	闪光的
fearfully	非常
lignicolous	长在树上的
remarkably	显著
protectingly	加以保护地
addlepate	傻瓜
successional	接连
whittle	损害
uniform	统一
slavonian	斯拉夫尼亚人的
metonymical	换喻的
raec	皇家陆军文教队
olympian	庄严
alphahelical	α螺旋结构
obtected	有皮壳的
shandite	硫铅镍矿
ergophobia	对工作之厌恶
highway	公路
bors	鲍斯爵士
unequivocable	明确的
napiform	芜菁状的
maximum	最大量
elizabethan	伊丽莎白女王
premise	前提
remythologize	使重新神话化
agglutinative	会粘着的
molestation	骚扰
unexpanded	未被扩展的
whiskers	胡须
coprophobia	粪便恐怖
polychromic	=polychrome
unitarian	一神论者
gambado	恶作剧
vahine	中太平洋波利尼西亚
independence	独立
moor	沼地
crispate	有皱边儿的
splinterless	不会裂成碎片
feelingless	无感情的
differentiable	可微的
sudaria	有耶稣像的手帕
unoffended	未被得罪的
mainmast	主桅
cohesion	内聚力
isolation	隔离
weco	=WEC
x	第二十四的
galliambic	由两个抑扬格音步组成
distressing	使烦恼
northbound	北行的
acritical	不危险
brimful	满到边际
procathedral	代主教座堂
echovirus	ECHO
herakles	=Hercules
piscine	鱼
hent	抓
undistracted	心神不烦乱的
prostate	前列腺
premalignant	癌变前的
lecithoid	磷脂的
impreg	浸脂材
provitamin	维他命原
hydroxylate	化
covered	有屋顶的
delirifacient	谵妄促成剂
plutocratic	富豪
deific	予以神化的
ripsnorting	大不了的
beetleweed	=galax
wsa	War
tremolo	颤音
valuate	对……作估价
diamond	钻石
backfisch	未成年的女学生
caterpillar	毛虫
eaglewood	沉香木
lexicographical	词典编纂
euphemistical	婉转
leftward	在左侧
geggie	巡回演出
forethoughtful	慎重
abortive	流产
ghent	根特
sopranist	女高音歌手
aircondition	装冷气机于……
commoner	平民
filamentary	单纤维
endnotes	尾注
tonkin	东京
arrestive	引人注意
unknowable	不能知道的
goaf	废矿
sideward	向侧面地
brightness	光亮
pneumothorax	气胸
asteroid	小游星
cannoneer	炮兵
medalist	受领奖章的人
peak	使竖起
explicable	可说明的
heavier	沉重
pterodactyl	翼龙
obtestation	抗议
peppertree	胡椒树
phatic	仅仅是交际性的
pushiness	粗鲁
hoist	升起
unveil	使公诸于众
laboured	吃力的
pizazz	潇洒
counterfeiting	伪造
postmarital	婚姻结束后
oma	orderly
terran	地球人
extortionate	过高的
pressure	紧迫
lobola	男方在婚前送给新娘的财礼
overland	经过陆地的
idiotropic	内省
deb	初进社交界的女孩
sesquicentennial	一百五十年的
mainour	在盗贼身上搜到的赃物
dystrophication	河水污染
interseptal	隔间的
unio	珠蚌
multicentric	发生于多中心
cokey	可卡因瘾君子
repose	静卧
heptaglot	使用七种语言
tribometer	摩擦计
weirdie	古怪的人
toltec	托尔特克人的
seedsman	播种者
malconduct	错误行为
electrodynamometer	电测力计
abrade	摩擦
firry	多枞树的
rising	增加的
eerie	可怕
tee	搁在球座上
allround	多才多艺的
moral	道德的
reticulose	网状
semishrub	小灌木
haemodynamic	血液动力
burl	树节
sympathetically	怜悯
unfastidious	不爱挑剔的
jollop	泻药
plover	珩科鸟
furry	有锅垢的
causey	堤道
overlook	远眺
metagenesis	世代交替
tungus	通古斯人的
cosponsor	共同主办人
safebreaking	=safecracking
polyether	多醚
intestinal	侵袭肠的
terahertz	太
hypogyny	下位
availably	有效
unmethodical	无顺序的
pray	请
badness	恶劣状态
riflery	打靶练习
graniteware	花岗石花纹的陶器
whorl	盘旋
gossipmonger	爱说闲话的人
megagametophyte	雌配子体
jussive	命令
scrupulously	多顾虑地
prostacyclin	环前列腺素
washerette	自助洗衣店
dialectology	方言学
gloam	黄昏
saloop	以黄樟皮等加味的热饮料
cullis	天沟
unimpressible	不可铭刻的不易受感动的
counterweight	称锤
spermatogenic	=spermatogenetic
irdp	Protocol
carbonatite	碳酸盐岩
perfective	完成
counterchange	使互换位置
melting	熔化
network	广播网
carneous	肉色的
bloodguilty	杀人
nonpositive	非正
decapitation	解雇
suspension	暂停
polyconic	多圆锥
conroy	康罗伊
bacchante	酒神巴克斯的女祭司
kmps	公里/秒
xinca	辛卡语
gutter	装订线
carborane	碳硼烷
circuitously	曲折地
antituberculous	抗结核的
thrive	繁荣
alternation	交替
reincrease	再增加
straight	正直的
bursiform	囊形
distichously	二列地
alternant	交替
dizzy	使人晕眩
lean	瘦的
jadishness	毫无价值
exine	花粉粒外壁
crustquake	壳震
inoculum	接种体
copyread	修改
piezometric	压力
verso	封底
courage	勇气
sclerophyte	硬叶植物
perusal	精读
fortitudinous	顽强的
march	进军
uss	Ship
submissive	顺从
conferee	参加会议者
sulfanilamide	磺胺
disadvantage	劣势
flyweight	次最轻量级的拳击选手
encomiastic	阿谀
epigene	表成的
cyanidation	氰化
readjust	再调整
microdiagnosis	微诊断
leptosomatic	细长型的
splenial	夹肌的
chary	吝啬
feathery	生有羽毛
overgraze	在上实行过度放牧
baae	Astronautical
nerka	红大麻哈鱼
warrior	战斗的
rap	敲击
dolt	呆子
sheriffalty	=shrievalty
unpicturesque	不生动
gangplank	踏板
thermae	温泉浴场
palmiped	蹼足的
reincarnate	使转生
ulotrichan	有鬈发
shamois	=chamois
abustle	熙来攘往的
candu	deuterium
rammish	好色
gallinule	鹁类小鸟
supranational	超民族的
amorce	点火药
declension	倾斜
salted	有经验的
samaritan	撒马利亚人的
tetchy	脾气怪的
fill	充分
improper	不合适的
larksome	嬉戏
impressionistic	印象派
charmless	不美的
lordotic	弓背姿势的
tartrated	自酒石
cleidoic	与环境隔离
slideway	滑道
pharmaceutist	药剂师
cloud	使黯然
scrofulous	堕落的
tew	warning
plumulate	有漂亮羽毛
doored	有门
tap	开发
survey	通盘考虑
countrify	使粗俗
existence	存在
astronaut	太空人
vassalage	隶属
warp	乖戾
seasoned	老练
ladefoged	拉迪福吉德
shrillness	尖锐刺耳
simplicidentate	单门齿目的
chitarrone	长双颈诗琴
mirror	镜子
featherlet	小羽毛
rhombohedron	菱面体
choice	选择机会
offal	垃圾
polypragmatical	多管闲事
fisted	握成拳头
brow	额
retinue	随行人员
burgomaster	市长
mechanism	机制
forbore	bear的过去式
receptive	能接纳
evaluable	可评价的
quatrain	四行诗
grinningly	露齿
gallantly	漂亮地
faradize	用以感应电刺激
cleared	清除
jibboom	第二斜桅
total	总
pahoehoe	绳状熔岩
bloop	做蠢事
childermas	儿童节
spirituelle	活泼
pet	爱抚
rejectamenta	垃圾
vaccy	=vacky
christocentrism	以基督教义为中心
lunarian	研究月球的人
workbasket	针线袋
evolutive	发展的
upbind	包扎
hearthrug	炉前的地毯
atrous	深黑
plu	与我们一样身份的人
vexillum	军旗
robustious	强壮的
confuse	使糊涂
transilient	飞越的
dysthymic	心情恶劣的
pliant	顺从
correctly	恰当
virogenic	病毒所致的
developmental	发展的
curiosa	珍本
sentiment	多愁善感
ticklish	难对付的
ruthful	充满感伤的
flicker	使摇曳
unsubmissive	不服从
tuan	先生
proclamatory	布告
hijack	抢劫
larkishly	好嬉戏
cheliferous	带螯的
fatefully	决定性
spirochaeticide	杀螺旋体药
snorty	令人讨厌
unacquainted	不熟悉的
acidanthera	非洲鸢尾
tuition	学费
insufflate	吹进
coronetted	戴冠
twister	歪曲事实的人
inshore	沿海岸
expediency	权宜
framed	加外框
claimer	要物求者
tenderly	温和
pearmain	红苹果
underpinning	支柱
reemergence	再度出现
rigidification	僵化
naturopath	理疗家
gymnastic	体操的
flavodoxin	蛋白
unprovided	无支援的
hell	地狱
integral	整体的
penile	用阴茎的
pull	牵引力
allantoic	有尿囊
apa	全点可寻址
bareheaded	不戴帽子的
idolatrize	盲目崇拜
shrilly	尖锐
adulterate	通奸
forwardness	热心
willing	乐意的
waterworks	眼泪
arthropod	节肢动物的
scenic	戏剧性
puri	宫殿
forbidden	严禁的
pomiculture	果树栽培
papalize	教皇制度化
administrative	行政法庭
perioeci	珀里俄基人
unsc	联合国安全理事会
cyclopedia	百科辞典
basting	涂油
warlord	军阀
hrs	hours
reflexological	反射论的
extricable	可解救
cacogastric	消化不良
mulligatawny	咖哩肉汤
jarovization	春化处理
bimbo	女人
illiberally	小气地
demandable	可要求
flightism	逃跑主义
baculiform	杆状
totter	动摇
ropemanship	走索技术
exophthalmos	眼球突出
mesh	网丝
flow	淹没
deep	深渊
confirm	使有效
unfathered	私生
upstart	暴发户
aglare	闪耀
lutist	弹琵琶者
breather	剧烈的运动
wdp	Layer
cultivatable	可耕种
interpolatory	插入
angular	有角的
excuse	原谅
renovate	刷新
expenses	开支
oesophageal	食管的
hors	不必
expire	断气
ncte	全国英语教师理事会
feat	漂亮
flump	砰然声
kazatski	哥萨克舞
quadrable	可自乘的
mystically	神秘
cryptozoic	生于偏僻地区
arthrotropic	致关节疾病的
minitanker	小型油船
tipsily	倾斜
setup	计划
foliate	覆有叶的
oceanic	生活于海洋
digit	阿拉伯数字
linkboy	持火炬的人
submuscular	肌肉下的
resolve	分解
synchronously	同步地
dichogamic	雌雄异熟的
tortuous	转弯抹角的
farce	闹剧
amiably	和蔼可亲地
hammercloth	马车车夫座上的布篷
msj	Master
violinist	小提琴家
gpl	License
fond	宠爱的
fluorescent	荧光的
dissuasive	劝戒
erodent	腐蚀药
pure	纯净
typecast	配合其型而决定角色
brushy	毛茸茸
otherguess	别种的
kailyard	菜园
undemonstrable	无法证明
chondrification	软骨化
firefly	萤火虫
taxonomic	分类学的
doubledome	有高度文化修养的人
chomskian	乔姆斯基语言学理论的
controvertible	有辩论余地的
carboniferous	石炭层
barren	单调的
zoograft	动物体素之移植
lankiness	又瘦又高的
nescient	无知
arrival	到达
melting	熔化的
mlw	平均低潮
existent	现存
mf	混帐东西
aptotic	无变化的
guatemala	危地马拉人
orpington	鸡的一种
antirheumatic	防风湿病
distolingual	远中舌
enugu	埃努古
identic	恒等的
slower	减慢
flavescent	逐渐变黄
deutoplasm	滋养质
tho	不过
undynamic	无生气
rac	Aero
dicker	还价
phencyclidine	苯环己哌啶
ferrophosphorous	磷铁
schizo	精神分裂症的
edd	Dictionary
interknit	使交缠
transat	大型甲板躺椅
incomer	进来者
selfishness	自私自利
komati	科马提河
blatant	吵闹的
imperceptible	感觉不到
pleadingly	诉愿
lualaba	卢瓦拉巴河
crush	压垮
echoism	形声
palladium	钯
supinely	仰卧
naeb	Broadcasters
inconsequently	不合适
erosible	=erodible
spermagonium	性孢子器
udp	User
greenmail	绿票讹诈
singlehanded	单手的
authorless	匿名的
somewise	用某种方法
augural	卜占的
unperforated	=imperforate
scr	Reconnaissance
aquatint	凹铜版腐蚀制版法
instill	慢慢地灌输
harlotry	妓女
interlard	混入
genii	魔仆
vaporization	喷雾器
dernier	最终的
westy	terrier
nehemiah	5
automatic	自动
circumgyration	旋转
perspective	透视画法
trifilar	三股
ambulation	移动
kuchen	德国式的蛋糕
spend	度过
hippish	悲伤的
launder	洗黑钱
assiduous	刻苦
multipoint	多位置
efficacity	功效
knockabout	小游艇
popery	天主教会
regard	重视
diagonalize	斜向移动
acknowledged	公认
prettily	悦人
smooth	平坦的
sordamente	柔和
cannular	管状
directorial	指挥者
capitular	牧师会法规
unsteadily	摇摆
tailored	剪裁讲究
way	大大地
mathematical	精确
anacidity	酸缺乏
excusal	免除
northwesterly	向西北
pit	正厅后排、正厅后排的观众
nonconformity	不一致
crankish	古怪的
dedicator	献身者
bouffe	喜剧性的
caracol	螺旋楼梯
pajama	=pajamas
anuresis	无尿
grazioso	幽雅的
supplicatory	恳求的
unspiritual	尘世的
chime	鸣
conditionality	受限制性
nigerien	尼日尔人的
bandy	打来打去
uncommon	罕有
legalize	使得到法律认可
ahum	轻哼的
averse	不愿意
inactively	不活动地
polling	轮流检测
reversedly	颠倒地
ineffectively	无效
excerption	抄录
filarial	丝虫
essoin	缺席允准
attending	主治
articulatory	关节
electrostatics	静电学
merry	欢乐
lazaret	检疫船
eastside	纽约市曼哈顿东区的
genially	亲切地
fjp	New
metamorphic	改变结构
heighten	升高
hydrometric	液体比重计
pyin	脓蛋白
tanto	太多
remedy	赔偿
nephology	云学
flimsy	没有价值
average	平均
inimicable	不利的
intrigant	奸夫
knotless	没有结
primitivity	原始性质
iconize	盲目崇拜
mavourneen	亲爱的
misplacement	遗忘
impossible	不可能的
awheel	骑脚踏车的
ventriculography	脑室造影术
balzac	巴尔扎克
diploblastic	双胚层的
dateline	国际日期变更线
gerardia	假毛地黄属植物
variorum	集注版的
inquilinous	寄居的
xms	specification
eversible	可外翻
methinks	我想
rosiness	玫瑰色
faldstool	折叠式椅子
laburnum	金链花
slade	Designers
gul	蔷薇属植物
freezing	冷冻用的
nereus	海神
glitzy	眩目的
myelosclerosis	脊髓硬化
commanding	发号施令的
wps	中文字处理系统
hamam	大众浴室
hennery	养鸡场
pawl	用制转杆使停转
gawk	呆子
cedar	雪松
serve	当仆人
kikladhes	为Cyclades之希腊文名称
incflds	包含域
span	范围
gmbh	beschrankter
inessive	指示地点
neurology	神经病学
passivism	消极主义
cromerian	克劳默人的
aidedecamp	副官
fontanel	囟门
gramineous	青草味
smoothness	光滑
potation	饮料
virosis	患病毒性疾病的
aeroballistic	空气弹道学的
princesse	公主装
levee	大堤
eonian	永久
vermicular	蠕虫
englobement	变成球状
malignance	恶意
spicy	加香料
choochoo	火车
inaugural	就职的
cycle	骑自行车
arbiter	判优器
wildwind	=hurricane
constrained	拘泥的
cocker	西班牙长耳猎犬
rapscallion	流氓
gallop	使飞跑
axseed	=crown
unequable	不平和的
endosmose	内渗
hippomania	爱马癖
hatefully	可憎
revolt	反抗
upright	正直
acetin	甘油醋酸酯
pietist	虔信派教徒
unisonous	协调的
romanza	浪漫曲
recalcitration	反对
riskily	危险万分
indeterministic	非定命论者
foresaid	上述
cardamine	碎米荠属植物
labialism	发唇音的倾向
suspension	悬浮
eleusinian	古代希腊
nondelivery	没有送达
antiquity	古代
unrwa	Agency
rhythmizable	予以节奏
fenestrate	有窗的
contagion	传染
reticence	沉默寡言
rambling	漫步的
amelioration	改善
modus	形式
tarn	小湖
prelicense	发放执照前的
hunger	欲望
levorotatory	左旋
terraneous	生存于陆地上
mediative	=mediatory
ichthyotic	鱼鳞癣的
marathonian	马拉松平原的
skeptically	怀疑
tangency	相切
jay	鸟
klan	三K党
multicollinearity	多重共线性
nightwear	寝衣
tempestuous	有暴风雨
independent	中立派
touching	动人的
preocular	眼前
housemaid	女佣
scuttle	急促地跑
ucky	脏兮兮的
corrupt	使恶化
paybox	售票处
phalanstery	共同居住之团体或其共居之房屋
breathless	无声息
hierogram	神符
boding	前兆
technicality	学术性
hydrometallurgical	湿法冶金
crayfish	小龙虾
maximin	使得点最多的战术
course	学业
lippen	依靠
pseudoalum	假矾
kokanee	红大麻花鱼
pilliwinks	夹指刑具
anemography	风论
davida	黛维达
recoronation	从立
taws	鞭打
indent	切割成锯齿状
overbrilliant	过分光辉灿烂的
fluorine	氟
distasteful	讨厌
deformation	变形
abide	坚持
sodomite	兽奸者
drum	鼓室
hadaway	快干!抓紧干!
incapability	无能
connection	亲戚
emulously	竞赛性地
ferdus	费尔德斯
skyline	以天空为背景映出轮廓
epidendrum	美洲石斛
quarte	第4姿势
figuline	陶器
pulmonic	由肺进行地
organophosphorous	有LrEs/
alkalinize	成碱性
davenport	小型写字台
meanly	吝啬地
extraterritorial	在疆界以外
afc	C
terminological	术语学的
helot	奴隶
concentrical	集中
qse	scientist
coenocytic	多核体
rezident	驻外特工
unwearied	不累
nerving	神经切除
unisonous	协调
rising	上涨
conjuration	咒语
superior	高手
sokotra	=Socotra
inkstone	砚
hypnotize	使着迷
evident	明显的
schlockmaster	次品制作者
expect	认为
theosophical	神智学的
graininess	粒状
disloyalty	背信弃义
cms	教会传教士协会
inky	漆黑
sbr	Butadiene
favour	宠爱
compossible	可共存
creak	吱吱响声
easier	更容易
bpi	每英寸字节数。
unslaked	未满足
flammability	易燃
verdancy	幼稚
refutably	可反驳
greening	绿皮苹果
slate	铺石板
radiac	辐射计
heptasyllable	七音节的诗行
gentlemanly	绅士派头
abdicant	退位者
nazirite	=Nazarite
pragmatical	独断
flatly	无力气
bemused	困惑
nlp	program
epizoic	体外寄生
transversal	横肌
ft	英尺
paratonic	外来刺激引起
book	篇
nailer	制钉者
shin	攀
dyfed	德韦达郡
intrepidress	无畏
wakeless	酣
extracranial	颅外的
colourably	可着色
shagginess	长成浓密繁茂的样子
hearth	壁炉地面
embryotic	萌芽期
brooky	多溪流的
comte	伯爵
herbarium	腊叶集
periodide	高碘化物
capillarity	毛细管现象
lucida	明星
ascham	阿斯克姆
unexhausted	未用竭
autodecrement	自动减量
preferential	优先
encephalomalacia	脑软化
fictionally	杜撰地
signory	领域
respectfully	谦恭
xxxix	39
ceremonious	隆重的
submundane	面下
unwinnable	不能赢
church	教会
rabbi	先生
unambivalent	肯定的
unbefriended	无朋友
crispation	挛缩
wantage	缺少
grandiose	宏大的
salvage	获救的财货
crabbily	乖戾地
periodate	高碘酸盐
unpretending	谦逊
unequaled	无比的
opponency	对抗
heckelphone	黑克尔管
countercoup	反政变
pesterous	讨厌的
phenomenalistic	现象主义
femicide	杀害女人
morphotactics	形态配列论
psammophilous	适沙生物
versailles	凡尔赛
devoted	深爱
womera	澳洲土人用以发射矛箭或标枪的一种器具
vitta	装饰用头带
tab	标号
immunorepressive	抑制免疫力
triaxiality	三轴
hippus	虹膜震颤
protoxide	初氧化物
esterifiable	酯化的
viridity	鲜绿
sheepcot	羊栏
insuperable	不能制胜的
gumption	气概
ai	Intelligence
scholarship	学识
radioecology	放射生态学
lapse	失效
gold	金
ignobly	卑贱
problematic	问题的
mesmerise	迷住
ceuca	Economic
slump	暴跌
reglet	平条
polarimetric	偏振计
exponible	应阐明的命题
underlooker	井下工务员
economical	经济
strepitoso	吵闹
progressionist	社会进步论者
thresher	打谷机
volitant	飞的
macilent	瘦
swanskin	天鹅绒的一种
privateering	掳获商船
schizophreniform	分裂样的
wildness	野生
projecting	突出
wash	耐洗
manipulation	操作
nutty	产坚果
azotize	使氮化
knickers	短裤
pliably	易曲折
hydel	水力发电的
fancywork	刺绣品
valency	价
agrometeorological	农业气候
haemagglutinin	血细胞凝集素
malay	马来西亚
radialization	放射
figuration	定形
outdistance	抛在后头
denunciatory	非难
brooky	河道纵横的
preachify	唠唠叨叨地讲
readopt	再采纳
jobber	做散工者
indefeasible	难使无效的
like	可能
shorefront	沿岸陆
gandhism	=Gandhiism
samba	桑巴舞
tubicolous	管栖的
presell	预售
dript	drip
desmolysis	解链作用
sonnetist	=sonneteer
rural	生活在农村
succedanea	代理人
inby	在附近
goldbrick	偷懒
venous	静脉的
unfitting	不相称的
bemazed	迷惑的
monochromist	单色画家
czarevna	旧俄公主
unescorted	无人护送
perceptible	显而易见的
exe	可执行程序的扩展名
asphyxia	昏厥
slaveholding	蓄奴
washeteria	自助洗车处
pulmonic	由肺进行
homesite	住宅根据
wrest	扭
headline	大字标题
barranquilla	巴兰基利亚
evaluating	评价
nomad	游牧部落的人
abruption	分裂
outdate	使过时
electrodelic	灯光致幻的
heelpost	门柱
micr	磁墨水字符识别
bayern	拜恩州(即巴伐利亚州
verligte	进步分子
disrespect	不尊重
peroxyborate	过硼酸盐
quotiety	系数
alumnus	男毕业生
siren	汽笛
punch	冲床
reconnaissance	侦察
procaryotic	原核的
gambol	雀跃
adumbral	成荫的
stunt	使绝招
enigmatical	难解
antispasmodic	止痉挛的药
screenings	筛后残余的物
qcb	Control
yellowtop	一枝黄花
imminency	急迫
maidenhood	处女性
fruition	实现
laurel	使戴桂冠
mean	平均的
unreversed	不相反
clique	派系
sparsity	稀少
haematothermal	温血
pinup	钉在墙上
unforensic	非法庭的
vibrancy	活跃
bizonia	二战后德国西部的美英占领区
chasmal	似裂罅的
prf	pulse
stodge	狼吞虎咽
prettyish	有点美的
receptorology	受体学
tradesfolk	开商店者及其家属
sejant	伸直前脚而坐的
incumbency	责任
tenderness	敏感
octahedral	有八面
dep	Employment
exaggerative	夸张
midsection	上腹部
ventose	喜欢讲空话的
infirmary	医务室养老院
oceanographic	海洋学
featheredge	削薄……的边
tonstein	白土石
engorge	充盈
ruthless	残忍的
robustious	粗鲁的
aba	毛织物
succedaneum	代用药
craziness	发狂
coelenterate	腔肠动物的
emphatic	语势强的
fossorial	掘地的
contradance	对面舞
unjoined	不连接
tergant	作拱背状的
biology	生物
manger	马槽
drowse	使瞌睡
selflessly	忘我地
tactual	触觉的
pali	巴利语
chrp	Hardware
thereby	在那方面
goethean	歌德派
cervicovaginal	子宫颈阴道
casuistical	决疑的
iatric	药物的
histogen	组织原
piscatorial	渔民
dural	硬脑膜的
backstair	间接的
fiduciary	基于信用
halophilous	适盐质环境生长
dynamotor	发电机
furnishings	服饰用品
lickspittle	低三下四
smokebox	烟箱
derivable	可引出
nongovernment	非政府的
pushover	容易打败的对手
branch	分店
countrymen	乡下人
beestings	牝牛产后的初乳
testify	证明
protrusive	突出的
imperatorial	大将军的
univalve	单壳
computerese	电脑行话电脑语言
at	在
ucla	at
ambulacrum	步带
gloss	欺人的表面
greaten	变伟大
uncontradictable	不能反驳的
supposing	不妨去……吧
towardly	有指望
fluonomist	扫烟囱的人
nephrotoxic	对肾脏有害处的
landtied	陆连
cuspidate	有尖头
jobholder	公务人员
kanu	Union肯尼亚非洲民族联盟
also	同样
revulsive	诱导的
unseeing	没有看到的
gangsterism	犯罪
hera	火箭助推榴弹
stingaree	黄貂鱼
irritably	性急地
vagary	奇想
snollygoster	不讲原则又夸夸其谈的精明人
state	州的
achordate	无脊索的
accumulation	积聚
banco	审判官席
wingtip	翼尖
fellagha	穆斯林游击队战士
slip	Serial
vagueness	含糊
unido	联合国工业发展组织
continual	频繁的
leeriness	猜疑
sustentive	支持
appendiceal	阑尾
relation	故事
paraceisian	帕拉切尔苏斯的追随者
buddhist	佛教
humungous	=humongous
waterloo	滑铁卢
dolorous	忧伤的
hemorrhoids	痔疮
unbacked	未驯服的
earpiece	听筒
mandolin	曼陀林
dysphasic	言语困难
stp	Spanning
physical	物理的
theatricalism	戏剧风格
fatigue	累活
nippy	凛冽
outstare	以目光压倒
somber	忧郁
wampum	金钱
countrymen	同国人
psalmody	赞美诗
keeled	备有龙骨
aspermous	无种子的
moll	歹徒的女帮凶
skyey	天蓝色的
detrimental	有害
bef	Force英国远征军
hairsplitter	吹毛求疵的人
ration	定量
flanneled	穿法兰绒衣服的
piscicultural	养鱼
justle	撞
hyperpnoea	呼吸深快
canalicular	似小管
dogmatic	教条的
hypothetical	假定的
suasive	有说服力的
overproportion	过大的比例
sextupole	六极
haemocytoblast	血细胞
flush	直接
hydrotherapeutic	水疗法
incorruption	清廉洁白
overcolour	着色过浓
dagoba	舍利塔
kithe	显现
aesthete	唯美主义者
ultraliberal	极端自由主义的
rebelliousness	难以控制
image	反映
deposable	可罢黜的
inapposite	不合适
receptive	善于接受的
squash	南瓜
forjudge	=forejudge
lpg	Liquefied
chyme	半流体的消化物
remnant	残留的
fortifier	增强论点力量人
mondain	上流社会绅士
litotes	间接肯定法
intractability	棘手
vagabondize	流浪
phytoflagellate	植物鞭毛虫
saturnism	铅中毒
salvage	抢救财货
flexural	曲折的
andron	古希腊男子专用房间
lithophile	亲石元素
ruttish	春情
misapply	滥用
hydropathy	水疗法
eolic	=Aeolic
homosporous	具同形孢子
infarcted	梗塞的
hate	憎恶
workmanlike	精巧
dizen	穿得漂亮
somatic	肉体
flew	fly的过去式
prancy	腾跃
truncheon	用警棍打
nasa	National
marking	斑纹
sessile	固着
gunnery	射击
ichthyolitic	鱼化石
galvanotropism	向电性
profligate	放荡的
hyenoid	残忍
caller	新鲜
clabber	变酸
diagnostician	诊断医生
lapicide	石工
righteousness	正义
secretively	隐匿
perchloric	高氯
fossilize	使成化石
ishikari	Bay
backstage	向后台
heptavalence	七价
implicit	含蓄的
phyllotactic	叶序
disaster	灾祸
fructification	结实器官
apb	points
auction	拍卖
balding	成为秃头
cosmopolitan	世界性的
yet	益发
uniform	一致的
virulent	充满敌意的
synecious	=synoecious
doll	美丽但无头脑的女子
nucleosome	核小体
resume	摘要
uncharitable	严厉的
nutso	发疯
brecknock	=Brecon
whp	水马力
lordly	有气派
rickets	驼背
zincy	含锌的
freethinker	自由思想家
ontogeny	个体发生学
determined	决定了的
cymose	聚伞花序的
plss	life
newt	蝾螈
poofy	搞同性恋
neanderthaloid	类似尼安德特人的
nrotc	Reserve
fastish	相当快速的
static	静力的
temporal	现世的
effusively	变溢地
prevail	盛行
tass	of
hardly	仅
moppet	宝宝
mre	宗教教育硕士
manganiferous	含锰
reembarkation	重新出发
xxxiv	34
electoralism	选票至上主义
buy	买
marengo	马伦戈式
nonluminous	无光的
pc99	PC99规范
inferential	推论性的
oracular	谜似的
hastate	戟状的
seed	萌芽
unmarry	离婚
pettish	闹情绪
airconditioned	装有空气调节器的
comminjute	粉碎
hegari	非洲高粱
anonym	假名
clypeiform	圆盾
quinze	十五点
purificator	圣杯的抹布
standing	标准
microprogrammable	可编微程序的
fructuous	多果实
nubbly	块状的
avionics	航空电子工学
margaritic	=margaric
unsavory	难吃
pneumatic	风力的
ingenious	机灵的
esophageal	食道的
gumptious	精力充沛
chirograph	教皇的亲笔特许证书
antiform	反传统形式
spoilage	损坏
bighead	自大
causal	因果关系的
skillfully	巧妙地
affranchise	释放
ache	渴望
pettish	易怒的
license	特许
vibrograph	振动计
current	现在的
filmdom	电影界
alloantigen	同种抗原
absently	茫然
contrary	相反
haematoid	血样的
tonsorial	理发的
furry	盖着毛皮
mintmaster	造币厂厂长
managerialism	管理主义
faldstool	跪拜台
submental	颏下的
marblehearted	铁石心肠的
imido	酰亚胺
reboil	使再沸
berat	统治者赐给人民的权利
irtron	星系红外线
histidine	组织氨基酸
adynamic	衰弱
hafnium	铪
intertropical	热带地方之间
disoperative	不合作
antichrist	反对基督者
lusty	健壮的
tuneful	音调谐美
pendency	垂下
pint	品脱
hostility	反对
phlogistic	燃素
fag	努力地工作
zinlac	玉米漆
jul	七月
prey	捕食
mongoloid	蒙古人种
pediform	脚形的
incursive	侵略的
sear	枯萎
uniplanar	同平面的
salted	盐味
lord	作威作福
mammy	保姆
unnoticed	不引人注意
rgt	regiment
upland	高
contiguous	邻近
civil	根据民法
eyesore	眼中钉
purl	潺潺流水
repellence	抵抗性
unstockinged	未穿长袜的
perdurability	持久
formular	公式的
feathered	像鸟般飞得快的
pock	痘痕
ahitophal	亚希多弗
fateful	决定性
seiche	湖震
minus	减去
sissified	女孩子气
becripple	使跛
obtund	使迟钝
itinerant	巡回
timbered	森林的
joyhouse	窑子
pandemonium	喧嚣
vacuum	真空
jag	狂欢
argentina	阿根廷
appellant	上诉
irriguous	可灌溉的
microstomous	小口的
wise	慎虑的
underwriter	保险业者
jake	家伙
scene	道具布置
about	大约
apiarian	蜜蜂
cab	计程车
abrupt	陡峭的
prepensely	故意地
fitch	臭猫
obscurantist	反启蒙主义者的
palisade	木栅
pediculicide	灭虱
wilding	野的
witchery	魅力
biscay	比斯开湾
unforgettable	忘不了
petty	小的
aggressive	有闯劲
assyrian	亚述语
cfc	chlorofluorocarbon
primary	第一位
plump	鼓起的
charcuterie	熟食店
trailside	小径一侧
absolutist	绝对论者
fluke	侥幸成功
doublet	成对的东西
runtishly	矮小地
hereditable	可继承
damnify	损害
fishlike	冷淡的
missouri	密苏里州
charmingly	迷人
bloodline	血统
acmesthesia	针刺感觉
hindoo	印度人
frascati	弗拉斯卡蒂白葡萄甜酒
ither	=other
scythe	长柄镰刀
alabaster	雪花石膏制
thuggish	暗杀的
savvy	理解
ebony	乌木制
posttranslational	转译后的
pathos	痛苦
aulic	宫廷
indonesian	印度尼西亚的
resolvent	分解物
tweeddale	=Peeblesshire
homocercal	正型
rack	折磨
db	database
faveolus	肺泡
certain	确定的
exacting	苛求的
coffie	连锁着被驱赶的一队奴隶
sirian	天狼星的
winded	通风
fossette	酒窝
purebred	纯种
reedit	重新编辑
raft	救生艇
fanum	披肩
lockless	无锁
msphe	Public
democracy	民主政治
representable	能被描绘
rotatory	回转的
assonance	类似的音
manger	牛槽
breviary	摘要
tenet	原则
agaric	伞菌
spiry	螺旋状的
hyperbolist	运用夸张法的人
xenocentric	喜爱外国之文化
cirrhosis	硬化
unseparated	未分隔的
ungalled	未擦伤
nutty	狂热
provisional	临时
cicatrix	叶痕
doss	睡床
averroism	阿威罗伊学说(伊斯兰哲学家阿威罗伊
scordato	变格定弦的
scumble	渐使颜色变浅
feeze	猛撞
fossilization	化石作用
pyrogenation	加热
bronze	青铜
my	马来西亚
hemingwayesque	具有
tintinnabular	丁当响
woman	女人的
overconfidence	自负
rehash	改头换面地重复
tailing	屑
translatable	可转移
remedy	治疗法
strawy	稻草一样
broadloom	织为单色宽幅的
varna	瓦尔纳
hade	垂直倾斜
corsican	科西嘉的
deistic	自然神论
fascinating	着魔的
entertainment	娱乐表演
suitable	适当的
indignant	愤慨
sciurine	像松鼠的
segment	分割
squalidity	脏污
filaceous	丝状
outward	外面的
scalding	尖刻
comradeliness	友情
fenceless	没有围墙
unbloody	未流血的
tzaddik	=zaddik
eunomianism	世纪基督教神学家优诺米
erethism	异常兴奋
dickensian	专门研究狄更斯者
shingle	鹅卵石
infuse	注
inner	里面的
civil	民间的
diazotroph	固氮生物
fusion	熔解
overnight	在前一夜
blossom	开花
aestidurilignosa	夏绿硬叶林
connotive	=connotative
unpolluted	清洁的
inveracious	不真实
gotham	哥谭镇
defoliant	落叶剂
helminthoid	肠虫状的
bombsight	轰炸瞄准器
fatefully	宿命
taig	天主教徒
palisade	用栅栏围护
repousse	金属细工
puppy	自负的青年
document	文档
dialectician	辩证家
transdisciplinary	跨学科
greenstuff	蔬菜
faultiness	有过失
capacious	宽敞的
plateau	高原
taxing	繁重
oarsmanship	划桨技术
vile	恶劣
servite	圣母玛利亚会修士
sprite	小妖精
pore	小孔
bacony	熏肉一样
macrocosmos	=macrocosm
mantlerock	土被
naily	钉有很多钉子
undressed	裸体
festivalgoer	参加节日活动者
endogen	内长茎植物
discord	不和谐
matted	暗淡的
instantiation	实例化
scienter	明知
gripe	激怒
insymbol	输入符号
biomagnification	生物放大
pe	Engineering
confirmedly	坚定
zincography	锌版术
songlike	像歌的
unpleated	无褶
intensivism	集约
parabolic	寓言似的
aob	Any
scleroid	硬质的
interlocutress	女谈话者
conradian	有康拉德特色
slavonic	斯拉夫民族的
jumpily	易变动地
largo	宽广的
stilly	静静地
rampageous	暴跳
runway	河道
endoergic	吸能
lipogenesis	脂肪生成
rawhide	生牛皮
augmentative	增大意义
thriftlessly	挥霍
exteroceptive	感受外界刺激
vulturous	贪婪的
ramp	坡道
araneiform	像蜘蛛
impiety	不虔诚
worshiper	崇拜者
gluttonize	暴食
yump	跃起
plexal	丛的
hookey	逃学
countermine	以计破计
wharf	码头
sluttish	邋遢
invariably	不变
smatter	一知半解
hempen	大麻制的
afoul	碰撞
chromogram	叠合式彩色正像透明片
contiguity	接触
guardsman	州辖预备役部队成员
injured	受损害
directorate	高级职员会
pitch	沥青
chromophil	亲色性的
vicinity	接近
langur	叶猴
cuddly	令人想拥抱
subeditor	副编辑
landgravine	伯爵夫人
ripeness	成熟
immunoreactive	免疫反应性的
grandmotherly	祖母
recalcitrant	反对的
inchoate	早期
connubially	夫妇般地
saucy	漂亮
boarfish	豚鼻鱼
twelvefold	十二倍地
lanceolate	披针状
frontage	房子的正面
insectivore	食虫植物
triclinium	有此种餐桌的餐室
lame	不完全的
universality	普遍性
crochet	钩边
illegally	不法地
ring	声调
iab	Internet架构委员会
cupcake	纸托蛋糕
heaping	堆得很高的
tshiluba	奇卢伯语
railhead	终点
conceivable	想得到
coony	机灵的
extrusion	突出的
thornback	刺鱼
boldness	大胆
skull	头骨
therapsid	兽孔目爬行动物
tearless	无泪
emulational	仿真的
archaeological	考古学的
protrusile	可伸出
unconditioned	无条件的
enzymolysis	酶解
causeless	偶然的
fistiana	拳击界
pop	Office
anury	无尾性
aristotelian	亚里斯多德的
superrational	超理性
nontuplet	九胞胎之一
underachieve	未能发挥学习潜能
infilter	渗进
supernatural	超自然的
dodecagonal	十二角形的
shaving	修胡须
eastwards	东方地
orogeny	山岳之形成
princock	=princox
colitis	大肠炎
unsuccess	无结果
kineticist	动力学家
unimproved	未加改良
hell	地狱中的人
spessartite	斜煌岩
fian	of
hirable	能雇用
worthless	无价值
polymorphism	多形性
hemiplegia	半身麻痹
forethoughtful	深谋远虑的
abstemious	有节制
sbn	Book
causalgic	灼状神经痛的
capricious	反复无常
plastochron	间隔期
betted	bet
mildewy	发霉
reproachless	无可非难
stardom	演员的身份
gynaecology	妇科医学
longness	长度
perceptual	知觉
encarpus	垂花装饰
careen	倾斜
humoristic	幽默
unimpressionable	不易受感动
quick	本质
sexcentenary	六百年
whoop	喘息
titanite	榍石
dcvo	the
evolutional	进展的
flakily	薄而易剥落地
gillyflower	康耐馨
revolutionise	=revolutionize
mohism	墨家思想
italian	意大利的
redtop	小糠草
autoincrement	自动增量
editorship	编辑的地位职位
downstairs	在楼下
infectious	易传染
hiker	徒步旅行者
cuss	家伙
diverticular	憩室
membra	的复数
ameslan	北美式手势语
circumambiency	围绕
ectype	副本
tubbish	肥胖的
overstory	上层林
formfitting	合身
exemplify	例示
genuine	诚恳
mammy	妈咪
sockdolager	决定性的打击
derivational	诱导
slab	把……分成厚片
discussible	可讨论的
accost	对……说话
dockize	为……设码头
ferlie	奇异景象
mutter	嘀咕
megagamete	=macrogamete
mrcp	皇家内科医师学会会员
baggys	宽短裤
downwind	顺风
diabolic	魔鬼似
intervocalic	出现在两个元音间的元音间
gustav	V
metasomatosis	交代
created	创造
ammonia	氨
cockneyism	伦敦人的派头
splotchy	有污点的
subjectless	无主题
enticing	迷人的
persuadable	容易说服的
sedimentologic	沉积学
telepathise	=telepathize
hematoid	血样的
sapless	枯萎
quadrennially	四年一次
rapture	欢天喜
magnitude	广大
isometrical	等大
anathemata	咒逐
edificatory	开导
dissociable	自相矛盾的
caliginous	朦胧
mapmaking	=cartography
hypohepatia	肝功能不全
ruminant	沉思
uncontested	没有人争
pedantic	书生气
emulable	可赶上
qpm	Police
unbidden	未受邀请的
nested	嵌套的
acrospire	旋状幼芽
elliptoid	椭圆
agrobusiness	=agribusiness
cool	凉爽的空气
seronegative	血清反应阴性
quadrisection	分为四等分
macular	有污点的
coxcombical	虚浮的
overcentralized	过于集权的
canyon	峡谷
noncampus	没有校舍的
peak	山顶
ruskinize	罗斯金化
bock	烈性黑啤酒
caul	大网膜
atomix	net
visionally	梦幻般
cylices	的复数
staggeringly	摇晃地
digitated	有趾的
grubstreet	文丐作品式
incendivity	引火性
disruptive	使破裂
tabasco	由非常辣的红辣椒制成的极辛辣的调味料
raised	发酵的
cloddish	土里土气
gabe	加布
lawsoniana	cypress
bailjumper	保释中逃亡之疑犯
giftie	能力
argent	银的
prostitution	卖淫
premise	作出前提
paranormal	超过正常
nightmare	恶梦
chronically	长期地
puckery	易皱的
helluva	很大
out	显露出来
unadvisable	不得当的
betwixt	在其间
treatment	治疗
erode	使变化
quotative	引证的
supralittoral	岸上
typothetae	印刷工
eeoc	Enploymcnt
hemiacetal	半缩醛
cornemuse	风笛
flange	法兰
wearproof	耐用
popularize	普及
cesarian	罗马皇帝的崇拜者
ptilosis	睫毛脱落
tabouret	小凳子
geometric	几何
pieridine	粉蝶科的
concoctive	捏造的
scout	监视
menstrua	menstuum
placental	胎盘
aerodonetics	滑翔术
homicidal	有杀人嗜好
unsuspected	未被怀疑的
cholon	堤岸
bridgeable	可架桥的
destructive	破坏
computeracy	计算机知识
amazedly	惊奇地
promptitude	迅速
slender	苗条的
magellanic	以麦哲伦命名
underslung	重心低的
aerobacter	气杆菌
hedger	作套期保值的人
condition	使达到要求的情况
trinket	琐物
meerschaum	海泡石的烟斗
convolution	回旋
endoglobular	血球内
buccaneering	海盗
securable	可得到的
unlock	开着
ek	Eastman
warp	变弯
disestablishmentarian	主AblIFmEn`teErIEn张政教分离者
caprate	癸酸酯
jaywalking	走路不遵守交通规则
bacchic	狂欢狂饮
epicentral	震中的
postliminy	战后公民资格或财产的恢复权
abyssinian	依索比亚人
notification	布告
unordinary	不平常
splay	张开
polystyle	多柱式
definite	明确
paleocrystic	古结晶的
current	趋势
gunite	喷射的水泥砂浆
tail	在后面的
belted	装甲的
consubstantial	圣体共存说
bizen	ware备前窑陶器
alizarin	茜素
skeeler	三轮滑冰鞋
militant	积极从事或支持使用武力的
poe	Port
conjunction	联合
swagger	漂亮的
tuneable	可协调
consultative	咨询的
coarsely	粗俗
apivorous	食蜂的
wizardly	男巫的
asthenic	衰弱的
oyez	静听
simplehearted	天真无邪
confer	赠与
hep	Plastic
proprieties	礼节
wainscoting	壁板
flexible	易曲的
crinite	有毛发
unjustly	不义地
uat	Aeromaritime
foxhound	猎狐用猎狗
melodramatise	=melodramatize
hobbadehoy	青年
monoaminergic	单胺能
headquarter	以……作总部
mayhem	故意的伤害罪
msj	新闻学硕士
feretrum	圣骨箱
rich	丰富的
godhood	神格
frena	frenum的复数
spiffing	出色的
forgetive	能够创造发明
westerner	美国之西部的人
nasty	污秽的
struma	瘤
crackless	无裂痕
transaxle	驱动桥
seismographic	测震学
thundering	雷一般响亮的
inby	向中心
sulfurous	含有硫磺
gyrodynamics	陀螺动力学
ketolysis	解酮作用
lymphoblastic	成淋巴细胞
blandly	殷勤地
entoptic	眼内的
organic	组织的
vhs	Home
grotesquerie	滑稽可笑
eyeservice	赞赏的目光
wismar	维斯马
interscholastic	校际
importation	进口
ramate	分枝的
yamato	日本人
participate	分担
supermalloy	超透磁合金
heavy	繁重
hdcd	Definition
introspectionism	譳FE`nIstIk/
asc	of
odourless	没有气味的
chaffingly	戏弄
calathiform	凹陷
mavis	梅维斯
laryngitic	喉炎
merited	应
providence	上帝
collie	牧羊狗
sunscald	晒伤
axe	大削减
solstice	至
unlove	停止爱
conventionality	老一套
uae	Arab
nyet	不
planter	耕作者
suety	牛脂一样
strikebreaker	破坏罢工
unattached	独立的
mongrel	混血儿
nana	祖母
shammer	骗子
aquarius	宝瓶座
broad	露骨的
sinecure	闲职
whomp	撞击的声音
roofer	盖屋顶的人
lithic	结石的
rightness	正直
reward	酬劳
twerp	无用之人
frigate	护卫舰
fillet	肉片
spinous	多刺的
ventrad	向腹部
uncontested	无竞争
malleate	压延
jubilate	欢呼
scurrilous	嘴损的
pittypat	快步而行
hufuf	=Hofuf
affiliation	联系
fortification	要塞
mac	介质访问控制
bulkily	巨大地
amazingly	令人惊讶地
indiscretion	欠详虑
flatcar	平台货车
bridewell	牢狱
lighthearted	快乐的
livelock	活锁
instant	即时的
kelly	鲜绿色
harbourer	窝藏
headworker	劳心者
supraspinal	脊椎上
vascar	Visual
crankish	暴躁的
wave	波动
cresylic	甲酚的
analyzer	分析器
knowledgeware'	NULL)
pismire	蚂蚁
crutch	拐杖
ceremonial	正式
sequent	接续而来
unmixed	纯粹的
corneous	角质
mecopteran	长翅目昆虫
greenwood	未枯干的树
swiftlet	金丝燕
filiferous	有丝状物
schanz	小街垒
comtian	孔德的
circumnutation	回旋运动
sugi	日本雪松
gmt	Mean
elaeometer	油重计
aden	亚丁
chaste	有道德的
brazier	黄铜匠
mesothoracic	中胸
trustfully	深信不疑地
usphs	Health
kerygma	福音传道
beethovenian	贝多芬风格
coha	on
heliotropism	向日性
shoreward	面向岸
vegetative	生活呆板单调
disrepair	塌毁
optimistical	乐观的
muttonchop	络腮胡
nobly	高贵地
naughty	顽皮的
eggheaded	书呆子的
howff	居住
grandfatherly	祖父似
clink	发丁当声
ahf	antihemophilic
bailable	可保释的
paralytic	瘫痪病人
cameleer	骆驼夫
leftism	左倾行为
fireboard	壁炉遮板
conjugality	夫妇生活
permittivity	电容率
hermaphrodism	=hermaphroditism
push	奋发
usual	惯例
aerobium	需氧微生物
graciously	和蔼地
recessive	逆行的
matriculant	投考者
bailer	水斗
psammophilous	喜沙生物
bureau	局
routing	行程安排
ablaze	着火的
time	记录……的时间
veiling	罩以面纱
extent	范围
danish	丹麦
biquadratic	四次的
lark	灰黄色
ocap	Platform
amaranthine	不死的
tankfuls	一槽的物
encephalitogen	en`sefE9laItEEn/
resistible	可抵抗
petrolatum	石油冻
pochard	红头潜鸭
galleries	图表种类
myosotis	勿忘我属植物
transpire	使排出
trustily	诚实
anarchic	无法无天的
nobly	豪爽
undiscernible	无法看出
moosewood	条纹槭
racquet	球拍
rook	骗子
impressiveness	令人难忘
solar	太阳
benthamism	功利主义
topograph	X射线物相照片
deep	深的
communicative	无隐讳交谈的
churchianity	教派派性
lampyrid	萤科
numbing	使麻木的
shizuoka	静冈
unsurveyed	未测量过的
lydian	吕底亚
unstressed	无重音的
eutrophy	营养正常
recurrent	再发生的
duopsony	某产品的市场
paraphrastic	改写成容易明白
crush	变形
bespatter	溅污
monterey	蒙特里杰克干酪
regular	有秩序
button	钮扣
rowboat	划艇
recalcitrate	执拗
densometer	透气度测定仪
alinement	排成直线
consubstantiate	成为同体
tirelessly	不屈不挠地
nannyish	正人君子的
rateable	可评价的
underdoctored	医生不足
lenape	德拉瓦人
pocket	财
trailer	拖车
sled	雪橇
firn	粒雪
gonfalonier	旗手
bereave	使失去
coombe	狭谷
mythological	虚构
polygamize	多配偶化
disubstituted	二基取代了
downright	全然
conidial	无性孢子
solebar	底部过梁
aal	Layer
jingly	叮玲响的
extension	客观现实的
extravagantly	挥霍无度
bladder	球胆
surcoat	外套
drop	微量
crawl	徐徐行进
oxygen	氧
cinematheque	影片储藏室
belligerent	交战
discipular	追随者的
unitar	andResearch
soap	Protocol
escheat	承受转归领主的土
following	部下
psf	square
unido	联合国工业开发组织
lawrencium	铹
baudelairean	关于波德莱尔
factious	好搞派系的
washland	河漫滩
prf	recurrence
televisor	电视播放机
slantindicular	有点斜的
neighboring	接壤
horae	霍莉
deflection	偏转
polyonymosity	一物多名
scaddle	易惊
edge	锋
hyracoid	蹄兔
attractive	有魅力
stag	刚长大的雄家禽
unaffectionate	缺乏爱的
unvexed	沉着的
anomalism	变态
curvy	弯曲的
opsonify	=opsonize
zagazig	扎加齐格
lystrosaurus	水龙兽
sdk	Software
vealy	初生牛犊般的
cuish	腿甲
pernicious	有害的
synoptic	对观福音书的
algae	海藻
sasebo	佐世保
rosery	蔷薇园
alongside	横靠
iranian	伊朗
crudeness	天然的状态
deaconship	执事
nuke	以核子武器攻击
unfitted	宽的
chlorella	绿藻的一种
accessary	同谋
ligurian	利古里亚人的
nitty	愚蠢
airsick	晕机的
ghastful	恐怖
iou	借据
singlehanded	单枪匹马
jujutsu	柔术
identically	同一地
sungrazer	掠日彗星
labourite	英国劳工工党党员
epineurium	神经外衣
willowy	多柳树
noisily	吵闹地
bliny	blin
gks	Graphics
rudy	鲁迪
kenny	肯尼
tocopherol	维生素E
rotatory	引起旋转
virginian	弗吉尼亚州的人
firstling	首批东西
cc	Islands
gynaecocracy	女权政治
corpulency	庞大
plasmodium	疟原虫
mirthful	高兴的
deism	自然神教派
strisciando	滑唱的
conscript	被征入伍的士兵
earnest	热心
b2b	to
resplendently	灿烂
leopard	豹
reintroduction	再介绍
gox	gaseous
fluxional	不定的
bev	十亿电子伏
throat	嗓音
adolescent	青春期的
putter	混过
uscgr	States
superficialize	表面化地处理
protea	普罗梯亚木
ristocetin	瑞斯西丁素
nlrb	National
tiptilt	使尖端翘起
dry	变干
claudian	克劳狄的
service	保养
lepton	古希腊的最小硬币
rounding	凑整
lithosol	石质土
lice	虱子
deuterogenesis	后期发生
foregather	偶然碰见
chicanismo	墨西哥裔美国人的强烈民族自尊心
bait	以饵引诱
caesural	休止
pansexual	泛性
mete	边界
haphazardry	随意性
foliicolous	叶上生
pyuria	脓尿
spicy	加香料的
smear	污点
accredited	质量合格
irradicable	根深蒂固
crank	脾气暴燥
isoseismal	等震线的
gph	gallons
misperceive	误解
reiterative	反复的
acock	歪斜着
incandescency	白热
incogitable	无法想像
flay	抢夺
adelantado	州长或副州长
soberminded	自我节制的
goosegog	醋栗
planograph	用平版印
costalgia	肋骨痛
laudation	颂词
polymorphic	多形
fuzzy	失真
qualification	限制
heteronomous	受不同生长规律支配的
shrimp	小虾
eutrophied	超营养作用的
rrb	Railroad
abalienate	移转
marly	泥灰质
twaddle	闲聊
archivist	案卷保管人
teledata'	NULL)
teasy	令人恼火的
theomorphic	似神
stealthy	鬼鬼祟祟
functionality	功能性
sensually	好色
piezoresistivity	压电电阻效应
polygene	多基因
volatilization	发散
driftlessness	无定向
romaic	现代希腊语
bastinade	棒打
unturned	未颠倒的
exoteric	开放的
vocally	用口头
sapor	味道
intuitivist	=intuitionist
cover	涂
mitigatory	减轻的
lcvp	craft
hulled	有船身的
congeniality	同精神
winter	冬季
rosemalt	=rosemaled
pistillate	只有雌蕊
associability	交感性
hadj	赴麦加朝圣
improvisatory	即席的
tweedy	粗花呢制
festive	喜庆的
afrikaans	南非白人的
identity	一致
feebleminded	无决断
grenadier	精锐部队的士兵
valued	尊重的
shroff	收帐员
slanchwise	斜向地
calculator	计算机
rhodesoid	罗得西亚化石人
admirably	极好地
seawant	=seawan
amplidyne	电机放大机
biased	有偏的
worship	拜神
metronomic	节拍器的
unheard	未听到的
reduction	缩图
harborage	停泊处
pd	钯
cutdown	缩小的
peachful	安详的
avellan	四臂榛果形
secularize	使还俗
vienna	维也纳
msa	Master
follow	注视
fateful	致命性的
gorsy	金雀花
eliminator	消除器
dipcoat	蜡质防水皮层
balsam	香液
pertinent	有关
hyperglycaemia	多糖症
scent	线索
halfway	不彻底
motorize	使机动化
evaginable	外翻的
indicate	指出
notion	概念
wrest	拧
mingy	卑鄙的
electrohorticulture	电化园艺
trammel	阻碍
unformat	恢复格式化
dubiety	怀疑
catching	迷人的
quintain	刺枪靶
estonian	爱沙尼亚的
bundle	束
untidy	不整洁的
regardless	不顾
streamy	流水般的
swingeing	有力
multiplexing	多路技术
impi	南部非洲班图族的一队武士
moronic	低能的
wet	有雨
verdant	翠绿
concordance	和谐
evictor	逐出者
hypobarism	比重低于脑脊髓液
fasching	狂欢节
pollard	修剪树枝
entry	对土地的侵占
bureaucratese	官场话
woad	菘蓝
either	任一
colorific	产生颜色
thinness	薄
neoorthodox	新正统运动
stopped	停下来
subcortex	皮层下部
back	早过去
wa	美国华盛顿州邮递区号
bissel	少量
swanky	炫耀
hurl	猛掷
stuggy	健壮
zapatismo	萨帕塔主义
overwalk	行走过度
repressive	压制的
injectable	血管注射剂
agana	阿加尼亚
belowdecks	在甲板下
raconteuse	女说书者
labiality	唇音性
adversity	逆境
dicker	小生意
kudo	奖赏
inappropriately	不适当地
snog	爱抚
mastoid	乳般突起
edta	乙二胺四乙酸
nephrotic	肾病变的
calculably	可计算地
daunomycin	正定霉素
scrivello	小象牙
hymnology	赞美诗学
barroom	酒吧间
ungifted	无才能
trieste	的里雅斯特
torso	未完成的作品
inquisitress	女审讯者
unimpassioned	没有激情
hyperthermal	极高热
christianlike	如基督徒的
costotome	肋骨剪
cathar	卡特里派教徒
frere	团友
oldy	=oldie
brix	德国科学家]
trickish	狡猾的
shockheaded	头发乱蓬蓬的
whipsaw	狭边钩齿粗木锯
tenebrous	黑暗的
siphonaceous	虹吸管状的
interfacial	界面的
fattest	丰满的
autotrophic	自造营养物质
hudson	York
strict	严格的
exhibitionism	自我宣传癖
squall	狂风吹袭
designator	指定者
culet	多面体宝石的底面
menshevism	旧俄时期之孟什维克党的社会民主主义
greensick	患萎黄病贫血的
indolence	愈合缓慢
sporozoite	子孢子
squeezable	可逼迫
breathlessly	屏息
dreamy	多梦的
vulcanize	硫化
delos	得洛斯
unsolvable	无法解释的
unjoined	未结合
vergeboard	=bargeboard
mechanical	机械似的
sycosis	须疮
ampliation	延期裁决
intermediary	中间物
castalie	=Castalia
resolve	解决
telluric	地上的
yavis	资质聪明、
raucousness	沙哑声
flintily	坚硬地
heavy	重
drollery	笑话
kinless	无亲戚的
weaken	削弱
spirally	成螺旋形
thermogravimetry	分析法
adgb	英国防空
pluripresence	多地点同时降临
bernie	伯尼
pierian	皮埃里亚的
galanty	show影子戏
upgrade	提升
trick	骗局
erotogenic	动情的
obtainable	可到手
crabgrass	一种杂草
wacky	乖僻的
epitaxial	外延的
escapist	逃避现实者
abolition	废除奴隶制度
hpgc	按陀螺罗经航向
paddington	帕丁顿
piggish	馋嘴的
genuinely	真诚地
bittock	少许
anglistics	英语学
cock	翘起
gedankenexperiment	思维实验
styrene	苯乙烯
joint	联合的
misdeem	判断错
tympana	鼓室
verecund	忸怩
gilbertian	诙谐
submissively	顺从地
dispreader	向各方展开
blackfeet	Blackfoot的复数
spindle	杆
yugoslavia	南斯拉夫
dartre	皮肤病
consolatory	可藉慰
site	遗址
subaquatic	半水生
lugworm	沙躅属
prefatory	序文
endurant	能忍耐
quaestor	主管财务官吏
sequestration	没收
soundproof	隔音的
cluw	Union
commend	称赞
stingy	有刺
outtalk	讲得比……多
homicidal	杀气腾腾
glidingly	滑行地
alluring	诱惑的
handpick	用手摘
nattily	帅
sitomania	间发性善饥
embryotic	初期
shool	=shovel
foundation	基金
idolatrous	崇拜偶像的
