toiler	劳动者
jwb	Welfare
euhemeristically	神话即历史论
damned	极
nairobi	奈洛比
epithalamus	上丘脑
slowness	缓慢
tactometer	触觉测量器
chart	制图
undissembling	不加掩盖的
baseband	基带
spiculate	针状的
exhaustion	详尽无遗的论述
acetyl	乙酰基
imap	Message
aniconic	无偶像的
undulated	波状
narrow	狭窄部分
rhodos	=Rhodes
eventuate	终于发生
fellow	同道
righty	用右手的
gardenless	无花园
incivilization	不文明
hirudinoid	似水蛭的
decapitator	解雇者
colewort	海甘蓝属
puling	呜咽
ichthyology	鱼类学者作
oppugn	抗击
inexpansible	不能膨胀的
concerted	协调
multidialectal	懂得2
ownerless	无主
eon	无数的年代
pluckily	大胆
knotless	没有节的
disseminate	散布
actuarial	保险精算师
mill	工厂
hypnograph	睡眠生理测定仪
peak	顶点
spill	使摔下
seething	沸腾
parcenary	共同继承
lincolnshire	林肯郡
jittery	神经过敏
defect	过失
spin	旋转
loose	宽松
prolamine	醇溶谷蛋白
unwittingly	无意地
parabombs	空袭
monocarboxylic	一元羧的
streakily	有条纹地
synchronously	同时
tapa	塔帕纤维布
chenopodiaceous	藜科的
duties	关税
fiorin	小糠草
eeling	捕鳝鱼
with	同……
abatement	消除
assailment	攻击
tache	钩扣
likewise	照样
charmless	无魅力
product	产品
bp	Beep
staple	常用的
unregimented	无组织
shapelessly	无定形
hoveller	无执照领港员
puccoon	紫草属植物
swaddle	束缚
aerosol	气雾剂
taper	锥度
prickle	扎
verisimilar	好象真实的
incity	市内的
star	星
pudge	矮胖的人
salicylate	水杨酸盐
trickiness	棘手
surfaceman	维护工人
blunder	做错
halftone	网板
sporangiophore	孢囊柄
arrowroot	竹芋粉
admiral	旗舰
satyromaniac	男性色情狂者
harvestry	收割
asu	Student
tridigitate	有三指的
ecliptic	日食
cracknel	薄饼干的一种
epilimnion	温度跃变层
libra	镑
inconsequently	不合理地
pane	面
unprompted	自发的
fundamentalism	此派的运动
choriocarcinoma	绒膜癌
dqdb	分布排列双总线
insect	卑鄙的人
seclusive	爱孤独
accomplice	同谋者
unsightly	不好看的
protechny	烟火
since	因为
sacred	神圣的
acgb	Arts
compunctious	内疚的
dou	即Dou
scrag	扭住……脖子
sophisticate	篡改
sittable	自始至终不必离座
holoenzyme	全酶
hedger	推卸回避的人
imperfectness	缺点
algerish	提倡艰苦创业精神
wandering	流浪
algologist	藻类学家
sandbag	沙袋
gct	Greenwich
cesspool	污秽场所
testimonial	证明书
northerly	来自北方的
demented	精神错乱的
unpaid	未付款
searcher	检查官
reticula	网状组织的
iadl	Association
periodic	周期的
thumbnail	极小的东西
colonus	封建时代初期之农奴
causal	因果关系
abm	AntiBallistic
wellhead	泉源
mesodont	中型牙的
selfishly	自私
ningsia	见Ningxia
temperately	适度
legend	中国最大的国有品牌微机制造商之一
damnum	损害
flush	冲洗
piperonal	洋茉莉醛
anaclastic	反曲
cassock	教士职位
necrographer	死亡启事作者
cleverly	聪明地
centriole	细胞中心粒
spcc	for
transmutability	可变形
smtp	简单邮件传输协议
turbulence	动荡
respect	有关
kludge	机
steal	偷
fourpenny	四便士的
explosible	可爆炸的
argute	机灵的
actuary	保险精算师
philotechnical	爱好工艺的
amadis	阿玛迪斯
carbinol	甲醇
bravo	喝彩
jackknife	用折叠刀切
prayerful	虔诚
isoceraunic	等雷雨
psellism	讷吃
rider	扶手
biotelemetry	生物遥测术
heft	举起试重量
parral	=parrel
try	磨难
headlike	似头
corpman	看护兵
pharmacopoeia	药典
striolate	具细条纹
soap	简单对象访问协议
abstruseness	深奥
chinaman	华人
interlude	间隔的时间)
rumina	rumen
circumterrestrial	围绕地球
filling	填补物
distillatory	蒸馏用
mean	用意
northing	北进
semiurban	半都市
toadeating	拍马
mask	石膏面像
opec	of
doa	送到时已死的
advertorial	社论式广告
ipm	minute
probity	正直
motory	运动神经的
phantasmal	幽灵的
melancholiac	忧郁症患者
unmotherly	没有母爱
cupula	子器
candida	假丝酵母
sassy	无礼的
cotentin	科唐坦半岛
illiberality	小气
teresina	特雷西纳
miseducate	教坏
propulsory	=propulsive
dolosse	异形块体
myxomycete	黏菌
imbower	以凉亭遮掩
fianna	芬尼安运动员
corrupt	贪污的
weld	焊接
jackladder	跳板
borrowed	伪造
relaunch	重新发射
tenantry	承租人
athwartships	横向
rurally	农村风味地
japanese	日语的
altricial	孵出后需母鸟照顾一段时期的
ruling	支配的
nonboarding	不供膳宿
irretentive	不能保持
oddpermutation'	NULL)
obtain	获得
uncdf	联合国资本开发基金会
allegorically	比喻地
corey	科里
inductivity	诱导性
gulfy	多旋涡的
scramble	匆忙
superannuable	退休后可领取养老金
foraminifer	有孔虫
cuss	乱骂
parvalbumin	小清蛋白
inexorable	无情
anorectal	肛门直肠的
enticement	引诱
slowpoke	迟钝的人
surge	滑脱
peristylium	周柱廊
referable	可归咎于……
sterile	贫脊的
diverting	有趣的
appoint	委任
cacophony	杂音
untaught	没有学问的
signable	可签名
demilitarization	解除武装
technics	工艺
stoical	坚忍的
cbu	cluster
appropriative	可拨用的
punctulated	有小点
pensile	做吊巢
noncellular	无细胞
unguard	使无防备
local	局部
fly	机敏
concentrative	集中性的
gamester	体育比赛中不屈不挠者
mitered	斜接
steamer	汽船
prc	Republic
chill	冷藏
revolutionism	鼓吹革命
hageman	factor
vasculitic	患脉管炎的
lavish	慷慨给予
leaven	潜移默化的影响
basis	根据
thereof	它的
glamorous	迷人
exhibit	陈列品
osteal	骨骼的
ending	结局
eternity	来生
roseate	容光焕发的
untruss	解开
leaded	行间空格特别大
rideress	女骑士
pothook	S形锅钩
lifesome	生动的
wergild	的赔偿金额
hawk	咳出
spirometry	肺
steno	速记
interlaced	交错
seabed	海底
phizog	=phiz
grumbling	出怨言
aeroelastics	空气弹性学
dae	doctor
oxycalcium	氧钙的
realizable	可实行的
visualization	使看得见的
roussillon	鲁西荣
thyrocalcitonin	降钙素
overstock	库存过剩
cerargyrite	角银矿
viscountship	头衔等
schematize	用计划表达
truehearted	诚实的
intricately	杂乱地
liege	君主
jarovize	实施人工方法使植物早熟
sedentary	不移栖
photoneutron	光中子
cryptographic	关于暗号
galvanize	通电流于
fortifiable	宜于设防
barely	几乎不能
division	分界线
homelike	亲切的
hydropsy	=dropsy
shelter	掩蔽
sloganeer	标语口号作者
pize	打击
solarimeter	日射表
proportional	比例
angwantibo	金熊猴
tco	瑞典专业雇员联盟就电磁场制定的更高标准
stanvac	美孚真空石油公司
omnifaceted	各方面的
remit	推迟
privately	私下地
ulsterman	北爱尔兰人
betcher	you
cowfish	江豚
nookie	=nooky
spinigrade	行进的
nitid	明亮的
mandan	其语言
redivivus	复活
irrevocable	不能取消的
debug	调试
smelt	胡瓜鱼
decasyllabic	十音节诗行
hadhramautian	哈达拉毛族
unwearied	不疲倦的
diuretic	利尿的
pleasant	令人愉快
uncomfortable	不舒服
norris	诺里斯
acritical	不危急
deductive	推论的
yokefellow	同事
importer	进口商
circumterrestrial	在地球周围的
polt	标出……的位置
moneywort	铜钱状珍珠菜
unprophetic	非正确预见的
legharness	护腿甲
calligraph	漂亮的书写
norwegian	挪威人
emanative	发散的
likud	利库德集团
soil	土地
absolutist	专制政治论者
mordancy	刻薄
diallel	双重
spicily	下流的
ivied	常春藤遮盖着的
endogenic	内成的
litchi	荔枝
punkie	蚊的一种
cooky	饼干
unstudied	非娇揉造作的
buddhist	佛教徒
draft	草图
episcopalian	主教的
abbreviate	简写成
fabulosity	无稽
merriment	欢喜
subcompany	子公司
satellitic	卫星
strathspey	其舞蹈曲
midgarth	人世
fijian	斐济群岛人
kinetograph	活动电影摄影机
extracurricular	课外
methanol	甲醇
sulfapyrazine	=sulphapyrazine
sunburnt	晒黑的
treatment	对待
be	存在
iarovize	春化
superscript	上角文字
araneiform	蜘蛛形
skysail	第三桅上帆
albuminoid	硬蛋白
ungifted	无才能的
intangibly	不明白地
proem	序言
precipitation	仓促
tufty	丛生的
anandrous	无雄蕊的
median	中央的
narky	脾气坏
renunciative	放弃的
epochal	划时代
module	模块
lapsable	易变
etr	Transfer
rayon	人造丝
treponema	密螺旋体
toper	豪饮者
boned	去骨
choice	精选的
ovaritis	卵巢炎
exemplar	榜样
vehicular	作为媒介的
murderous	非常危险
dragonnade	对新教徒之迫害
potstill	罐馏器
northwestwardly	向西北
calumniatory	中伤
ascensive	进步
qnp	queen''s
apa	澳洲通讯
npv	value净现值
incompatible	矛盾
kent	v
carnotite	钒钾铀矿
communicate	通信
capitalintensive	资本支出庞大的
swale	洼
taking	吸引人的
irreplaceability	不能取代
subdelegate	副代表
tacky	俗气
decadal	十的
drowsily	昏昏欲睡地
hardener	硬化者
heretic	异端者
hammerblow	打击
grateful	感激的
radiogenetics	放射遗传学
rcaf	Canadian
usher	前驱
korean	朝鲜语
isometrical	等容积
metayer	分益耕农
agilely	敏捷
endopsychic	灵魂中的
crimpy	皱缩了的
sidewise	向一边
kishke	真皮
mensurable	可测量的
another	不同
visibility	可见性
scenery	风景
attrition	磨损
osteitic	骨炎的
drinkery	酒店
unfed	未得到食物
electrograph	电位记录器
ethnocracy	一族统治
penelope	珀涅罗珀
insinuate	使慢慢滋长
tributary	辅助
lithographic	平版印刷的
aciduric	耐酸
thieve	偷
presto	急板之乐曲或乐章
raca	一文不值的
jag	颠簸的移动
goad	唆使
streamy	多水流的
cucaracha	一种墨西哥歌舞
retractile	取消
disrelish	嫌恶
unitary	整体的
maternal	似母亲
wove	weave的过去式
idc	互联网数据中心
fashionable	时髦
crispate	卷缩状
encomium	称赞
indicatory	表示
elicitation	诱出
authority	职权
octahedra	octahedron
callable	随时可偿还的
caster	调味瓶
steep	浸渍
sciamachy	模拟战
lovelace	色鬼
sothic	天狼星
feller	樵夫
sulcate	有沟的
legendry	轶话集
tribrach	三短节音步
decolour	使脱色
baor	British
ululant	吠的
enclosure	四周有篱笆或围墙的场地
era	代
pert	鲁莽的
bacillicide	杀杆菌剂
been	有
peculation	侵吞公款
hamhung	咸兴
slim	纤细的
fancied	虚构
merge	结合
uncloister	使脱离隐修院
sanguine	面色红润的
standing	标准的
backbeat	基调强节奏
whitewash	涂脂抹粉
pouched	有袋
peptic	胃蛋白酶
tenor	男高音
deploitation	经营
icy	冷淡
parasitic	寄生的
etherization	醚麻醉
romper	背心连裤子的衣服
paragenesis	paragenesia
dithered'	NULL)
cashomat	自动付款机
facula	光斑
amati	阿玛蒂提琴
march	进行曲
fraction	小部分
succursal	附属机构
quintan	每隔五天发作的
uncover	揭示
gelatiniform	胶状的
caladium	贝母
cautelous	小心的
dll	Dynamic
holder	支持物
comsomol	共青年团团员
gradation	阶级
recruit	补充
heptangular	七角
thrustful	劲头十足
acromegalic	肢端肥大症患者的
seasonably	合时令地
daily	日报
upward	声高
legantine	教宗使节
equal	相等的事物
de	德国
infrasound	次声
unwarrantable	不正当
snaky	阴险
coprophilous	嗜粪癖的
bestrid	bestride的过去分词
atremble	发抖地
bulk	体积
pseudoclassic	拟古典的
restrainedly	谨慎
groovy	槽
whipcord	拉紧的
gyration	螺层
elegant	文雅的
progeny	后裔
inverseimage	逆像
hospitably	善于款待
sweeping	规模大
deliverly	迅速地
sacrosanct	极神圣的
anthropomorphosis	有人形的
homeomorphous	同拓扑
rubeosis	潮红
two	两个
debriefing	任务报告中提出的情报
nib	鹅管笔的尖端
magnipotent	强有力的
wolfsbane	附子草
suggestible	可建议的
byrnie	锁子甲
promote	升级/降级
thermoform	使加热成形
exoergic	放能
blavatsky	布拉瓦茨基夫人
pertinence	针对性
inductance	感应系数
thirstily	如饥似渴
quickness	迅速地
diverse	不同
alphahelical	α螺旋结构的
exalted	高尚的
vendible	可销售
technochemistry	工业化学
lampas	彩花细锦缎
believable	可信的
mediation	调停
antitragus	对耳屏
zlatoust	兹拉托乌斯特
arboreal	树栖的
leukodermal	白变病的
preaxial	躯椎前
rightward	在右边的
structure	建筑
moulder	铸工
irreducible	不能削减的
quizzical	嘲弄
falteringly	口吃地
invective	漫骂的
martialize	使军事化
ndis	Interface
trappy	圈套的
market	使上市
synoptic	概要的
laminose	薄板的
dyspeptic	胃弱
disparagement	轻视
trickish	狡猾
setter	镶嵌工人
unlanded	不拥有土地的
foil	衬托
foodaholic	嗜食者
pulverous	粉状
palaver	谈判
drypoint	铜版画
determinately	确定
accost	搭话
vortically	旋转地
aids	获得性免疫功能丧失综合症
woodenly	呆板地
weakly	虚弱的
vectorgraph	矢量图
quenchable	可熄灭
synantherous	聚药
prosiness	无聊
completely	十分
uplift	举起
established	确定
myriapodal	多足纲节肢动物的
downtrodden	被压制
generalizable	可归纳的
mothering	归宁
heavy	巨大
arthurian	亚瑟王的
symbolise	=symbolize
trophy	奖品
machinize	使成为机器
autocracy	独裁政府
laurentian	劳伦系的
abradant	磨蚀剂
subsidence	陷没
parodos	合唱队登场时唱的歌
fervor	炽热
twinflower	林奈花
necessary	必需
channel	沟
duration	持续时间
qpm	女王公安勋章
sociogenic	社会引起
nostologic	老年医学的
bioassay	给……作生物测定
myology	肌肉学
southwesterly	向西南的
yeomanry	自耕农
solitarily	寂寞
ding	反复地说给人家听
fsb	Bus
dumet	铜包镍铁丝
baubee	=bawbee
tridentate	有三尖
fall	秋天的
posthorse	驿马
unkindness	不近人情
inharmonious	不合谐的
manometry	测压法
infrasonic	次声的
unobstructed	畅通无阻的
wreck	破坏
sncf	des
discretization	离散化
squawk	诉苦
colorized	彩色的
numskull	笨蛋
enunciator	发音清晰者
headrace	导水渠
aggregation	聚合
throwback	返祖
nonreturnable	不能退还的
trample	踩踏
arboreal	树栖
strafford	homas
jointless	无接缝
journo	报人
cargador	搬运工
euploid	整倍体
upstream	溯流
sedgy	莎草的
rhodochrosite	菱锰矿
methantheline	乙胺太林
gozitan	戈佐岛
asonant	无声音
preventable	可阻止
arenaceous	沙
gan	gin的过去式
ttf	TrueType字型文件
maiden	处女
secund	只在一边
filamentous	细丝状
pentagynous	五雌蕊
professional	职业艺人
municipally	市政上
sound	听起来
transformation	9trAnsfE`meIFalism/9trAnsfE`malist/9trAnsfE`mally/9trAnsfE`meist/9trAnsfE`
seat	席位
local	本地新闻
maquillage	美容品
wakamatsu	若松
lot	一块
chaplaincy	礼拜堂牧师之职位或任期
pattern	模范
puberal	青春期的
negligent	疏忽
nother	各异的
untearable	不能撕开的
circumference	圆周
esterify	酯化
micromicrofarad	微微法
unsuccessful	失败的
glitzy	耀眼的
oberon	天王星之第四卫星
discobeat	迪斯科节奏
strandloper	斯特兰特卢珀人
man	人类
transversal	截线的
effortless	不费力气的
mite	小孩
voltairean	伏尔泰
tway	天汇汉字系统
lay	产提出
dhooti	印度男子所缠之腰布
roast	烘烤
diacritical	为区别的
tensive	张力的
universal	普遍
enteron	消化道
scurvy	下流
metacenter	外心点
decohesion	检波器恢复常态
undynamic	无活力的
hapenny	=halfpenny
distressful	使苦恼
introduction	介绍
disequilibrate	打破……的平衡
faithful	详确
total	合计
trencher	有关膳食的
streamflow	流速及流水量
routinize	使成常规
viaduct	高架桥
phlogistic	炎的
ofris	Frisian
vermicular	蠕动的
muscadine	圆叶葡萄
dard	印度河上游的各种印度语
saving	保留的
kuwaiti	科威特的
wrest	歪曲
unobserved	无人遵守的
disfavor	失宠
glen	幽谷
cephalate	有头的
jog	漫步
unyoke	停止工作
enterpriser	干事业的人
eccentricity	离心率
jughead	傻瓜
replace	代替
freckle	斑点
waterhead	脑积水
demographer	人口统计学家
bank	沙洲
concentrative	集中
fallacious	虚伪
lingeringly	逗留不去
lockless	无锁的
piave	皮亚韦河
inorganizable	不能组织的
virulent	剧毒
flaked	精疲力竭
lazaretto	传染病院
ssafa	and
provocatory	=provocative
signpost	路标
tommyrot	荒唐事
oblique	无诚意
nomothetic	制定法律的
periodical	定期的
babouche	无后鞋跟的套鞋
hornswoggle	骗
facp	American
suppleness	顺从
rehearsal	演习
amebiasis	=amoebiasis
tap	轻拍
pim	Management
flyable	可以飞行的
pretend	假装
select	挑选
knowledge	学科
indoor	户内的
brainless	无头脑
seminoma	精原细胞瘤
interpretive	作为说明的
mossback	绿毛龟
spheriform	球体
toss	掷
dialysis	分离
boffo	非常流行
tritish	有点陈腐的
varimax	最大方差法
agname	别称
capsular	蒴的
iatric	医药
clear	净得
hydrogenate	使与氢化合
airboat	汽船
spinsterish	适合于老处女的
thermoform	给……用热力塑型
pda	个人数字助理
mischievous	有害的
feeblish	较弱的
goad	刺激物
inoxidize	使不受氧化
redissolve	再溶解
bouncing	活泼的
impugnable	可抨击
cytophotometry	细胞光度学
unliquidated	未例外
orchidaceous	兰花般
orthokeratology	角膜矫正术
angulated	使有角的
baggageman	行李收发员
unartificial	非人工
irrigation	灌溉
polyphyletic	多源
msfm	Forest
quassia	苦木科植物
umbellet	=umbellule
dressily	打扮入时
grappler	手
photogenic	易上镜头
oeillade	媚眼
yaup	高声喊叫声
underwriter	承诺支付者
laminose	压成薄板的
syrtic	流沙的
unscriptural	非基督教的
thuggish	暗杀
humoral	体液
maungy	坏脾气的
rickety	患佝偻病的
bidialectal	精通两种方言
taxus	紫杉
silversmith	银器匠
extragalactic	银河系外
rooseveltiana	罗斯福主义
henotic	使和谐的
bardian	吟游诗人
crumb	面包屑
inchworm	尺蠖
sick	呕吐
pyrotechnics	烟火使用
capitalizable	可作资本的
dizzyingly	令人昏乱
disproof	反证物
divider	分配器
localism	方言
katabasis	撤退
perturbation	动摇
disafforest	砍伐森林
seismotic	震
enhancive	加强的
archangelic	大天使
walkout	罢工
villainous	腐化堕落的
unbroken	继续
vicissitudinous	变迁的
hopping	卖力的
semiconductor	半导体
billingsgate	粗俗的骂人话
duality	二元性
sigmate	在字尾加上S字形的
compulsory	义务
rotascope	=gyroscope
coolly	自若
padlock	关闭
sthenic	兴奋的
salientian	无尾目
deerstalker	猎帽的一种
immigratory	迁入
baseballer	棒球队经理
convert	使……改变信仰
usha	Authority
damselfish	小热带鱼
baptize	给人施洗礼
unloose	解开
orthorhombic	斜方晶系的
heady	鲁莽的
photophilous	喜光
wandering	徘徊的
swith	迅速地
humourous	富幽默感
buckaroo	牛仔
distant	远的
incorporeal	无形体
subindex	分索引
frosting	无光泽面
cumbrous	讨厌的
studdingsail	翼横帆
gottland	=Gotland
ungrammatical	不合文法的
gingham	洋伞
cataclysm	大变动
sciolto	自由
borage	紫草科
fox	变酸
hempie	爱恶作剧
untruthful	不诚实的
migratory	流浪的
vibrancy	响亮
botb	Trade
suffer	受痛苦
residual	残留的
washiness	水分多
begrudgingly	小气
rundown	裁减
audience	接见
mildly	适度地
unreconstructed	脑筋转不过来
conquer	征服
chalcocite	辉铜矿
sublimate	纯净化
proletarianize	使无产阶级化
pantological	百科全论的
embezzle	挪用
beige	浅褐色
circs	事情
hardhead	傻瓜
fairytale	优美无比
didactical	教学
fox	奸狡地行动
rocking	摇动的
detached	分离
sleave	分成细丝
nastily	不洁地
disconcertedly	惊慌地
stagger	摇摇摆摆
ovulatory	排卵的
domesticable	可移植
leishmanial	利什曼原虫的
otherworldly	专注于精神方面的
batholithic	岩基的
impregnation	怀孕
fictionally	杜撰
trench	挖战壕
forestall	垄断
impurity	混杂物
gyral	旋转的
udf	统一光盘格式
absurdism	荒诞主义
chute	斜道
mariticide	杀妻
dnf	did
pacchionian	glands帕基奥尼氏体
uninfluential	没有影响
frequency	发生次数
firmer	坚固的
headstone	墓石
infect	传染
tiliaceous	椴科植物的
serigraph	绢网印花
shield	保护
adhesive	带粘性
wholescale	成批的
menispermaceous	防己科的
pederasty	男色关系
suitably	适宜地
correspondency	符合
bioelectrical	生物电
archie	Internet上一种用来查找其标题满足特定条件的所有文档的自动搜索服务工具
hematopoietic	生血的
rift	裂口
digs	住处
used	习惯的
exploiture	利用
confirmatory	确定的
mayfly	蜉蝣类
callipers	测径规
canaliform	状似运河或管子的
befog	罩入雾中
yardage	火车站内栏舍之使用费
ease	放松
umbra	本影
erectly	垂直地
idiotropic	内向的
degust	品尝
perspective	观察
actualite	时事
lucid	明晰的
dna	Architecture
brickfield	制砖场
subacute	稍尖的
mailer	邮寄者
daytaller	按日计酬的工人
deterministic	确定性
beggary	卑劣
fault	毛病
advised	细想过
urge	力劝
northwest	西北
ablution	清洗
illusionism	迷妄论
catalepsy	强直性昏厥
scudo	19世纪以前的意大利银币单位
ps	跋
nonconforming	非一致性的
sideline	迫使退出
habitancy	居民
recidivate	再犯
rightly	公正地
regain	重到
dishoard	减少……的储存
facs	Surgeons美国外科医师协会会员
promiscuity	杂乱
asteroid	星状的
unclassifiable	不可分类
directtissima	直接攀登
oversupply	供给过多
outdoor	室外
infatuate	冲昏头脑
liturgism	仪式主义
unnoteworthy	不值得注意
caramel	焦糖
cornett	=cornetto
hirudinoid	水蛭的
blatherskite	爱说废话的人
unreachable	不能达到的
telangiectasis	毛细管扩张
bleary	朦胧的
delicate	脆弱
superconscious	超常意识的
scutwork	枯燥的粗活
tepid	不热情的
unacknowledged	未答复的
farriery	蹄铁场
aperiodically	不定期
rba	Royal
quandang	=quandong
hunger	渴望
nymphaeum	罗马式建筑
castice	在东印度群岛出生和居住的葡萄牙人
lapsed	流失的
intraswitch	交机内的
preciously	仔细
hpna	Home
richly	富裕地
scrap	扔弃
digitated	有指的
unimplemented	未生效
mystagogical	传授秘诀
square	公平地
dogged	顽固
veda	吠陀本集
immorally	不道德
caddy	小罐
stodge	搀和
coquet	娇艳
soliloquize	自言自语
exercitor	包船者
levigate	挑选
hag	沼
frank	坦白
rickshaw	人力车
lumbaginous	腰肌痛的
aghast	惊骇的
romeldale	罗姆尔代羊
bullish	上扬的
wisha	哎呀
victoriate	维多利亚银币
spill	溅出
reverberatory	回响的
neeze	=sneeze
sickish	多病
it	pro
tudor	英国都铎王室
inexpugnable	不能驳倒的
habergeon	一件衣服
subaerial	天空下的
dejeuner	午餐
kotow	卑躬屈膝
campfire	营火会
corny	谷类的
muff	皮手笼
languorous	怠惰的
obeisance	顿首
croquet	击自己的球使其撞打对方的球
gfwc	Woment''s
electropositive	盐基性的
redefine	重新定义
purchase	买
tridentine	特伦托主教会议
divulsion	扯破
newsreader	新闻广播员
preterlegal	不合法的
assistant	助理
salty	有盐分
aforetime	以前
lasher	堰
unitary	一元
invected	作边周
fastigiate	锥形的
operation	实施
magnet	磁体
pyrosulphate	焦硫酸盐
phoenician	腓尼基人
ghi	=ghee
doldrums	忧郁
intentional	故意的
preceptorial	教师
ackey	电镀用的硝酸硫酸混合液
maidenliness	柔和
calcic	含钙的
subcaudal	尾下的
carpale	腕骨
obliquity	倾斜度
refection	小吃
thorshavn	托尔斯豪恩
kneepad	护膝
boozeroo	痛饮作乐
divisional	师的除法的
wittily	机智
disturbing	烦扰
imperceptive	无感觉
substation	分站
tizwin	=tiswin
charmless	无吸引力的
bdtr	在一个很短的时间段内能够达到的最大数据传输速率。
flatten	变平
efficiency	功效
caninity	狗类
daywork	散工
underdo	使煮得嫩
palingenesis	新生
extra	不包括在价目内
batch	批处理
consummate	圆满的
salina	盐沼
nasserite	纳赛尔的支持者
taiwanese	台湾人
filial	孝顺的
argyria	银中毒
noctuid	夜蛾科之昆虫
furfuraceous	似麸
hydroscopical	深水望远镜的
goldeye	类似鲱鱼可供食用的淡水鱼
inestimable	无价
authentically	确实
solder	焊接
begone	走开!滚蛋!
confabulation	闲谈
bellyful	满肚子
repunit	循环整数
bisection	两断
airdate	广播日期
lipper	涟漪
dressily	衣着讲究
castte	城堡
wholescale	大量的
tinnily	光亮而不值钱
tonalist	使用调性的作曲家
corolitic	树叶纹装饰的
flightily	浮躁地
color	外貌
unexpected	想不到的
totter	蹒跚
rumormonger	散布谣言者
harshly	严厉
quap	夸普
sinew	体力
balminess	芳香
sedilia	sedile的复数
wise	明智的
cusk	鳕鱼的一种
hyperpnoea	气喘
vibration	摆动
strait	苦恼
lustreless	平淡乏味
comfortlessly	不舒服地
aerial	航空
mooch	缓行
tumultuary	骚动的
espionage	间谍
moorish	摩尔人风格
vitamin	维他命
calamine	炉甘石
chevalier	爵士
discredit	使丢脸
globularity	球状
disinteresting	索然无味的
resole	给换鞋底
verecund	谦卑的
hincty	神气活现
czar	专制君主
anathematize	咒逐
palmer	朝圣者
selflessness	无私
donald	唐纳德
ferned	长满羊齿植物
silphid	埋葬虫
unhasty	慢吞吞的
noncommittal	不明朗的
crown	顶上有
coarsely	鄙俗
persuade	劝说
flimsy	浅薄
lordly	贵族般
polaron	极化子
iambus	短长格
week	星期
preoviposition	产卵期前
directness	直接
besotted	糊涂
sheepskin	毕业证书
gravidity	妊娠
navvy	工人
orca	魔鬼
engorge	贪吃
volga	伏尔加河
halt	使立定
caboshed	面朝前而无颈
epistolary	书信体
nominee	被提名的人
anxiety	渴望
fugleman	领导者
improvisatorial	即席
peritus	神学顾问
sponsorial	教父
depressing	阴沉
quintessence	精华
cramp	狭窄的
doggo	静静躲藏着
acetylate	加乙酰基于
megametre	兆米
foully	卑鄙
formal	外形
resiliometer	弹力计
saltatorial	跳跃的
erythrosine	赤藓红
burgoo	燕麦牛奶粥
rarer	更珍贵的
garni	配有饰菜
creesh	润滑脂
piercer	钻孔器
chemisorb	用化学方法吸收
voguish	时髦的
methenamine	乌洛托品
eremophilous	荒漠生
astute	狡猾的
felicitously	适切
aweto	冬虫夏草
fractional	碎片
undivorced	未分居的
overemphasis	过分的强调
beret	贝雷帽
nohow	一点也不
sarcoma	恶性毒瘤
premise	预述
fulgid	灿烂的
ventilation	通风
inductive	感应的
undeveloped	未开发的
goodwill	善意
sue	提出诉讼
antinoise	抗噪音
etymologic	语源学的
lima	狐贝属
irritating	气人
ohio	俄亥俄州
stinker	发恶臭之人
ruling	流行的
cos	莴苣的一种
shmaltz	=schmaltz
conation	意欲
endurable	能忍耐的
tropology	圣经中的比喻之解释
lockfast	锁牢
conjuring	咒术
corrigendum	勘误表
standard	标准
lipless	无嘴
schnook	笨人
polymyxin	多粘菌素
beefalo	皮弗娄牛
aspishly	似毒蛇地
osteology	骨学
dronish	懒惰的
presswoman	女记者
anecdotic	轶话
redivious	复活
hippolyte	希波吕忒
beachbound	往海滨去
cockle	使皱
wordy	多言的
atingle	兴奋
inflictive	加以打击
sponsor	主办者
onomatopoetic	拟声
politicize	搞政治
ricochet	跳飞
laker	湖畔派诗人
haggard	野性的
subvert	搅乱
famine	饥荒
translunary	似梦
poppy	深红色
trickiness	微妙
sas	System
telepathize	使传心
mac	橡胶雨衣
despiteously	可鄙地
gormandizer	老饕
frankhearted	无隐的
incipient	初始的
pullulate	抽芽
superhawk	鹰派分子
lawman	警官
incisal	割
ecbatic	表示结果
volume	体积
previse	预知
cartilaginous	软骨
clactonian	旧石器时代文化
dainty	适口的
quagmiry	多泥沼
christcross	十字形徽号
multiformity	多形
extremity	极端
annunciation	天使报喜节
tother	别
ungainliness	怪样子
fortieth	四十分之一
calfskin	小牛的皮
foregoing	在前
biomembrane	生物膜
fructification	结果实
am	在
fortnight	两星期
mucronulate	具尖突
aqueduct	沟渠
afield	在战场上
semisecret	半秘密
circumfluent	周流的
starveling	挨饿者
radiogramophone	收音电唱机
unfed	未得到食物的
quartus	第四的
speak	演讲
crepuscular	黄昏
proso	黍
spile	木栓
lyophobic	疏液的胶体
timid	羞怯
boeotian	笨蛋
orthograph	正射影
seismographer	测震学专家
squama	鳞状物
unpoetic	无想象力
iv	静脉内的
tetanize	使强直
inconsequence	不合理
synthetical	合成
ascap	and
fraught	充满……的
ya	adult
yaupon	代茶冬青
faint	变得没气力
uterine	母系
felly	轮圈
unthatch	移去……上覆盖的茅草
cigarshaped	雪茄烟形状
adiabatic	绝热
jacobin	法国雅各宾派
citizenship	公民的身份
aquagun	水下狩猎标枪
feldspathic	含长石
hermetic	密封
pentangular	有五个角
succursal	从属的
barney	吵闹
percuss	轻敲
reproducing	再制造
celibate	禁欲的
sogat	Society
biparty	两党连合的
lander	登陆车
leeway	偏航
lobectomy	叶切除术
unbelievable	难以置信的
extension	范围
stannic	四价锡
infiltree	以渗透方法入境的人
carbuncled	用红玉
brahmanical	婆罗门
bisync	Synchronous
ruined	荒废的
irian	伊里安(即新几内亚岛
plus	正
esthonia	爱沙尼亚
goyische	=goyish
anthropophuistic	神人同性论
adoptionism	相信耶稣是上帝义子的学说
traumatology	创伤学
unobservant	不遵守的
shirty	发怒的
cpo	officer
washy	水分多
pettish	易怒
time	时侯
radioulnar	桡尺骨
entirely	一概地
amende	道歉
norward	向北的
beseech	恳求
fission	分裂
undress	使卸去装饰
lustrum	五年时间
valiancy	骁勇
bultery	食品贮藏室
skeptical	怀疑性
circumvent	包围
cithaeron	西塞隆山
genuflector	屈服者
radiator	水箱
loco	发疯
underground	地下的
motorise	=motorize
cast	浇铸
haddie	=haddock
pedicure	医师
brainwash	以宣传说服
jarring	刺耳
phanerozoic	显生宙
lissotrichous	头发直
undiscipline	无训练
radiate	有射线
lightless	不发光的
oblique	间接
conradian	康拉德的
vomitus	呕吐物
semidilapidation	半倾圮状态
perpetuity	永恒
inventer	发明家
apt	有……倾向的
coha	拉丁美洲事务委员会
opercula	operculum的复数
aeropolitics	国际航空政策
orthogonalize	使正交化
hydroborate	=borohydride
squeal	长而尖的声音
nonutility	实用
parasitical	寄生
recrement	再吸收物质
marsupial	有带动物
de	Direct
extemporaneous	即席的
pillar	栋梁
reflectional	反射的
flapdoor	活板门
disjuncture	分裂
staccato	断奏
voodooist	伏都教信徒
outback	内
brotherly	亲兄弟般
derry	民谣
senatorial	参议院的
weldor	焊工
appallingly	令人毛骨悚然
taxicab	出租车
ramayana	罗摩衍那
augsburg	奥格斯堡
seto	ware
fertilize	使受精
pa	巴拿马
courtlike	高雅
pitt	Farmer皮特街"农夫"
question	审问
evidentiary	根据证据
raptured	欢天喜
preferable	更好
ragwheel	链轮
abseil	沿绳滑下法
different	不同
calyceal	萼的
sidewards	横着
calorifics	热学
execratory	诅咒性
promote	/
antiquity	古老
dactyl	强弱格
tubulate	成管的
mitigant	减轻
irrelevantly	不合适
prudish	装正经的
cleo	克利奥
fluviatic	河川的
reserve	储藏量
hyssop	牛膝草
scratch	刮擦声
venerably	尊敬地
episematic	花纹使同种动物互相认识
kindlessly	冷酷地
catalyse	促成
regermination	再发芽
nocuous	有毒的
jackal	豺
snippet	小片
narrowfisted	吝啬的
familarity	亲密
glossography	注释
prestigious	享有声望的
polyp	息肉
subinfeud	分封
rap	轻拍
quisling	卖国贼
fogbroom	驱雾器
despicably	可鄙地
neurochemistry	神经化学
argentine	银
peasant	农夫
arrogantly	傲慢
maidenish	似处女的
ululance	=ululation
corporality	物质性
scoff	轻蔑地说
piezoresistivity	压电电阻率
appreciatory	感激
vliw	word
armscye	衣服上缝衣袖的孔
flexometer	挠度仪
sidle	横着走
subsidence	下沉
dicom	Imaging
psychobabble	心理呓语
bvm	Mary圣母马利亚
fertiliser	=fertilizer
venerably	崇敬地
subliterate	粗通文墨的
mumpish	愠怒的
contactor	电流接触器
roil	激怒
hazard	使遭危险
concurrence	同时存在
grotto	岩穴
anker	安加
grimly	可怕地
checkweighman	监秤人
withering	进行干燥处理
shtick	特色
sale	贱卖
shorten	变短
outset	开端
wrinkle	皱纹
whoopee	表示兴奋激动的心情时的叫声
blazing	炽烧的
rectificative	纠正的
indistinctly	朦胧地
wreckful	造成失事
campership	野营补助金
short	不足的
don	君
undergarment	贴身衣
sisterhood	姐妹关系
novelist	小说家
talisman	法宝
boswell	为密友写传记的人
achy	疼痛
upright	笔直
antagonist	敌手
separately	分离
catonian	严厉
trickish	难对付的
join	加入
shock	打击
psammophyte	沙生植物
divulged	泄露
elaborately	苦心经营地
puniness	微小
uterus	子宫
recitatif	=recitative
smartly	火辣辣地
penetrative	深刻
rudderstock	舵杆
losable	易失
dialectologist	方言学家
spook	惊吓
cherubic	可爱
afternoon	下午的
isogamous	同配生殖的
calorification	热的发生
ecr	electronic
exosmosis	外渗
punchboard	烂污货
cyclonet	旋流净化器
consolute	会溶质
oho	高兴
stretcher	担架
apractic	精神性失用症的
proser	唠唠叨叨的人
pet	亲昵
flagellant	苦修者
fall	阵亡
gemological	宝石学
decisive	决定性
sclerotic	硬化的
verbify	使动词化
received	被一般承认的
target	目标
troglodyte	老顽固
volsteadism	禁酒主义
throatily	嘶哑地
uncomfortableness	不舒适
wheatland	小麦
manipulator	操纵器
buffalo	美洲野牛
spark	活力
francophile	崇拜法国
tegular	瓦状的
infectum	未完成体
orbit	眼眶
daee	of
castellated	构造如城的
solmizate	用音名唱
suntandy	新天地公司
exude	发散开来
hyetal	雨量的
appalling	骇人听闻的
malolactic	苹果乳酸的
relate	发生关系
waltz	华尔兹舞的
secko	性犯罪者
roughneck	粗鲁的人
sheerly	全然
hapless	倒霉的
betake	使致力于
mean	预定
fastidiously	一丝不苟
ruritanian	想像中之王国
knucklehead	蠢人
succise	截断状
tass	苏联塔斯通讯社
shakeout	轻度经济衰退
assemble	聚集
sebe	southeast
shutter	百叶窗
moving	移动
nonrecognition	不承认
pollee	接受民意测验的人
unfailingly	无穷尽
ultrabasic	超碱
latinity	拉丁语的知识
abolishment	废止
colloid	胶体的
gaudy	华而不实的
oversea	外国的
pluuiose	雨量多
piquancy	痛快
maryology	=Mariology
whenever	无论何时
taboo	禁忌、避讳
linen	亚麻的
theater	电影院
elicitation	启发
steersman	舵手
incontinent	荒淫
flitch	切成鱼块
visit	访问
prelatic	主教制
soul	灵魂
jazzman	爵士音乐家
icrp	Commission
roofless	无屋顶
rejoneo	马背斗牛术
lonely	孤独的
faint	微弱
commentate	评论
wee	微小的
blithe	高兴的
aonb	Natural
complaisant	彬彬有礼
interspace	空间
plumose	羽毛状
herculean	力大无比的
settee	有靠背的长椅
fulgor	灿烂
pendency	悬垂
pecuniary	金钱上的
externally	外形上
kvutza	小型集体农场
ho	钬
device	设计
log	把……锯成段
conclusion	结论
overhung	overhang的过去式及过去分词
strabismal	斜视的
trotty	疾走的
acyl	酰基
proof	使不被穿透
profiteering	不正当利益
imo	在我看来
rim	镶边
interspinous	棘突间
perfectible	可使完美
photometric	光度计
caledonian	古苏格兰的
lansing	兰辛
zwitterionic	两性离子的
fane	神庙
grisly	恐怖
bontebok	南非白纹大羚羊
carpogonial	果胞的
seriate	连续排列
gory	血淋淋的
brutish	如野兽般
harbourless	无港的
prepubertal	青春期前
brahmaputra	雅鲁藏布江
ard	acute
fasciolar	小束
provided	倘若
procacious	冒失的
chloramine	氯胺
preglacial	冰河期前
builder	营造商
contemptibly	卑鄙地
paraldehyde	仲醛
indurative	变硬的
extraterritorial	rI9tR:rI`AlEtI/n权
grippe	流行性感冒
rotatee	调防回归军
ningyoite	人形石
citywide	全市性的
tsangpo	Zangbo
interval	间隔
very	真正的
upcurrent	上升气流
amorite	亚摩利人
department	部门
sylvan	有森林的
vassalic	封臣的
almsgiving	救济
chablis	白葡萄酒的一种
unsegregated	没有种族隔离的
desiccated	干
circumrotatory	旋转
finish	末道漆
equiprobable	等概率
yellowy	淡黄
contractive	有收缩性的
barren	单调
leviathan	巨物
alabaman	阿拉巴马州人
poise	使平衡
indiction	诏示
vicarious	代理人的
entry	入口
robotomorphic	机械
peduncle	肉茎
stud	钮扣
deliverly	迅速
eiderdown	鸭绒被
stove	炉
wae	=woe
scoleces	scolex的复数
delphine	戴尔芬
gremmie	技术拙劣的运动员
unregimented	无组织的
exine	孢子外壁
sixteenmo	十六开本
fat	养肥
skiplane	雪上飞机
cresylic	杂酚油
imagic	形象般的
period	节
dry	干燥
epochal	新纪元的
sub	低能者
tutee	受辅导者
juristical	法律的
theosophy	接神学
judicable	可审判
formal	正式的社交活动
mortar	用灰泥涂抹
symmetrize	使均衡
incoagulable	无法凝结
zane	赞恩
precedence	优先
strikingly	醒目地
if	是否
implacentate	无胎盘
manifesto	宣言
sternly	苛刻地
unartistic	非艺术的
radicular	小根
galimatias	胡言乱语
namable	可命名
replant	移
cuspy	设计得很有效率
striated	有细条
welter	沉溺
chord	腱
reflectingly	深思地
telangiectasy	=telangiectasis
equaliser	=equalizer
precolonial	沦为殖民地前
sundial	日规
aghast	惊骇
direct	指示
afferently	传入
angelical	天使般
bronzy	青铜色
undecomposable	不可分解
azotemia	氮血
dinky	极小
audiocassette	盒式录音磁带
appreciable	可感知
confederacy	私党
leninist	列宁主义者的
localism	地方主义
cardia	贲门
joyancy	欢庆
triplication	三倍
button	扣住
adipocere	尸蜡
noctilucent	生物发光的
practically	事实上
boustrophedon	右行左行交互书写的
vandalic	汪达尔人的
future	未来的
nagaland	那加兰邦
speechify	演说
pirineos	=Pyrenees
diphenylaminechlorarsine	亚当氏毒气
rich	富饶的
reservation	保留
meticulosity	一丝不苟
frugivorous	常食果实
garrotte	绞杀
safely	安全
corrugated	缩成皱纹
stag	不带女伴的舞客
oak	橡树
assassinator	刺客
liver	生活优裕的人
recharge	再充电
moderato	中板的
foundation	建立
hyposensitive	弱敏的
frumpy	不见世面
takeup	收紧
nostologic	老人学
tipnet	TIPnet
tall	长
spandy	极好
vileness	讨厌
nutshell	坚果壳
accoutrements	军人的配备
agatha	阿加莎
nickelic	含三价镍
studdingsail	副帆
sterile	贫脊
hakka	客家人
underlying	潜在的
unsmart	不精明的
sup	进晚餐
superlatively	最高地
methoxamine	甲氧胺
tendrac	=tenrec
skittish	易激动
diminishable	可减少
weeping	垂枝的
enkindle	激起
saccharometer	糖度计
nec	NEC公司
cheeringly	令人愉快
zoom	摄象机移动
granitic	由花岗岩形成的
ascocarpous	子囊果的
take	感受
unpresumptuous	不骄傲的
flush	发烧
wraac	Women''s
magnetostatic	静磁
fateful	决定性的
unep	United
clinandrium	花粉囊
polytetrafluorethylene	oethylene/`pClI9聚四氟乙烯
multifactor	多种因素
tightfitting	贴身的
literacy	有教养
wilsonian	威尔逊
slouchy	懒散的
shade	黑暗
jug	关押
magician	善于变戏法的人
asyllabic	非音节
tumble	仓惶地行动
corer	去心器
prelection	讲演
lighthearted	心情愉快的
makable	可制作
shade	阴暗
badman	受雇刺客
hammal	搬运工
regality	王位
auxotrophy	营养缺陷型
redeemable	可赎回的
toddle	东倒西歪地走
pithily	有力
more	更加
extrascientific	科学范围外
piligerous	具毛
sullen	阴沉的
overaggressive	过于侵略成性的
burying	埋
princox	花花公子
exciting	令人兴奋
troublemaker	惹麻烦的人
rundlet	小桶
phantasmagoria	9fAntAzmE`^CrI/
egodystonic	自我失调
snowbell	大叶野茉莉
laxation	松弛
complemental	补充
improper	不合礼仪的
phlegmatical	迟钝的
bpi	inch
backsheesh	小费
trochaic	长短格
ingeniously	贤明
fast	紧的
rosyfingered	具有玫瑰色手指
supposititious	假
undercooked	煮得欠熟的
playgoer	常看戏的人
molecast	=molehill
blip	雷达上显示的点
scurrility	下流
parka	皮制大衣
formal	正式
wake	醒着
pistachio	阿月浑子树
pwd	Public
joshua	约书亚
riparian	河边
plethoric	过多的
honest	正直
ssbn	Nuclear
diandrous	有两个雄蕊
sweetness	甜蜜
tinge	使带气息
orient	东方诸国
handful	一把
battlesome	好争吵的
swivelpin	转向节主销
recapitulatory	着重阐述要点的
scrap	废料
orate	大言不惭的演说
associational	联想
darkish	微暗的
mammonism	拜金主义
hardcover	精装书
kalmia	美国石南科
interfascicular	束间的
finish	毁掉
abominable	令人憎恶的
dichroism	分色性
possibilist	可能派成员
mythologize	给神话分类
narco	=narc
touchingly	难以取悦地
pistachio	淡黄绿色
organic	有机的
stilly	平静的
russet	黄色苹果之一种
noctilucent	夜发光的
rearward	向后面
druzhinnik	民兵
bromidic	无聊的
herodian	效忠希律一世的
supine	向后靠的
capricornus	摩羯星座
crackpot	想入非非
mre	Religious
harborage	避难所
state	国营的
facture	制作
commanding	指挥
desna	杰斯纳河
jealous	妒忌
tongs	钳子
jesuitism	阴险
race	种族特征
cognation	血族关系
chin	下颚
fastener	按钮
dike	堤防
scatty	低能
fainthearted	懦弱
topless	穿袒胸衣
calycular	杯状构造的
ligament	韧带
pyrenees	比利牛斯山脉
tentative	试验
verification	查证
testacean	贝壳
snoop	到处窥视
landownership	土地所有
tyke	小孩子
orexis	欲望
ashlared	用长方石板砌成
dehumidify	除湿
aspartate	天
putrefactive	腐烂
annuli	环形
tropaeolum	旱金莲
incurve	使向内弯曲
periodically	周期性地
celotomy	绞窄赫尼亚切开术
gyroidal	回转
pitiful	令人同情的
discoverture	无丈夫的人
mysticism	神秘主义
worry	忧虑
chockablock	摆满
thinly	稀疏地
cartman	卡车司机
ah	攻击直升机
readership	读者的身分
anarchistic	无政府主义的
silence	使安静
scanty	不足
untamable	难驯服
nitwitted	傻
after	后面
diabolize	受魔鬼的影响
untamable	不能制服
trapball	射球戏用球
leprosy	麻疯病
fidgety	不安的
frater	会友
passionless	没热情
scrinium	装卷轴用的圆筒
fuze	导火管
karpathos	喀帕苏斯岛
glandule	小腺
brigantine	双桅帆船的一种
blouson	甲克衫
qumran	Community
anachronously	不合时代
hardcover	精装
quaternity	四人一组
boche	德国兵
atheoretical	与理论无关
unco	非常
preventative	=preventive
distillate	蒸馏物
ostrich	鸵鸟
tagalog	塔加路族人
elliptically	省略
swirl	挥击
outright	立刻
weighman	过磅员
effendi	阁下
clodhopping	不礼节
ardent	热情洋溢
hafta	to
tom	汤姆
talking	说话的
invincibility	无敌
wiredraw	拉长
japonic	日本特有
exsuccous	无汁
mushily	糊状
dernier	最终
hypotenuse	直角三角形之斜边
mortgager	抵押人
easygoing	不严肃的
seti	for
markhor	捻角山羊
unpleasure	不愉快
nitric	含氮
spinate	有刺的
aspirer	热望者
chorda	索
waterman	运水人
piling	打桩
indeterminate	模糊的
diaphanous	透明
blockhouse	圆木小屋
flyer	孤注一掷
whid	敏捷地移动
recuperate	复原
collaborateur	=collaborator
hoggery	养猪场
suborbicular	近似圆形
neutronics	中子物理学
ripstop	防破裂
comber	梳机
panda	黑白相间的熊类
unshrinking	不收缩的
dunnock	篱雀之类的鸟
alphanumeric	包括文字与数字的
sialoid	唾液状
reap	收获
thud	轰的一声
tsoris	不幸
primarily	首先
at	对准
laurel	桂冠
calvinism	加尔文主义
cottonwood	三叶杨
exhort	忠告
subtractive	负的
college	高等专科学院
favorite	中意的
relucent	光辉的
pyrograph	烙花
variable	变量的
stratotanker	同温层加油机
frantically	狂暴地
treat	款待
idle	空转
relaunch	重新发动
beleague	围攻
abruptness	唐突
antimatter	反物质
thenceforward	从那时
unshakable	不可动摇
emasculate	柔弱的
plutocracy	富豪统治
chuff	粗人
autolithograph	用直嬗∷⒎
fool	浪费
hurst	丛林
weight	重量
included	内藏
sunken	沉没的
pianism	钢琴演奏技巧
foolish	卤莽
epochmaking	极重要的
today	现今
meromorphic	亚纯
fortification	筑城术
playwear	游乐装
inyala	林羚
resigned	听天由命
revisit	第二次访问
wealthy	富人
usga	United
lad	家伙
capucine	monkey
bathometer	水深测量计
daystart	晨间
unpaying	无利润
hill	斜坡
vertical	直立
glycoside	配糖类
intracity	市内
securely	安全地
draught	拖
weather	经受住
topknot	顶髻
ace	一流
unsalted	新鲜
regular	正式队员
duplicity	奸诈
kabyle	其语言
menado	万鸦老
saving	节约
obstetrical	产科的
tectrix	覆羽
suakin	萨瓦金
orderless	无条理的
ineducation	缺乏教育
curial	元老院
veronica	维罗妮卡
dopaminergic	多巴胺能
gaulish	高卢
brandling	幼鲑
trichomata	毛状体
pallid	苍白的
thriftily	繁荣
thermophil	嗜热的
herder	牧人
floodlit	泛光灯照明的
swim	游泳时穿戴
sia	Airlines
firearm	火器
abortion	夭折
frenchmen	法国人
echogram	音响测深图
heptose	庚糖
congest	使拥塞
prelexical	词前成分的
radio	无线电广播设备
cowbell	母牛的颈铃
rosulate	成玫瑰花形排列
unreasonable	不合理
baptismally	用作洗礼的地方
microphotograph	缩影照片
populate	使人民居住
nosogenesis	发病原理
piddling	微不足道
trouser	裤子
drastic	猛烈的
udometric	以雨量计测定
sebotrophic	刺激泌脂的
larger	大
oviferous	带卵
communistic	共产主义者
fairway	航路
unluckily	不幸
saucepot	蒸煮锅
appulsively	撞击
abyssal	深渊的
distal	末梢
underinflated	充气不足的
secondary	次要的
bountiful	宽大
solenoid	螺线管
lohengrin	罗英格林
swank	虚张声势
mattrass	=matrass
picofarad	皮
broad	宽
substitute	替代
semimilitary	半军用
histamine	组胺
homebrewed	家酿的
perforce	必然地
heading	标题
sideman	伴奏者
onomatopoetic	声喻的
foeman	敌兵
augite	普通辉石
adsorbent	吸附剂
er	symb
newsiness	新闻多
fidge	坐立不安
disclination	旋转位移
servosystem	伺服系统
calla	水芋
more	超过
compensability	可补偿性
leglet	脚饰带
richly	贵重地
agiotage	货币兑换
painsworthy	值得下功夫
pvm	Machine
unretarded	未延迟的
photosensitise	tosensitize
hodometer	车程计
acheulian	欧洲旧石器时代早期文化的
dative	与格语
bantingize	施以班亭氏疗法
photodegrade	光降解
accommodationist	妥协
kilohm	千欧姆
choice	可选的
immigrate	移来
motionless	不动的
pallidly	无光泽地
trias	三叠系
rasp	用擦菜板擦碎
ferry	渡口
laparotome	剖腹刀
ablutionary	沐浴
orderliness	整齐
crevalle	一种可供玩赏及食用的鱼
indomitably	不屈服
disconformity	不一致
vagabond	浪荡
ludicrous	可笑的
eristic	争论
swimmingly	轻易
underpinning	基础
endowmenfpolicy	人寿保险单
polecat	臭猫
woodland	森林
opponens	对向肌
solubility	可解释性
recommendation	介绍
cogged	骗人
zoisite	黝帘石
scagliola	仿云石
exemplary	惩戒性
entail	使必需
gemmiferous	产宝石
electrolier	吊灯架
width	广博
discontiguous	不连续的
melchiades	圣梅尔凯亚迪兹
cdgps	System
boadicea	博阿迪西亚
apocryphal	伪经
gainless	一无所获的
efficient	生效的
fructuous	多产的
thymol	麝香草酚
citizenize	赋予公民权
aerotaxis	趋气性
fakement	伪造
scrumptious	味美的
triboelectric	静电
shopboy	伙计
regretable	=regrettable
uddi	"Universal
opposed	敌对
left	左倾的
supersensible	超感觉的
ancillary	补助
internship	实习医师
tarre	=tar
columniation	柱
slaughterous	好杀戮的
unpeaceful	不平静
august	令人敬畏的
parenthetical	附加说明的
paranoia	妄想狂
beguin	=Beghard
tolerant	有耐药力的
urbicide	城市特征的丧失
remissible	可赦免的
nascence	起源
mount	使上马
sbm	单点系泊
panoramist	全景画家
dissentious	好争论的
gyroplane	旋翼机
militaristic	军国主义
plainclothesman	便衣刑警
workpeople	劳工们
bazaari	商人
zygophyllum	霸王属
monstrous	难以置信的
thermantidote	冷气装置
stramony	=stramonium
thin	稀少
pronograde	俯行的
anticaries	防龋
pare	修
several	pro
picocurie	百亿分之一居里
diamantiferous	藏有钻石
concertation	共商
bangbang	枪战影片
nullproc'	NULL)
neoplasm	瘤
sickly	苍白
glonoin	硝化甘油
bumblepuppy	牌戏
hermes	element
vacate	腾出
rangoon	仰光
fruitless	不结果实
gauzily	纱似
carola	卡罗拉
thermostatic	温度调节装置
elect	推选
snoop	私家侦探
highteen	十八九岁的
spoliaopima	所夺得的武器
midnoon	正午
stearic	硬脂酸
retentivity	保持力
untaa	Assistance
digenetic	复殖
aldehyde	乙醛
octodecimo	十八开纸
accusal	控告
turbopump	涡轮泵
atrociously	万恶不赦
seedy	破旧
superconscious	超意识的
exemplarily	可为鉴戒地
uncontradictable	无法否认
take	拿
nitrochloroform	三氯硝基甲烷
ammo	弹药
elysium	至福之境
bonne	保姆
circle	盘旋
ast	Seek
contrabassoon	倍低音巴松笛
benefic	有益的
biffin	暗红色的餐用苹果
bourgeoise	中产阶级的女人
pseudopodium	虚足
contextless	无上下文
unexaminable	无法测知
pull	拔
stravage	漫游
expressman	营捷运业者
delivery	发送
postimpressionism	后期印象派的画家
vehement	激烈的
loving	钟情的
renationalize	重新收归国有
albizzia	合欢树
sweetly	香郁
junoesque	高贵优美
tricentennial	三百周年纪念
cultivated	栽植的
calendric	日历的
meliaceous	楝科
camalig	仓库
ratbaggery	流氓行为
diablo	暗黑破坏神
plaid	格子花呢披肩
timidly	羞怯地
curietherapy	镭疗法
pinwork	细小凸出饰纹
addle	腐坏的
lark	云雀
goosy	似鹅
extract	摘录
prosthesis	弥补
dystopian	反面假想国的
reindict	对……再起诉
juniorate	开办两年制预修班的学院
hypophysial	垂体的
gloss	光彩
chromophore	载色体
vela	菌膜
farcie	塞有馅
leeward	在下风方向的
celebrated	著名的
cozen	瞒
leafy	阔叶的
stiffly	呆板
rounding	圆的
footle	做笨事
cowhearted	胆小的
checked	格子花纹的
canaan	迦南
ostrichlike	鸵鸟般回避现实的
boardroom	会议室
suctorian	吸管类动物
plantation	耕
booze	酒
gladdest	glad
unsaturated	不饱和
rulebook	规则手册
connatural	同性质的
disadvantage	不利
napoleon	拿破仑
kilometer	千米
papacy	教皇的在位期间
imaginabale	可想象的
astutely	敏捷地
disapprobation	不答应
vole	什么都干过
helpmeet	伙伴
dressing	调味品
composedly	镇定
arioso	咏叹调
transmutability	可变化
talent	才干
foolish	卤莽的
phoneuision	电话电视
scolopendrid	蜈蚣科百脚
xylophagous	蚀木穿孔
polypropylene	聚丙烯
unemotionality	无感情
eastwardly	从东方的
daughterly	女儿
irradicable	不能根除的
quaver	颤音
saxonism	源自盎格鲁撒克逊语的
molder	崩溃
apprise	通知
unmelodious	刺耳的
barococo	过分精雕细凿
sunnism	逊尼派教义
cachinnatoria	放声大笑
hill	小山
bechic	治咳嗽的
silklike	似丝
orobanchaceous	列当科的
phosphodiesterase	磷酸二酯酶
foreshow	预兆
passenger	乘客
moulder	崩溃
mustard	芥菜
irruptive	深入
plutocratic	财阀的
bigeminal	二联的
untuneful	不悦耳
scholiastic	古典注释的
shrank	shrink的过去式
stray	离群
whoa	停止
grainy	粒状的
brose	麦片汤
recording	唱片
monogenesis	单源论
multicentre	涉及多个中心的
geologize	研究地质
disallowance	拒绝
wean	使断奶
armoric	阿莫里凯
renown	谣传
tyrannic	专制君主
unbalanced	不均衡的
sear	使枯萎
hepatica	地钱属的植物
tack	作文字形移动
company	陪伴
sudatory	促汗
tallyho	用吆喝声表示发现
geriatrics	老人病科
tutti	合奏
sitting	坐着的
mystificatory	使人困惑不解的
rswc	care
spongy	像海绵
adducent	内收的
suspensive	可疑
vespiary	大胡蜂巢
fainthearted	胆小的
rdx	旋风炸药
recreance	懦弱
mopey	消沉的
chemotactic	趋药性的
irradiator	辐照器
hydroacoustic	液压产生声能
preediting	预先编辑
isotonic	等压的
epidemical	传染病的
profiteering	暴利
proton	质子
acetification	使变成醋
subjacent	在底下的
fellowship	奖学金
choragic	合唱团指挥
cytomegalic	巨细胞
isochrony	=isochronism
holosericeous	有丝状短毛
rueful	悔恨
prc	China
wile	诱骗
reformatory	革新的
mecometer	婴儿长度计
iterate	反复说
clinging	有粘性的
biedermeier	彼德麦式样的
nazim	警察总长
neurone	神经细胞
nonfat	脱脂的
hecatonchires	赫卡同刻伊瑞斯
negotiatory	协商的
marvel	大为惊异
eburnated	似象牙般坚硬结实
bogus	伪造
baronize	封为男爵
tablet	书写板
lampas	硬口盖炎
applicator	涂药器
breezy	活泼
colorful	华美的
groupuscule	小团体
superliner	超级班轮
dantist	但丁专家
unshroud	除去……的面纱
roundlet	小圆
pedantocracy	腐儒统治
skeletonize	非常瘦
iaru	International
unicuspid	单尖的
lhc	Chancellor
assentient	同意
convenable	可召集的
visitorial	巡察的
capon	阉
tracheate	有气管的
andizhan	安集延
dynamitard	=dynamiter
osier	柳条做的
slim	苗条
fashioned	……风
struck	strike的过去式和过去分词
philologic	语言学
chorister	唱诗队指挥
beseechingly	恳求
gutser	重跌
damning	受永罚的
turnix	=button
rowton	house
girdle	腰带
nebulated	有不明显斑纹的
mothery	醋母样的
toboggan	平底雪撬
boron	硼
yearningly	怀念地
miracle	奇事
creche	托儿所
upgrade	上坡
zinckenite	辉锑铅矿
summon	召集
nowackiite	硫化铜锌砷矿
sacred	神
pba	Buildings
concourse	宽阔的大街
capper	装盖的人
chekhovian	契可夫的
sprinkle	撒
dangerousness	危险
actually	实际上
breathless	气喘吁吁
misinformation	误报
ucla	University
lignocaine	利诺卡因
yakow	亚考牛
dantean	但丁研究者
farrier	马医
remoralize	使重有德性
ulotrichous	鬈发人种的
metalinguistics	研究语言与其他文化活动之关系的语言学
treasure	珍藏
valerianate	戊酸盐
faculative	偶发
dement	使发狂
texel	特塞尔绵羊
geranial	香叶醛
operagoer	经常看歌剧的人
stuma	激动
dps	数据保护系统
insectarium	昆虫饲养所
outcast	被排斥的
bookselling	书籍贩卖
casuistical	决疑
unlovely	不漂亮的
crowded	拥挤的
cystic	胆囊
exposal	曝光
traditional	传统
citramontane	山这边
pukkah	份量充足
meningoencephalitis	脑膜脑炎
insulinize	用胰岛素治疗
preproduction	预制造
dinosaurian	恐龙的
basketfish	筐鱼
stand	持久
triangulable	可单纯剖分
liaison	连音
grinding	磨擦
dehorter	劝阻者
dissaving	动用储蓄
recital	朗诵
radialized	放射
carcinogenic	致癌物
icelandic	冰岛
ceremonially	礼仪上
centavo	分
protectory	儿童教养院
zirconic	含锆
flense	剥取脂肪
typhous	斑疹伤寒症的
emcee	担任……主持人
powys	波厄斯郡
rotifer	轮虫
oma	marketing
understate	打着折扣说
aeromechanical	航空力学的
juicehead	酒鬼
quip	说讽刺的话
proteiform	易变形
proscribe	禁止
superjacent	压在上面
downcast	悲哀
adipic	油质
thalassic	海的
from	来自
rdo	Remote
unmeditated	未加思考
ib	Building
nls	language
vulcanizate	橡皮
lexicography	词典编纂
coleopterous	甲虫类的
gopura	楼塔
snuff	扑灭
fullmouthed	威势十足
favorite	喜欢的事物
lanthorn	=lantern
elasticity	弹力
collegiality	共同掌权
imprecatory	诅咒
probe	探测器
theatergoer	戏迷
lotic	激流群落的
lentiginous	雀斑的
effortful	充满努力
north	北部
photoperiodism	曝露于阳光而产生的反应
expositor	评注者
mehitabel	梅海塔布尔
seminiferous	产生种子的
symantec	美国著名软件公司
inhomogenous	多相
mocock	桦树皮盒
sneering	轻蔑
rocklike	坚硬如岩石
clipboard	剪贴板
inventress	发明家
sound	测深
heft	重要性
vamp	即席伴奏
lutescent	稍带黄色的
tyrannically	残暴
execrative	诅咒的
niftic	漂亮
streamy	多溪流的
sulphane	硫烷
beginner	初学者
coordinate	同等者
semiconical	半圆锥形
inorganized	无组织的
piolet	破冰斧
fleshpot	煮肉锅
emptying	空出
governessy	古板
crunkle	使起皱
treachery	变节
tortfeasor	犯侵权行为者
fine	纤细
verkrampte	顽固分子
shijiazhuang	石家庄
exotericist	信奉者
middling	中级品
distilled	由蒸馏得来的
powerhouse	发电站
vorticose	=vortical
theatergoing	观剧
voguey	时髦
dieselize	柴油机化
gliomatosis	神经胶质过多
empower	授权与
terminological	术语学
etruscology	伊特鲁里亚学
parodist	打油诗作者
peroxide	以过氧化氢漂白
salbutamol	舒喘灵
hypercomplex	超复数的
precipitinogen	沉淀原
minimus	最年轻
unmotherly	没有母爱的
wiseass	=smart
grandmotherly	慈祥的
tenantry	佃农
sulfurous	硫磺的
resident	常驻的
atrazine	阿特拉津
beauteously	美地
neve	冰原
smutty	煤黑的
nutcracker	星鸦
bindery	装订所
dustcloak	防尘罩衣
organdy	一种细薄的棉织品
draggly	不整洁
invertebrate	无骨气的人
nose	前端
plurally	作为复数
drum	鼓膜
rancherie	居留
haemolymph	血淋巴
pulverize	研磨成粉
subtransparent	半透明的
overhead	在高处
quaintly	优雅地
undergo	忍受
eurygnathous	上颔宽大
sonagram	声谱图
transact	办理
sorites	诡辩法
cryptic	含义模糊的
fellow	朋友
deckhouse	舱面船室
lapicide	石匠
denominator	分母
abolishment	取消
scurfy	满是头屑
squash	易压烂的物品
soar	高涨程度
princesse	紧身连衣裙
parison	料泡
gavot	加伏特舞曲
yagi	八木天线
reinfecta	事情尚未完成
arrect	警戒严密的
pantomorphic	呈所有各种形状
legibility	易辨认
sax	XML简单API
correctly	恰当地
untraceable	难以寻找的
colorful	华美
folklorist	民俗学者
educationist	教育家
fabricate	捏造
jabberwocky	无意义的话
impractical	昧于实际的
unworking	不在工作的
misanthropic	厌恶人类
fiery	火的
troilus	特洛伊罗斯
flickering	一闪一闪
ejaculation	射精
multipliable	可增加的
spatioperceptual	空间知觉的
hiaa	America
forensics	辩论术
literalness	文字
aye	是
brindled	有斑纹的
illusory	错觉
gq	quarters
jainism	耆那教
nebraska	内布拉斯加州
madness	疯狂
gentleman	男厕所
participled	受诅咒的
odontalgic	牙痛的
ensnarl	使缠绕
sublime	卓越
sbr	一种橡胶
piteous	哀怨
sum	和
ergastulum	感化院
livid	铅色
claybank	土堤
calcific	石灰质
bondstone	砌合之石
pilgarlic	受人嘲弄的人
handwork	手工
magnesian	镁
astable	非稳态
gorget	护喉
rive	使沮丧
breakthrough	突破
cimeliarch	放置教会宝物之房间
crustily	粗暴地
fecund	肥沃的
transudation	漏出
barren	荒地
owe	欠
microreproduction	缩微印刷品
nonresidential	非住宅的
delusive	迷惑的
himalayan	喜玛拉雅的
nonnegotiable	不可流通
prudential	谨慎的
unawares	不知不觉
longevity	资历
auriscopically	耳镜地
dryer	干衣机
antichloristic	阴氢剂
archly	主要地
agonizingly	使人烦恼地
slip	片
matchbook	纸板火柴
whizzo	出色的
brawl	怒骂
townhouse	镇公所
xxix	罗马数字
tuberculose	=tuberculate
docetic	幻影说
seashore	海岸
decamethonium	十烃季铵
corymbose	伞状花序的
fladge	鞭打
coastward	向海岸的
shoulda	=should
escheatage	没收产业权
elicitation	抽出
fodder	弹药
herd	把……赶在一起放牧
drivel	胡说
foaming	布满泡沫的
foucquet	Fouquet
fellowless	没有伙伴的
terrier	狗的一种
attend	注意
eleatic	埃里亚
commove	使骚动
hebrewwise	希伯来式地
firebomb	火焰炸弹
thew	肌肉
veritable	真正
biogenic	生物所造成
inp	of
superior	上级
irrespectively	无关
scatty	疯狂的
instructress	女指导
insoluble	不能溶解的
curette	用刮匙刮
hypercatalexis	过律
misrule	暴政
idolization	盲目的崇拜
nonsensical	荒谬
moppet	娃娃
zagros	Mountains扎格罗斯山脉
fletcherism	弗莱彻主义
diminution	缩小
inconsecutive	前后不连贯的
tomato	番茄
mayan	玛雅人
biblist	圣经信仰者
euphorbia	大戟属植物
hoot	鸣响
destructional	破坏
flay	剥皮
fatherfucker	讨厌鬼
sledding	雪撬的使用
captive	被俘的
arraign	责难
apiary	蜂房
bebop	爵士音乐的一种
passover	逾越节祭神的羔羊
source	发起者
usurp	篡夺
torsion	扭转
tide	潮流
hero	英雄
inassimilation	不同化
schrank	双门衣柜
tappit	有顶饰的
nonflying	不飞
jokesmith	爱说笑话者
short	突然
weatherproof	抗风化
newel	中心柱
efficacity	效力
salsify	婆罗门参
wiredraw	抽成铁丝
pike	长枪
beg	请求
antiperspirant	防汗药
delegatee	被delegant指定向第三者还债的债务人
excusably	可辩解地
far	甚远
lamenting	悲哀
argillaceous	似粘土的
heptachlor	七氯
busman	公共汽车司机
liberally	不受限制
kronshtadt	喀琅施塔得
furl	叠
autobiographic	自碼l/C:tEJbaIE5^rA降
resail	再航行
prosodiac	=prosodic
ambler	慢慢走的人
foreman	陪审团主席
moshav	莫夏夫
neuroblastoma	成神经细胞瘤
steady	坚定不移
vitreosil	透明石英
galbraithian	加尔布雷思
spiritualistic	降神术的
scan	扫描
flaked	精疲力竭的
wintery	冷漠
arthral	关节
hate	憎恨
sabbatarian	守安息日的人
softheaded	愚蠢的
optician	光学仪器商
henhearted	怯懦的
shakespeareana	莎学文物
fluster	使慌张
wcc	World
armrest	扶手
cpff	成本加固定费用价格
megohm	兆欧姆
titian	提香
inequality	不平均
discourteous	无礼貌
defoliator	除叶剂
gmbh	Haftung
tumultuary	喧嚣
service	服务性的
isolated	孤立
perfectible	可完成
amphitheatrical	圆剧场式的
collateralize	以……作抵押
rdram	DRAM
pursily	因有钱而傲慢
odds	几率
extension	扩充
sapanwood	苏木
deicide	杀神
nonlogical	不合逻辑
spheric	球
lenitive	减轻痛苦
period	没有了
ordinal	依次
glout	皱眉
manageress	女管理人
freesia	小苍兰属植物
homebody	家庭第一主义的男人
pimozide	双氟苯丁哌啶苯并咪唑酮
fermi	费尔米
disagreeably	不合口味
fallboard	木窗板
blessedly	神圣
gi	GIs
hemocoele	血管体腔
pri	Interface
inappreciation	不欣赏
aviary	大型鸟舍
preclusive	妨碍
hogget	二岁的公猪
scutcheon	标牌
responsion	答复
socioecology	社会生态学
obovoid	倒卵球形的
wry	歪曲
endocast	内腔模型
unaverage	杰出
start	起动
amazing	令人惊异的
pushing	有进取心
fidgety	难以取悦的
noaa	Atmospheric
biradial	双重对称的
archival	关于档案的
steatite	皂石
sty	猪栏
defoam	去除泡沫
cardinal	主要的
tempestuous	暴乱
slaggy	熔渣
electrify	电气化
evensong	晚祷
coed	对男女都开放
shirr	焙烤
comber	拍岸浪
divarication	意见不同
regge	雷琪理论
interdepend	互相依赖
minerva	智慧和技术及工艺之神
unequivocable	毫不含糊
dower	给以用以维持生活的财产
monopropellant	单元推进剂
promethean	独创性
tumour	瘤
withy	柔韧的
rummy	甜酒
unorganized	无条理的
lcm	Common
hostess	舞女
malayan	马来人
fascicle	束
skibobbing	雪犁运动
undistinguished	未经区分
arrive	到达
cad	Computer
amaigamate	合并
levis	Levis
tussal	咳嗽表现的
matripotestal	以女族长为权威
easiest	轻松的
cannonproof	防弹
hic	嗝
wicker	柳条
juggle	篡改
smithereens	碎片
erasmus	伊拉兹马斯
umw	United
mild	温柔
endoneurium	神经内膜
lowestoft	洛斯托夫特瓷
canalage	水路
band	镶边
epibolic	外包
druggie	瘾君子
scv	Sons
etrog	依特劳格金像奖
raiser	筹集者
anecdotist	讲述或搜集逸事的人
gynecologic	妇产科医学的
hyperon	重核子
isotransplant	同基因移植物
organization	组织
necrogenic	腐尸
deregister	撤销……的注册
course	方针
montenegro	Yugoslavia
censurable	该责备
didymium	钕镨混合物
tony	托尼
trillion	万亿
hemophilia	血友病
occupational	职业
straight	正直
passiveness	顺从
suspensible	可悬浮的
marchioness	侯爵夫人
hurler	投掷者
compliment	问候
promote	提拔
acta	Telecommunications
evaginable	翻转
alcaic	句法的
egoinvolvement	自我介入
gyration	回转
numerous	无数的
felsitic	致密长石的
boff	高声笑
manx	马恩岛
gondole	乘
reasoned	详尽论述
atropism	阿托品中毒
shipwreck	海难
origin	血统
spur	鞭策
hydroacoustic	液压产生声能的
pawl	棘爪
seasonableness	合时宜
bitstock	钻柄
nonfood	非食物
evertile	=eversible
liberally	大方地
geck	鄙视的表情
neurosyphilis	神经系梅毒
caucasia	高加索
oracular	神谕的
graphitoid	似石墨
ethnocentrism	民族优越感
cymose	聚伞状
ossiferous	含骨化石的
thaumaturge	魔术师
exoderm	外胚叶
gemmiparous	发芽生殖的
milkman	售奶工人
incisure	切迹
arthrotropic	亲关节
unaided	未受协助
fame	盛传
nrotc	Training
unconfessed	未承认的
eurytopic	广适性
hike	增加
cardiopathy	心脏病
pythonic	神谕
woodhorse	普通竹节虫
ittf	国际乒乓球联合会
sulphide	n
lytic	细胞溶解酶
cuspidate	尖端的
fusible	可熔的
armyman	军人
labial	唇音
acetarious	拌生菜食用
hogarthian	贺加斯风格
aerosiderite	陨铁
fried	油炸
edi	Data
sparkish	美男子般的
novitiate	见习期
hyperchromic	高色性贫血
catalog	编目录
quadricycle	四轮的
checkup	身体检查
prang	撞击
acephalous	无头
dell	幽谷
marina	散步道
saga	传奇
alguazil	警察
binge	狂闹
interknot	打结把……连在一起
haberdashery	男子服饰经销店
rotograph	复印相片之一种
adjuratory	誓言
gibbous	突起的
uninformative	不增长见闻的
noninitially	不是最早
ocd	Office
fabricant	制作者
dampproof	防湿的
splent	=splint
zig	之字形
lazarist	遣使会会员
backkward	向后地
shovelboard	打圆盘游戏
exopathic	外因病的
lawing	诉诸法律
zimbabwean	津巴布韦
underwood	下木
exultingly	得意地
roadwork	长跑运动训练
polysaccharid	多聚糖
trover	追索侵占物诉讼
kettle	釜
harmonious	和睦
pied	斑驳的
destoolment	废除
seedleaf	宽叶烟草
solicitude	关怀
terrorise	=terrorize
circumstantial	依照情况的//
mainstreet	在大街上进行竞选活动
mildew	发霉
cranberry	酸果蔓的果实
nighthawk	夜生活者
iou	owe
abaft	向船尾
weariful	厌烦
claudius	克劳迪亚斯
jarring	刺耳的
monotheism	一神教
stopping	停止
valvate	有阀门
technopsychology	工艺技术心理学
excogitation	发明
enfold	包进
rio	Janeiro
tanling	被太阳晒黑的人
collateral	间接的
crenelated	雉堞状
prestige	威信
sacculus	小囊
asid	Society
kosher	合适
gasman	煤气工场的工人
compotator	酒伴
nonconformist	不信奉英国国教
grey	灰白
gardener	园丁
woundy	极大
spirket	船底板间的空隙
devilry	残暴
clownery	滑稽
paraphrasis	释义
thalassochemical	海洋化学的
actually	如今
pedophilia	恋童癖
iguanodon	禽龙
ventose	喜欢讲空话
isis	伊希斯
variational	变更
pappy	半流质的
juvenility	不成熟
shapeless	无定形
uniform	均衡
unate	非蚀的
plateful	一盘
playa	海边休养
electrofishing	电渔法
intellective	智力的
rj	road
vile	低廉
dressguard	护衣装置
bribee	受贿者
lav	厕所
begat	beget的过去式
underscore	强调
rhinolaryngology	鼻喉科学
ephedrine	麻黄素
despicably	卑劣
repeople	使人重新住入
biologic	生物的
doss	床铺
indies	印度地方
pigmentation	着色
kiloparsec	千秒差距
cognate	同类的
misdistribution	分配
kiwanian	基瓦尼俱乐部的会员
elizabethan	伊丽莎白一世时代
cymose	聚伞状的
qpm	Medal
olive	橄榄叶
unfirm	不牢靠
crm	Relationship
speltz	=spelt
eleemosynary	慈善的
epileptoid	癫痫的
unentangled	不曾复杂化
mass	聚集
cc	Carbon
polemist	善辩论者
ulsterman	乌尔斯特人
uri	Resource
genevese	日内瓦人
gingerly	慎重的
dorsad	背部
variety	品种
private	私营的
aborted	失败的
uscg	United
teary	哭泣的
ginzo	意大利人
aurar	eyrir的复数
sybaritic	奢侈逸乐
bearable	支持得住的
photoactinic	光化射线的
unrifled	未在枪膛内制来复线的
alpeen	粗头短棍
raceme	总状花序
cardinal	枢机主教
telescreen	荧光屏
smirch	弄脏
mensurability	可测量
subdual	征服
earthen	陶制的
hear	听见
arret	告示
schnecken	蜗牛形面包卷
voluminal	容量的
cutify	皮肤形成
appealingly	上诉地
jolterhead	大脑袋
observational	观测的
frothily	如泡地
undro	联合国救灾组织
attired	用鹿角装饰的
rarp	Reverse
hyetology	降雨量学
nib	装尖头
calotte	半球帽
underlying	根本的
cystourethrography	线照相术
brine	盐水
studbook	血统证书
isopycnic	等密的
zeldovich	氮的氧化成一氧化氮的过程
hooknose	鹰钩鼻
dysprosody	言语声律障碍
hymenotomy	处女膜切开
malic	苹果
freewheel	自由飞轮
bichlorid	二氯化物
scum	铁渣
renegue	食言
nannar	巴比伦神话的月神
counterexample	反例
nonpeak	非高峰的
churching	安产感谢礼
gray	灰白
glowing	生气勃勃的
autosome	常染色体
hub	毂
structuralist	结构主义
jeopardise	危及
pronate	使俯身
novobiocin	新生霉素
itt	Corp
eurycephalic	阔头的
aduncal	向内弯曲的
sincere	真诚
winsome	迷人
way	中途
upstream	溯流而上的
spinigrade	行进
running	转动
pistolier	=pistoleer
quohog	=quahog
colourbreed	培育……使具有特定毛色
uplooking	有志气
cosmopolitanism	世界大同主义
ur	乌尔
turgescent	浮夸的
barmaid	招待员
guru	领袖
molluscoidal	拟软体动物的
aborigines	原居民
fancify	奇特的装饰
tortious	侵权行为性质的
noctambulant	夜间步行
discommendable	反对
afterbody	尾部
stp	生成树协议
document	文件
graciously	优雅
floodplain	涝原
timecard	考勤卡
superior	上级的
dullish	昏暗的
adularescent	淡蓝色变彩
ai	安格拉
morton	莫顿
inherently	固有地
blur	污损弄得模糊不清
tantivy	快的
manor	领地
anisotropy	各向异性
hvar	高速航空火箭
gcse	Education
coruscant	闪的
glare	显眼
multifarious	各式各样的
canavalin	刀豆球蛋白
summon	振作
decumbence	横卧
relativist	相对主义者
yet	仍
strap	带
zelanian	新西兰
learnt	learn的过去式和过去分词
unpublicized	未经宣传的
immunogenesis	免疫发生
being	存在
megajet	超大型喷气式飞机(比波音747
impoverishment	穷困
metacarpus	掌骨
constative	表命令、计划、愿望等之假定的
familiarization	精通
unsteadily	摇摆地
catacomb	茔窟
tousle	乱七八糟的一团
horsing	通读校样
undefiled	无污
lordly	有贵族特点
sagely	贤明地
doubtful	不确
froward	难驾驭的
equilibratory	保持平衡
transurethral	经尿道的
ankylosis	胶着
poor	贫穷
dekaliter	=decaliter
murdabad	打倒
inscriptive	铭文的
hyena	土狼
littlish	较小
leafed	有叶子的
templelike	似神殿
guest	来宾
nephelitic	霞石的
fhwa	联邦公路局
unbodied	无形的
sudan	苏丹
settltment	解决
premarketing	上市销售以前
pangola	grass
abyssal	深海
agouty	=agouti
thurifer	宗教仪式中捧香炉的人
boldness	冒失
evanish	消灭
levulose	果糖
savable	可节省的
selflessly	无私地
retirant	=retiree
primateship	大主教之职
republicanism	共和主义
sorb	吸收
trustworthy	可信赖
trinitarian	三位一体的
teknonymy	因子女得名制
finned	有鳍的
libertine	放荡的
diadromous	有扇状叶脉
idahoan	爱达荷州的
allethrin	丙烯除虫菊
rheidity	流变度性
chasm	裂口
counsellor	顾问
rarest	最稀罕的
manes	灵魂
capacity	生产量
eglestonite	氯汞矿
eutectoid	共析
essayistic	随笔
turnabout	旋转
bibliomania	藏书癖
canalicular	似微管的
overturn	颠倒
fmi	e
congener	同属
cer	Rules
ulcerously	患溃疡地
celibate	独身
viviparous	母体发芽
deringer	大口径短筒手枪
symptomize	=symptomatize
unclassical	非古典
lappic	拉普兰人
desipient	琐碎
mammilla	乳头
hummocky	圆丘般的
deepwater	深海的
cc	Copy
rhodesian	罗得西亚人
commandership	总司令之职
taboo	避讳
boy	儿子
opponent	对立
stearate	硬脂酸盐
skinflint	吝啬鬼
touch	碰
yankeedom	美国
dinosauric	恐龙般大
inbreaking	侵入
bumtang	布姆唐
fixedly	不动
decare	十公亩
dissociable	不爱交际
hematoblast	血小板
eutectoid	共析的
pakistani	巴基斯坦
pulverable	能研成粉末
diffusedly	普及地
consequence	推论
stipe	柄
biocidal	杀生的
petroliferous	产石油
flabbergast	使大吃一惊
ophidian	蛇样的
despicably	可鄙
abm	异步对称模式
chawl	分间出租的宿舍
terminal	接线端
southwardly	向南
strive	力争
glamorize	使光荣
rabblement	骚动的群众
beslobber	缠吻
nihilistic	无政府主义
tame	平淡的
cubbyhouse	小屋子
pelter	投掷的人
tussive	咳嗽
mycetozoan	粘菌
titivate	装饰
corf	煤炭箩
imperfectness	不完全
eventuate	发生
demystification	启发
synovia	滑液
opisthobranch	后鳃目软体动物
resorbent	再吸收的
unaccounted	未说明的
fat	胖的
rootedness	根深蒂固
ammonic	氨
absence	没有
wallow	打滚
impeachable	可弹劾的
tragicomical	悲喜剧的
noncampus	没有校舍
bashfully	内向
chromophore	发色团
gesticulation	做姿势传达
trichinous	旋毛虫病
squanderer	放荡者
adullamite	退出自由党的议员
exposed	暴露的
adenomatous	腺瘤的
rurp	钩状小钢锥
babblingly	胡说地
swim	充溢
effeminize	使带女人气
mercilessly	残忍地
rhombohedral	菱形的
consecrated	神圣
cyclophosphamide	环磷酰胺
vulvae	外阴
bearwood	药鼠李
slum	访问贫民区
peptogen	助消化物质
cinerama	全景电影
tenderly	温和地
excellent	卓越的
rfe	Free
dilate	使膨胀
woods	森林
azimuthal	方位角
rainbow	幻觉
basidiospore	担子孢子
depressive	郁闷
notecase	钱包
macabre	令人毛骨悚然的
crt	Tube
homoplasy	类似
cherry	樱桃
ganefo	Forces新兴力量运动会
geckotian	壁虎类
scuff	拖足而行
axenic	无外来污染的
lysimeter	测渗计
quodlibet	神学上的论争
methylamine	甲胺
harmost	古希腊时斯巴达殖民地的军事统治者
tame	驯服
radiolarian	散线虫类的各类动物
ebn	east
parade	炫耀
semicoma	半昏迷
droob	呆子
conquerable	可战胜的
scholarship	学问
czarevna	旧俄太子妃
born	天生的
grand	盛大
struggling	奋斗
epigrammatist	讽刺诗人
understock	存货不足
graupel	雪丸
spiry	尖塔状的
gastriloquy	腹语术
narrow	气量小
cafe	小餐馆
ease	悠闲
wisp	小把
remedy	修缮
invest	投～
recoupment	扣除
bloodsucking	吸血动物
slubber	草率地做
ampelopsis	蛇葡萄属植物
ruschuk	=Ruse
emergent	突然出现的
paper	证件
rashness	轻率
amphibrach	短长短格
relative	比较而言的
heavenly	天上
semiyearly	每年两次的
mendicant	乞丐的
incontinuous	不连续
axenic	无外来污染
anapaest	短短长格
uc	无处不在的计算机
federal	北京连邦软件产业发展公司
mesodont	中型牙
am	调幅
pennyweight	本尼威特
pyrographer	烫花人
guileful	狡诈
neurohormonal	神经激素
punkin	=pumpkin
regal	适于帝王的
ineffectually	无效地
euthenics	环境优生学
bellybutton	肚脐
volutin	迂回螺菌素
rude	猛烈的
slovenia	斯洛文尼亚
dupe	易受愚弄的人
praedial	属于土地的
secretary	部长
wane	衰落
monophonic	单频道
pensione	小旅馆
miscount	数错
stub	挖除断株
wyatt	怀亚特
northern	北方的
granular	由小粒而成的
unido	Organization
kettledrummer	定音鼓鼓手
harmonious	和睦的
respecting	说到
overfleshed	肥育过度的
curtilage	庭园
story	假话
aikido	合气道
competence	能力
practolol	醋氨心安
endostyle	内柱
supposed	假定
expediter	官方发布的件的人
tenonitis	=tendintis
buster	庞然大物
kremlinologist	苏联政体研究者
snubbingly	冷落怠慢
areologically	火星科学研究地
medicine	医学
surpassingly	卓越地
guidwillie	热诚
scrimpy	不足
hypophysectomy	垂体切除术
fleuron	花形图案的装饰
clansman	同宗的人
licet	那是准许的
filoselle	丝棉
incarnadine	粉红色的
sunwise	和太阳在天空上移动同方向地
easterly	东的
spindly	细长的
blind	缺乏眼光或判断力
tepal	被片
tell	告诉
autocollimation	自准直仪
fictitious	编造
fascinatress	有魅力的女人
prongy	有叉尖的
bluefish	美洲大西洋海岸所产的青鱼
propertied	有财产
salvageable	可打捞的
avidity	贪婪
spessartite	锰铝榴石
leftist	左翼的人
exemplary	警戒性
laced	加酒
inarticulacy	口齿不清
ephesine	=Ephesian
echocardiography	超声波心动描记术
refutal	反驳
nemoricoline	生长在树丛中的
prank	装饰
blinkard	很笨的人
quaquversal	穹状
hypochondria	忧郁症
undivorced	未分居
potecary	药商
thankworthy	应该感谢
stoneman	石工
allochthonous	属曾被地壳动力搬移的
paumotu	=Tuamotu
photophilous	适光的
crowbill	喙状钳子
hypnotism	催眠术
everglade	沼泽地
take	取
chairbed	坐卧两用的折椅
industrialize	工业化
tassel	抽穗
clonesome	模仿别人
epithalamus	丘脑上部
bepaint	化妆
airborne	空气传播
humourous	富幽默感的
bismuthic	含五价铋的
lenitive	润泽药
certain	某些
viniferous	为酿酒而栽培的
detrition	磨损
volplane	滑翔下降
overland	陆上
gager	检量官
fibroid	纤维状
deranged	疯狂的
sex	阴茎
idioglossia	自我语法
tubal	管形的
nondiscrimination	一视同仁的
ripely	成熟地
guileful	诡计多端
gauntry	构台
verticillium	wilt
inflection	变形
incorporative	有结合倾向
biotin	生物素
scraping	刮擦的
aggravating	加重
ne	原名
unselfishly	无私
depressed	沮丧
shambles	废墟
thecodont	槽齿类的
pressroom	记者室
screenings	筛屑
gabardine	一种斜纹防水布料
admissive	容许的
planont	活动孢子
unsummoned	未被召集
queerish	奇怪的
seignior	藩王
cypress	柏科树的
issp	政策计划情报系统
plastics	外科修补术
microscale	微小的规模
gallinaceous	鹑鸡类的
lawfully	守法
topi	转角牛羚
washy	脆弱
snaky	多蛇的
astylar	无柱式
unvalued	不受重视
sack	短而松的袍装
excitor	刺激神经
contrariness	矛盾
saltus	跳越判断
ticklish	不稳定
charily	俭省
irriguous	可灌溉
ulsterite	北爱尔兰人
idyllist	牧歌作者
porn	色情文学
slinkingly	偷偷摸摸
educatee	受教育者
pelage	毛皮
flunky	奴才
drillion	天文数字的
spleenful	脾气坏的
olifant	=oliphant
changeable	可改变的
stellate	星形
crumbly	脆的
plainsman	平地人
capapie	全身地
elasticize	使具开朗
tuberculize	使成结核性
vacuous	茫然若失的
abstractive	具有抽象能力
construable	可做语法分析
brushland	灌木林
refractable	折射性
sublimize	使升高
batting	打球
observatory	天文台
gratuitous	免费的
dubbing	配音
squire	治安官
interesting	引起好奇
seminatural	半自然
outfit	得到装备
spezia	斯培西亚
irresolution	犹豫不定
supportably	可忍受
bedabble	泼湿
distant	间隔的
telpherage	空中电动缆车运输系统
keybutton	键钮
folkloric	如同民间传说
galavant	=gallivant
renfrewshire	伦弗鲁郡
trotty	轻快的
pseudoplastic	假塑性
autographically	亲笔
receptive	能接纳的
choler	胆汁
rejuvenate	使年轻
windbreak	防风墙
genesis	起源
aftercare	疾病治疗后的照顾调养
fluctuant	变动的
bioavailability	生物利用度
piggish	贪心
stress	逼迫
pinder	=pinda
momentary	瞬间的
schoolmiss	天真少女
crinoline	带衬的裙
equivalent	相等的
suppose	假设
burma	缅甸
explicit	外在
cystoscope	膀胱内部检验镜
noteworthily	显著的
polt	情节
compunctious	内疚
lich	死尸
flapdoodle	瞎话
phobic	病态性恐惧
nae	决不的
elevenfold	十一倍
verrucose	疣状隆起
maniple	小队
urceolate	瓮状的
clincher	夹子
handmaid	女佣人
vociferous	大声叫的
concubinage	纳妾
unpredictable	不可预知的
rubricity	变红
regrant	再次同意
nc	Control
chileanize	使智利化
hath	have的第三人称单数现在式
scream	尖声喊叫
routing	邮件路由
lacrymal	流泪的
woodbin	木柴箱
gunmaker	枪炮制造工
meanly	卑贱地
chalcedonic	坚强的
destination	目的
helplessly	无望地
maul	大槌
ultranationalism	极端民族种饕
ligulate	舌状
blossom	兴旺
carryall	旅行提袋
expositor	解释者
carley	卡利救生筏
ideogram	意符
diffusible	可散播
scratch	抓
limicole	赭蚓
flock	大量
nulliparous	未产妇的
mpeg	Moving
terpsichorean	舞蹈的
mushily	玉米粥状地
aphanitic	隐晶岩的
salome	萨洛米
anatomize	仔细分析
gyrose	环形的
dickens	魔鬼
carposporangium	红海藻之特殊胞子囊
scalariform	梯状的
clairvoyante	女千里眼
antideuterium	反氘
clannish	宗族排外的
thermotropic	向温
tentative	试探的
microfibril	微纤维
gallicism	另一种语言中法语成语或字句
cozy	安逸的
eugenia	尤金妮亚
discontented	不满意的
urological	泌尿科学
alacrity	活泼
inchoative	开始的
harmonious	协调的
usurious	高利贷的
iconomatic	用图像表示
salad	色拉
delicate	精致的
foresaddle	前部胴体
bacciferous	结浆果的
crust	硬壳
murderer	杀人犯
bored	无聊
indemnitor	赔偿者
compulsory	被强制
tomograph	断层X光摄影装置
callipers	卡钳
godmother	教母
surprise	令人惊讶
paulette	波莱特
crusian	=crucian
womanish	像女人的
actinon	锕射气
sociopathic	反社会
ceraceous	蜡状的
woofy	粗直浓密
quadriform	包含四种形态
policlinic	家庭诊所
paranephros	肾上腺
frock	外衣
trehalase	海藻糖酶
weltschmerz	厌世
nondiapausing	非滞育中
brothel	妓院
nohow	毫不
accentual	重音
rp	菲律宾共和国
granum	叶绿体基粒
ballistite	火箭固体燃料
smarmy	虚情假意
intilted	向内倾斜
besom	扫
fix	使固定
fddi	Data
teleswitch	遥控开关
parasitical	寄生的
savourily	有滋味地
transformation	改革
jackass	傻子
lymphoblastic	淋巴母细菌
drumble	行动缓慢
dionysian	酒神节
monochroic	一色
unep	Nations
extrasolar	太阳系以外的
flypaper	捕蝇纸
persian	波斯人
troublemaker	捣乱者
ne	原名的
incommutable	不能变换的
likewise	又
uriniferous	输尿的
chromatically	套色
pittypat	劈劈拍拍
spermous	精液状
chowtime	进餐时间
ioof	Fellows
interproximal	邻接近端间的
prey	牺牲者
cinematography	电影术
coptic	埃及基督徒
benefit	受益
pusillanimous	懦弱
puff	夸张
heteronuclear	RNA
movably	可移动地
oke	没问题的
poolside	游泳池边
cocarcinogen	辅致癌物
pood	俄国的重量单位
reggeism	=Regge
faceup	面部朝上地
lamington	拉明顿蛋糕
pons	桥
superfluorescence	超荧光
plumb	垂直
sadduceeism	撒都该教
embracive	全部包围的
mileage	英里数
poltroon	胆怯
masonry	石工术
bullous	大泡
falkner	William即Faulkner
blackout	中断
lawyer	律师
reparative	修缮
decollation	杀头
rill	小河
impolitely	无礼
unaspiring	无抱负的
ruthlessly	冷酷地
zonda	佐达风
telescopically	伸缩
flutter	乱跳
evacuee	被疏散者
noviciate	初学者
sputter	喷溅声
scene	情景
boogeyman	具有超人力量的恶巫
meander	漫止
personal	针对个人的
chemisette	紧胸内衣
ineffective	工作效率低
alden	奥尔登
perdie	=pardi
dives	富豪
emphatic	用力的
atomry	原子武器
incorporative	合并的
nascar	Racing
gasthaus	旅馆
soapmaking	制皂
transducer	变频器
umpire	仲裁人
living	逼真的
ganglia	神经中枢
philatelic	集邮的
hazily	模糊
inaccessible	达不到的
flaxen	淡黄色
option	选择权
cisc	instruction
hyperostotic	骨肥大
spirilla	螺旋状菌
infectious	有传染性
confessionary	告罪的
nyc	纽约市
visitant	贵宾
bicentric	二中心的
inconsonant	不协调
elinvar	镍铬恒弹性钢
depose	废
unfulfilment	未实现
carpentry	木工工作
icebound	被冰封冻着
azimuth	方位角
mesozoa	中生动物
thalassic	海湾的
lugouqiao	芦沟桥
super	极好的
blackamoor	黑人
micrographics	缩微图形学
coagulin	凝固蛋白
divinize	奉为神圣
contredanse	对面舞曲
determinative	限定词
analogously	类似
prue	普鲁
unpeg	解除管制
alkalescent	弱碱性的
levelling	测量高低
richard	理查德
syntagm	语段
bloat	使膨胀
superacid	酸性过多
terrine	陶制盖碗
hexylresorcinol	己基间苯二酚
damper	断音装置
tectosphere	构造圈
bimorphemic	双语素的
lambeth	伦敦坎特伯雷大主教官邸
secam	SEquential
phylloxanthin	叶黄素
shamefacedly	羞愧
dumb	无说话能力
inequilateral	不等侧的
benedictional	赐福的
notungulate	=notoungulate
physoclistous	闭鳔
canalled	开成运河
successivity	连续
fuddle	狂饮
emetic	引起呕吐的
ribbing	肋材购架
rotogravure	轮转影印
ccst	中国图文电视广播规范
managerialist	经理主义拥护者的
bluebeard	青须公
ofuro	大浴盆
ferronickel	镍铁
leeward	向下风
moonfish	翻车鱼
spaish	西班牙
mocker	模仿者
malice	蓄意犯罪
snore	打着鼾渡过
julienne	切成条的
duff	顽固不讲理的人
resident	居住
prefrontal	前额的
profaneness	污秽
atrociously	万恶不赦地
xenotropic	亲异的
sublimate	使升华
rhinal	鼻
comma	逗点
dicker	十张
avowed	公开宣布的
epizootic	体外寄生的
noctuid	夜蛾
advice	建议
undutiful	不孝的
bighearted	慷慨
reserpinized	用利血平治疗的
unpardoned	不被原谅的
goglet	陶制长颈瓶
vermicide	打虫药
bahada	=bajada
crypt	土窖
political	行政上的
dustheap	垃圾堆
yearlong	持续一年的
convent	女修道会
democritean	德谟克利特哲学
scale	剥落
harl	麻的纤维
developmental	发展
panplegia	全麻痹
policymaker	政策制定者
scrimmage	混战
thrust	挤进
stainless	不锈的
warrant	凭证
brookite	板钛矿
wye	Y字形物
preferable	更可取
releasor	让渡人
fishway	鱼梯
historic	有历史性
nonabsorbable	不能吸收的
purchaser	买方
fruticose	灌木的
after	后面的
airily	快活
mishook	击失误
factoried	工厂林立
ablare	吵闹
imprudently	鲁莽地
tricarpellary	三心皮的
evidence	根据
valetudinarian	体弱多病弱多病
eradicable	可根除
runabout	轻便汽车
peruvian	秘鲁
reference	提及
mandator	命令者
polyzonal	多环带
didactical	教导的
youthfully	年轻
hormonal	激素
scream	喊叫声
unweight	移去……的重量
chimera	蛇尾的吐火怪物
diastatic	淀粉酵素
roomily	宽敞
damon	达蒙(与其友皮西厄斯
matron	女舍监
aciculignosa	针叶植被
complicity	共犯
mount	乘用马
oxlip	樱草之一种
oblatory	供奉物
histopathologic	组理学说的
blighty	英国本土
inoculate	嫁接
unture	不正确的
dread	恐惧
intrant	加入的
barelegged	没有穿袜子的
hydrosulfate	硫酸氢盐
bigotry	顽固
desirable	悦人心意
unchurched	不属于任何教会的
tumid	肿胀的
relate	讲
uninspired	未赋予灵感的
tawie	顺从的
protestatory	表示抗议
flyaway	轻浮
centrobaric	重心的
barbican	碉堡或其他类似的防御工事
buckler	用盾防护
capitulation	投降
adytum	密室
flush	齐平
dmd	Dentariae
fractious	易怒
interfaith	不同宗教信仰者
finite	有限
bedpan	睡床用脚炉
unreckonable	不可计算
denudation	滥伐
ingratiate	使讨好
execratory	诅咒性的
ellington	Duke
hoarding	囤积
portly	一表人材
salii	舞蹈祭司
hvar	high
matron	主妇
love	零
dink	漂亮
anilinctus	舐肛
quietish	有点安静的
sialic	硅铝带
pree	证实
parietal	体壁的
caution	谨慎
uninterrupted	未受干扰的
epitomist	写节录者
execrate	诅咒
bounteously	丰富地
smell	闻到
emcee	主持
predicably	可断定地
heliotaxis	向日性
girth	围绕
greengrocery	蔬菜水果零售商
knockabout	到处闲荡的
titular	有头衔
prc	of
biogenic	源于生物的
calorify	加热于
externality	外形
changeably	可变地
afficionado	=aficionado
hexahydrobenzene	六氢苯
ropeyarn	一星期内不工作的一个下午
antics	滑稽的动作
spunk	火星
tempermament	性情
antiarrhythmic	抗心律不齐的
hyphenation	用连字符号连接
diamagnet	抗磁体
ectotropic	体外营养
king	纸牌中的K
hyperborean	寒冷的
prosateur	散文作家
underrepresentation	代entId/
sternutatory	催打喷嚏的
desolation	荒芜
natheless	不过
keynesian	符合凯恩斯理论的
pish	叫一声哼
kiss	轻拂
rebukeful	充满责备的
lateralization	偏侧优势
floweriness	似花
deprecatory	不赞成的
immoderation	无节制
deadsville	令人厌烦的
neuropathic	神经性
smogbound	烟雾弥漫的
sedentary	惯于久坐的人
rga	Royal
pyrrha	皮拉
pitpat	卜卜心跳声
boxty	马铃薯面包
ntfs	Technology
loveliness	魅力
lustily	强壮地
gun	油门
reship	把……再装上船
boorish	乡土气
filthily	丑恶地
consanguineous	血亲
clipped	省略一部分
morphographemic	语素字素的
equitable	平衡法
hogleg	"猪腿"手枪
indelibility	难忘
bakeapple	云莓干
pepsine	胃液素
principial	原始
coenocytic	多核细胞
somite	体节
reappointment	连任
plumulaceous	关于绒羽
gladiatorial	斗剑者
envelop	包围
rotproof	防腐
exalted	高位的
feigned	做作
aneroid	无液的
converse	相反
polypragmatical	多管闲事的
undemanding	不严格的
shoo	所发声音
earring	耳环
allosaur	异龙
prospekt	大街
vfd	volunteer
platform	月台
unendowed	没有天赋的
ocap	Application
sainted	上天堂
orobanchaceous	列当科
lack	没有
revisit	重临
matrilateral	姑表关系
hypaethral	无屋顶
reclusion	隐居生活
tana	塔纳湖
polyoestrous	=polyestrous
nonconformity	不墨守成规
slate	暗蓝灰色的
push	干劲
martini	马提尼酒
endurant	能忍耐的
oneself	自己
retribalize	使重新部落化
trench	堑壕
hemothorax	血胸
rantipole	放荡
cylinder	汽缸
virulent	恶性
preselective	预选式
tealess	无茶
chartist	人民宪章运动的一分子
loadstone	磁铁矿
revelation	被揭露的事
histopathology	组织病理学说
idiomatically	惯用地
uninjurious	不招致损害
teniacide	=taeniacide
preterite	过去式
deplane	下飞机
ashine	发亮地
spile	打小孔
fallacious	虚妄的
chellean	=Abbevillian
zebrula	雄斑马与雌马交配所生之杂种
tights	贴身衬衣
indent	订货单
thalami	脑丘
assaultiveness	好动武
opprobrium	耻辱
pigmentize	获
untuneful	刺耳的
crackpot	不切实际的
gargle	漱
flyover	跨线桥
vitae	的复数
tannaim	tanna的复数
individualise	赋予个性
inerrant	无误的
bumpkin	乡巴佬
greediness	嘴馋
neurogenetics	神经遗传学
wizard	有魔力
ncv	no
nasogastric	鼻饲的
excircle	旁切圆
scribal	抄写员
twisty	转弯抹角的
cringle	索眼
reprocess	再生
flavorful	可口的
hjs	sepultus这里埋葬着
gazabo	人
lobsterling	小龙虾
abidance	居住
marmorean	冰冷
department	局
pentomic	五群制的
tympanic	鼓膜的
refashionment	再作
subaerial	面上
malefactress	坏女人
plimsoll	橡皮底帆布鞋
sheepkill	laurel
furred	长着软毛的
ormolu	镀金物
elucidation	阐明
lacrosse	长曲棍球
background	不重要或不引人注目的地方或位置
deceivable	可骗的
concatenate	连接
dephlegmator	精馏器
demonian	魔鬼似
jellied	涂凝胶物
cockily	自高自大
fortunate	幸福的
hound	卑鄙的人
force	推动
roughage	粗饲料
cutup	滑稽的人
hotly	激烈地
qaranc	Royal
profitably	有利
else	别
vittle	的变形
ectropion	外翻
rejuvenate	返老还童
gec	通用电气公司
genoese	热那亚人
seer	先知者
inspirational	给予灵感
insurrectional	起义
scumboard	拦渣板
chanceless	无机会
traitorous	叛变
rhythm	节奏
springhead	根源
alalia	哑
mediate	居中调停
somasteroid	体海星亚纲的
synchronizer	同步装置
englut	吞下
saddler	马具商
mainstay	中流砥柱
tremendous	极大
cantlet	小部分
queue	排队
sigmate	S形的
pool	共有
cementitious	有黏性
chronograph	记秒表
vacuolate	空泡
overthrew	overthrow的过去式
kishke	皮肤
dossy	漂亮
homelike	亲切
bridging	剪刀撑
antidote	解毒剂
saiga	赛加羚羊
pugilist	拳击家
precolonial	殖民地时期前的
ecr	register电子现金出纳机
terroristic	暴力主义
pudendum	外生殖器
bafflegab	难懂的话
dunnite	D型炸药
terminative	终结
myelocytic	leukemia
cowl	通风帽
imperishable	不灭
partialness	不公平的
stinking	讨厌
ventricle	室
bristled	多刺毛的
canned	一稿数用
myself	我自己
polecat	北美产之臭鼬类
hermitry	隐居
townward	往城里
dreamland	梦境
laminate	碾压
acqierement	才艺
espousal	婚礼
scrappy	碎屑
uscg	美国海岸警卫队
unshaded	未遮住的
squattage	牧羊场主占有的财产
spellbound	被咒语所镇住的
cyaneous	深蓝色的
plasmalemmasome	质膜体
clobberer	修理鞋子或修补衣服的人
roast	烤
tiddledywinks	弹小圆盘进杯子的游戏
regenerate	使新生
inosculate	连合
seigniorial	领主
antecessor	前任者
cowtail	似牛的
forward	前锋
townswoman	城镇的女居民
linn	峡谷
heptastylos	有七条柱子的建筑物
amalekite	亚玛力人
collocate	配置
oma	agreement有秩序的市场销售协定
marathonian	马拉松战役的
colemanite	硬硼酸钙石
individualistic	个人主义的
quicksandy	似流沙
compulsive	禁不住的
transfixion	钉住
unmovable	=immovable
hydrocracker	碳氢化合物分裂器
euploidy	整倍性
indolently	怠惰地
flush	奔涌
hildegarde	希尔德加德
unstrained	未过滤的
drove	drive的过去式
postform	对进行后成型加工
enantiomer	对映体
coprological	热衷于色情文学
languishment	无力
viciousness	恶意
castalian	灵感源泉的
craniate	有头盖
discept	争论
supportable	可忍耐的
evaluable	可评价
pollinic	花粉
mdap	Defense
autogenetic	自生的
taxing	繁重的
ultranationalism	狭隘民族主义/饕逭
auc	since
book	登记
conduplicate	双折
astir	活动
ringster	党徒
eximious	超凡的
cryogen	冷冻剂
utp	Paired
microscopic	用显微镜可见
whoever	任何人
puseyite	Puseyism
proud	意
palpably	易觉察地
sterile	不育
abscisin	离层素
quietive	趋于寂静
sax	Simple
joiner	工匠
swirl	大口喝酒
monoclinal	单斜的
gearcase	变速箱壳体
urc	统一资源引用
agonic	无偏差的
deflation	缩小
acellular	非细胞
wintery	如冬的
semidivine	半神的
ivba	国际排球协会
wittig	维蒂希反应
fated	宿命的
knobby	多节
abiological	非生物的
semiyearly	每年两次
fib	撒小谎
zonally	地带地
possession	领地
unveracious	不真实
days	时期
extrahazardous	危险性特别大的
nitwit	笨人
glidingly	流畅
manganous	二价锰的
kosovo	科索沃
heartsick	苦恼
tonalist	作品以有调性为特色的作曲家
haplont	单元体
sina	西娜
finery	精炼炉
gossamer	轻飘飘
callithump	喧闹嘈杂的游行
boned	骨骼的
macroscopic	肉眼可见的
speciously	外观好看
perfecto	两头尖的中型雪茄烟
rummer	大酒杯
speciosity	外表美观
wrangle	辩驳
pellucidly	透明地
hedonistic	快乐主义
basebred	无教养的
orgasm	极度兴奋
chiack	戏弄
clogger	木屐匠
jade	绿色的
bedge	徽章
tearing	痛苦
unknown	未知的
myrmecophagous	食蚁
pinnatiped	蹼足
mingily	吝啬
bat	Training
unseeing	不注意
battels	校内各学杂费用
ginny	意大利人
interdiction	禁止
autobiographic	自传作家
coliseum	大公共娱乐场
hymnarium	美诗集
leucosis	白血球组织增生
offal	碎屑
bachelor	幼雄兽
lowlander	苏格兰低地地方的人
tubule	细管
woodenly	笨拙
sootlike	似煤烟
mission	使命
best	最好的
gum	橡胶
ms	MS
lhd	Doctor古典文学博士
bpa	国际权威发行量认证机构
quilt	摘录
featheredge	薄边
epistasy	=epistasis
acceptance	相信
lawny	草坪
lall	把/r/音读成/l/音
nefariously	穷凶极恶地
gangliated	有神经节
truckie	=truckdriver
hogwild	放纵
pleochroism	多向色性
vasa	=Vaasa
fiduciary	信托的
stuporous	麻木
dietarian	遵守饮食规定者
thole	有耐心
stagnantly	萧条地
alive	活着
usom	Mission
tgwu	Union运输与普通工人工会
berate	严厉指责
pinfeather	鸟的新生毛
create	创作
pomona	果树女神
boreal	北的
comeliness	漂亮的
congregation	集合
attacker	攻击者
abbeystead	修道院所在地
confraternity	协会
proscript	被排斥的人
skyward	向天空
distinguished	高贵
competitress	为competitor的女性
ib	智能大厦
consolette	小型落地式收音机
attrit	消耗
cumbrous	累赘
castaly	卡斯塔利亚泉
mint	来源
perilous	危险的
neotropical	新热带区
singletree	车前横木
barbarous	刺耳的
batwing	状似蝙蝠之翼的
fulminous	雷电
gastroschisis	腹裂
sidestream	侧流烟
voluminousness	浩瀚
castile	橄榄香皂
unsubmissive	坚强不屈的
anybody	重要人物
exvoto	出于许愿
overculture	主导文化
aquosity	潮湿
cardiectomy	贲门切除
inexplainably	无法解释
osteological	骨
wordily	罗嗦
raaf	Air
sopite	解决
basophil	嗜碱细胞
uncontradicted	未受反驳
nauplial	具有甲壳动物无节幼体特征的
deltawinged	有三角翼的
luniform	月状的
levantine	筑堤
kneehole	桌下可容双膝的地方
aristotelian	亚里斯多德学派
trigoneutic	一年三抱的
farewell	辞别
creamery	乳品发售店
regulatory	调整的
matchlock	火绳枪
indubitability	毋庸置疑
caudate	有尾的
morose	郁闷的
antimalarial	抗疟
sear	枯萎的
quadratics	二次方程式论
solarium	日光浴室
jeepable	可通行吉普车的
waywardly	难以捉摸地
trichoma	毛茸
comfort	安慰者
gambade	恶作剧
surely	安全地
semismile	抑制着的笑
raunchy	淫秽
protuberate	凸出
braggart	吹嘘
histophysiological	`hIstEJ9fIzI`CIE`lCdVIkEl/
whorled	有涡漩
legpuller	恶作剧
doa	送到时已死
sarcomatoid	=sarcomatous
spread	铺
diadelphous	两束花丝的
elastically	有弹性地
murmur	发低沉连续的声音
extant	未毁的
tong	煤钳
unfluctuating	不波动的
uterine	同母异父
provincialize	使带乡土气
casting	铸件
notional	概念
statement	综述
supernal	超自然的
hydrosulphide	氢硫化物
antifertility	反受精
crossbuttock	一种拦腰抛掷
sheltery	庇护的
ectozoic	外寄生虫
extragovernmental	政府管辖之外
poaceous	禾本科的
awaken	唤醒
humpery	性交
measles	痧子
faultfinding	喜欢挑剔
lithophyte	石生植物
bulletheaded	顽固的
impedimentary	阻碍的
evaluating	评估
zymosis	传染病
equiponderance	等重
eutrophy	由于矿物质的增加而适合动植物生长
persevering	不屈不挠
proclinate	前倾
hazel	Hazel
olfactory	嗅觉
martial	战争的
constant	常数
comtian	实证哲学
branch	支流
nativism	本土主义
scorekeeper	得分者
acting	演戏
indivertible	不能引开
aimlessly	漫无目的地
archdukedom	大公的地位
rifle	抢夺
taiwanese	台湾人的
succulently	多汁地
ditchdigger	挖沟者
fozy	肥胖
candlefish	蜡烛鱼
capitalisation	=capitalization
eyespot	眼点眼点
ppb	billion
circumfusion	四散
antilogy	思想
piggish	馋嘴
demagogue	煽动政治家
droogie	小流氓
vulgarity	粗野行为
uniface	仅一面有图案的
cerography	蜡画术
dine	进餐
herd	牧群
moorage	系泊
ring	打电话
acetylco	A乙酰辅酶A
pentarchy	五国联合
incitant	兴奋的
inexpiable	不能平息
oxcart	牛车
chalcophanite	黑锌锰矿
severally	各别
notaphily	集钞票癖
overtax	课税过重
whisky	威士忌酒
whizzo	出色
achy	疼痛的
newbie	新兵
tail	监视
talweg	=thalweg
usac	美国汽车俱乐部
titaniferous	含钛的
vagarious	异想天开
neglectful	忽略
blues	忧郁布鲁斯歌曲
susceptive	敏感的
lagune	海滩
microsphere	微球体
skeletony	骨架似的
utilitarian	功利的
pronounced	断然
dissolving	消溶的
fair	直接
cham	可汗
coattail	上衣后摆
phototypography	照相排版
bisync	Communications
oxychloride	氯氧化物
xenodocheum	旅馆
fmn	flavin
cointreau	橘味白酒
kirghizian	吉尔吉斯
isopentyl	=isoamyl
edinburgh	爱丁堡
lincomycin	林肯霉素
surgent	汹涌
tgv	Vitesse
depot	军械库
bifid	两裂
backwind	使风转向
chare	做零工
surmise	猜度
unsung	未唱
epicondylar	上髁的
wrecking	遇难船
polygynous	一夫多妻
sclerotioid	似菌核的
shady	成荫的
hyperventilation	换气过度
textual	原文的
cobaltic	钴的
coxed	有舵手的
stingy	小气
impracticability	不能实施的事项
tracheal	呼吸管
regimen	政权
pessimist	悲观主义者
scourings	社会渣滓
dennet	敞篷二轮马车
eyeleteer	针眼锥
radarman	雷达员
gossip	闲谈
aonb	of
civilized	文明的
warden	典狱官
disrespectable	不体面
mosstrooper	流寇
quingenary	=quincentenary
counterfort	拱柱
baume	波美比重计的
arid	干旱的
alfa	a
period	过去某段时期
fractionalize	把……分成几部分
dmt	multitone
geomorphic	似地球形状的
lye	用碱液洗涤
contaminative	弄脏了
bullroarer	吼板
current	现在
suctorial	有吸附的
maffia	黑手党
greengrocery	蔬菜类
emancipative	旨在解放的
shulamite	书拉密
nothingness	不存在的状态
regard	致意
marlinespike	穿索针
article	商品
collop	皮肤的皱摺
balaclava	巴拉克拉法帽
soldierlike	有军人样的
redigest	重新领悟
auc	urbe
taxless	免税
diapsid	双窝类的
wwf	世界野生动物基金
defective	有缺陷的
caveat	中止诉讼手续的申请
assertory	断言
megalocephalia	=megacephaly
depopulation	减少居民
pelagian	远洋动物
hal	硬件抽象层
otherguess	完全不同种类的
rhoda	罗达
dead	死者
boliviano	玻利维亚货币单位
concentric	同中心的
asteroid	小行星
afternoon	午后
mediocre	普普通通的
tinwork	锡器
auntie	阿姨
storey	层
metafile	图元文件
unmarried	单身的
cloy	过饱
skinch	节约
breadth	宽度
sucker	吸管
autotelic	自己本身具有目
mescaline	酶斯卡灵
scud	飞奔
antalgic	镇痛剂
description	形容
astigmatometry	散光度计
leviable	应纳税的
unattended	未敷裹的
johannisberger	德国
keeping	饲养
coupe	双座四轮轿式马车
exuberate	充满
ticklish	难对付
log	原木
epigeal	贴地生长的
enrich	使富足
photovoltaic	光电
wacko	古怪的
pigtail	猪尾
incised	切入的
stateliness	威严
hoot	大声叫嚣
catch	燃着
smell	嗅
remorselessly	无悔意
triggerman	保镖
pace	溜花蹄
emerge	形成
ergophile	爱好工作者
flatly	水平
downy	多丘岗
excrescency	瘤
meagrely	瘦地
retail	转述
ppcc	Consultative
compensate	偿还
aftermarket	贩卖修理用零件的市场
threesome	一人对两人的比赛
handwrought	手工
ectal	外侧
remnant	残迹
hognosed	鼻子像猪鼻的
unaccountably	无责任的
brunhilde	布伦希尔德
humanize	变为有情
placement	布置
sonsy	丰满的
implosive	内破裂形成
xenoantiserum	异种抗血清
lubricative	润滑的
peculiar	特有财产
duodecagon	十二角形
queerly	奇怪
flagitious	极恶
hypersexual	性欲过度
underboss	黑手党二老板
peeper	偷窥者
spectrofluorometer	分光荧光计
sciurine	松鼠科动物的
suffragist	主张扩大参政权的
vesiculate	小泡的
boscage	草丛
lentiform	小扁豆似
thoron	钍射气
proselyte	改变宗教信仰
skopje	斯科普里
tagmemicist	法位学家
yond	彼处的
sealflower	荷包牡丹
psilanthropism	耶稣凡夫论
southerner	南方人
fractionary	微少
queendom	女王的尊严
styracaceous	安息香料
retrogress	退步
march	使行军
acclimate	使服水土
slobbery	流口水的
aerarian	关于国库的
carbamic	由氨基甲酸获
atop	在……的顶上
obtest	恳求
helluva	很大的
chymist	化学
contentedly	安心地
chemotactically	趋药性
hospitably	善于款待地
veracious	说实话
flectional	屈折
roentgenopaque	X光透不过去的
raceabout	竞赛用游艇
moor	系住
speaker	喇叭
concordat	宗派间的协约
intelligibly	易理解
excise	国产税
vocationally	职业上地
goatee	胡子
capetown	南非共和国立法机关所在
hopeful	怀有希望的
squeezable	可压挤的
hayrack	干草架
gey	相当地
uncommon	罕有的
sdram	DRAM
cartman	赶大车的人
ritzy	时髦
bodywork	车体
aspersory	洒水器
unvanquishable	不能克服
renowned	有声誉的
incisor	门牙
mux	混乱
tromso	特罗姆瑟
wobble	摆动
ecc	Correction
climacteric	呼吸峰
fletcher	造箭者
taxing	费力
hamal	搬运工
gun	开大的油门
abroach	开个口使水流出
hashimite	哈桑王族的
bylaw	次要法规
acidity	胃酸过多
digraph	两字母发一音
hazy	模糊的
precipitantly	倒栽地
arty	艺术家气派
slaver	奴隶贩子
lightface	细体铅字
octal	八进制
lutetian	古名
administrant	管理的
sandblast	喷沙
secularization	还俗
simple	简单
oberon	Titania
timeworn	陈旧
uses	Employment
becrawl	向……爬行
mitigative	镇静剂
shrinkable	会收缩的
episperm	外种皮
percuss	敲
demeanour	行为
brownstone	上流社会的
boracite	方硼石
journalistic	新闻从业员的
reintroduction	再引入
otherwise	否则
worth	值钱的
teratogeny	畸形生长
imploring	哀求
unconcerned	无忧虑
unpleasing	讨厌的
horizon	视野
vortically	旋涡似地
abortus	流产胎
state	规定
lovebug	黑色小毛蚊
gynecologist	妇科医生
ratine	平纹结子花呢
missiology	传教工作研究
unsought	未追求
anglian	盎格鲁人的
tuck	鼓声
grave	铭记
presidial	管辖
tetrapetalous	四花瓣的
grouse	牢骚
annex	附件
manito	大神
nightwalker	梦游者
protandry	雄蕊先熟
corbeil	花篮装饰
touchhole	火门
buffo	滑稽
parch	烤
siderostat	定星镜
hutch	养小动物的圈栏
inaptly	不适当地
situs	地点
transilient	突变
assentient	赞同
ebu	Broadcast
huffy	发怒的
coneflower	黄雏菊属植物
throughother	杂乱地
rebus	画谜
irreclaimable	不可恢复的
acuate	尖的
osteitis	骨炎
idol	崇拜物
decasualise	=decasualize
presidial	主持的
subcuticular	表皮下的
distributive	分布
squirish	样子像乡绅的
acclimatise	=acclimatize
plasticator	塑炼机
unbuttered	未涂黄油
bulkhead	防水壁
spirit	妖精
oops	表示惊讶
conflicting	相矛盾的
suprathreshold	超阈值
resurrective	使死者复活的
connection	接线
anticlimactic	虎头蛇尾
tearful	含泪的
acervate	成堆生长
rifle	步枪
hortator	奖励他人者
syntheses	综合性
civil	有礼貌
milimetre	公里
stockade	围起处
fany	Nursing
pumpable	可用泵抽吸的
agreeable	使人愉快的
unpublicized	未公开的
streamlined	改进
foist	使混入
cryptic	神秘
canella	白桂皮
tightness	紧密
toxaemic	血毒症
bionomics	生态学
oribi	侏羚
phonetic	语音的
brownnose	拍……的马屁
additional	附加的
snr	信噪比
reentry	再入
silicomanganese	硅锰
regenerative	再生
defiance	蔑视
casuarina	木麻黄属的各种常绿乔木
gleam	使发微光
questioner	发问者
horseman	骑师
eidetically	特别逼真
runt	矮子
stilly	默默
xylographic	木版印刷
frightful	非常的
tasset	=tasse
gravely	严峻
autarchy	专制国家
flagman	平交道看守
inconsequence	矛盾
zolaesque	左拉作品的
lpg	Petroleum
spurious	伪造的
advertising	广告
disturbingly	动摇地
ustc	States
kretek	丁香香烟
goad	煽动
gapa	地对空导弹
our	我们的
trash	无聊的作品
rescinnamine	萝芙木碱
arguably	可论证
militaristic	军国主义的
paraplegic	截瘫
sarcostyle	肌柱
godson	教子
sac	液囊
unknit	松开
leaping	跳跃而行
walk	行
realizable	可了解
lepton	轻子
subtle	稀薄
ideational	概念的
poor	卑鄙
myoclonia	肌阵挛
mission	任务
material	重要
debate	辩论
mesosphere	中间层
antibiotics	抗生素
overcapitalization	资本之过高估价
lightstruck	意外曝光
mutiny	兵变
sloughy	泥沼
inobservantness	不注意
fin	五元纸币
parachronism	年代记录错误
unmelodious	不入调的
metaldehyde	四聚乙醛
unoffended	不生气
nod	点头
negativistic	抗拒性
transmutative	变质
inflammation	怒火
aetiology	原因之说明
rba	British
amphigamous	无性器官的
flavoprotein	黄素蛋白
antinatalism	人口限制
scutate	盾状的
her	她
repent	悔悟
tripey	垃圾般的
cocky	过于自信的
reppo	depot=repple
goody	糖果
scarify	乱割
umbilic	中心的
ominous	恶兆
proud	骄傲的
haplography	掉字
assignment	作业
craped	绉纱的
leave	出发
wolfer	捕狼者
sei	鰛鲸
inflammation	燃烧
quoin	外角
steadfast	坚定
vagabond	懒汉
tenderer	投标人
jalopy	破旧的飞机
plerom	中柱原
embryotrophy	胚胎营养
resplendence	灿烂
covariation	共变
moor	荒野
accusatival	宾语的
unpleated	不打褶的
divided	分开的
rabble	聚众闹事
pretersensual	超感觉
resemblant	摹仿
peridotite	橄榄岩
wintry	寒冷
dreep	=drip
antipathy	反感
hamose	具钩
acritical	不危急的
indestructibly	无法破坏
eggbeater	打蛋器
blamelessly	无可责难
lccmarc	国会现行机器读目录文件的图书馆
reject	不合格品
fx	exchange
piolet	冰镐
apractic	运用不能症
chlormadinone	氯化孕酮
outturn	产量
cordage	绳索
definitize	使成定案
nail	指甲
irradicable	不能根除
bordereau	照会
whiplike	像鞭子
voluptuary	耽于酒色的
still	依然
czech	捷克人
chain	一系列
classwork	老师与学生一起在教室做的功课
fatter	胖
swimming	游泳用
sulfuret	硫化物
humorous	诙谐
merely	仅仅
unlikely	未必
pomerania	波美拉尼亚
foliose	叶子覆盖的
back	后退
headstrong	任性的
salbutamol	舒喘宁
homologate	同意
charge	冲锋
discontinuer	中止
ala	翅
centaurea	矢车菊
baculine	鞭刑
brainman	参谋
filbert	榛子
sloughy	脱落的
synergic	合作
lutescent	稍带黄色
niggard	小气鬼
lithographer	平版家
rue	芸香
swept	扫频的
wired	极其兴奋的
pipewort	谷精草
remontant	一季多次开花的
pushful	富有进取心
passant	向前直走姿势的
eutropic	向阳光性的
unuseful	无益的
discontinuous	不连续的
timbales	蒂姆巴尔鼓
scunge	借入
dictaphone	录音电话机
worked	作装饰用的
damned	非常
furious	激烈
psychotomimetic	拟精神病的
divine	非凡
melting	融化
remanent	剩余
toplofty	瞧不起人的
volatilize	挥发
cyperaceous	莎草科的
dermoid	皮状的
nauseated	厌恶
aarnet	Research
paganise	=paganize
catchweight	无体重限制
literalness	无修饰的
poculiform	杯形的
opposed	反对的
temerity	蛮勇
fucker	笨蛋
trial	审判
bundle	包
natch	当然
subentry	分项
thalassic	海
contralto	女低音歌手
trump	打出王牌赢
fasti	年表
landlocked	为陆地所包围
unbolt	拔去门闩
gametogeny	=gametogenesis
aryan	雅利安人
stoneman	石匠
hedonism	快乐论
missis	妻子
turnabout	变节者
replacement	交换
bourbonism	顽固的保守主义
serve	服务
ornl	Oak
jump	跃过
sining	西宁
hyperfocal	超焦
decimal	以十为基础
fictitious	编造的
wreckful	导致破灭的
incantation	咒语
hoatching	挤满的
faint	昏倒
keepsake	纪念品
axel	前外一周半跳
blossom	发展
prosecute	作检察官
indological	印度学的
azeotropism	=azeotropy
undro	Nations
duero	=Douro
teleoperator	遥控操纵装置
chance	偶然性
sizer	筛选器
apterygial	无肢的
uar	阿拉伯联合共和国(阿拉伯埃及共和国
wrongdoer	做坏事的人
anthropoid	类人猿
anhydrate	除去……的水分
proximity	亲近
dermatoid	皮样
patientless	无病人
kellock	应急锚
sitfast	坐輶瘤
calliope	卡利俄铂
nujiang	River
heimisch	不拘礼节的
adoptability	采纳性
coeval	同时代
alnico	磁钢
xanthopsy	所看之物皆显黄色之症
subtotal	小计
paigle	高报春
benthamic	边沁学说
rembrandtesque	伦勃朗风格
foretime	已往
meatworks	屠宰场
candleberry	蜡杨梅或其浆果
irbm	intermediate
whirlabout	团团转的
alexin	补体
fib	一击
embed	使嵌入
alackaday	呜呼
kwacha	克瓦查
theonomous	服从上帝意志的
ridge	山脊
bayman	住在港湾的居民
hyperemization	充血作用
wove	布纹的
widukind	威德金特
divergency	分离
entries	个
vociferance	大声叫喊
calculate	计算
planography	平版
punishment	惩处
dps	Protection
punctum	色斑
map	地图
unreduced	未弱化的
skip	跳跃
spiritualism	招魂说
jady	似玉的
dichroitic	二色的
kremlinology	苏联政体研究
rabbanite	rabbinite
fibreboard	纤维板
picturesque	独特的
ruddle	代赭石
chrysocarpous	结金黄色果实的
gesneria	苦苣苔科
apoise	准备好的
papery	象纸的
kinsey	Kinsey
prudently	谨慎
fishable	可钓鱼的
spicebush	洋腊梅
chinoperl	中国俗曲演唱文学研究会
sigmatropic	σ移位的
amitrol	氨基三唑
somniloquist	说梦话的人
predispose	使偏向于
underground	秘密的
cankerous	腐蚀的
hindoo	印度教教徒
calculated	适合
reunite	再结合
used	用旧了
doubler	大碗
tackling	卷起
doltish	愚钝
wacko	发疯
unpremeditated	非预谋的
record	创纪录的
milestone	重要事件
fissionable	可引起核分裂的
cad	Design
equilibrize	使平衡
medalist	设计奖章者
scr	侦察车侦察
co	Certificate
emma	女子名
agaric	蘑菇木耳
zanu	National
englishism	英语语法
dauphin	法国皇太子的称号
intracardial	心脏内
anaplasia	退行发育
fieldwards	向原野
emulsification	乳化作用
nonexistent	不存在
colidar	光雷达
supercluster	超星系团
parcelgilt	局部镀金的
canfield	甘菲德牌戏
holophrasis	单词句表达
piping	滚烫
holdback	障碍
exospheric	外大气层的
auris	耳
strategical	战略的
unright	错误
landmass	大陆
juvenilize	使保幼
hassid	=Hasid
yaffingale	绿啄木
organizable	可变为有机体
nonrecurrent	不再发生的
funked	发霉
cothurn	=cothurnus
determine	使下定决心
polysemous	一词多义
insuperable	不能克服的
swab	擦洗
them	他们
pacifier	抚慰者
heidi	海蒂
interpretive	解释
dog	小人
vidual	寡妇的
opaquely	无光泽
taxonomic	分类学
inform	告知
sponsorial	保证人
wanderjahr	漫游年
hili	的复数
inspirational	有灵感的
cycle	整套
representability	能被描绘
ogam	欧甘碑铭
ocso	of
cribrose	筛状
frigidaire	其商标名
antiphon	轮流吟唱的歌
semiofficially	半正式
rumbustiously	喧嚣
urge	催促
nonofficeholding	在野的
bobstay	斜桅支索
tourism	观光事业
ingleside	炉边
finfooted	有蹼
amor	爱神丘比特
volcanicity	火山现象
egged	煽动
casually	偶然地
dna	Applications
iceblink	冰原反光
lachrymal	啜泣的
inactivity	不活泼
fill	装满
hyphenism	归化美国的公民之精神或风范
timeless	永恒
frad	Frame
rhabdomere	感杆
subside	衰减
gag	讨论终结
pennant	细长三角旗
loom	织机
schoolman	烦琐哲学家
bolivar	委内瑞拉货币单位
manager	管理器
portend	预示
seto	=Seto
slan	超人
fetishist	物神崇拜者
mislabel	贴错标签
thermae	公共浴池
pagan	异教的
sixfold	有六部分
froth	发泡
vaginitis	鞘炎
aquarist	水族养殖业余爱好者
tiffin	午餐
queenlike	女王般的
guizhou	贵州
key	锁上
hydropath	=hydropathist
graser	γ射线激光器
rattling	很好的
inquietly	焦急
kindergarten	初级
xml	Language
calyces	花萼
patron	赞助人
unwanted	讨厌
krameria	=rhatany
prang	轰炸
justly	公正地
pose	佯装
hulloo	=hallo
ensanguined	血染
lengthily	冗长
gray	灰色的
scribbler	三流作家
shiva	七日服丧期
whim	幻想
extroverted	喜社交的
entertaining	愉快
ascorbic	维生素C的
ebullient	沸腾的
formulate	用公式表示
rexine	其商标名
stocky	健壮结实的
tranylcypromine	强内心百乐明
tuneful	音调谐美的
intensively	强烈地
sighthole	窥视孔
alveolar	齿槽音
agamy	无婚姻制
while	消磨
unlearned	没学好
streaked	不安
desertion	丢掉
bedside	床旁
collop	薄肉片
calculated	适当的
rcvs	Royal
propeller	推进者
laingian	兰恩治疗法的追随者
forepeak	船首舱
admire	钦佩
grandfather	祖父
wtc	World
overaggressive	过于侵略成性
overlie	睡在……上面
amazonian	有男子气
bulge	凸出部分
habanera	哈巴涅拉舞
audience	拜见
immotility	不能游动
unobservant	不注意
handbarrow	手推车
autoplastic	自体成形术的
aglossal	无舌
sawbones	尤指外科医生
smallwares	杂货
quarterfinal	四分之一决赛
cranky	暴躁
industrially	企业
jointless	无关节
individualism	利己主义
plantation	大农场
tractable	驯良的
compartmental	分割为若干部分的
indestructibility	不能破坏
hypogenous	下生
exophthalmus	眼球突出
reichsbank	德国国家银行
wilderness	荒地
sympathizer	同情者
scenario	或是某一特定情节
genially	亲切
wipo	Property
laptev	Sea
pyrometallurgy	热冶学
budding	发育
flexuous	波状
theatrically	戏剧化
strive	奋斗
reclusive	隐遁的
killjoy	扫兴的人
dupe	欺骗
phthisical	肺结核的
set	布景
ecr	cash
dysthymic	心境恶劣的
pasquinade	讽刺
planiform	扁平形
dyarchy	两头政治
tetrandrous	具四雄蕊
hypocorism	委婉语
jazzophile	爵士乐爱好者
chylification	形成乳糜
minor	未成年人
shat	排泄粪便
accouchement	分娩
overspread	铺满
jd	少年罪犯
nominalist	唯名论
datemark	日戳
laureate	戴桂冠的人
okay	赞同
cod	鳕
discontiguous	不连续
navajo	=Navaho
unapproachable	不能接近的
generotype	=generitype
calibration	标度
complicacy	复杂性
hageman	凝血因子XII
unsubstantial	不坚固
negotiatory	交涉
ropewalking	走钢索
unfettered	被除去脚镣的
halophilous	喜欢盐
contrivance	想出的办法
object	宾语
hogarthian	贺加斯风格的
gamester	赌徒
anteriorly	居先
ivan	男人名
loanword	外来词
utilise	=utilize
umbrageously	浓荫地
initial	词首的
vocative	呼唤的
booklore	书本知识
disparlure	雌舞毒蛾引诱剂
semiofficially	半正式地
homogenize	均质化
ureter	输尿管
feat	技艺表演
headland	向水中突出的陆
taurine	金牛座
sinecure	挂名职务
defoaming	消去泡沫的
preemptive	抢先的
questura	警方
fanatic	盲信的
posttension	使
flightily	轻狂
limaciform	蛞蝓形
sennet	喇叭号声
inferrible	可推论
intimidatory	威胁
radiation	发热
musette	牧歌调的曲子
johnsonian	庄重的
tintinnabulary	铃
tsinan	济南
scullduggery	=sculduggery
claustrophobic	幽闭恐怖症
chyme	食糜
biophilosophy	生物哲学
rich	肥沃
ban	禁止
osteal	骨
baroque	形式怪样
aliform	翼状的
owlery	鸮栖息地
pinhead	无足轻重的东西
tarnation	诅咒
edi	Electronic
gaudy	华而不实
indigent	穷困
unsccur	Conservationand
aborad	离口侧
transitive	及物的
stateswoman	妇女政治家
nonarticulate	不分节
nsa	国家安全局
morphotectonics	构造地貌学
handlers	操作者
coexecutor	共同执行人
past	过去
unclasp	解开扣子
xcv	罗马数字
glutethimide	多睡丹
cognovit	被告承认书
idle	空闲的
largo	缓慢曲
twopence	价值微乎其微的东西
pygmaean	极小的
thresh	颠簸
upshot	结果
hurtfully	有害
supine	仰卧
volatilizable	易挥发的
discretely	离散地
flickering	摇曳
jidda	吉达
accident	意外事件
sale	廉价出售
flatterer	奉承者
cheezit	走开
sheba	of
incursionary	侵略
righthearted	诚实的
zoroastrian	与索罗亚斯德教有关
unrent	不受侵扰的
biscuit	小点心
intravascular	血管内
hypothermia	降低体温
whiplike	鞭子似
glucose	葡萄糖
detectable	可看穿
grantsmanship	获得捐款的本领
autocoding'	NULL)
anticlimactic	突降法的
pertinently	适切
endarterium	动脉内层
contradictory	反对
militant	好战的
unfishable	不适合钓鱼的
justinianian	查士丁尼一世
nwa	Airlines
triangulate	a由三角形而成
wilderness	荒
molly	娘娘腔的男人
gammon	胡说
tonal	音调的
roadway	路线
auc	city
unprojected	非预料
elimination	排除
unthanked	没有得到感谢的
ophthalmic	眼科的
punch	打孔
fading	枯萎
separative	分离性的
buses	公共汽车
calligraphic	书法的
inexhaustible	无穷无尽
improbability	不大可能的事物
forthcome	向前
harmonics	和声学
picnic	野餐
