hub	网络中心
wdp	Transport
antsy	坐立不安的
inosite	纤维糖
feature	起重要作用
cowtail	有牛味的
dutifully	忠实
dipartite	划分的
secretively	稳秘地
capillarity	毛细管作用
arrayal	排列
complaisant	柔顺
pocket	击……入袋
befitting	适合
superannuation	领养老金退休
ruffian	凶恶的
interferometric	干涉仪
reversion	反转
estrogenic	动情激素的
starve	使饿死
rummery	酒店
warsong	军歌
possible	可能存在或发生的
marlinespike	解索针
bund	同盟
reward	奖赏
letdown	减低
humourless	一本正经的
matrimonial	根据结婚的惯例
hydrofluoric	氢氟酸的
malfeasant	不法行为
mortuary	停尸房
piping	笛声
nondescript	难以区别的
defy	违抗
zygosporic	接合孢子
drawstring	拉带
saponaceous	圆滑的
uneconomical	浪费
racialism	人种偏见
devolution	转移
crackled	有脆皮
arctic	北极
cern	for
somesthetic	躯体感觉
declivitous	向下倾斜
emerge	显现出来
variational	变更的
bisque	桔黄色
pawl	制转杆
pepsinogen	胃蛋白酶原
migronaut	无国籍游民
rhinology	鼻科学
remorseless	不屈不挠
zigzag	弯弯曲曲地
motley	小丑
pale	暗淡
appreciate	鉴赏
paigle	药用樱草
layering	压条法
gastronomic	烹任学的
wildfowl	猎鸟
acetophenone	乙酰苯
ile	"倾向"
escapee	逃避者
sulfa	磺胺类药剂
colourably	似是而非地
extraparochial	教区外
areopagus	最高法院
beerengine	啤酒泵
masticatory	咀嚼的
fascinating	醉人
pooch	杂种狗
lightplane	私人小飞机
deliberation	商议
digest	融会贯通
body	人
slough	脱落
gristle	软骨
volcanologist	火山学家
bla	Bachelor
rs	rupees
fetch	售
dac	Aircraft
department	系
undone	未完成
religionary	涉及宗教的
suitability	相配
reverent	尊敬
conestoga	一种大篷马车
scarlet	深红的
weightiness	重
slavish	盲从的
hydrostatical	流体静力学
zi	zone
scurvily	下流
very	甚
papillary	长乳突的
whipstall	尾冲失速
ruler	直尺
impenitent	顽固
commodore	海军准将
aglisten	光辉耀眼的
sigmoid	C形
richelieu	黎塞留河
past	过去的
ken	见地
subcutaneous	皮下用的
assailment	痛骂
ani	自动号码标识
with	关于
hyperparathyroidism	甲状旁腺功能亢进
nacarat	鲜艳的桔红色
allegorically	寓言地
wll	Wireless
fiducial	基准
photography	摄影术
tarsal	眼睑软骨的
loathful	令人讨厌
crave	渴望
anastrophy	倒置法
equipment	铁道车辆
acolyte	侍僧
cedarapple	rust
smudge	弄脏
lucullan	富裕的
offering	献礼
bractlet	小苞片
chrysocarpous	结金黄色果实
groats	碾去壳的燕麦
blooming	盛开的
criminal	犯法的
shaky	不安
help	助长
sochi	索契
presence	出席
winterbound	受到寒冬限制的
private	秘密
ophiolatry	蛇崇拜
colacobiosis	寄生在异种昆虫社会之生活
tellable	可述说的
rowland	ring
textile	纺织
cucumber	黄瓜
bluster	怒号
pipa	负子蟾
vrml	Language
boxroom	储藏室
eremophilous	栖荒漠的
sensitize	变得敏感
ornithopod	鸟脚亚目恐龙
suppressible	可以压制的
abode	住处
device	装置
truer	确实的
abortionist	为人堕胎者
skutterudite	方钴矿
systemic	系统
elfish	如小精灵的
compurgator	为他人作证者
uric	尿的
epoxy	环氧
migrate	移动
idiomorphic	整形
bivinyl	联乙烯
rheological	流变学的
chomp	咬响牙齿
indusium	囊群盖
fluxion	消失
ambrosial	特别美味
chloritization	岩石中的矿物变为亚氯酸盐
sinitic	中国文化
hydrofracturing	液力加压开裂
parison	玻璃半成品
pacemaking	定步速
circumlunar	月球周围
walla	经办业务人
paster	粘贴的人
endowment	捐款
windless	喘不过气的
realizing	明确无误
hedger	骑墙派
rhizomatous	生地下茎的
inulin	菊粉
pythic	=Pythian
nebbich	=nebbish
acedia	绝望
alabama	阿拉巴马州
indirect	间接
strook	strike的过去式和过去分词
roadbook	路程指南
cowshed	牛舍
crankous	易怒的
felsitic	致密长石
unphysiologic	不符合生理规律
austronesian	Austronesia
blinkard	常眨眼或视力不佳的人
waec	西非经济共同体
likely	可靠
circularly	圆地
floriferous	多花的
habile	灵巧
delivery	交付
flourish	处于旺盛时期
seafaring	水手工作
epigene	表成
prefocus	使预先聚焦
protopodite	原节
foreclose	取消抵押品赎回权
feeling	感觉
offhanded	立即的
anabasis	进军
pram	童车停车场
closehanded	吝啬
aduncous	向内弯曲的
indirectly	间接地
cyma	波状花边
nsf	Science
last	使维持
sacculus	球囊
megalith	巨石
alpenglow	染山霞
barococo	过分纤巧的
metewand	评价基准
stelae	石柱
rectorial	教区长的
fray	被磨损
tackle	扭倒
eonian	永远
boulevardier	花花公子
aristotelean	亚里斯多德的
nonrated	非军士级的
articulacy	口齿清楚的说话能力
pbb	polybrominated
excavate	开凿
dainty	适口
educe	引出
branchial	鳃状的
untidy	凌乱的
flightless	不能飞
isoparametric	等参的
mohammedan	回教徒
sarcasm	挖苦
lightless	不发光
reist	=reest
absquatulate	逃走
rejon	木柄长矛
stipulation	约定
nascar	Car
humoristic	诙谐的
ectostosis	软骨膜下骨化
quittance	赔偿
dead	死
pharmaceutic	配药学的
miee	Member
experimentalize	做实验
wafer	用干胶片封
fay	接合
twirler	军乐队
plantlet	苗
quadrille	四对方舞曲
strobotron	频闪管
emergent	浮现
tropaeolum	金莲花
eib	欧洲投资银行
cca	dapter
triandrous	三雄蕊的
means	方法
sweaty	出汗的
swift	雨燕
jennings	詹宁斯
iconolater	圣像崇拜者
randomicity	随机性
lully	Raymond卢利
gloam	变朦胧
mcpo	Chief
acidy	有些酸味
guilty	犯罪的
shazam	快变
hogget	一岁以上的羊
crumple	变皱
lullaby	摇篮曲
deltoid	字形
encoignure	置于墙角的装饰性家具
unaffected	不矫揉造作的
query	询问
felspathic	像长石
cryptic	隐藏的
coloratura	花腔女高音
hesitant	吞吞吐吐的
baalize	改信巴尔神
tumesce	肿胀
halloa	喊叫
quakerish	谨严
paul	保罗
outworn	废弃的
anemochorous	由风散布种子的
sphincter	括约肌
humourless	缺乏幽默感
vacillation	不果断
sympatholytic	阻滞交感神经的
gulliver	格利佛
swanskin	天鹅绒般
hide	剥……的皮
congruity	调和
varicellate	具有小螺层隆起的
piliform	毛样
welchman	=Welshman
carvacrol	香芹酚
milchig	乳制
sneakingly	卑鄙
bitsy	极小的
heavy	笨重地
forecast	预见
harmonization	调和化
hives	假膜性喉头炎
decoration	装饰品
boned	骨骼
primacy	首位
fizzwater	汽水
commercioganic	有市场
grungy	邋遢的
elusively	巧妙逃避地
image	映像
ooze	渗出
blat	不加思索说出
sciential	知识
unsmirched	未受玷污的
massy	巨大的
sackless	无害的
rabid	狂暴
equerry	掌马官
subordination	部属
pe	体育课
epilimnion	变温层
wastebin	垃圾桶
ridable	可骑马通过的
sinistral	用左手
happenstantial	偶然发生
mostaccioli	意大利斜切短通心粉
venereal	性病
ilo	Labor
intranational	民族内
transact	处理
soloistic	独唱
aspuint	侧目地
nebulose	=nebulous
glans	龟头
undyed	天然色的
hypochondria	臆想病
warren	养兔场
freaky	畸形的
interprovincial	省与省之间
disconfirm	证明不成立
bronchial	支气管
thong	皮带
polycentrism	多中心主义
ustc	Commission
fainthearted	无精神的
teutophobe	恐惧条顿者
hal	Layer
mismanagement	管理不善
jeremias	=Jeremiah
gec	General
humorless	缺乏幽默感的
odor	名声
drollery	笑谈
flexibility	机动性
taoist	道教信徒
transeunt	超出己身之外
subalpine	亚高山带
revolting	令人厌恶的
astigmatism	散光
bullyrag	威吓
apogeotropic	背
hilar	门的
cryptological	密码术
biblioklept	偷书人
gibraltarian	直布罗陀人
abolitionize	使赞成废除黑奴制度
brs	英国道路服务处
creatin	肌氨酸
flute	凹槽
womanish	柔弱的
hydrosulfide	氢硫化物
essentialism	基本教育说
option	买卖的特权
ole	Linking
usbek	=Uzbek
unexcited	不兴奋
appropriator	占用者
fruticose	灌木
calculi	结石
nubilous	多云
vance	万斯
paralyze	使麻痹
melanocarcinoma	黑癌
primulaceous	报春花科的
brainpan	头盖
daytaller	散工
sql	Structured
hoodoo	招来不幸的人
polje	灰岩盆地
sympetalous	合瓣的
wba	世界拳击联合会
caseinogen	酪蛋白原
absent	缺少的
entocondyle	内侧髁
orthopterous	直翅类的
promote	晋升为
sphygmomanometer	血压测量计
slate	暗蓝灰色
underlying	根本
acronichal	薄暮
castigator	谴责者
accident	事故
equality	相等
daggerboard	中插板
trench	战壕
hobbledehoy	小伙子
distaste	讨厌
closest	最靠近
tab	标签
sympathizer	支持者
obsequial	葬礼的
bacchic	酒神
unwrought	未加工成成品的
chott	北非小盐湖盆
irritability	过敏性
perceivably	可知觉地
victor	维克托
disintegrator	粉碎机
iatric	医师的
lethargic	昏睡
crosscut	捷径
college	学会
linalool	里哪醇
parsnip	欧洲防风草
echogram	回声深度记录
vidette	小型哨艇
prostate	前列腺的
avarice	贪婪
unspent	没有用完的
xanthochroi	金发白种人
fingerlike	指状
insecticidal	杀虫剂的
hdl	high
interlope	闯入
coralbells	珊瑚钟
indetectable	不可察觉
eustace	尤斯塔斯
lingulate	舌状
derisively	嘲弄地
washcloth	洗碟布
plainness	明白
thames	泰晤士河
impairment	损害
exultantly	狂欢地
satinpod	缎花
urundi	乌隆迪(东非国家布隆迪
cpff	fixed
tetany	手足抽搐
computerate	非计算机盲的
slingshop	弹弓
spareness	贫乏
ppm	million
detonate	引爆
eradicative	根除
quilt	缝被子
lighthearted	快乐
magnitude	量级
hypoazoturia	低氮尿
discal	盘状的
hide	掩藏
aidedecamp	侍从武官
db	分贝
era	时期
cmb	Chase
epistolary	用书信的
thermoelement	温差电元件
punty	顶底杆
unmelodious	音调不悦耳的
sexagesimal	六十的
platiniferous	产铂的
strut	支柱
iaupe	International
safety	保险
king	首领
brutify	具兽性
hermetical	密封的
rough	粗略的
ridgepiece	栋木
cochlear	耳蜗
antidromic	逆向
preemptive	有先买权的
contumacious	反抗法院命令的
uncharted	海图上未标明的
female	柔和的
fostress	养母
oarweed	昆布
header	页眉
depreciatory	贬值的
cheder	=heder
humbuggery	欺骗
absorbable	容易被吸收的
tintinnabulary	铃声
tutor	监护人
beverley	贝弗利
superabundance	过多
unpretending	不装模作样的
halfpenny	半便士铜币
continental	大陆
chronically	习惯性地
spice	调味品
tribromide	三溴化合物
inegalitarian	不平等的
pupiparous	蛹生
appealingly	上诉
northwesterly	位于西北方
bargain	议价
euclidean	欧几里
scoopy	汤匙式的
hatchway	舱口
scran	残渣
subcortex	下皮层
flexional	屈折的
carrier	邮递员
homeomorphous	同胚
ins	插入键
brushy	灌木丛生的
conceptualism	概念论
goggle	护目镜
byronic	冷笑而浪漫
pie	弄乱
pittypat	噗噗跳
geocentric	由地球中心所见成测量的
hashing	散列法
divine	神的
commonplace	平凡的事
saltant	突变型
corpselike	似尸体
alliterative	头韵体
font	字形
pintano	岩豆娘鱼
proportionment	匀称
entoptoscope	眼内媒质镜
unavoidable	不能避免
buirdly	高大结实
nonpathogenic	非病原
arras	花毯
lackluster	无光泽
criticism	批评
ips	per
katzenjammer	头痛
jimp	苗条
amplectant	攀附的
vito	维托
fade	淡出
peak	最高
unimposing	不庄严
ssa	社会保障总署
outright	全部地
largo	庄严的
kooky	怪人的
nacreous	真珠质
emi	电磁干扰
indirection	间接
freeness	不拘泥
basidiomycete	担子菌类
decomposability	分解性
recordership	记录员的职位
hepatopexy	肝固定术
dislike	嫌恶
geographical	地理学的
ferial	平日的
lunitidal	太阴潮的
torrefaction	烘焙
petrographical	岩相学
rim	蓝框
timorous	胆小
variscite	磷铝石
wile	诡计
propagation	传播
oppression	镇压
reposit	使复位
midsemester	学期期中
backwoodsy	蛮荒
sometime	曾经
assuringly	保证地
coach	训练
hesitant	犹豫
paracusis	错听
feeling	衷心
indeedy	=indeed
tyumen	秋明
biserial	与双列有关
station	配置
demultiplexer	多路输出选择器
accord	给与
crimpy	卷缩了
imperialism	帝制
eel	美洲鳗
flimsy	浮夸
culm	灰煤
quad	方庭
fill	弥漫
revisor	修订者
disinflation	制止通货膨胀
considered	被尊重
unskillful	不熟练的
unduly	不正当地
beaverette	人造海狸皮
preparative	准备
overshoe	套鞋
screen	掩蔽物
mesocardium	心系膜
revaccinate	再接种疫苗
every	每个的
invidious	易招嫉妒的
vine	蔓生植物
justificative	用以辩解
corticate	有外皮
catlike	偷偷摸摸
spiry	尖塔状
immunorepressive	抑制免疫力的
cogon	白茅属植物
cageling	笼中鸟
obtuse	愚蠢
concede	承认
trapes	漫步
signatary	=signatory
sniffable	可闻
naughty	淘气的
crenelated	雉堞状的
dolorous	悲痛
society	上流社会
disyllable	双音节式
yha	Association
molest	调戏
ghostliness	朦胧
file	档案
obtund	使缓和
mol	克分子
evict	逐出
whet	使兴奋
appaloosa	阿帕卢萨马
peasantize	使成为农民
unprevailing	无影响的
rrb	Retirement
wrest	夺取
sting	刺
chou	心爱的人
qcb	Block
gulgul	防蛀涂料
chromatopsia	色视症
arboriculturist	树木培植家
statecraft	管理国家的本领
somnambulance	梦行
spicy	出产香料的
fortune	财富
cathartic	通便的
chelonian	龟类的
reimport	再引进
ibadan	伊巴丹
unordinary	少有
imperfection	非理想性
woodenly	笨拙地
incommunicative	不爱说话的
dnb	Dictionary
true	忠诚的
guidwillie	高兴
sinologue	研究中国文化者
secularize	使凡俗化
greenback	背部为绿色之动物
levigate	捻成细粉
hieron	神庙
diversionist	进行牵制活动者
spectrophosphorimeter	分光磷光构舛燃
jinan	济南
fatuous	昏庸的
staminodium	=staminode
catholic	天主教的
saguaro	仙人掌之一种
hyalomere	明区
rental	租金额
arrhythmically	节律不整
venomous	有毒
nourishment	营养品
futurama	未来世界展示
renunciative	放弃
allopatric	在不同地区发生
remedy	药物
ally	同盟
diminution	减少
jovial	高兴的
delphic	暧昧的
brotherly	兄弟
snubby	好轻视人的
triplicate	三重的
unregistered	未注册的
singing	歌唱
eclipse	使黯然失色
petroleur	用火油纵火的男子
xylocarp	硬木质果
curtail	简略
choosy	好挑剔
dirtily	龌龊地
wooly	毛织品
constructively	建设性
sickish	象是要吐
solutrean	梭鲁特文化的
furious	狂暴的
imminent	逼近的
hardcore	核心部分
hyperpyrexial	体温过高
undemanding	要求不高
picture	描绘
phonogram	语音图
magic	有魔力的
trematode	吸虫的
casually	临时
colonialist	奉行殖民主义的国家
tightfitting	紧身
dindle	震颤
microblade	薄刀片
ramp	蔓延
filth	不洁
upbeat	乐观的
locutorium	=locutory
tongking	=Tonkin
saigonese	西贡
sural	腓肠
tuner	调谐器
outworker	外出工作人员
equalize	使相等
stockily	矮而粗壮地
feasance	履行
ibs	情报库系统
nox	诺克斯氧化氮
tabetic	脊髓痨
semifinished	半制的
shorthorn	短角牛
accrete	共生的
fearfully	颇
supertransuranic	超铀后的
commotion	骚动
cruciferae	十字花科
complexity	复杂性
subdelirium	轻度谵妄
cyanohydrin	氰醇
brachycranic	圆颅型的
internuncio	使节
whisht	默然
applicator	为人敷药的人
robustly	粗鲁地
essential	本质
holocaine	霍洛卡因
reprehensibly	应受责难地
direct	直率的
libate	喝酒
addressor	说话者
galvanize	电镀
proceeding	学报
dihydroxyacetone	二羟基丙酮
incarcerate	把……关进监狱
sixpenny	便宜的
interceptive	妨碍的
skeleton	万能钥匙
imperceptive	无知觉能力的
overall	全面的
emanative	流出
erda	Research
rumor	谣言
filly	小雌马
plutus	普路托斯
emigre	流亡者
inherent	内在
bizonal	分为二地区的
withal	对此
vitalism	活机论
unheated	未加热的
influent	流入的
before	以前
acequia	灌溉水渠
lunilogical	与月球研究有关
linlithgowshire	林利思戈郡
pack	包装货物
philatelic	集邮癖的
tritish	有些落俗套
contaminator	致污物
jollification	热闹
barren	不孕
confessionary	忏悔室
featherbed	任闲职
electroballistics	电子弹道学
minbar	敏拜楼
dignified	有威严的
unprohibited	合法的
rvsvp	plait
florid	绚丽
bulky	大
negabinary	负二进制数
neurodepressive	抑制神经
optokinetic	视动
cow	大型母兽
eremophilous	栖荒漠
positive	确实
punjabi	语
senarmontite	方锑矿
aeruginous	铜绿色的
karl	卡尔
abridgment	删节
khz	千赫兹
psychologic	心理上的
juice	液
sawblade	锯片
volitive	意志
flickeringly	摇曳
weeknights	在每个周日夜晚
far	久远地
floriation	花饰
ballistic	弹道
ingratitude	不知恩
suffering	受苦
adjustive	调节
raspy	焦躁
unclarity	不明确
leprechaun	妖精
gleaning	拾遗
pocketbook	钱袋
inn	住旅馆
sdk	Kit
expeditiously	敏捷地
supravital	体外活体的
pleonasm	冗长
masterless	无主
choice	宠爱的
lawdy	=Lawd
playback	录音重放
discommode	使不方便
lavage	洗胃
asymmetric	不均匀的
acis	埃西斯
incinerate	把……烧成灰
questura	警察局
scranton	斯克兰顿
exalted	高位
smart	漂亮
emile	埃米尔
isolato	被逐出者
unsung	未唱的
cornbrash	石灰质砂层
comtesse	伯爵夫人
ethelind	埃塞琳德
downstage	在舞台前地
worthy	可敬
spicily	讽刺
pigwash	饲猪的厨房剩菜
convincing	令人心悦诚服的
mend	修理
montonero	庇隆主义左翼城市游击队员
hurtling	飞奔
imperatorial	大将军
subception	=subliminal
bamboozle	迷惑
eprom	电可编程只读存储器
theft	偷窃行为
methylbenzene	=toluene
languisher	衰弱、憔悴的人
immunodiagnosis	免疫诊断
lark	诗人
salon	沙龙
fluidram	=fluid
indeterminist	非定命论者
polymastigote	多鞭毛的
reallocate	再指派
tortious	侵权行为的
widen	加宽
hall	会堂
zoology	动物学
leptonic	产生轻子的
pied	杂色的
cursive	草书体的
echinated	有棘皮
sloppy	溅污的
robe	长袍
scombrid	鲭科鱼
ecru	本色的
biramose	二枝的
vaporisation	=vaporization
wwf	Federation
pretreat	预先处理
dozy	想睡的
semiautobiographical	半自传体
aleatory	侥幸的
phototypesetter	照相排字机
mundane	平凡的
anticlimactic	突减的
longbowman	使用大弓的人
virulent	致命
outlandish	外国气派的
flagman	旗手
osmotic	渗透性
leisurable	不慌不忙
finestra	隙缝
gi	美国步兵
fireroom	火室
narcoanalysis	麻醉分析
typhoidin	伤寒菌素
smell	臭味
interfere	妨碍
uigur	具有维吾尔人的特点的
seagirt	四面环海
firebrand	煽动叛乱者
vitriolize	用硫酸烧
repat	遣返回国
sax	API
unbacked	无人押注的
springboard	出发点
tower	城堡
purpoint	=pour
amble	溜蹄
naupliiform	甲壳动物无节幼体形
insectile	由昆虫组成
offprint	选刊
essential	基本
svga	Video
comportable	合适
polystome	多口孔体
rivalship	竞争
genially	和蔼
cotswold	=Cotswold
derogate	贬损
pdq	Damn
peroxidize	过氧化
syllabicate	读出各个音节
indecisive	非决定性的
anthropic	人类的
unimpressive	不令人信服的
ascribable	可归于……的
diluvium	洪积层
endemic	地方的
nocent	有害
acerbity	刻薄
eaux	的复数
radiate	流露
age	同时期的人
temerarious	不顾一切的
matthias	马提亚
uninjured	未受伤害
able	能……
unornamented	朴素的
nasofrontal	鼻额骨的
gazetteer	地名辞典
sunfall	日落时分
mesozoic	中生代
aloetic	芦荟的
inestimable	无法估计
asepsis	防腐处理
hemp	大麻
pompier	救火员用
maul	打伤
scaled	有鳞
wafd	埃及国民党
cakewalk	举行步态竞赛
cokernut	椰子
aerify	在……注入空气
methodist	卫理公会教派
shaky	不可靠
jollify	使快乐
shag	粗烟丝
forked	叉状的
asean	东南亚国家联盟
onrush	猛冲
wistful	想望的
glossematic	语符学
diathesis	素质
mossback	动作迟缓的大鱼
unswerving	不偏离
lithophilous	爱石
information	见闻
inker	电信用打字机
enantiotropy	对映现象
tritagonist	第三演员
larkishly	好嬉戏地
silly	无助
calotte	头盖帽
malmsey	白葡萄酒的一种
semiyearly	每年两次地
fcis	the
bogie	妖怪
vacate	离
devilry	恶行
monticulate	有火山丘的
tedious	沉闷的
misguided	被误导
underdeveloped	不发达的
subzone	分区
cupriferous	含铜
inadmissible	难承认
every	每个
diaphanous	透明的
slummock	狼吞虎咽
imperialization	帝制
distillatory	蒸馏用的
majorcan	马略卡人的
motorize	使摩托化
theocratic	神权政治的
epiphytotic	植物流行病的
pledge	举杯祝……健康
rj	junction交叉路口
peak	帽舌
dicotyledon	双子叶植物
gilly	侍从
druffen	酒醉的
indistinction	难辨认
klatch	谈话会
anisochronous	非等时同步
prestige	威望
displace	移置
transmigrant	移民
broadcast	播放
unfreeze	使解冻
unanswerable	无可辩驳的
unwillingness	不愿意
henotheism	单一主
applicably	适当
hazy	烟雾弥漫
determined	决定了
phosphofructokinase	磷酸果糖激酶
loom	迫近
grieved	伤心
conventionally	按照惯例
puritanical	清教徒
whensoever	无论何时
fussily	大惊小怪
miscible	易混合
riposte	还刺
peasantry	小农阶级
vastly	许多
begrudgingly	小气地
endwise	末端朝前或向上的
whp	水功率
digestibility	消化性
theomorphic	似神的
lexicographic	词典的
comminatory	威吓
ambuscade	埋伏处
mongolian	先头愚型症
gibbet	绞刑
nautical	航海的
semiparalysis	半瘫痪
archaeologist	考古学家
experiment	试验
recast	重新铸造
thrive	茁壮成长
hjs	jacet
iced	装冰
decubital	褥疮的
housefly	家蝇
caulomic	和茎结构形态相当之结构
superposition	重合
tall	夸大的
tandoori	泥炉炭火烹饪法
severalfold	有几部分分的
sebaceous	脂肪分泌
aerially	在空中
propertied	使用道具
epaulement	肩墙
kosciusko	科修斯科山(在新南威尔士州东南端
overnight	通宵
pyrex	派热克斯玻璃
inebriated	酒醉的
prosperous	繁荣
fusimotor	肌梭运动神经
nemoricolous	生长在树丛中
indispensable	不可缺少
reincite	再煽动
infidel	无信仰者
mashy	n
outwatch	长守
vxd	Driver
folklike	=folkish
unmerciful	残酷的
rafter	筏夫
semilogarithmic	半对数的
who	那……的
perbromate	过溴酸盐
citing	引证
marlite	泥灰岩
iatrochemically	化学疗法地
unkindness	不亲切
sculpt	造型
awol	without
hawk	兜售
overnight	晚上
iaru	Amateur
ordinance	条例
cretaceous	白垩的
rident	兴高采烈的
ani	动画光标文件扩展名
cagey	谨慎小心的
commensal	共餐的
canned	录音
poop	船尾楼
sensuous	感觉上的
ependymal	室管膜
remonstrative	抗议的
lancewood	其原木
rhemish	=Rhemish
kazan	喀山
ncsa	for
neurotrophic	神经营养
dissociable	不爱交际的
boatable	可行船的
malay	马来西亚的
religiose	笃信宗教的
involucrate	有蒴包
sevenfold	七重的
samely	单调的
earned	挣得的
screever	马路画家
mesotrophic	中滋育的
electrosensory	电感
sniffy	嗤之以鼻的
ruritanian	对王室持浪漫主义观念
autocorrelator	自相关器
inimitably	独特
burns	大鬓角
unaffected	不矫揉造作
floodplain	泛滥平原
tendril	蔓
fade	使褪色
restive	难控制的
finical	过分周到
unlovely	讨人嫌的
caries	骨溃疡
landlocked	为陆地所包围的
talky	多对话
sas	Scandinavian
rylean	赖尔方法
anaclitic	情感依附
cracker	胡桃夹
downtrend	下降趋势
uscgr	Coast
lipstick	口红
comparison	对照
piped	拷边的
congregational	公理教会的
catwalk	桥上人行道
person	身体
sigil	图章
import	意思
monstrosity	畸形
price	价格
tinfoil	锡纸
christingle	service
prefade	给作预退色
republication	再版
anticlockwise	逆时针的
caesalpiniaceous	豆科山扁豆属
sightsee	观光
catchall	包罗万象
eddo	芋根
clothesprop	晒衣绳支柱
setiparous	生刚毛
quadriform	有四种形态
nouvelle	中篇小说
fittest	适当的
incarnate	人体化的
preen	打扮漂亮
cutler	刀匠
psittaceous	鹦鹉般的
inelegantly	不优美
lick	打
biotical	生物
sonochemical	由声化学现象产生的
involve	包括
feod	采邑
macrocephalic	畸形
stunt	阻碍……发育
multiparous	一胎多子的
sensationalist	感觉论者
salpingitis	咽鼓管炎
bikini	比基尼泳装
absorbency	吸光度
typescript	以打字打的文件
rondelle	圆开物体
laughing	带笑的
azonic	不限于一地方的
hemishere	大脑半球
minicomputer	小型机
inflame	燃烧
radiotechnology	在工业上的运用
undissembled	真正的
respect	关系
oceanologist	海洋学家
parian	帕罗斯岛产白色大理石的
cryptogam	隐花植物
muckle	重要的事
anestrous	不动情期的
flagitious	罪大恶极
reasonless	不合理
sexploitation	色情利用
everybody	人人
od	过量毒品
probational	试用的
repatriate	遣返
bermudan	=Bermudian
overflew	overfly
labradorite	闪光拉长石
irreproachable	无可指责
prepensely	预先谋画地
insatiably	不知足
couth	文雅的
politely	优雅
topless	无顶
feckly	几乎
bathhouse	公共浴室
reinsertion	重新插入
pill	弹丸
ungimmicky	不耍花招的
satanophobia	魔王恐怖
hyperrealism	高度写实主义
paperbacked	纸面的
cry	叫
magdalen	从良的妓女
idolatry	偶像崇拜
yankeeize	使扬基化
undersign	签名于末尾
circularly	循环
zanu	Union
pleasurable	愉快
damning	毁灭的
talocalcanean	距
popish	教皇制度
quickie	速成的
diffusible	扩散性的
lodgeable	适合居住的
northwestward	西北方
colligation	综合
lax	松驰
feeling	同情
song	歌曲
examine	检查
zincoid	似锌
calescent	增温
docudrama	文献电视片
impar	奇数的
registration	登记
knightage	骑士
haemospasia	杯吸导血法
unpracticed	练习不足
prestissimo	最快
pree	尝试
dwelt	dwell的过去式和过去分词
resegregate	在……恢复种族隔离
annularly	环状地
contrive	设计
planoblast	浮游水母
procuratorial	代理人的
oblatory	奉献
breezily	微风地
japanization	日本化
unendued	未赋予
schedular	时间表
afar	遥远
voluntary	自动
correlative	相关的
wail	悲痛
mainsail	主帆
remontant	一季多个花期
conoscope	锥光偏振仪
poleaxe	以斧砍倒或攻打
trendline	趋势线
gyrograph	旋转次数测度器
duma	杜马
vop	p
dross	无用之物
the	那
deflationary	通货紧缩的
dankish	阴湿
multipurpose	多目标的
oozy	软泥的
entomostracan	切甲类的
trail	痕迹
revive	回想
grill	严加盘问
diarist	日记作者
composmentis	精神健全的
extroverted	外向性的
shaving	刨花
russki	=Russian
nazir	印度籍法官
deft	敏捷熟练
touchable	可食用的
dozen	一打
girth	围长为
grisliness	令人毛骨不悚然的可怕的
undemonstrative	含蓄
chamber	会所
scavenger	清道夫
shield	防护物
unsmart	不洒脱
billowy	巨浪似
inconvertibility	不能交换
electriferous	带电
huron	休伦湖
peculiar	特殊
eloge	悼演颂词
punningly	一语双关
trapezium	梯形
tailstock	顶针座
lav	盥洗室
morbidezza	细腻
netfs	National
montanic	山区
rapturous	兴高采烈
commercioganic	吸引力的
distichously	二分
reassign	再分配
alterability	可更改性
unbridgeable	不能逾越
alcoholometer	酒精比重计
adventist	基督再临论者
knottiness	纠纷
contredanse	对面舞
ajut	伸出
partan	蟹
catastrophism	n
dreadful	可怕的
histogenesis	组织发生
speedily	快快地
antiauthoritarian	反独裁主义者
unappealing	不能打动人的
genuinely	诚实地
rommany	=Romany
pristine	质朴的
incapacitation	使无资格
temporariness	暂时
discept	有分歧
microinstruction	微指令
red	亏空
rental	租贷
africander	南非牛
inestimable	无法估计的
joseph	约瑟夫
churchgoer	经常去做礼拜的人
dramaturgy	戏剧作法
blueprint	设计图
sociolinguistics	社会语言学
campy	同性恋
elitist	杰出者
intrench	使起皱纹
tab	TAB键
ufo	不明飞行物
waxy	蜡色
litterbin	废物箱
rostrate	有喙的
confection	糖果
percutaneous	经由皮肤
conglomeration	团块
granulocytopenia	粒细胞减少
ricebird	食米鸟
mabe	人工养殖的珍珠
employment	使用
sexduction	性导
penology	刑罚学
nortriptyline	去甲阿米替林
doglike	顽强的
knottily	纠纷地
centenary	一百年的
ungreeted	未致意的
steamroll	以不可抗拒之力前进
gax	oxygen气态氧
mucopurulent	黏液性及脓性
epicardial	心外膜
dread	恐怖
galactophorous	产乳的
drawstring	细绳
gradin	阶梯的一级
revoltingly	叛乱地
smokebox	烟室
droning	声音低沉单调
eradicator	去污剂
wash	洗涤
daric	达里克
xinca	辛卡人
uncle	叔父
explicatory	说明
plaintful	哀诉的
lienal	脾的
appealing	吸引人
bootlegger	酿私酒者
stroke	敲
ejaculation	射出
choice	挑三拣四
telemotor	液压传动操舵装置
idg	美国国际数据集团
show	外观
roundabout	道路交叉处的环形路
rutilant	发红色火光的
kvell	吹牛
expositor	说明者
karelian	卡累利阿人的
enneagon	九角形
glacis	缓冲地区
jwv	Veterans犹太退伍军人会
can	能
antirust	不锈的
wave	波
foregone	预知的
inez	伊内兹
aggressively	攻势
unapproved	未经批准
notion	打算
eyebrow	眉毛
amortisement	摊还
eutropic	向阳光性
detection	侦查
industrialist	工厂主
phthisic	结核病的
swabber	负责打扫工作的船员
massoretic	=Masoretic
phylloclade	叶状枝
sera	serum的复数
equilibrant	平衡力
overwear	使过度疲乏
coincident	符合
locum	临时代理
polite	文雅
mesothelioma	间皮瘤
lecithoid	磷脂
photochemical	光化学的
dicast	审判官员
carrageenan	角叉胶
floppily	懒散地
antipyretic	退热剂
thio	硫代
overconfident	过于自信
grainy	粒状
efficient	有效率
federally	同盟
fsb	前端总线
obverse	正面的
amain	突然
appropriable	可挪用
unashamed	问心无愧
greatest	最伟大
draghound	经训练能循臭迹追踪的猎犬
dishtowel	干毛巾布
ultramundane	超俗的
veronal	佛罗拿
fellness	残酷
fusible	熔解的
unglue	硬使分开
score	评价
frederica	弗雷德里卡
bourg	村镇
confluction	会合处
deray	纷乱
arenic	竞技场的
vision	幻影
sulfinyl	=sulphinyl
aurorean	晨曦的
intransigency	不妥协态度
homoiothermous	恒温动物
nonresidential	非住宅
unstriped	非横纹的
cyanoguanidine	氰基胍
katana	刀
mens	心
paging	页面调度
sestertii	sestertius的复数
outsourcing	外购
grossly	粗
voodoo	伏都教
sloppy	潮湿
confine	限制
forgery	伪造物
bisulphide	二硫化物
mensurability	可测性
videodisc	电视唱片
unspent	未耗尽
dishing	碟形的
aeroginous	产气
zymotechnics	酿造法
hyperconscious	a知觉太过敏锐的
stratagem	计谋
average	均分
estimator	评价者
pratincolous	栖草原
eunomic	井井有条
gaius	圣加伊乌斯
leather	皮革制品
zincify	镀以锌
fizz	活跃
balanced	安定的
study	论文
longtimer	长期刑囚犯
morcellate	切碎
fingerparted	如手指状辐射
history	历史记录
restoration	重建
barometry	气压测定法
hylophagous	食木的
supportless	无支持者的
otherness	不同
point	弄尖
superb	庄重的
quickish	相当快
handbound	用手装订的
disennoble	降低品格
heckuva	=helluva
superciliousness	傲慢
isotonic	等分
tributyl	phosphate磷酸三丁酯
homeothermal	=homoiothermal
reimpose	重新征收
fool	干傻事
wad	把……卷为一卷
excuse	致歉
sloppy	溅污
aardwolf	土狼
cravenly	胆小
hypostasis	根本原理
toner	调色剂
transcend	胜过
galactokinase	半乳糖激酶
gi	美国兵
bimonthly	双月的
entame	使驯服
roughscuff	下层人民
marduk	马杜克
overcapacity	生产能力过剩
funabout	小型游乐车
donkeyish	愚蠢
yvr	加拿大温哥华机场之代号
sixpenny	六便士的
indic	印度的
xxxv	35
bregma	前囱
slipslop	无味
immensurable	不可衡量
try	试
wdp	无线寻址信息协议
logarithmic	对数
catechise	盘问
negativistic	抗拒性的
drafty	有缝隙风吹入
dolomitic	含白云石的
dado	台座
fornix	穹窿
vistadome	观景车顶
unreasonableness	无理性
detrusive	推落
rulership	统治者的地位
pantagruelist	庞大固埃
magnicide	重大谋杀
sanious	排出脓液
pyrite	黄铁矿
exoergic	放能的
unseeing	不注意的
unreel	回卷
percentagewise	在百分比上
autobus	公共汽车
create	造成
ciliiform	睫毛状
heronsew	=hernshaw
cyclonic	气旋的
tetraonid	鸡形目禽鸟科的
pmla	Association
ferrety	似雪貂
warily	小心
oilily	光滑地
thickheaded	笨的
promontory	隆起
lunatic	疯子
amaranth	苋属植物
romneya	罂粟科植物
etymologize	指示语源
deconcentration	分散
roundup	驱集
phosphatic	含磷酸盐
drive	驱动器
amass	积聚
fetishize	以……为偶像
russetish	略带红褐色
misprize	蔑视
embellishment	装饰
posthypnotic	催眠后
ostensive	以事实例证
caster	轮脚
huly	=hooly
latter	后面的
trappy	圈套
leant	lean的过去式及过去分词
traffic	用……作交换
languet	象舌头的东西
perennial	永久
hydrogasifier	加氢气化器
bellhop	旅馆侍者
dawdling	闲逛的
theomorphic	神形
nae	不的
actinodermatitis	X光皮炎
labiovelar	唇软颚音的
condonable	赎罪
implacentate	无胎盘动物
embroider	刺绣
cultivation	培养
ozonesonde	臭氧无线电探测仪
contradictory	对立物
mhw	high
candent	白热的
washerwoman	洗衣妇
protocol	协议
dextrous	机巧
mearns	=Kincardine
roving	粗纱
determination	果断
mambo	曼博音乐
bradypepsia	消化徐缓
offbeat	不规则的
royal	第一流的
conflate	合并
imperfect	减弱
consonance	和音
mobile	可移动的
indissolubility	不溶解性
trot	小跑
fateful	重大的
gangliate	有神经节
skywatch	天空观察
librarian	图书馆员
bay	绝路
jomon	绳纹文化
swabian	斯瓦比亚的
embolize	发生栓塞
perihelion	近日点
intacta	未遭玷污
soapbark	皂树皮
technofreak	技术迷
movably	可动性地
limbers	污水道
penicil	毛撮
hematogen	血原汁
resolution	决议
papable	适于并可能继承教皇职位
professional	专业
medley	混合物
featherbone	羽骨
distress	穷困
erect	笔直的
marxist	马克思主义的
forward	前进的
motoneurone	运动神经元
inform	获悉
scenical	风景的
journalistic	新闻从业员
champaign	原野
floribunda	花束月季
rush	突袭
adrenalize	使兴奋
bacillus	杆状菌
explicable	可解释的
tremendously	可怕地
undermanned	船员不足的
co	货源证书
spindle	锭子似的
baconian	培根哲学的
attractively	动人地
peculiarly	特别
synaesthesia	共同感觉
iniquitious	极不公正
crocein	红色或橘红色染料
gpd	每日加仑数
acusector	电割针
qpm	Queen''s
salvageable	可打捞
affrontedly	被冒犯地
faggoty	同性恋
pupillometer	瞳孔计
puckery	弄皱的
northerly	来自北方
charily	小心谨慎
guidable	可指导
interferometric	用干涉仪测量
triblet	心棒
backflow	流向来源
surmise	猜测
christcrossrow	字母表
hernial	疝
prettyish	有点美
conceptual	概念上的
trot	快步走
msphe	of
herakleion	=Iraklion
embark	登上
reservedly	客气地
gonococcus	淋菌
shortchange	少找零头
singularly	另人无法理解地
supernaturally	超自然地
mandan	曼丹人
plagiocephalic	斜头
continue	继续
predetermine	预先确定
guana	鬣蜥
stook	堆禾束
seidel	大啤酒杯
crackbrained	不谨慎的
verboten	禁止
sierran	锯齿山脊的
vitae	vita
coequality	同等权利
fideicommissary	财产遗赠的受益人
lowness	卑贱
downer	令人沮丧的人
gnn	Network
lothario	好色之徒
bratty	不服从的
squire	大地主
mussily	吵闹
rural	乡村风味
equate	视为平等
your	pro
pitted	有凹痕
dropper	使滴下的东西
accessary	帮凶的
magnet	磁铁
emotivity	易动感情
soed	Oxford
saveable	=savable
leavings	残渣
crura	下肢
hydrodynamic	水力的
motorist	常坐汽车的人
sermonize	布道
looky	瞧
leprologist	麻风学者
surgical	外科手术
capstone	顶点
tartness	锋利
odic	颂歌
fair	公正
biennial	二年一次
overcuriosity	过于好奇
section	断片
iaupe	of
achromatous	无色
firebolt	霹雳
rehearse	排练
respectfully	尊敬地
hypoallergenic	低变应原
earthen	陶制
iniquitously	非法
infrequent	很少发生的
displeasing	令人发火
appendices	见appendix
document	公文
cynomolgus	猕猴
ephebeum	=ephebeion
crenulate	小圆齿状
diminutively	小
haematopoiesis	造血作用
sericulturist	养蚕者
fruitive	能产果实的
acetic	乙酸的
dispersedly	分散地
schlockmaster	劣货制造者
jerkin	短上衣
unmeditated	自发的
nccj	Jews
indices	index
hornet	大黄蜂类
unheard	未被倾听的
den	兽穴
overstaff	为……配备人员过多
zoosemiotics	动物符号学
toastmistress	女祝酒提议人
vestibular	门口走廊的
illude	诓骗
carper	苛评者
mcat	College
ring	拳击场
aboil	沸腾着
carbecue	热压熔化废旧汽车的装置
economical	经济的
guano	人造
taskwork	重活
shepherd	牧羊
heathrow	Airport希思罗机场
udp	Datagram
retributive	报应的
geep	山绵羊
lipotropic	抗脂肪肝
handsbreadth	一手之宽
hydrosulfate	硫酸化物
maunder	唠叨地讲
kinabalu	基纳巴卢山
jambeau	护胫铠甲
relativistic	相对论的
confectionery	糖果店
lime	石灰
hebetic	青春期发生
width	/
proteiform	形式多变
everybody	每个人
bowery	树荫
golgotha	墓地
laster	持久之人
noncaloric	无热量的
calgary	卡尔加里
jaap	傻瓜
harmonic	和声的
polyhedric	多面体的
ibex	野生山羊
setback	挫折
muck	鬼混
banteringly	嘲弄
silverfish	蠹虫
preemployment	录用前的
caravaggiesque	卡拉瓦乔
evanishment	消失
pomeranian	人
ambiguous	不明确的
unscrupulous	肆无忌惮的
florin	一种货币
leasehold	租赁的
iodate	碘酸盐
hyetal	雨
instancy	紧急
shortia	岩扇
jaspilite	碧玉铁质岩
cheerleader	啦啦队队长
loss	输
failure	失灵
gerodontics	老人牙医学
unsung	未在诗歌中歌颂过
electrotype	电版
bowels	内部
tsamba	糌粑
carrion	腐朽的
succinyl	琥珀酰
carioca	克力欧卡舞
polygalaceous	远志科的
denunciation	告发
potable	饮料
uninventive	才能的
vum	发誓
sleet	下雨雪
work	劳动
unpracticed	练习不足的
procacious	鲁莽
rectilineal	哥特式建筑
headstrong	顽固的
snowswept	大雪纷飞
sexidecimal	16进位的
theandric	神人两性结合
perfin	=spif
salinogenic	能形成盐的
wigged	戴假发
loan	借
phytochemical	植物化学
cinetheodolite	=kinetheodolite
actinal	有触手的
kinglike	堂堂的
sensate	知觉的
clangorous	叮当响的
monseigneur	有此荣衔的人
recording	记录用的
combine	联合收割机
glossal	舌的
decretal	法令的
evident	显然的
carbamic	氨基甲酸
agrestial	农田中野生的
doglike	象狗
sympathetectomy	交感神经切除术
secund	侧方的
intended	故意的
existential	存在判断的
yemen	也门
presentence	判决前的
cyanocobalamin	维生素B12
colorimetric	色度的
snakemouth	红朱兰
facilitate	推动
phrasemongering	空谈
pots	旧式普通电话服务
charmless	不美
nuke	以核武器攻击
exhaustive	无遗
amplificatory	放大
queenliness	适合当女王
azotobacter	固氮菌
meroplankton	暂时性浮游生物
defuze	拆除雷管
missish	小姐似
throwaway	宣传小册子
nervine	神经镇定剂
hellen	赫楞
integraph	积分仪
semicomatose	轻昏迷的
unentertained	未得到娱乐的
toluic	甲苯酸
orthodox	正统
vmi	Military
yap	吵嚷
dirl	抖动
silt	残渣
chipper	爽朗
pronatalism	提高人口出生率主义
refutal	驳斥
stayer	抑制物
stickle	坚持己见
reign	统治
insoluble	不能解决
originative	有创作力的
extrusion	喷出的
unlearned	无教育
scrap	互相殴打
cureless	无法医治
rhyme	用韵诗表达
cayman	鳄鱼
roseroot	蔷薇根景天
comb	梳
fslic	Loan
crisply	清楚
calciphile	在石灰质土壤生长的植物
undaunted	勇敢
crumby	低等
ground	场所
ridgelike	如脊的
pleuroperitoneal	`plJErEJ9perItE`ni:El/
clear	清除
spaghettini	意大利式特细面条
whoever	无论谁
easterling	东方国家的人
gnawing	苛责
spitball	唾沫曲球
latinity	拉丁语的使用
lionly	狮子似
jwb	Board犹太人福利委员会
metrazol	米特腊唑的商标名
civilize	使文明
japanese	日本
undomesticated	未驯服的
bookmaking	著作
comtian	实证主义的
banjax	胜过
micr	Character
isacoustic	等声强的
triangulable	可三角剖分的
immolation	祭物
minisize	微型
amadou	火绒
goldwynism	的妙语
osteoma	骨瘤
pneumonia	肺炎
interminably	无限地
boffo	风行一时的
libraire	书店
riptide	激流
gastriloquy	口技
lampadephoria	火炬接力赛跑
mill	压榨机
reason	理智
means	意味
villus	长茸毛
gum	橡胶树
faint	虚落地
wolfsbane	牛扁
manipulable	可操纵自如
scraping	刮擦
drave	drive
fadeometer	褪色试验器
undercut	底切
hag	沼地
headmistress	女校长
derivation	词源
hyacinthine	风信子的
exhaust	不会枯竭
bettina	贝蒂娜
hilt	柄
hahnemannian	哈内曼疗法的
marseilles	马赛布
fagot	成束熟铁块
aspca	Cruelty
bicorporeal	有两个身体的
cachou	口香糖
bats	怪异的
wicked	不道德
scrootch	=scrooch
unaspiring	无上进心的
noncommittal	不承担义务的
pretense	伪称
explicit	直率的
rakish	放荡的
semilustrous	半光泽的
territorial	领土
spencerian	斯宾塞哲学的
adriatic	亚得里亚海
lithophyte	岩表植物
shortage	不足
education	训导
unawakened	潜伏的
bismuthic	铋
subtotal	求……的部分和
peer	贵族
lull	变平静
dogtrot	小跑步
silicic	硅
trochar	=trocar
hipshot	跛的
outlie	露营
tolstoian	信仰托尔斯泰的人
esquimau	爱斯基摩人
haggard	憔悴的
rolamite	无摩擦滚轴
overmaster	制服
tba	be
cashbox	钱箱
younger	年纪较小者
rude	粗鲁无礼的
cingalese	锡兰人
swaddle	襁褓
anticly	古怪
conscription	征召
watertight	水密的
baffle	困惑
narrow	勉强的
geniculation	膝状弯曲
dedicated	专注的
enforceable	可强行
flocculent	絮凝的
tannoy	扩音器的一种
imperfectible	无法致于完美
uplift	促进
french	法国的
leapfrog	跳背游戏交互跃进
gink	家伙
gemutlich	和善的
komsomolsk	共青城
revise	校订
wooer	追求者
doubtful	不确的
total	总数
material	素材
skillfully	技术好地
unwitnessed	未注意到
nonconformist	不遵奉英国国教的基督新教徒
processible	=processable
director	指挥仪
miserable	痛苦的
banalize	使庸俗
wram	窗口式显示存储器
gorgy	多峡谷
cataleptiform	似强直性昏厥
songkhla	宋卡
shamefacedly	羞怯地
medley	杂录
unkink	放松
epicanthus	蒙古内眦赘皮
barrelful	一桶之量
uncorrupt	无讹误的
immanent	固有的
cuddlesome	令人想拥抱
dare	胆敢
uscg	States
haplography	漏写
liveryman	穿制服的仆役
nodose	结节多
phosphatidylcholine	卵磷脂
overfree	过分自由的
procaryotic	原核
smartly	潇洒地
remorseful	懊悔的
myalism	迈尔巫术
gainless	毫无进展
turnery	车削产品
girlish	适于女子
nonflying	不能飞的
casein	干酪素
collectivise	=collectivize
rush	飞跃
impavid	大胆
cue	暗示
convincible	可使信服
character	特征
bid	祝愿
haematogenesis	造血作用
moody	喜怒无常的
altarpiece	祭坛装饰
organ	器官
feed	放牧
venus	金星
cactaceous	仙人掌科
underline	下划线
lichenaceous	青苔般
stony	多石
semiarboreal	半林栖的
aja	of
unwary	易受骗
rogatory	查询的
fozy	愚笨
crimp	使卷曲
blastoderm	胚盘
gleeful	愉快
etymology	语源
daybreak	黎明
winning	胜利
scale	衡量
gneissose	片麻岩的
knower	认识者
blobberlipped	嘴唇肥厚的
peak	最高峰
trotty	小跑的
heritability	遗传可能性
moonfaced	圆脸的
explanate	平坦
coleopterist	鞘翅目昆虫学家
transfection	转染
imbrue	玷污
rugged	崎岖
olympian	奥林山神的
venezuelan	委内瑞拉的
bigot	顽固者
catastrophism	劫数难逃论
diseaseful	不健康的
metonym	换喻中所使用的词或短语
dmd	Device
surgy	大浪翻腾
incorporeal	非物质
hyperpnea	喘息
prosodic	作诗法的
clangorous	叮当响
chiliad	一千年
omnidirectional	全方向的
retort	曲颈甑
fodder	喂
uranic	铀矿的
fenestrated	有窗的
electromyogram	肌动电流图
chickling	小鸡
ileac	回肠
optical	眼的
cornucopia	丰饶
grasping	握
secondi	secondo的复数
reversion	逆转
anode	阳极
detailed	详细
filthily	不洁地
pulse	脉搏
mongline	单线
indistinguishable	不能识别
ascocarpous	子囊果
laced	有花边
voyage	航行
libationer	把酒泼洒在地上祭神者
unavoidable	不可避免的
forcipiform	钳状的
naillike	像指甲
madre	妈妈
refer	指点把……提交
forktail	尾巴开叉的鱼
diametical	直径的
improper	不合适
lippen	相信
astrocompass	星象罗盘
ethnical	人种
otorrhea	耳漏
plutonism	火成论
nudie	裸体黄色影片
idioplasm	异胞质
comusmacv	Command
tap	攻螺纹于
atmospherically	由大气压所致地
agonising	苦闷
dishorn	切去……的角
antineutron	反中性子
sociable	增进友谊
horny	角状
potstone	不纯块滑石
hardcase	强悍
thalidomide	安眠药之一种
rabbet	嵌接
tensible	可伸长
twigged	有嫩枝
scribble	乱写
imprudently	鲁莽
cover	代替
amerce	惩罚
skeletonize	节略
eastside	纽约市曼哈顿东区
wuhu	芜湖
inclinometer	倾角罗盘
earthrise	地出
vibrator	颤震器
market	在市场上交易
lose	错过
semicentenary	半世纪的
delectate	使愉快
symantec	主要产品有Symantec
snug	暖和
hormonology	内分泌学
lank	平直的
lawbreaker	犯法者
summate	求和
unquestionably	无可非议地
staphylococcal	葡萄球菌
gossamer	轻而弱者
rhumbatron	空腔共振器
plumbeous	沉重的
begone	走开
anthelix	=antihelix
tolstoyan	信仰托尔斯泰的人
firstcomer	最先到者
tripos	荣誉学位考试
uncannily	神秘地
ngwee	恩韦
erotica	色情书籍
agrobiologist	土壤生物学家
aerial	高耸的
pracharak	宣传干事
water	水位
pba	Public
crabbery	捕蟹处
malfeasant	行为不正
spreadsheet	电子数据表
smon	亚急性脊髓视神经病
pronounced	讲出来
aculeate	一针见血的
waxen	蜡制的
crm	客户关系管理
lowlife	来历不明的男人
muddle	糊涂
voluntary	故意的
stemmed	去掉茎
bushwalking	丛林徒步旅行
lenity	宽大处理
ornithosis	饲鸟病
yiddish	意第绪语
dread	担心
unresponsive	无答复
mustache	髭
bluebonnet	苏格兰兵
cassia	桂皮
distinguishable	可辨识
antipathic	反对倾向的
wifely	适合做妻子的
plerocercoid	全尾蚴
square	成直角
sincere	诚挚
smacking	精力充沛的
hindbrain	后脑
haemostat	止血器
fisherman	渔民
orient	东方
intermediary	中间的
euploid	整倍体的
hpna	Networking
florilegium	选集
tyrolean	提洛尔人的
chevroler	雪佛莱汽车
octopus	章鱼
pinko	有左倾政治思想的人
burning	强烈
hostility	敌意
moll	歹徒的情妇
omar	奥马尔
revulse	激起……的强烈反感
amorce	玩具手枪的雷管
overcurious	多问
moonport	月球火箭发射场
gutter	檐槽
dw	数据仓库
allantoic	有尿囊的
pemmican	摘要
digest	消化
cubiform	立方形的
swim	眼花
khrushchevism	赫鲁晓夫主义
federalese	联邦政府的官样文章
fighting	好战
meshugga	发疯似的
writ	正式文件
ack	Acknowledgement
skulduggery	欺骗
chinoiserie	中国艺术风格
prismy	五光十色
mint	薄荷
woefully	不幸
unwooded	不长树木的
melodious	音调优美
astromancer	星卜术
phthisiology	痨病学
conquer	克服
thankful	感谢
would	将
eclair	一种指形小饼
picture	相似物
enlace	缠绕
let	出租屋
phosphoric	磷
neocolonialism	新殖民地主义
seilbahn	缆车铁道
cinchonize	用金鸡纳处理
pvt	volume
conveyable	可搬运的
vermiculated	蠕虫的
uncomplex	非组合的
ioof	Independent
tetraethyl	四乙基
collagenous	产生成胶
flinty	强硬的
idolum	谬论
precipitate	贸然轻率的
paralegal	律师的专职助手
styliform	尖笔状
scuba	水中呼吸器
stigma	耻辱
span	横越
intertidal	高潮线与低潮线之间的
modeling	造型
knavishly	恶棍地
terrestrial	陆
uninterrupted	不停的
argenteous	银灰色的
sudoriferous	分泌汗
congenitally	先天
tsadi	=sadhe
ethical	民族
netlike	网状
cashbook	现金簿
natural	天生
intwine	盘绕
loanee	债务人
obelia	薮枝螅
acquisition	获得
remind	使想起
macroevolution	大进化
sunglow	朝霞
furring	镶边
accidentally	偶然地
unstuck	未粘住的
tomboy	行为似男孩的顽皮姑娘
lichenize	覆以地衣
semitic	闪族语系
interjection	插入之语词
underground	下
agrestic	乡土
decumbent	爬在地上的
callout	插图的编号
speel	攀爬
wetware	湿件
fellowship	伙伴关系
unenvied	不受人妒忌的
referent	指示物
ebu	欧洲广播联盟
dehydroisoandrosterone	脱氢异雄酮
harvestman	收割者
breadwinner	养家活口的人
familiarity	熟悉
nitrometer	氮量计
autobiography	自传
premorse	啮蚀状
breslau	布雷斯劳(波兰西南部城市弗罗茨瓦夫
wise	方法
resplendent	华丽
neglige	睡衣
detoxicant	麻药
cariosity	龋
scenario	想定
umpty	若干的
mayan	玛雅语
preindustrial	未工业化的
pogo	弹簧单高跷
unalienated	未转让
procurement	取得
hsaa	Sciences
apanage	属地
telethermoscope	=telethermometer
desultorily	杂乱无章
cumulate	累积的
nerts	呸
drillion	无限大数目的
syncretic	调合的
majorcan	马略卡语
substratal	根本
sogat	and
feminality	女性的特质
senor	绅士
smoking	抽烟
jaunce	跃马前进
gula	咽喉
quina	奎宁
snapshot	简单印象
verbigeration	言语重复症
unventilated	不通风
refractile	有折射力
usquebaugh	威士忌
fictionally	编造地
caninity	狗性
bounteously	慷慨地
fettle	修补
inalienability	不能让与
maladjustment	不适应
djebel	=jebel
sensualist	好色之徒
begirt	被包围的
potty	便壶
sacw	aircraft空军一等女兵
carrageen	角叉菜
droppable	可抛弃的
unmurmuring	不咕咕哝哝
outrigger	突出的梁
shamanize	萨满教化
back	向后地
dite	一点儿
seaboard	沿海地方
judiciable	应受审判
duplicable	可加倍的
syncaine	盐酸普鲁卡因
footstool	脚凳
womankind	妇女们
broadside	全面的
tricolor	三原色
daee	doctor
creamcolored	乳酪色的
irone	鸢尾酮
photoreaction	光致反应
vomit	催吐剂
acpi	Interface
favorite	宠爱
theresa	女子名
magnifico	贵族
disallowance	驳回
regretful	抱歉的
riffle	浅滩
gam	联欢
leptospira	螺旋体
crablet	小蟹
gorgonian	可怕
landowning	作为地主
cypsela	连萼瘦果
additional	另外的
unsound	不健全的
schizophrenic	精神分裂症的
gallinaceous	鸡的
commis	小职员
mississauga	米西索加
pack	包装
plenteous	许多
vouch	确定
convict	证明……有罪
carlowitz	奥地利产的红葡萄酒
reckon	计算
grass	草
hollywood	好莱坞
melodist	声调悠扬的声乐家
peloponnesian	伯罗奔尼撒半岛
definition	精确度
snowmobilist	=snowmobiler
tracheate	用气管呼吸的
reconsider	重新审议
mollusc	软体动物
nightwear	睡衣
inarguable	不容争辩的
propellant	推进的
trophy	授予……奖品
ishmael	社会公敌
unreasonable	不合理的
amygdalaceous	扁桃类
sternutative	催打喷嚏
jinx	不祥物
commons	下院
logroll	互投赞成票使通过
laudation	赞美
pruinose	覆盖白粉
dismally	沉闷
mischoose	误选
amerceable	应罚款
hyposensitize	消除过敏
preplacement	录用前的
monogamous	一夫一妻
astigmatoscope	散光计
blackhearted	恶毒的
compellent	令人信服的
townee	市民
aestheticism	唯美主义
pontifex	教皇
intoxicated	极其兴奋
spine	地面隆起地带
unreversed	非反向的
trotsky	托洛茨基
astable	不稳
meditative	爱思考
sovkhoz	国营农场
blissout	极乐状态
saghalien	库页岛
explanans	解释前提
hatband	帽边的缎带
discusser	讨论者
brackish	有盐味
manstealing	绑架
enkindle	点燃
och	啊!
icenian	爱西尼人
lockgate	闸门
recompute	再计算
bastardize	判定为私生子
inimitable	无法模仿
naphtali	拿弗他利拿弗他利宗族
racemulose	串状排列
virginal	十六
bleuderoi	深蓝色
lapidicolous	生长在石头底下的
accommodable	可适合的
backstop	支撑物
avail	有利于
blastocoele	分裂腔
clement	宽厚的
assr	Republic
swag	垂花饰
pharos	灯塔
shinsplints	外胫夹
moire	波纹
womanlike	女人般
rhinogenic	由鼻腔引起
platinous	亚铂的
resolved	断然的
encyclopedical	百科全书
ebony	乌木
zolaism	自然主义
musth	狂暴状态
likely	很可能
heterosexual	异性恋的人
cbc	Broadcasting
irrespective	不顾的
sncf	Chemins
cleanliness	清洁
palaeomagnetism	古磁学
lacrimal	满是泪水
hortator	劝告者
cannikin	小罐
courtroom	审判室
cutthroat	杀人
anathematic	厌恶
wizzled	皱缩
contignation	架
rightward	向右地
prominence	突出物
dalapon	茅草枯
screamer	惊人的标题
vanpool	上下班交通车合用小组
intrepidly	无畏
chummery	同宿舍
mrs	Muzzle
jewelry	珠宝
cave	投降
gentleman	绅士
ephemeralization	再生加速化
plump	突然
europe	欧洲
crispy	易碎的
reinforce	修补
hertfordshire	赫特福德郡
khuskhus	=cuscus
anapest	抑抑扬格
heatronic	高频加热处理
surrounding	周围
anthema	疹
unluckily	令人遗憾
customs	进口税
accepted	公认的
compulsive	强迫
evenminded	镇定
terminal	每期的
gadgety	小发明的
resistencia	雷西斯膝西亚
privately	秘密
fructuous	多产
farmy	有农场的
amusement	消遣
tetherball	绳球
antimagnetic	防磁
redbrick	新大学的
boorish	农民的
inkiyo	=inkyo
add	加起来
stress	着重
bodley	=Bodleian
orientate	朝向
chlorofluoromethane	氯氟甲烷
approximatively	近似
decolorant	漂白剂
ball	舞会
somnambulary	梦游的
import	重要
murkiness	阴沉
unpatriotic	不爱国的
dingbat	钱
filamentary	单纤维的
unfleshly	非肉体
oppilate	使阻塞
corfiote	科孚特岛之居民
level	齐平
doing	所作所为
numerology	数字命理学
unpriestly	不像教士
assign	赋值
shadowy	阴凉的
nonmiscibility	不混合
quotability	引用价值
coastal	海岸的
poikilothermic	冷血动物的
tritish	有些落俗套的
resentful	怨恨的
jointress	拥有寡妇所得继承权的女子
barstool	酒吧高脚凳
jamaican	牙买加
sagger	箱
swannery	天鹅饲养地
hearty	强烈
iyft	信息随手可
recurrent	循环
synthase	合酶
snowman	雪人
laterad	向侧面
past	结束的
demystify	使非神秘化
deific	予以神化
ata	Technology
waxy	光滑的
capsule	瓶帽
destructible	易毁坏
cursive	草书
heliozoan	太阳虫目动物
dicotyledonous	双子叶
rosy	蔷薇色的
unharming	无害
condemnation	定罪
measles	麻疹
pulsate	跳动
citrus	柑橘类的植物
supertype	父型
by	经过
cystourethrography	膀胱尿道X
resupinate	颠倒的
tenseless	没有时的
wholescale	大规模的
resurvey	再测量
correctness	正确性
provoke	惹起
capitalizable	资本化
comic	喜剧的
seizing	扣押
saffron	干藏红花粉金黄色
didactical	教学的
dell	小谷
accusative	宾格
lmg	gun
depaint	描绘
escarpment	绝壁
watchwork	手表机构
buoyancy	浮力
hall	大厅
infuriate	狂怒
uranous	四价铀
ata	Advance
scapular	肩胛的
patronage	保护人的身份
transilient	跳跃
trembly	战栗
perfect	全然
yersiniosis	耶尔森氏鼠疫杆菌肠道病
troffer	暗灯槽
jerk	猛拉
argillaceous	含粘土
redroot	美洲茶
scordato	变格定弦
gasless	不用气体的
gastronome	爱吃的人
ju	六月的简写
astigmia	散光
spat	一巴掌打去
dismemberment	分割
nuchal	颈背的
spermatheca	受精囊
pyrheliometer	日温计
lathwork	板条
broomrape	肉蓰蓉
tenderfeet	最初级的童子军
galalith	乳石
hedgy	多灌木树篱
inobservance	忽视
rld	liquor
senhora	贵妇
contrition	后悔
mythoheroic	歌颂神话英雄事迹
festucine	浅黄色
sicative	促进干燥
lilylike	像百合
ruffian	凶恶
acquiesce	勉强同意
supergalactic	超星系
undaunted	大无畏的
computation	估计
jesuitism	耶稣会教义
armourial	纹章
enclosure	围栏
cereal	谷类食品
surrealistic	超现实主义的
walkable	可以走去
variolar	=variolous
curiousness	好学
sesamin	芝麻明
photovaristor	光电变阻器
cautel	谨慎
malabar	马拉巴尔海岸
cannonproof	防弹的
buttony	多钮扣
apteral	无侧柱
gel	凝胶体
response	反应
rouseabout	牧羊场的杂工
gyration	旋转
lithoscope	结石检查器
escort	护卫
corruptive	使堕落
tungus	通古斯人
crank	脾气暴燥的
retuse	浅凹形
overweening	夸大了
garn	接着说下去!
lysogenesis	溶源性
pushily	一意孤行
smudgy	满是污垢
exceeding	极度
mechanoreception	您械性刺激感受作榆起机械性刺激感拭
student	学生
extrabold	用特黑体字排印的
cansure	责备
phenomenal	能知觉
translatory	平动
unneutral	非中立的
asphyxiator	碳酸气灭火器
implied	含蓄的
tracheal	导管的
evidential	证据的
unabated	不衰退
botheration	纠缠
knightlike	骑士风尚
pertness	无礼
countersign	答令
sore	疼痛的
sinfully	不道德地
reveler	饮酒狂欢者
hyperbolise	=hyperbolize
cakewalk	一种步态舞
frightfully	可怕地
perfoliate	茎贯穿叶而生长的
retractile	收缩
corsican	科西嘉人
confinement	分娩
underground	秘密
nogg	砌木砖
intimidator	威吓者
ailurophobe	极其讨厌猫的人
untwine	拆开
phosphoric	含磷
baee	education
marrowy	多髓的
variform	形状不同
recomfort	再安慰
record	报告
static	静态的
bosthoon	笨蛋
octan	每隔八日发一次的
nas	网络附加存储设备
italianism	意大利精神
recto	书籍的右页
spreadable	容易被涂开的
antacid	抗酸性的
preoviposition	产卵期前的
cupferron	铜铁试剂
emotional	情绪
menagerie	动物园
husk	剥……的壳
avengement	报仇
subside	沉淀
power	供以动力
doolie	一年级新生
cluw	工会妇女联盟
contractible	缩小的
frederic	弗雷德里克
renerve	重新振作
working	施工用的
sputteringly	语无伦次
commensuration	相当的
gaulish	高卢人的
previsional	有先见之明
rda	dietary
cheliform	螯状的
canalled	开成运河的
farthest	最大程度地
oblomovism	奥勃洛莫夫作风
supplementation	增补
pulverous	满是粉
deepwater	海洋上的
sliminess	粘性
flowerlike	象花的
hematoblastic	血小板
bibliopegistic	书籍装订蕋Ik/
guage	线规
espieglerie	戏弄
stanhope	印刷机的一种
rewake	再醒
metopon	甲基二氢吗啡酮
running	奔跑
hygeian	健康女神
physiographic	形学
cinquecento	16世纪意大利艺术
concessioner	特许权所有人
rebind	重新装订
amorously	妖艳
volcaniclastic	火山碎屑的
capriciously	善变地
wasteful	不经济的
insessorial	适合于栖止的
racist	种族主义者
brandy	糖果
preemptor	先取者
magnetostatic	静磁的
cariostatic	止龋的
artificer	技师
lychnis	剪秋罗属
hiaa	Association
maiden	无经验
belief	信仰
uses	美国就业局
subsist	供养
jovial	愉快
biopoiesis	无生源说
civilized	有礼
yugawaralite	汤河原沸石
theologically	神学上
lavatory	厕所
peculiar	罕见
reposal	安卧
athleticism	竞技热
weatherize	的越冬御寒性能
moderato	中板
ambulatory	非固定的
chessel	制干酪的模子
overplay	表演过火
machinable	可加工的
unjustly	不法地
semidry	半干的半干冲洗法
process	程序
submarine	水下的
knightly	骑士般的
adsorbable	能吸附
hostess	女房东
sclerosis	硬化症
fingerling	一指长的
inobservantly	不注意
caprine	公山羊
herm	赫姆头像的方形石柱
asymptomatic	无症状的
inchoation	开始
bestowal	给与
point	尖端
concluding	结束的
rosanne	罗赞
spurious	假造
bottom	装底
trituration	研碎物
windsurf	风帆冲浪
worthful	有价值的
comanchean	卡曼奇纪
ally	同盟国
bugger	兽奸者
subdeaconate	职位
foraminiferan	有孔虫目
rattle	发出卡嗒卡嗒声
men	man
tidal	定时涨落的
wont	惯常活动
correspondency	一致
anabaena	项圈藻
jumper	跳跃的动物
seedy	结籽的
superhelix	超螺旋
emotive	使感动
tessellation	镶嵌式铺装
cloudless	无云的
parallel	类似
intellectualize	使知识化
gemmiferous	发芽的
king	国王
cabochon	依天然形状磨圆的宝石
nontoxic	无毒
lamellose	似薄片层
hygiene	卫生
iberian	伊比利亚人
migrant	移居者
goodly	优秀
metapsychical	心理玄学的
contemptuously	轻蔑
unslumbering	一直警惕着的
postilion	左马驭者
kartell	挑战书
bianca	比安卡
extrafloral	在花外的
lah	音
calendric	日历
asphyxiation	窒息
westward	西方的
herbartian	体系的
speechless	酩酊大醉的
aid	有帮助的事物
undispersed	未被驱散
radiology	放射线学
flocky	毛丛状
hornwork	角制品
phonographic	留声机的
deltoid	三角形
ferrovanadium	铁钒
unconquered	未被征服
allegorical	寓言的
diseaseful	产生细菌
syllepses	兼用法
ballistics	发射学
cterm	通信终端协议
molest	困扰
caudal	近尾部
trouvaille	横财
dextral	右侧的
kaross	毛皮毯
jeffersonian	的支持者
hurst	树林
unture	不合标准的
branching	发枝
dqdb	Distributed
antiform	反对在艺术品创作中使用传统形式和材料
jinrikisha	黄包车
quixotic	唐吉诃德式
incogitable	无法想像的
senectitude	晚年
seasonal	季节性
unspliced	非绞接
now	现在
gangliate	有神经节的
pusillanimous	胆小
irredentist	民族统一党员
scandent	攀缘的
ussuri	River
lixiviate	浸出
laxatively	放肆地
curvicostate	具曲脉的
chlorenchyma	绿色组织
loathful	令人讨厌的
heulandite	片沸石
divinely	凭神的力量
semideify	使半神化
rockwork	假山
linewalker	管道巡查工
outridden	outride的过去分词
semiagricultural	半农业
nonnasal	非鼻
sound	探条
spinsterish	适合于老处女
avadavat	=amadavat
membranate	有膜
either	任一的
seedbed	苗床
torrid	热带的
malefactress	女罪犯
hexaemeron	关于创世之论说
slinky	体态富于曲线
ruffly	起波纹
delible	可除掉的
triplication	使作成三份
exertion	尽力
stemmed	去掉茎的
rightness	贴切
acyclic	非循环
setback	复发
vaquero	放牛者
socialism	社会主义运动
foretell	预测
thoth	透特
gentamicin	庆大霉素
axunge	油脂
trifle	浪费
pasteboard	不坚实
lengthman	路段养路工
historic	历史上著名的
endogen	单子叶植物
frontward	朝前
contrive	发明
clairaudient	有超人听力
intraperitoneal	腹膜内
pop	砰
fibrosarcoma	纤维肉瘤
gratuity	贺仪
restauratrice	餐馆女店主
esteem	认为
valence	原子价
pmla	Language
redone	redo
rattle	喋喋不休
mississippi	密西西比河
semidet	半独立式住宅
pseudoplastic	假塑性的
bunnia	零售商
samoyedic	撒摩耶人
hagiolater	圣徒崇拜者
vanessa	蛱蝶
unshaped	粗糙的
vugular	晶簇性
flimflam	骗取
woodlark	森林云雀
ole	对象链接和嵌入
aau	Union
erda	and
chitlings'	NULL)
craniognomy	颅形学
living	生存空间
poleyn	护膝铠甲
accentuate	重读
tuscany	=Toscana
unwarned	未被告诫
photoflash	照相闪光灯
collapsar	黑洞
aseasonal	四季可用的
preconize	宣告
psia	磅/平方英寸
symphonism	交响乐
elicit	得出
sententiousness	简洁
breakdown	崩溃
fullhearted	热情的
home	深入地
bronchitis	支气管炎
key	解答
corymbose	伞状花序
logbook	飞行日志
allosaurus	异龙
carom	碰击而反跳
crape	黑绉纱
butcherly	如屠夫地
manticore	怪兽
augural	前兆
erk	英皇家空军阶级最低的兵
sba	小型企业管理局
supraoptic	视上
slithery	滑的
emmet	蚂蚁
concede	勉强
tack	食物
lone	孤独
homoeothermic	同温
boysenberry	一种杂交草莓
toco	责打
partnership	合伙
exaltedly	得意忘形地
momental	动量的
dropsy	贿余
argillite	硅质粘土岩
mcp	chauvinist
underdog	受压迫者
marquesa	侯爵夫人
farinose	被粉
electric	电动的
yakitori	烤鸡肉串
darkly	呈黑色
facia	计器板
analphabetic	文盲
eumaeus	欧迈俄斯
conquistador	西班牙征服者
chime	敲出和谐的声音
inter	葬
inconsistent	不一致
subastral	星下
dts	Systems
strigous	被硬毛
impenitency	顽固
espiegle	爱戏谑
metamorphose	变质
cynocephalous	似狗头
torricellian	experiment托里切利实验
apologetically	道歉地
spry	活泼
absolute	完全
asdic	潜艇探索器
integumentary	外皮的
polygamical	=polygamous
viscountship	地位
kago	日本轿子
prisage	输入酒税
eclosion	羽化
hence	因此
homopolarity	同极
dittany	白藓属的植物
blundering	笨拙的
co	of
nontitle	赛
chaste	朴素
vela	缘膜
preindustrial	未工业化
aeolic	伊欧里斯语
owl	Window
flour	面粉
interconversion	互变
radiesthesia	感应力
maidless	不雇女仆的
thyself	pro
biracial	代表两种人种
oligochaete	寡毛纲
mundane	世俗
pyrenean	比利牛斯山脉
cymbalo	扬琴
unaffectionate	没有感情的
motorial	运动神经
implacentate	无胎盘的
kickout	踢转板迎浪
seemly	适宜
phatic	仅仅是交际性
clicket	弹簧锁
impromptu	未经准备地
greenish	呈绿色
centripetalism	向心性
conic	二次曲线
srs	Socius
armament	军备
set	规定
heartiness	热心
mhg	German
abasable	可降低的
adeline	艾德琳
vaginated	有叶鞘的
bulge	凸出
laguey	麻烦
minutiose	注意琐碎细节的
yokelines	操舵索
score	终点线
unaffected	自然的
draughty	通风良好的
xxx	罗马数字
queerly	奇妙
interfere	干涉
pern	蜂鹰
ably	能干地
crisscross	十字形的
brightly	明亮
dikereeve	水利管理官
publish	公布
plumate	具羽毛
nannyish	一本正经
unavoidable	不能避免的
multiracial	多民族的
reinspection	重新视察
sideline	倾斜
revival	苏醒
nightmare	可怕的事物
financially	财政上
exteriorly	从外部
supernal	天上的
trashery	垃圾
outrigged	装有外伸支架的
jingbang	一伙
mental	精神
creatinine	肌氨酸酐
grotto	洞穴
jcr	Common
exclusive	唯一的
distiller	蒸馏器
llanero	大草原居民
parma	帕尔马
riven	rive的过去分词
potassium	钾
material	实质性
spokewise	辐射状的
praecipitatio	降水性
scotch	苏格兰语的
turkmen	土库曼苏维埃社会主义共和国
crescentade	新月军
prehistoric	史前
kerne	轻装步兵
palaeoethnobotany	古民族植物学
afford	供应得起
featherheaded	蠢
outward	外出
groschen	奥地利的青铜币
unlooked	未经检查的
reconstituted	再生的
maturate	成熟
variably	不定
magnesian	镁的
lunge	跃进
pfda	Pure
undirected	未受指导的
phenomenal	能知觉的
cockeye	扭曲
unclassified	不保密
usufructuary	用益权的
caravan	旅行队
retreatant	静修者
vociferously	喊叫地
synoptically	概括性地
flagitious	无耻的
unstained	清白
revisability	可修改
hispania	西班牙
erode	受腐蚀
teutomaniac	亲德派
natural	天赋的
bootlick	谄媚
hela	=Hel
impot	惩罚学生做的工作
manacle	给……上手铐
nonsked	不定期的
storytelling	说谎话
invected	作边周的
tightfitting	贴身
assumption	担任
flimsy	脆弱
ping	发出砰或咻的声音
blaze	激发
epistome	口上片
urushiol	漆酚
exploratory	探险
semarang	三宝垄
undated	未标日期
organule	=molechism
lanugo	汗毛
jar	震惊
revulsion	抽回
organon	工具论
forwarder	运输业者
divarication	分歧
veil	遮蔽
repair	补救
copyreader	技术编辑
hid	information
tumble	使滚翻
incurably	不能矫正
uncalled	未经请求的
latifundio	大领
merchant	商业
selvaged	有织边
fellow	学会特别会员
pluriaxial	在次生枝上开花
though	可是
oversimple	过于简单
puzzlist	编迷语的人
farinha	木薯粉
lansdowne	兰丝唐呢绒
frothy	多泡的
towardly	有希望
pennyroyal	薄荷类
appropriation	挪用
transilient	飞越
venturous	好冒险的
canvass	向……拉票或拉生意
forgiven	forgive的过去分词
limnograph	湖水水位测量计
checkage	查对
subscibe	订阅
stagger	摇晃
spreathed	发红的
nonneoplastic	非肿瘤
heady	任性的
purl	金银绉边
payola	贿赂
bigg	大麦之一种
teasy	爱戏弄人
brigandage	抢劫
tike	杂狗
deprecation	反对
subirrigate	地下灌溉
karaism	卡拉派
apart	分别地
reprovable	该责备
windburn	风造成的树皮或树叶损伤
sailmaker	修帆工
proprietorial	所有的
loose	开船
trigamous	一夫三妻
vibrator	振荡器
fallow	不活跃的
jog	慢跑
exuberance	丰富
godlike	庄严
koedoe	=kudu
key	调
vasoactive	作用于血管的
blithely	快乐地
piping	尖音的
jadotville	贾多特维尔(扎伊尔东南部城市利卡西
emit	散发
behead	斩首
phagun	印度历的12月
prealtar	圣坛前的
farrier	兽医
comprehensible	可理解
choice	选择权
panthelism	唯意志论
lazyboots	懒骨头
sportswriter	体育新闻记者
unpromising	没有希望
pardi	当然
geez	古埃塞俄比亚语
bumpkin	土包子
conjunction	关联
perfectible	可完成的
hammal	男仆
buster	茁壮的孩子
overture	建议
mns	Master
field	田赛的
dbcp	二溴氯丙烷
pyaemic	毒血症的
effect	作用
kindling	引火物
crisis	转换期
caseload	待处理案件之数量
chevalier	武士的随从
recreancy	不忠
lumbosacral	腰骶的
cockaigne	安乐乡
supplicatory	祈愿的
frosted	受霜害的
hayley	海莉
unequable	不平和
kirghizian	吉尔吉斯人的
amphiaster	双星体
losing	失败的
feetfirst	死
polygon	多边形
sedgy	莎草
bestialize	使野蛮
far	远方
polycrystalline	多晶的
flagellate	鞭索形的
duodecimal	十二分算的
amygdala	扁桃形结构
hanger	衣架
collective	集体
entrain	乘火车
federal	国内主要的正版软件经销商
skeletonize	大量缩减人员
thoughtfully	仔细
fissure	分裂
agitato	激动地
liquid	易变
isoperimeter	等周图形
macropodous	大胚轴
shank	腿骨
foram	有孔虫
alliance	联盟
rhemish	Testament
superstitious	迷信的
quebrada	山涧
restrictionism	限制主义
universal	通用的
wreathen	的过去分词
monoculture	单一栽培
katabatic	下降的
prentice	徒弟
echo	禁止在屏幕上显示批处理命令行
louisianian	美国路易斯安那州的人或居民
seismetic	=seismal
concordat	协定
phenolate	酚盐
wither	衰退
hammy	闹剧的
temporomandibular	颞下颌
tripartite	三重的
housework	劳动
jilt	抛弃情人的女子
czechish	捷克斯拉夫的
recessional	议会休会的
anthesis	开花期
fantail	扇状尾
typically	作为特色地
eric	科教资源信息中心
natator	游泳者
pipestem	烟斗管
ibm	美国国际商用机器公司
niue	纽埃岛
kemalism	基马尔主义
fenestral	具透明点
theatricals	戏剧
transmissible	可遗传的
triplicate	三个一幅中之一
grassplot	草
painstaker	勤恳的人
fullmouthed	口牙长齐的
fanatic	狂热者
aggravate	加重
swaybacked	背凹了
animated	动
fallen	堕落
aerotactic	趋氧性的
unpardoned	未被宽恕的
upu	Universal
gradient	梯度
noumenally	实在地
lied	德国民谣歌曲
autodyne	自差
surfbird	千鸟属的一种海鸟
bloodless	冷酷
slighting	轻视
rude	残暴的
flush	泛滥的
tokodynamometer	=tocodynamometer
vauntful	自夸的
unordinary	异常
rosyfingered	具有玫瑰色手指的
ostmark	东德的货币单位
sacrament	用土覆盖
efficient	能干的
magnetic	有磁性的
bumbledom	小官僚作风
pallasite	橄榄陨铁
falculate	镰刀状
chump	大肉片
recessive	隐性的
reassure	使……安心
greet	问候
forked	有叉子
beaker	有倾口的烧杯
isolating	绝缘
mainsheet	主桅帆操纵索
ceramic	陶器
ipecacuanha	吐根
tdma	Time
levelheaded	头脑冷静的
aleak	漏水
undisturbed	安静
determine	决定
orchestrion	奥开斯里特翁琴
cystectomy	囊切除术
unexpiated	未赎回
checkroll	核对名册
inflatable	膨胀的
diction	言语
exopoditic	外肢
bib	过多喝酒
intermediate	中间
pinken	使成粉红色
celestially	神圣地
untraceable	难以捉摸
latah	拉塔病
pectinated	栉状
revalidate	使重新生效
lysis	消散
tyke	劣犬
venturi	文丘里管
tankship	油船
cassava	木薯
impactful	有力的
speak	谈话
landsman	同胞
noncommunicant	不受圣餐的人
honeysuckle	忍冬
insurrectional	叛乱
beltway	环路
uplift	情绪高涨
con	反对地
pascual	长在牧场的
eurithermophile	能在摄能在摄氏零下30度氏零下30度与60度与60度之间存活的之存活的
grumblingly	发牢骚着
violaceous	紫罗兰色
unreactive	不起化学反应
sequestration	扣押
homoiotherm	恒温动物
nodulous	有小瘤
sternutation	喷嚏
nepheline	霞石
namaycush	大鳟鱼
fit	适合
falsehearted	背信
rendering	打底
able	能……的
ophiolite	蛇绿岩
python	大蟒
fakement	赝品
voluminal	体积的
rarebit	家兔
blame	谴责
seasoning	调味品
resilient	有回弹力
lionism	捧社会名流
seam	层
uprise	升起
transpositional	置换的
trebuchet	小型秤
presswork	印刷品
suppressible	可隐藏
seapiece	海景画
overexpose	使感光过度
unvalued	未评价过的
slapjack	一种简单的纸牌戏
benchboard	操纵台
undaunted	大无畏
aesthetic	有审美感
changer	动摇者
grill	烤
squirearchy	地主阶级
accountantship	会计职务
gynaecea	闺房
twopenny	两便士的
outcast	被逐的
palatium	宫殿
denunciatory	攻击的
depaint	描写
irradiance	发光
lowing	牛鸣
sleet	下冰雹
wild	野生
shift	推托
snakefly	骆驼虫
chemotactic	趋药性
cluw	Coalition
orkney	奥克尼郡
inductor	感应器
diminishable	可降低的
infringement	侵害
carlish	粗鲁的
amnion	羊膜
currently	当前
atheroma	粉瘤
tremendously	非常地
congratulation	祝词
multiracial	多民族和睦相处的
nonprescription	未经医生处方可以买到
qkt	knight
underpowered	动力不足
periclean	伯里克利的
collaborator	合作者
crick	引起痉挛
poetic	诗歌的
monumental	纪念碑的
contentment	知己
exigence	紧急
melaphyre	暗玢岩
suspectable	有嫌疑的
molybdenian	钼
rhinencephalon	嗅脑
sternly	苛刻
proponent	建议者
beneficiary	受益人
freeze	冻结
unimodal	用单峰分布描述
whereover	在那上面
computistical	统计计算的
dynaturtle'	NULL)
slumgum	蜂房内残留的渣滓
agonize	折磨
nailhead	钉头装饰
idle	无价值
zebrawood	其木材
ptilopod	脚上有羽毛的
baryonium	重子素
flattish	稍平的
bistable	双稳的
lithe	柔软
very	很
scratch	凑合
tactic	策略
envious	嫉妒
loss	伤亡
echopraxis	模仿倾向
tikker	断续器
minoan	克里特文明
burns	络腮胡子
responsive	响应的
wet	弄湿
dahomean	=Dahoman
presence	到场
unbodied	离去躯体
shelleyesque	=Shelleyan
fist	手
criteria	标准
grungy	邋遢
mump	乞求
anile	似老妪
macruran	虾
trimly	整齐地
ultimatum	最后通谍
girn	吼叫
sumotori	相扑运动员
grandpapa	外公
reverently	虔诚
wlm	women''s
hepatatrophia	肝萎缩
iconoclasm	打破旧习
modiste	经营女装或女帽店的人
impeccable	不会做坏事
burdensome	烦累的
humourously	幽默地
deed	事实
palladious	=palladous
toothful	微量
lophodont	脊牙型的
elastomeric	弹性体
remove	距离
privateering	以私掠船巡逻
interfacial	分界面的
rafflesia	大花草属
stillroom	食品储藏室
godavari	哥达瓦里河
correctional	矫正
concuss	使猛烈摇动
mulatto	黄褐色
sigurd	西格德
specific	种的
abduce	外展
incorporation	结合
indwelling	内在的
zymoplastic	成酶的
poaceous	禾本科
arctoid	熊状
madding	发狂
drop	滴
understandable	可以理解的
kino	吉纳紫檀
silicium	硅
aneurysmal	动脉瘤
atheistic	无神论
igo	=go
knives	刀子
acidly	不悦地
pruinose	具粉霜
continued	延续的
gillie	仆役
ultimogeniture	幼子继承制
diffusive	普及
absorptive	有吸收力的
bms	Bachelor
histioid	类组织的
heptagonal	七角的
squish	果酱
genocide	有计划的灭种和屠杀
sponge	依赖某人生活
sentimo	分
gersdorffite	辉砷镍矿
flack	高射炮
nosogeographic	疾病地理学
cinematheque	实验电影院
dependent	随……而定的
climactic	渐层法
probationary	试用
fripper	旧衣商
ppcp	PowerPC
ridge	山脉
field	旷野
bioecology	生物生态学
skilly	麦片粥
denominational	宗派的
repository	智囊团
wollaston	渥拉斯顿环形山
xanthochroous	带黄色的
saltwort	藜科冈羊栖菜属植物
visive	视力的
sheepshank	羊的小腿
transferee	被调任者
treasure	珍爱
dateless	无期限的
paner	削皮器
narrow	眼光短浅
turboelectric	涡轮机发电
reductor	减压器
nbw	by
billyboy	平底驳船
fanatic	盲信
choreman	作短工的工人
sorrow	悲痛
siff	=syph
elva	埃尔娃
sopaipilla	油炸蜜糕
economo	奥地利神经病学家
frenzied	狂热的
echinococcosis	包虫病
wtp	Layer
fontal	洗礼的
manna	甘露
quern	手推磨
screenwash	挡风玻璃自动清洗器所作的洗刷
emulsive	乳剂质的
rivage	海滨
degrease	除油污
subplot	次要情节
eximious	杰出的
ruggedly	险峻地
cyborg	半机械人
voraciously	贪得无厌
cdgps	Differential
occupancy	占有
eroica	Symphony
equipment	装备
gem	美玉
uniform	始终如一的
pki	公用密钥体系结构
karyosome	核粒
reputably	卓越
nucellus	珠心
outcross	使远交
scarification	乱刺
kingside	王翼
dissentient	不赞成的
contentedly	安心
homestay	在当地居民家居住的时期
autoeciousness	寄生
sugariness	糖质
orbit	轨道
misarrangement	把……安排得不适切
typed	打字
triacetate	分子中含有三个醋酸基的
polemical	挑起争端的
courtesy	允许
embed	包埋
arsine	胂
outgroup	外围集团
routinism	墨守成规
radiography	放射线照相术
nonchalant	冷淡的
rattle	吓吱声
ponce	庞塞
monochroic	单色
hygrostat	恒湿器
roman	罗马人
raspy	焦躁的
vertebrae	椎骨
matte	不光滑的
last	楦
roquefort	羊乳干酪
birchite	=Bircher
disjoin	分离
beery	象啤酒的
nyp	尚未出版
april	四月
barbellate	表皮有钩形短刺
rathaus	市议会厅
pachytene	粗线期
packboard	帆布背包
unbearably	不堪忍受
misconduct	明知故犯
prepossessing	灌输
humiliate	羞辱
footfall	脚步
vigesimal	以20为基数的
aftershaft	副羽
christian	信徒
arrect	警戒严密
maelstrom	猛烈的力量
jor	乔(印度传统乐曲拉格
intellectual	显示智力
mol	摩尔
rocklike	坚硬如岩石的
paperbacked	平装
human	人的
ruggedization	耐用
warrant	正当理由
excremental	粪便
commoner	自费学生
keeve	大桶
proportionably	成比例地
channelize	使形成沟渠
smart	漂亮的
pedestrianize	步行
smolder	闷烧
understand	省略
bellyband	肚兜
transcend	超越
heterofil	共轭丝
fasciated	成束
bust	半身像
rich	肥沃的
gum	树脂
bespangled	以发光之金属片装饰
thunderbolt	雷电
metaldehyde	聚乙醛
gladly	欢喜
gyani	吉阿尼
baedeker	入门手册
acpi	高级配置与电源接口
podocarp	罗汉松科
timid	羞怯的
usng	Guard
prius	在前
recursive	递归的
blanch	使变白
blacksmith	锻工
maritime	海上
esb	the
situated	处于……的立场
ruffianly	残暴
pappy	糊
italian	意大利人
refer	提到
interspinous	棘突间的
continuous	连续的
diallel	异雄同雌的
patricide	杀父
gemmate	发芽
coevolve	共同进化
underlying	潜在
pathology	病理学
unture	不忠实的
assessor	审核员
klutz	不善交际的人
inextricable	无法解脱
arrange	排列
sexipolar	六极的
reinfection	再感染
caution	小心
couverture	巧克力层
illegal	违法
washingtonian	的人
reliction	水位渐消退
clitellum	环带
trinitarian	三位一体说
peroxide	过氧化氢
stagirite	古马其顿斯塔利亚人
tastefully	高雅
perversive	曲解
piagetian	皮亚杰
hobohemia	流浪者生活
catridges	字体盒
hurricoon	侦测飓风气球
waterworn	被水冲蚀
pinocytized	被胞饮的
discomfort	不适
philosophical	哲学的
committeewoman	女委员
nephelinite	霞岩
noctiluca	夜光虫
frowsty	肮脏
inaudibly	不可闻地
bobtail	短尾
obtected	有皮壳
suggestive	启发的
qmg	general
mass	群众
riband	缎带
flaccid	没气力的
irene	和平女神
suppressible	可以压制
myotomy	肌切开术
wishfully	渴望
webernesque	韦伯恩音乐的
knoll	小山
neodoxy	新学说
tractile	可拉长的
deep	深
fecund	丰饶的
unriddle	阐明
throughly	十分
secundum	依照
somnambulist	梦游症患者
everywhither	向各方
accentor	鸣禽
intercessory	调解的
great	崇高的
obediently	顺从
taoist	道教
sangfroid	镇静或沉着
consubstantial	同质
wavetable	波表
isolato	离群的人
flagstaff	旗杆
fortitudinous	坚忍不拔
viscounty	头衔等
albata	铜镍合金
dyschronous	不合时的
medulla	骨髓
extraordinaire	特别的
emancipate	释放
co	Cash
shindig	狂欢会
crosscurrent	反对意见
upwafted	被托起
brachydactyl	短指的
tubuliflorous	管状小花
gradgrind	葛擂硬
nonuple	九个一组
fordless	不能徒涉
brackish	可厌
featherbrained	轻浮
reverberation	回响
impulsively	有推动力地
trappean	暗色岩质
iconomatic	名称的
propitiator	劝解者
granger	农民协进会会员
achievable	可有成就
twirl	转动
branch	支脉
ensorcel	迷惑
vigilant	警惕着
infective	有传染性的
wilton	威尔顿机织绒头地毯
snootful	一份酒
trigonometer	研究三角学的人
microporosity	显微疏松
teachableness	适于教学
patina	薄层
freeness	任性
conspire	共谋
equitable	平衡法的
inveterate	根深的
effusive	感情横溢的
angulated	使成角的
smilodon	剑齿虎
variational	变化性
infraction	违反
kabuki	歌舞伎
octan	八日热
fairness	正直
summarization	概要
inquiring	爱追根究底
nundinal	古罗马市集日的
jazzily	有爵士特点
orins	Oak
pierian	缪斯女神
lush	味美
nonpersistent	非持续的
crossed	交叉的
mossback	头脑守旧的人
garage	车库
hegira	逃亡
minister	部长
darkie	轻蔑黑人的称呼
dentinasal	齿鼻音
netting	编网
brainstorm	灵机一动
publication	发表
cubital	尺骨
monarchical	帝王
lord	封建领主
hemispherectomy	大脑半球切除术
whiplike	鞭子似的
pizazzy	有精力
buckshee	意外获得之物
zealand	西兰岛
rectilineal	直线的
laotian	老挝语的
ems	Service
treat	交涉
fallacious	不合理的
gastronomic	美食法的
interplait	使交织
colubrine	蛇似的
wholeness	全体
ripply	潺潺声的
offshoot	支流
horsefeathers	胡说八道
manx	马恩岛猫
myocardium	心肌
loom	织布机
implacability	不缓和
kerne	乡下人
masorete	马所拉学士
labile	易发生变化的
anthologist	选集的编者
unstudied	非娇揉造作
unimaginative	缺乏想象力的
uncover	揭露
heartsease	心平气和
costuming	衣料
ocker	无教养的澳大利亚人
hipshot	股关节脱臼
premolar	前臼齿
vinaceous	葡萄酒
tgwu	and
doorstop	制止门过开之物
carbamic	由氨基甲酸获得的
cissoidal	蔓叶线的
supravital	超活体
theirs	他们的
asyndetic	连接词可省略
proclaim	显露
untrod	untread的过去式和过去分词
titular	有头衔的
dependent	由……决定
cathead	船首锚架
toaster	举杯祝贺者
malleable	有延展性的
superimpregnation	=superfetation
pure	纯净的
tailpipe	排气管
pompous	华而不实
shave	削刮
populate	移民
sceptical	怀疑论
nee	娘家姓的
shaky	虚弱
perceptible	可察觉的
lamellose	包含薄片层
disimprove	使恶化
ghostwrite	代笔
bullethead	笨蛋
indivisible	除不尽的
separate	单独
apolar	无极的
eblaite	埃卜拉语
schefflera	鹅掌柴
drupaceous	可生核果
stream	河流
hpgc	per
haptical	触觉的
consular	领事的
chowtime	开饭时间
header	队长
immune	免疫
schoolteaching	授课
acadian	阿卡迪亚人的
apathetic	缺乏兴趣
appropriative	可拨用
inhabitativeness	爱家
fogbound	为浓雾所围困
corrugated	使起波状
morbid	病态
glitzy	耀眼
uncorruptible	不会腐败
asturias	现构成奥维亚多省
antiscriptural	反对圣经
selenodont	月齿动物
annoying	讨厌的
delimit	划界
tilth	耕过的土地
erect	建立
anury	无尾
posttreatment	治疗后的
depolarize	去偏极
heliced	以螺旋装饰
fault	故障
gramarye	魔法
cubhunting	猎幼狐
beslaver	使满身唾液
psoriasis	银屑癣
tonguefish	舌鳎
unleavened	没放酵粉的
unearned	不相称
recessional	撤回
toxaemic	血毒症的
unput	未提出的
kopfring	弹端环
helianthus	向日葵
nubble	小块
demodulate	使检波
backpedal	变卦
bubblegum	泡泡糖摇滚舞曲
personnel	人员
extension	扩展名
ifo	object
geniture	产生
kite	使上升
crotchety	反复无常
abject	卑鄙的
rapture	欢天喜地
sferics	天电
craggy	崎岖
dibasic	二盐基
ultraright	极右
ilocano	伊洛卡诺人
brakie	制动手
healthy	有益于健康的
pollard	糠
eugenist	优生学家
glob	一团
nucleocapsid	核包核酸
plump	使丰满
unprojected	未计划
largo	宽广地
lattermost	排在最后的
organizer	筹办者
jackeroo	无经验者
homeomorphous	同拓扑的
trunk	把……放入旅行箱内
holoparasitic	全寄生物
intarsiate	木造镶嵌细工的
racemiform	形似串状花的
picara	女无赖
nonnutritively	与营养无关地
histology	组织学
fusional	熔合的
upya	操你妈的
super	上标/下标
gettable	能得到的
nutso	发狂
collective	集体的
epistolary	书信的
rubefaction	皮肤发红
anecdotic	爱谈轶事
likely	或许
selfheal	夏枯草
diatropic	横向性
heterozygote	异质接合体
blur	涂污
risc	Set
unmotherly	与母亲身份不相符
adiaphorous	中立的
gleg	活泼
nevus	=naevus
ogle	注视
boy	男仆
haiphong	海防
nodous	多节
levelheaded	头脑冷静
jocosely	诙谐地
philhellene	爱好希腊的人
intentness	专心
translatability	可译性
fillip	弹指
spirit	诱拐
median	中央
blastema	胚基
exhibition	显示
unimpressive	印象淡薄
phantasmal	幽灵
nonlicet	非法的
prepensely	预先谋画
vastly	巨额地
enlistment	服役期间
injuriously	有害地
sintering	烧结
whomever	whoever的宾格
warn	注意
constituency	顾客
balkh	大夏
stuma	焦虑
level	齐平的
elucidative	说明的
inviolately	未受侵犯
offput	使困窘
space	距离
unpersuaded	未被说服的
hypermetamorphic	fEsIs/
superphysical	超物质世界的
celloidin	火棉
shammas	=shamas
bossy	浮雕装饰
femicide	杀害女人者
wire	电报
sensibly	聪明地
blast	毁灭
bucksaw	木锯
mohock	年轻贵族流氓
thriftily	节俭地
twinborn	双胞胎
moll	女流氓
windup	终结
existent	生存者
flustration	慌乱
fallen	倒下
nanism	矮态
complete	完成的
slub	搓捻
syndic	理事
spcc	Cruelty
parallel	相应
psilophytic	裸蕨植物
export	出口
cleruchy	古希腊将征服土地配给公民之制度
menad	酒神节女祭司
frisk	轻摇
rail	铁轨
finick	懈怠
theism	茶中毒
docile	容易教的
barefaced	公然
plss	portable
stope	采矿场
corporately	团结地
ssrc	Council
unfading	不褪色
pattern	图案
finnicking	吹毛求疵
unconsummated	未完成
humorless	非常严肃的
fancy	异样
water	供以水
geriatrics	老人病学
cosmetologist	美容品业者
craniopagus	头盖骨连在一起
feretory	圣骨箱
extensibility	可延长性
invalid	残废的
fond	喜欢的
unthanked	不被领情
blusterous	狂吹
triton	Intel公司的PCI
valetudinarian	有病的
nonorgasmic	不能进入情欲高潮的
dead	绝对
bulletproof	防弹
rabic	狂犬病的
dictature	独裁政府
proctodeum	=proctodaeum
refrangibility	折射性
sightless	盲的
rephrase	改述
chummery	同房间
associate	副
revelatory	启示
flocky	毛丛多的
inadmissible	难承认的
sevenfold	七倍
francine	弗朗辛
nymphet	仙女般的少女
blasphemer	辱骂者
whammer	钢锥锤
ditto	重复
afeared	受惊的
pellock	鼠海豚
wholesomely	有益健康地
filamentous	纤维所成
mantelpiece	壁炉架
man	城域网
partible	可分的
adjectivally	作形容词用
garni	配有饰菜的
remittor	出票人
disjuncture	分离
rataplan	发咚咚声
constate	断言
menam	湄南河
beelzebub	别卜西
lamellate	有薄层
podocarp	罗汉松科的
argentate	银色的
unhip	不符合集团其他成员所遵循的习俗的
sawder	谀辞
apterous	无翅的
satanic	魔鬼般的
rodriguan	罗得里格斯岛的
inp	Photos国际新闻图片社
cardiac	贲门的
pendeloque	鸡心形挂件
gerontotherapeutics	老年保健学
sympathetic	合意
badmintoon	羽毛球
planogamete	游动配子
uncustomed	无须付关税
interfold	使交错折叠
gimmicky	巧妙手法
tba	应予发表
pulpous	果肉状的
disk	磁盘
harsh	刺目的
contributory	贡献
tickler	使人发痒的人
saphenous	隐静脉
bicorn	新月状
diaphone	雾笛
puckish	恶作剧的
privatism	个人主义
northamptonshire	北安普敦郡
tanglement	混乱
unforced	不勉强
leukocytotic	白细胞增多
goaty	好色的
wysbygi	You
twopenny	两便士
dorsad	背部地
instrumentarium	全套器械
scout	巡视
zaikai	财团
satiation	饱食
purlin	檩
degenerative	变质
defiant	挑衅
sidle	侧身而行
forest	住在森林中
salute	举手礼
unction	涂油礼
greedily	贪食地
lutenist	弹琵琶的人
cockcrowing	黎明
wisdom	明智的行为
sobby	=soppy
gastral	消化道的
priesthood	僧侣
psat	Aptitude
prenatal	出生以前
prejob	职前的
concavity	凹度
unembellished	未装饰
irrelevantly	不恰当地
spleuchan	钱袋
velvety	象天鹅绒
sextodecimo	十六开纸
touching	关于
coop	小屋
outnumber	数目超过
snooze	打盹儿
arhythmical	无韵律的
lifelong	终身的
moslemic	伊斯兰文化的
candu	Canadian
sexangular	六角
counterclaim	反诉
maximum	最大极限的
upscale	高消费阶层
baee	bachelor
cyc	cycling
elementary	初步
vera	Vera
canaliculus	微管
betwixt	在……中间
bpc	Codex英国药物处方书
hundredweight	半公担
repaper	重新用纸裱贴
teacher	教师
outscore	得分超过
residence	居住
fold	合拢
wacko	古怪
deferentially	表示敬意地
bingle	打出安打
sculptural	雕刻般的
unshapely	不好看的
periodically	定时性地
mackman	拉皮条的人
nana	护士
pomfret	银鲳
luminometer	照度计
weariful	令人厌倦
corny	有鸡眼的
madafu	椰子汁
cirrhotic	肝脏硬化症
seignior	封建制度的君主
caid	酋长
uncongeal	解冻
contain	自制
utter	绝对
disagreeably	不合口味地
bugbane	美洲升麻
emr	retarded
truncheon	警棍
exuviation	脱皮
placental	胎盘的
quivery	震动的
unstatutable	与法令相反
phytoparasitology	寄生植物学
culmiferous	含有碳质页岩
glance	眼光
aare	阿勒河
pike	梭子鱼
roundup	赶拢一块的牲畜
whereabouts	所在之处
lumber	伐木
extortive	强求的
luculent	光亮的
worthy	应……的
compactly	简洁地
worm	虫
foremost	首先
furious	激烈的
warp	偏差
aicpa	Public
fabianist	费边主义者
sparsely	稀少地
repulse	拒斥
hqmc	Corps
oligoclase	奥长石
foremost	最重要
rosita	罗西塔
embrave	鼓舞
schoolmarm	女学究
deepwater	深海
dux	成绩最优的学生
asocial	缺乏社交性
metallurgical	冶金学
regular	等边的
illuminating	照亮
pappoose	婴儿
perambulatory	巡视
shea	非洲酪脂树
msdn	微软的开发商网络
lapse	失检
forebear	祖宗
aacs	Service
thuswise	那样
electrodermal	皮电性质
reportorial	记者
dipteral	双翅类
knowledgeable	知识渊博
epural	在尾部的
liturgician	礼拜仪式学家
coldish	微冷
southeasternmost	极东南的
benthon	水底生物
puddingheaded	愚蠢的
flicker	假装昏倒
soleus	比目鱼肌
waterward	朝水
corneal	角膜
semifabricator	半制品制造商
living	起作用
inconclusively	非决定性
restraining	控制
safecracker	保险箱窃贼
ouidah	威达
radiogenic	适于无线电广播
uprootal	灭绝
rtm	Read
undefined	不明确
readableness	值得一读
overlap	交迭
vulcanizate	硫化橡胶
tethyan	蒂锡斯海
desiderate	亟需
museque	贫民区
obsolescence	退化
taser	泰瑟枪
voluble	易旋转
belfried	有钟楼的
rayon	人造纤维织物
unpriestly	非教士的
innocuously	无毒
pasteboard	纸板
stylo	尖管状的自来水笔
linsang	灵猫
locutionary	非语内表现行为
claptrap	应景
arillate	有假种皮
inkosi	酋长
comate	多毛的
xenia	种子直感
simious	猴的
dago	意大利人
stepchild	前夫所生子女
lambrequin	钢盔头巾
physiotherapeutic	=physiotherapy
and	和
design	图谋
microsporidian	小孢子虫
scr	Windows屏幕保护程序扩展名
brutish	如野兽般的
unlicked	幼稚的
lighting	照明设备
valueless	不足道的
advocacy	鼓吹
evangelistically	传道地
protension	延伸
unconventional	不依惯例l/
mukalla	木卡拉
quietus	寂灭
garden	花园
gonocyte	配子母细胞
aram	皇家音乐院准会员
haemostasis	止血法
retractile	伸缩自如
sforzato	加强
corrector	校正者
monosaccharose	单糖
naggish	劣等的
pyrograph	烫花
alban	奥尔本
ludic	开玩笑的
piercingly	感动
aclu	American
minicam	camera
proverbially	众所周知
slan	智力和体格超群的人
pylorus	幽门
jungian	易雍的
persuasively	口才好地
electrify	使通电
behoof	利益
grandiloquent	夸张的
eidetically	特别逼真地
fishway	鱼道
chatty	爱讲闲话
itching	痒的
lightly	轻松
gobble	咯咯叫声
favourer	照顾者
weight	负担
embedding	埋藏
octavo	八开纸
blueberry	越橘的一种
wash	镀金于
endothelium	内种皮
pickled	烂醉如泥的
paperless	无纸传输信息的
lh	左手
unrenewable	不可更新
incontrovertible	/
disheveled	不整洁的
koranic	可兰经的
mpeg	Group
ameristic	非分裂组织的
janizary	亲信
super	上等的
ferlie	奇迹
vortex	旋风
synodal	教会会议
strawy	稻草
pitchometer	螺距测量仪
unregistered	未登记
bef	Expeditionary
knit	结合
host	主人
nih	of
parvus	少的
trichloroacetaldehyde	氯醛
experiential	经验上
through	自始至终
rustically	简朴地
uniparous	单梗
publishable	可发行的
wee	很少的
procoagulant	促凝血
missish	小姐似的
misspoke	misspeak的过去式
commerciogenic	有市场吸引力
alimental	食物
flq	Front
appetent	意欲
discord	不和
cinecamera	电影摄影机
collude	共谋
basketry	编制工艺
diphosphate	二磷酸
rhymer	作诗者
favourite	特别喜爱的
pyrolysate	干馏物
sell	出售
protrudent	突出的
pageant	露天表演
myotic	瞳孔收缩剂
bailment	保释
reformable	可改进的
anhydrate	使脱水
prohibitory	很昂贵
souse	弄醉
azorean	亚速尔群岛的
mediaeval	中古
pantaloon	裤子
monatomic	单原子
proven	prove的过去分词
overlight	用强光给……照明
adultly	老成持重的
girlo	年轻妇女
wimple	起皱摺
additional	附加
wellspring	泉源
houseleek	石莲花
squama	鳞片
towery	有塔
sheeny	有光泽
hackie	出租汽车司机
muciferous	充满黏液的
nontraditional	不符合传统的
gotter	=got
habanero	哈瓦那居民
hierachical	等级制度
cadmean	卡德摩斯的
romance	写传奇
contained	包含
chrysanth	=chrysanthemum
assize	立法会议
infrasonic	次声所产生的
condition	以……为条件
sistership	=sisterhood
kitty	小猫
bib	口水兜
agravic	失重的
acidulous	不悦的
overlive	活得过长
lanuginousness	如绒毛
mutate	变异
marbleize	使有大理石花纹
universality	多方面性
gateleg	table折叠式桌子
cylindraceous	圆筒状的
galleryful	楼座所能容纳的人数
decussate	交叉成十字形
wheezy	老生常谈的
pirouette	以脚尖旋转
fetch	诡计
ballsy	有种
kinema	电影
saltigrade	跳行型的
draft	草案
readily	乐意地
adversarial	对抗
geodimeter	光速测距仪
lenitive	缓和剂
put	put的过去式和过去分词
unreconstructed	旧思想的
trustiness	可靠
unaccustomed	不习惯的
crackable	会粉碎
mantes	mantis的复数
devotional	信仰的
cocytus	科赛特斯河
exalted	高尚
fluky	幸中
otek	欧泰科技股份有限公司
recording	记录用
contradictorily	矛盾地
chubbiness	圆胖
preparedness	已准备
heth	希伯来文第八个字母
avernus	地狱
culturati	有文化阶层
flush	充沛
pectoral	肺病药
stetson	斯泰森毡帽宽边帽
unspoiled	未宠坏
emergent	突然出现
ammocolous	砂生的
schlepp	无作为之人
felonry	重罪犯
finagle	欺骗
fall	降低
coehorn	掷弹筒
gratefully	感激地
gabrielle	加布里埃尔
glucocorticoid	糖皮质激素
sadden	悲哀
gingiva	齿龈
autonym	以真名发表的作品
fondly	亲爱
mail	邮件
wetly	潮湿
greaseproof	不透油
lounger	漫步的人
packstaff	货囊支杖
accession	就任
mutograph	电影摄影机
ferreous	铁的
slashing	尖锐
unusual	不寻常
nemoricolous	生长在树丛中的
contrasty	明暗差别强烈的
pavilion	阁
calla	马蹄莲
whole	完全的
whereunder	在那下面
belowstairs	在楼下
roundabout	迂回的
accessory	附件
uncombed	蓬乱的
togated	庄严的
notable	显著的
ahum	轻哼
unabated	不减弱
pangwe	人
level	水平
anticipation	预期
monogamist	遵守一夫一妻主义的人
limosis	空腹
conspiratory	阴谋的
potentially	潜在地
glosseme	义位
cavalvy	骑兵
larksome	好嬉戏的
stylish	漂亮的
starry	布满星星
pullout	拉
precise	精确
tophamper	桅上或甲板上不必要的重物
nonnutritively	没有营养地
twinned	一胎双生
reckon	料想
unworldly	天真
incontinently	不能自制地
crumble	弄碎
spiramycin	螺旋霉素
farthest	最远的
wvf	世界退伍军人联盟
shareware	共享件
extramural	市外
tonguelet	小舌状物
lsv	vehicle月面车
surmullet	羊鱼
aback	向后地
quarter	方面
bid	支付
multiwindow	多窗口
cholate	胆酯
widest	广阔
tom	Tom
spellbound	出神的
volley	迸发
chicane	无王牌的一手牌
transgression	海进
scarce	不足的
clostridium	梭菌属
fawny	近鹿毛色
come	合计为
choppy	不断改变方向
quinquelateral	五边的
hotel	监狱
blaze	情感爆发
sneering	轻蔑的
sculpture	雕刻
screwball	精神有点怪
intrapsychic	心灵内部的
brocaded	织成锦缎
ducking	闪避
chiccory	菊苣根
goldfinch	金翅雀
boehmenism	伯麦主义(德国神秘主义哲学家伯麦
friary	男修道院
swimmy	模糊
pittypat	卜卜作声地
unboundedly	无边际
loop	循环
rush	急需
vaporous	冒出蒸气的
bluebonnet	矢车菊
dprk	People''s
polyelectrolyte	聚合电解质
mopus	[常作mopus
silkoline	=silkaline
anharmonic	不和谐的
anhydremia	浓血症
rondure	优美的弧形曲线
kelly	黄绿色
dissemblance	虚饰
pruriently	挑逗性
uterine	子宫
criticaster	小批评家
succussatory	振荡的
trochal	轮状
revoltingly	背叛
humanistic	人文主义的
macroptic	患视物显大症的
educible	可推断
kmt	中国国民党
neighborly	邻居似
wavetable	MIDI的一种合成技术
pretended	假装的
domain	领土
flabbily	软弱地
outwit	以智取胜
teched	神经不正常的
worm	蜗杆
violence	暴虐
thema	行政区
tarantella	其舞曲
ribby	贫穷
regulable	可调整的
gerontogeous	东半球的
reversed	颠倒
fungoid	菌类
distributive	分配的
pandoor	从事掠夺的兵
birdbath	置于庭院
impoliteness	粗鲁
seaside	海滨的
gammer	老妪
trochaic	长短格的
mammiform	乳房形
towardly	温顺地
affectivity	情感性的
charger	充电器
knucklebone	指关节骨
piquancy	辛辣
feel	同情
tergiant	作拱背状的
marauder	掠夺者
ravc	皇家陆军兽医队
unapprehensive	不怀疑
pressingly	恳切地
swage	型铁
os	操作系统
deliquium	精神错乱
evidence	明显
kindle	照亮
saxicolous	生于岩石间
fetch	售得
chemiculture	水栽法
bale	痛苦
poke	拨开
deoxidizer	还元剂
lord	称王称霸
disenablement	丧失资格
striking	显著的
wildwood	原始林
typeface	字样
liberatory	释放
rescuee	被营救者
butty	监工
daddle	浪费时间
trail	拖
hungarian	匈牙利人
handrail	栏杆
invultuation	显形
waxing	上蜡
kindless	冷酷
limacine	蛞蝓
lithic	石的
anathematically	憎恶地
bulky	容量大的
pinochle	一种纸牌游戏
theomorphic	有神之形象
compassable	可达成
sorn	强求膳宿
melchisedech	=Melchizedek
corvet	专门追求军官的海军女兵
sortie	出击
founder	变跛
atrous	深黑的
fiend	成癖者
premonition	前兆
dissatisfaction	不满
fusionism	联合论
unphilosophical	缺乏哲理的
waur	=war
jellied	凝成胶状
fairyism	神仙气质
isophyllous	等叶
squadron	一群
osp	光信号处理器
underwood	丛林
dazed	头昏的
distraction	分心的事物
folly	荒唐事
desultory	散漫的
riproaring	骚动的
islandless	无岛屿的
perfoliate	贯穿性
ialc	approach
hyperostosis	骨肥大
thrid	=thread
division	区分
dateless	年代不详
machida	町田
visit	降临
incest	乱伦
coprecipitate	使一起沉淀
hypnotic	易被催眠
cosmopolite	世界公民
corridor	走廊
unattained	未获得的
balliol	贝列尔学院
gunport	炮门
abskize	逃脱
underbuild	建筑在……的下面
toplofty	骄傲的
cutify	移植皮肤
colourless	乏味
pounder	有一磅重量的东西
polymethylene	聚亚甲基
dichroiscope	二色镜
viridian	鲜绿色
contraceptive	避孕
caber	投棒
flowery	花
disciform	圆形
quadrantid	象限仪流星
lentil	小扁豆
savage	原始的人
disguise	掩饰
swapo	Organization
postbellum	美国南北战争后的
joyancy	高兴
anoxemic	血缺氧
unassuaged	未得满足
reflexible	反射性的
bloodily	血迹斑斑地
simar	=cymar
whitehanded	两手雪白的
degrading	丧失体面的
liner	班机
woundy	极度
hoatching	密集的
untold	数不清的
houseguest	在家过夜或暂住的来客
aggressive	有闯劲的
thermate	混合燃烧剂
cullender	滤器
pandowdy	苹果布丁
banknote	钞票
gemel	孪生
journal	分类账
trias	三叠纪
arugula	芝麻菜
cookhouse	户外厨房
psychrophilic	喜爱寒带地方的
impetuous	激烈
thespis	泰斯庇斯
invest	投资
ssid	Set
holder	固定器
supereminent	卓越
florescence	花期
checkerberry	鹿蹄草或果实
chemosorb	=chemisorb
impregnate	注入
radiobiology	放射生物学
intrigue	阴谋
smellage	芳香植物
rosiness	光明
guarantee	抵押品
pyrosis	心口灼热
explosive	暴露
fiery	热烈
rightfulness	合理
ribby	多罗纹的
accredited	公认的
wend	走
agriology	原始人类学的
exoskeleton	外骨骼
cliff	绝壁
ssrc	Social
xerarch	在干旱地发展的
unrhythmic	没有节奏的
carbocyclic	碳环形
taking	取得
ablastin	抑殖素
washing	洗涤用的
flyer	飞鸟
waiver	弃权证书
guillemot	海雀科的鸟
usts	States
granophyre	文象斑岩
laudatory	赞美
trembler	摇尾鸟
maintainable	主张
saudi	沙特阿拉伯国家的
taintless	无污点的
summons	传到
reelect	改选
roadable	兼用汽车
growler	鲈类
spinster	老处女
patter	发出急速轻拍声
neighborly	友好
backscratching	为共同利益而互相利用
radiculose	有很多细根
pigheaded	愚蠢的
fenny	长在沼泽地带
metaphorize	将……比作
scotchwoman	苏格兰女人
theophoric	有字义为"
cicisbeism	意大利在十八世纪有夫之妇与人私通之风气
argentine	银色工艺材料
lethargize	使昏睡
lmbc	Club玛格丽特夫人划船俱乐部
versifier	将散文改成韵文的人
varnish	修饰
level	同高
penumbral	日月半影
splendidly	壮观
theatrician	戏剧艺术技巧熟练的人
doll	玩偶
unmaidenly	非少女身份
deaf	聋
speculate	推测
trochleae	软骨轮
shackle	束缚物
sequestered	扣押的
laminaria	昆布属植物
enseal	加封
extinguish	使黯然失色
grisaille	纯以灰色的装饰画法
second	二等品
pectoral	肺病的
clavated	棍棒状的
smattering	少数
persuader	说服者
manual	手工的
power	动力
pitch	定调
frightful	可怕
whimper	呜咽
incumbent	职责所在的
pentamethylene	环戊烷
turkmenian	土库曼人
passable	可通过的
salvy	软膏似
gink	人
odds	可能的机会
without	没有
laborious	勤劳
shrewish	爱骂街
immunohistochemical	免疫组织化学
misarrangement	排错
blower	吹风机
snooper	窥探者
separably	可分离地
tushery	古文体
chthonophagia	食土癖
mendicancy	乞丐
polycarpellary	多心皮的
circumvolant	环绕飞行的
uranus	天王星
clad	穿衣
nietzschean	尼采哲学
kerygma	传教问答中强调福音的要旨
admonitor	训诫者
deed	功绩
conflicting	不一致的
uplifted	上升
cumbersome	讨厌
vanilla	香草
crampit	立脚铁板
equivocally	可疑
substitute	替换
exurban	城市远郊
emmeline	埃米琳
catalyzer	触媒剂
nauseate	使厌恶
idle	虚度
vfat	Table
plasmodium	原形体
traveling	旅行
foreplay	前奏
postnasal	后鼻的
upswell	隆起
outpour	流出物
fulguration	电灼疗法
introgress	种质渗入
sporogenic	=sporogenous
superload	load
page	事件
lud	=lord
laryngopharyngeal	咽喉
inconsiderable	琐屑的
gainfully	有收入地
trappean	玄武岩质的
mouthless	无孔
raa	Arts
monocotyledonous	单子叶植物的
hoot	猫头鹰的叫声
untold	数不清
pulmotor	其商标名
lecithic	有卵黄
sloppy	溅湿
kitling	顽皮的
tatter	碎布
puerperal	产后的
bespread	铺满
absolutory	给予宽恕的
cranch	=crunch
unaccompanied	无伴侣的
thiram	福美双
plainsong	单声圣歌
maduro	色深味浓的烟草做的
asphyxia	窒息
retry	再审
hastate	戟状
ectogenesis	体外发育
fastuously	高傲
nontraditional	非传统
tramp	踏
work	功
astroid	星状的
winterbound	受到寒冬限制
polyclonal	多细胞系的
hemosiderin	血铁质
nuplex	业综合企业
availability	有效性
antedate	比正确日期早的日期
encompass	包含或包括某事物
loose	不精确的
prolifically	多产
hora	传统式圆舞
sori	的复数
flagitious	无耻
nonproficiency	不精通
camion	卡车
faithful	忠实的
associationism	联想心理学
dudish	花花公子般
sheath	外壳
galbraithian	具有加尔布雷思学说特点
counterorder	与前令相反的命令
unbarbered	未修面
brisk	活泼的
recessionary	衰退
carex	苔属植物
dentation	齿状突起
idiotropic	内省的
crystal	晶体
albuminate	白朊化物
volcano	火山
slaveholding	拥有奴隶的
outside	外面的
lamaist	喇嘛教徒
jugglery	戏法
microtron	电子加速器
howl	怒吼
judgement	意见
hyperverbal	说话过多的
mullion	直棂
shag	追赶
glandular	有腺
galenic	其医术
peppy	活泼
record	唱片
arsenical	含砒素
perennially	永久
herbaceous	似绿叶
densometer	密度计
kokura	小仓(原日本九州岛北岸港市
lickerish	贪婪
dagga	印度大麻
catenulate	链状
hemizygous	半合子
jeopard	使受危困
feculent	不洁
seton	挂线
kbp	king''s
camiknickers	连裤紧身内衣
optical	光学的
gloss	掩饰
extirpation	消灭
kodachrome	柯达彩色胶片
mollusca	软体动物类
lactide	丙交酯
roister	摆架子
lie	躺
interlocutory	对话
quiveringly	颤抖
inhabitiveness	喜欢待在同一住所
naupathia	极端厌恶
plumulate	羽毛华丽的
gibbous	突起
contrafactual	违反事实的
paragenesis	共生
last	末尾的
pectinose	果胶糖
chromatrope	旋转彩光板
suppliantly	哀求着
decimate	每十人杀一人
mover	搬运家具的人
tenuous	纤细
gaily	欢乐
most	最大的
welter	颠簸
hudson	州东部的河流
anthophagous	以花为食的
moot	审议会
monostichous	单列
verjuiced	不高兴的
bummel	闲逛
infix	中缀
bacchante	酒神巴克斯的女崇拜者
adsorbable	能吸附的
emigratory	移民的
revision	修订本
exclusivism	排外主义
apennine	Mountains亚平宁山脉
gloriole	光轮
kingdom	上帝的统治
notionate	充满幻想的
seething	火热
freezing	严寒
sling	吊索
qbp	pawn
lofter	把球向上高打用的铁头球杆
entirety	全部
wannegan	=wanigan
geopotential	重力势
yaounde	雅温德
rhinopathy	鼻病
breviary	每日祈祷书
corelative	=correlative
gaited	某种步态
tritoma	火把莲
anzus	太平洋共同防卫组织
stylography	尖笔书写法
chop	砍
tritheism	三神论
semiautobiographical	半自传体的
aeonian	永久
lifetime	一生
subcontraoctave	大字二组
unavailable	难以获
scantling	一点点
faggoty	女性化
wealthy	充分的
grayling	褐色蝶类
sectionalize	使具有地方性
pore	气孔
grommet	金属扣眼
brace	振作起来
ms	军标
usaid	United
rsvp	Reply
dexterously	巧妙
alkyl	烃基的
monobloc	单层的
wlm	liberation
elegantly	优美
referendary	审查官
greeneian	格林风格
atlantic	大西洋
woody	木头般的
buttock	船尾
distinctness	不同
dewater	使脱水
briquet	硬固燃料
extraartistic	与艺术无关的
lacerant	令人痛苦的
pelargonium	天竺葵属的植物
pantaloon	Pantaloon
sideline	附带销售的货物
beefy	结实的
resuscitable	能复活的
horseless	自行推进
columelliform	小柱形
signorine	未婚女子
hydroxyapatite	羟磷灰石
critic	评论家
subhumid	有足够雨量供草木生长
summit	顶点
mirth	高兴
girth	以带束缚
phlebography	静脉搏动描记法
strigil	刮身板
aurantiaceous	橙黄色的
sweeping	彻底
chlorophyllous	叶绿素的
fair	美丽的
heterogony	世代交替
simulate	模拟
reviver	使复活的人
hogly	=hoggish
myotropic	影响肌肉
straightedge	画直线用尺
skinny	膜状
rummy	奇妙
fixture	装置器
collateral	间接
fanfare	喇叭或号角嘹亮的吹奏声
acceptance	承诺
rami	ramus
fasten	集中于
sarcocele	睾丸肉样肿
disfigurement	毁容
seasoned	经验丰富的
expurgatorial	修订
fetichism	物恋
yangon	仰光
powder	变成粉末
marquessate	=marquisate
bushmanship	=bushcraft
apiology	蜜蜂学
krone	克朗
passively	被动
incunabulum	古版书
vinyon	维荣
underestimate	低估
solidungulate	马科
deave	使听不清
lame	变跛
flintily	坚硬
substance	主旨
southwardly	往南
petalled	有花瓣的
colourless	无色的
pintoricchio	Pinturicchio
schoolmiss	女学生
anthropography	人种志
geomagnetic	磁
reif	赃物
protogenic	原生的
hydrothoracic	胸膜积水
hyperaggressive	野心勃勃的
bilabial	双唇音
jeepney	吉普尼车
ue	and
lawny	草坪般
attitudinal	根据个人态度的
wakeless	熟
pit	窖藏
rocket	飞速上升
interpage	把……印在插页上
theia	忒伊亚
beretta	四角帽
profound	造诣深
hypericum	金丝桃属植物
hama	哈马
struvite	鸟粪石
batten	船舱周框的压条
felid	猫科动物
gerontophilia	对老年人的过度关爱
doorkeeper	看门的人
hyperborean	寒冷
slaveholding	蓄奴的
frosting	玻璃粉
myology	肌肉系统
statism	中央集权下的经济统制
watchword	暗语
pretended	虚假
slubbing	废纺粗纱
upclimb	攀登
annectent	连接
crinolette	裙衬
petechia	瘀斑
foremother	女祖先
dac	Company
apt	适当的
uncalculating	没有心计的
dink	装饰打扮
sunshade	帽遮
monostichous	单列的
anxiously	不安地
histologist	组织学家
clavicornia	锤角组
ana	一句名言
caritative	博爱的
fenderbar	防擦木棒
diencephalon	中脑
lognormal	对数正态的
pare	削
surrounding	围绕物
carbonaceous	碳质的
sunfed	Nations
federative	联合的
nice	正派的
sideward	侧面的
supine	懒散
voluminous	容积大
extirpate	摘除
thanatorium	死亡收容所
confute	驳斥
climate	气候
slip	失足
acidfast	耐酸
yali	海滨住宅
agreeable	惬意的
deoxidation	还原
recitative	背诵的
promiscuity	混乱
instance	场合
megalithic	使用巨石的
vashti	瓦实提
nonenzymatic	不涉及酶作用的
spread	宴会
recision	取消
amenophis	阿梅诺菲斯
timbered	用木材
glassmaking	玻璃
aphtha	小溃疡
porcellanous	=porcelaneous
ruling	主导的
minstrel	吟游诗人
incurability	不能矫正
genocidal	集团屠杀
unset	未凝固
freezing	冰冻的
endometritis	子宫内膜炎
transportable	可运输的
heliotherapy	日光浴治疗法
qic	尺磁带盒
darfur	达尔福尔
broadside	侧面地
jarring	震动
conscriptive	涉及征召或征用
everyplace	各处
superior	较高的
cephalad	向头部
sourly	性情乖僻
burst	爆发
rancidly	令人作呕
unweary	不厌倦
kerbside	马路边
nonferrous	不含铁的
voyage	航程
reparative	赔偿
carbuncled	有粉刺
bellerophon	柏勒罗丰
prodigal	浪子
hyperphagic	食欲过盛
piliform	长毛状
noddie	笨人
personal	个人
waif	信号旗
astringently	压缩
diapedetic	血球渗出
yapped	卷边装钉
available	有空
footer	页脚
drinkable	可饮用的
teratogen	致畸剂
unexpanded	未被扩大的
carport	车库
atheromatous	粉瘤
asid	美国工业设计师协会
innocent	清白
screen	放映
tsarist	俄国帝制
centrism	温和主义
casuistical	诡辩
netherward	向下
antitubercular	抗结核
august	威严的
pleiades	昴宿星
thowless	没精打采
orion	所爱的猎人
backwoodsy	粗野
eternal	永恒
scuppernong	斯卡珀农葡萄
ptomain	肉胺毒
juggle	欺骗
hippy	嬉皮士
gdmo	Managed
itinerary	路线
preformation	预先形成
image	想象
micelle	微团
overproud	过分自豪
contrary	反面
destool	废除
siliceous	硅酸
aggregately	一共
televisible	=televisable
boniness	多骨
monstrous	凶暴的
dvi	Interface
file	卷宗
unbundling	分类计价
backrest	靠背
depasture	饲养
upstate	偏僻的
goethean	歌德风格
sulfamethoxypyridazine	=
malthusian	主义者
multidimensional	多维
luminescence	发光
incompatibility	不两立
seismograph	地震仪
lolly	钱
phoenix	长生鸟
grub	掘
equalize	补偿
xhosa	科萨人使用的班图语
southwester	一种后沿较宽可护颈之防水帽
sniper	狙击兵
grave	低沉的
woof	低吠声
lim	秘鲁利马机场之代号
admissive	容许
reducible	可约
arthrodic	摩动关节的
stopper	制动器
phenomena	现象
attainability	可达到
longanimity	坚忍
unmaidenly	非少女身份的
galvanic	流电的
fleetingly	飞快地
creationary	创造性的
attenuable	能稀释
abnormity	异常
monospermal	单种子的
coefficient	系数
terra	土地
illogically	不合逻辑
goluptious	香喷喷的
counterview	对质
wander	离题
soundscriber	桑德斯克莱伯录音机
crambo	同韵字
semidetached	只有一边相衔接
derrick	井口上的铁架塔
prejudicious	有侵害的
composedly	镇定地
profluent	平稳流动
tachygrapher	速记员
bigness	大
saltpetre	硝石
enhancement	增进
morale	民心
joypopper	尚未上瘾的吸毒者
pat	小块
vetanda	禁止的事情
imparticipable	不能共有
phraseogram	连语速记记号
administrators	管理人的职位
cerebel	小脑
crotchet	小钩
migratory	迁移的
architrave	楣梁
unpitied	没人可怜
staffer	职员
rotc	Corps
basketstar	=basketfish
boychik	男孩
lha	Lord
jamin	refractometer
forester	林务官
mhr	House
wpm	每分钟字数
atropinization	阿托品化
belated	迟来
horripilate	使毛骨悚然
gaiseric	盖塞里克
wabenzi	瓦本茨人
emersonian	爱默生
demolishment	毁坏
catty	猫
spy	侦探
survey	审视
gsm	System
ordinary	平常的
refitment	改装
rpg	Role
locomobile	自力推动
humongous	极大的
subsensible	难以感觉到
tindery	火绒似
colles	fracture
afflict	使痛苦
wsj	Journal
regermination	重新生长
struggling	苦斗
amchitka	安奇卡岛
mediamorphosis	新闻媒介对事实的篡改
antiknock	抗爆剂
alexin	防御素
searchless	不可理解
graven	不可磨灭
magnetofluidmechanic	mA^`ni:tJ9flU:IdmI`KanIkEJ9flU:IdmI`kAnI/
adipic	脂肪的
theatric	戏剧的
alabamian	阿拉巴马州的
rutty	遍地车辙的
oilily	圆滑的
courses	课程
washy	多水的
uso	Service
yakut	雅库特人
imitating	效法
bathymetric	测海学
excess	超过
imperfect	未完成时
foothill	丘陵地带
textured	有织纹
oaec	Cooperation
regretful	遗憾
keybar	键棒
plough	艰苦前进
psychodelic	=psychedelic
very	及其
chloroacetic	氯乙酸
proglottis	节片
suprapersonal	超私人
verify	打开或关闭文件的读写校验
lucidity	清晰
alabaster	雪花石膏制的
posttension	后张
engorge	使充血
milch	生乳的
procryptic	具保护色的
underrate	低估
photoflood	使用照相泛光灯
garut	加鲁特
fearful	恐怕的
barge	蹒跚
drubbing	彻底击败
dividual	分开
carabinier	卡宾枪手
quadricycle	四轮车
recantation	取消前言
undignified	无威严
ichthyoid	鱼状的动物
conchology	贝类学
vernal	青春
misexplain	错误解释
orthowater	=polywater
xenodocheum	接待外人之旅馆
prevalent	流行的
par	标准
igneous	火成的
beauty	美景
favorite	心腹
cumbersome	麻烦
follicular	滤泡
propagator	传播者
driver	驾驶员
pintado	大西洋马鲛
pat	恰好的
taboo	禁忌
udt	一致性数据传输
underclothed	穿衣过少的
roselike	像玫瑰
prestigious	声望很高
adoringly	崇拜
fenian	芬尼亚会会员
conchoid	贝壳状
recur	再来
suspender	吊裤带
uncivil	粗野的
apothecary	药师
ametabolic	不变形的
picara	女流氓
lowlands	苏格兰东南部的低
oviform	卵形的
stereoscopically	实立体镜地
cummer	女人
riotous	骚乱
rugged	粗糙的
rake	倾斜
connectionless	无连接
rvsvp	s
pegmatite	结晶花岗岩
lightness	轻盈
gasifiable	可转化成气体
knavery	流氓行为
nubbly	多瘤的
unhired	未租用
degenerative	变质的
craziness	狂热
sporadosiderite	含有铁粒的陨石
flush	使齐平
joint	连接的
grissino	棍形面包
draggy	拖拉的
spook	幽灵
foolproof	极坚固
unsoiled	未弄脏
irrevocably	不能撤回地
defective	欠缺的
feazings	拆散的绳端
profound	造诣深的
exemplify	例证
fulgor	光亮
filer	锉磨工人
clannishly	派系地
annex	附加
hemoglobinuria	血红素尿
catechetics	问答式教学法
superplastic	超塑性材料的
defile	隘路
consumedly	格外地
incompletion	不完全
cognitive	有感知
log	伐木
trifid	三裂
sheerly	全然地
clericalize	使当牧师
upcast	排气竖坑
gentlewomanly	淑女的
russell	此整流器发明人]
fulling	漂洗法
eccentrically	反常地
organdie	一种细薄的棉织品
gso	Officer一般参谋
mattress	沉床
precompensation'	NULL)
exterior	表面的
koulibiaca	=coulibiac
unparallel	不平行的
amphiaster	双星型
nannofossil	微型浮游生物化石
incompatible	不调和的
opium	用鸦片处理
qr	queen''s
unfailingly	不倦地
smolt	两岁大的小鲑鱼
denitrator	除氮器
characterless	缺乏特征的
poppycock	胡说
gene	基因
tradition	传统
surgeonfish	热带鱼的一种
pneumogastric	肺和胃
tannate	丹宁酸盐
rich	有钱的
incarnate	肉色
xiphosuran	剑尾目动物的
studious	热心
regurgitation	回流
wrongly	错误
casuistics	决疑论
gypsy	吉普赛人
stoneware	瓷器
airwaves	电视广播
seigniorage	货币铸造税
umbelliferous	伞状花科
empirism	经验论
unhasty	不匆忙的
ppb	part
escheat	承受转归领主的土地
unfaithful	不诚实
matricentred	母权
henbane	天仙子
isometric	等大
mycostat	防霉菌剂
ecofreak	起劲的环境保护论者
scout	守候
whiff	一阵香气
symbolistic	象征性的
solitude	孤独
putter	行为懒散
tremendous	巨大的
unprejudiced	无偏见的
urceolate	坛状的
character	刻
anachronous	年代错误的
prefrontal	额叶前部的
macroevolution	种外进化
ensample	举例
bimillennial	两千年
afterripening	后熟作用
windiness	多风
eyeable	可见
excise	切除
fense	篱笆
litek	莱泰克
inseparate	不分开的
affective	情感
present	出席
slip	摆脱
evadingly	推托
fantasticate	空想
praetorian	执政官的
frothy	起泡的
backboned	有脊椎骨
cubit	腕尺
lawgiver	立法者
mangily	生满疥癣
protrusive	推出的
trot	忙碌
bib	工作服的上部
teriyaki	红烧的
treachery	背信弃义
christly	如耶稣一样的
effable	可表达的
knottily	有结
belted	佩礼带
towery	有塔的
lairy	艳俗
factor	代理人
superweak	超弱的
chait	印度历的1月
spacious	大规模的
hepaticoenterostomy	肝管肠吻合术
undressed	穿着便服
umbrageously	浓荫
detail	细节
lance	捕鲸枪
meatman	屠夫
leave	请假
parsifal	帕西发尔
scant	缺乏
late	新近
toastmistress	宴会女主持人
tautosyllabic	同音节的
subclass	子集
flunk	放弃
ogive	尖顶拱
aerofoil	机翼
exquisitely	敏锐地
basis	基础
dingily	邋遢地
crumbly	易碎
alack	呜呼
pshaw	表示不耐烦
comedy	喜剧性的事情
oman	阿曼
antichristianism	反基督教
purlieu	界限
centesis	穿刺术
palship	伙伴关系
paper	纸上
constant	恒量
oxidant	氧化剂
matrilocal	入赘的
adiaphorous	不偏不倚
archil	海石蕊
microbic	=microbial
dog	尾随
rancor	深仇
mammiferous	哺乳动物的
tipcat	棒打游戏
fruition	结果实
dumb	不说话的
confiture	果酱
vliw	超长指令字
stubbed	粗短的
unharmed	太太平平
whare	房屋
endobiotic	生物内生
autophyte	自养植物
heterogeny	世代交替
ultramarine	群青色的
gosport	通话软管
demoralization	纪律松弛
chivaree	嘈杂
centralization	集中
drivership	保养和维修技术
