soporose	催眠的
maceration	泡软
abrupt	生硬的
abcd	Collection
appetizing	美味可口的
ineloquent	不传达表情
unsuccessfully	无用
perivisceral	内脏周
grantee	受颁赠者
zuni	祖尼语
passably	也还过得去
laniferous	有羊毛的
pyrographer	烙花人
craftily	狡猾
tetramer	四聚物
gangtooth	暴牙
gloss	作注释
clarinet	竖笛
lamentable	不快
rhinolaryngitis	鼻喉炎
alumroot	矾根草
placet	赞成票
pomiferous	结梨果的
throstle	画眉鸟
biaxial	二轴的
venomous	恶意的
matin	晨歌
pilgrimage	朝拜
transmit	传达
hazel	榛子
mischievous	淘气的
manufactory	制造厂
inanimation	不活动
thumbnail	极短的
competent	有能力
asleep	睡着
slingback	露跟女鞋
rattailed	鼠尾状
upturned	翻过来的
symmetrical	对称
vitriolic	硫酸
overcareful	过分用心的
prepose	将前置
fairness	顺利性
haste	急忙
straightforward	dly//
irradiant	灿烂的
dutifully	忠贞
sha	angle恒星时角
agrophilous	栖耕
dogdom	养狗界
larcenist	盗贼
fecund	多产的
faints	劣质酒精
jillet	轻浮的女子
indictable	可起诉的
drearily	可怕地
gallization	加水和糖
nobody	无人
desuperheat	减温
psychologise	=psychologize
incursionary	侵略的
nonviolently	非暴力
winebibber	酒鬼
respectively	各个
ecotage	生态破坏演示
vasostimulant	刺激血管
stroam	散步
valiant	英勇的
glulam	胶合层积材
oily	油滑的
spoony	傻子
sonority	响亮
madid	泪汪汪的
glooming	怒容
bum	游民
fortitudinous	坚忍不拔的
blithe	高兴
jcl	control
worried	闷闷不乐
derivatively	衍生地
sputteringly	结结巴巴地
plumbiferous	产铅的
underivative	不乏独创性的
rotund	圆形
underpinner	支承用的支撑
teen	使烦恼
drizzle	细雨
jbs	Birch
venire	陪审员召集令
cecrops	刻克洛普斯
salle	大厅
grotesque	奇形怪状
nondrinking	戒酒的
adios	再见
eyetie	=Italian
prepositional	当前置词的
jsp	Java服务器页
exaggerative	夸大
underclothing	贴身衣裤
gynecic	=gynaecic
powerman	发电专业人员
embolic	栓子的
marmorean	大理石
joke	玩笑
graupel	霰
useless	无益
recremental	渣滓的
disproof	反驳的证据
greediness	贪吃
railroad	由铁道运输
formal	形式的
ier	乘数
obtruncate	砍去头部
bms	Science
fetial	处理国际问题
larker	嘲弄者
bioassay	生物鉴定
hypophysial	垂体
perversion	颠倒
sculpsit	由……所雕刻
oxaloacetate	草酰乙酸盐
pullout	拔
ionicity	电离度
ineptly	不适当
curriery	鞣皮业
detritivorous	食粪
mould	霉
sphygmomanometer	血压计
striking	惊人
interiorly	在内地
frighten	惊恐
nabi	伊斯兰教的先知
regenerate	新生
earhole	耳孔
servantgirl	年轻女仆
ruga	皱纹
saving	搭救的
loch	湖
kernel	要点
deputy	代理人
silkworm	家蚕
testamentary	遗嘱的
outstare	将……瞪得无法招架
blithely	愉快
suited	匹配
veronese	维罗纳人的
monthly	每月一次
wail	哀号
times	时期
swirl	漩涡
professional	专业的
jabez	杰贝兹
embarrassingly	使人难堪
amused	开心的
rubricator	加红字标题的人
sedate	稳重
vivific	赋予生气的
unreserved	不隐瞒的
shovelfish	=shovelhead
downswing	向下之一挥
galvanoplasty	电铸法
konstanz	=Constance
recompense	报偿
ambsace	最无价值的东西
distance	一长段时间
pendent	未定
congealment	冻结
unneutral	不公正的
tatty	不值钱的
unventilated	空气不流畅的
leucin	亮氨基酸
agglutinin	凝集素
changeful	富于变化的
enforceable	可强迫的
flabbergast	哑然失色
headlike	头状的
binnacle	罗盘箱
posy	花束
banket	含金砾岩层
arty	装艺术
excogitate	研究出
rasped	刺耳的
triserial	排成三列
fruticose	灌木状的
storiology	传说学
makeevka	=Makeyevka
vizir	高官
spiritualistic	降神术
yokohama	横滨
sycophancy	拍马屁
rcvs	Surgeons
emulable	可赶上的
zigzag	作Z字形
extraterritorial	治外法权ality/`ekstrE9teally//
seastar	中国海星电脑集团
hermoupolis	厄木波利斯
stockbroker	股票经纪人
pressbutton	电钮
covert	隐藏处
semidiurnal	每12小时一次的
accelerant	促进剂
radiosymmetrical	辐射对称
cocktail	鸡尾酒的
multipliable	可乘
chauvinism	沙文主义
tcb	care
boule	立法会议
sermonesque	说教
leafage	叶子
exhilaration	愉快
triserial	只有三个轮生体的
secondary	中级
orally	口头上
coder	编码装置
sublime	异常
floriculture	栽培花卉
nonnuclear	非核的
avail	效用
octu	Cadets
desalination	减少盐分
biovular	二卵生双胞胎特有
worktable	缝纫桌
ndis	网络驱动器接口标准
anorak	带风帽的粗呢大衣
woodworking	木工艺
salbutamol	柳丁氨醇
deodorizer	除臭剂
programme	编程
retiform	有交叉线
eclectic	折衷
unsized	不依一定尺寸制造的
calypso	卡里普索
demarch	市长
millet	稷
excusatory	辩解的
dumbartonshire	=Dunbartonshire
britishly	似英国人地
froth	泡沫
methodology	方法论
refluent	回流的
uneducable	不堪造就的
thanatopsis	死亡观
pitch	掷
delenda	被删去之部份
unselective	不加区别
superficialize	使表面化
unwisdom	愚昧的言行
gwyniad	白鲑
indigence	穷困
dormie	=dormy
cloudwards	朝着云
duplicate	完全相同
cruck	曲木
still	仍
burglarproof	防盗的
chastiser	儆戒者
copiously	丰富地
sordamente	抑制
fledging	羽毛初长的雏鸟
brahma	宇宙最高的永恒的实体或精神
brd	德意志联邦共和国
nonexportation	禁止出口
venous	静脉
jwb	Jewish
ansate	有柄状部分
regard	关心
adopt	收养
egoboo	自我赏识
suberose	似软木
pentyl	戊基
phylloclade	代叶枝
agrology	土壤学
accommodable	可适合
veritably	真实地
ccpit	Promotion
thrifty	节约的
stridulate	吱吱叫鸣
hempie	似麻
semiferal	半野的
mussily	混乱地
sulfurate	硫磺的
surgically	如外科手术般地
determine	测定
anticoherer	散屑器
reviviscent	复活的
recede	后退
croquis	略图
golden	金色的
strac	Corps
smeary	弄脏的
autodestruction	art
