bottine	半长靴
balky	执拗的
nancified	搞同性恋的
minuteman	独立战争时立即应召的民兵
pharmacy	制药业
albumin	白蛋白
flashlight	手电筒
ethyl	乙烷基
inwrap	围绕……
inextricable	解不开
magistral	威严傲慢
intrigue	激起……的兴趣
lisping	咬舌
fosbury	福斯贝利式跳高
untalented	不聪明
vauntful	自负的
pisciculture	养鱼学
future	前途
enormously	巨大地
trendy	流行
enflurane	安氟醚
irresolution	优柔寡断
afs	Service辅助消防队
scent	嗅猎
setoff	装饰品
greenwing	绿翅鸭
mis	Management
automatism	自动力
shivery	令人悚然
equalization	平等化
outspread	伸开
indent	缩排
riffle	洗牌动作
fructosan	聚果糖
counterplea	抗辩
fissiparous	有分裂能力
moonish	反复无常
invulnerability	刀枪不入
smart	灵巧地
ultrasonic	超声
hoodlum	阿飞
mts	机器翻译系统
shade	图案阴影
cumbrous	讨厌
indusiate	幼虫膜
bathybic	深海底
battlesome	好斗的
antecedence	先行
cinefluoroscopy	荧光屏电影摄影检查术
hidropoietic	流汗的
obeah	非洲黑人间奉行的巫术
verve	神韵
specific	特效的
arouse	鼓励
heterocyclic	杂环的
ochlocrat	主张暴民政治的人
zone	地域
dimethylmethane	二甲基甲烷
wisely	聪明
speciology	物种学
burse	钱包
rhapsodic	狂想的
goon	呆子
oestrus	牛虻
quercine	栎木制
deliration	精神错乱
lordling	大人
nucha	项
franciscan	圣芳济会
vasopressor	血管加压的
delphinium	飞燕草
ingressive	进入
panic	恐慌
polynesian	玻利尼西亚人
nutant	下垂的
tumefacient	使肿胀的
conscienceless	不知廉耻
madrilena	马德里女人
godwinian	戈德温
slenderize	使细长
acotyledonous	无子叶
ethical	民族的
rounceval	大豌豆
manicou	鼠鼹
farthest	最大程度
dog	坏蛋
friended	有朋友陪伴的
pimozide	哌迷清
acephalous	群龙无首
swat	重拍
sterile	毫无结果的
welt	鞭打
rockbound	僵硬
ecp	Port
chalk	白垩
streaky	容易变的
efflorescent	风化的
firebrand	燃烧的木柴
nondefense	与军事防御无关
slopewash	斜坡冲刷物
anemometry	风力测定
nibmar	先组成由非洲人代表占大多数的政府然后准许独立
rotatory	引起旋转的
lingo	行话
kingbird	极乐鸟之一种
homonymous	同音异义的
proprietary	所有
timer	定时器
parenteral	肠胃外
troglodyte	穴居人
lizardite	利蛇纹石
drumbeating	宣传
carcinoid	良性肿瘤的
calender	砑光机
pentatonic	五音
theory	理论
unostentatious	/
hate	讨厌
hypocoristic	表示亲爱
syzygy	朔望
remnant	零料
crepuscle	黎明
disclaimatory	否认
galvanography	电铸版术
animating	启发的
curtle	ax=cutlass
encincture	环绕
crustaceous	外壳
maris	玛丽斯
tongueless	沉默
courageous	有胆量
downcourt	前场篮下
remarkably	非常地
spindle	轴
mamillate	有乳头状突出物
varvel	对……感惊异
extant	未毁
insurgence	叛乱
penstock	压力水管
symmetrize	使相称
unaverage	突出的
homogamous	雌雄同熟
refashion	再做
above	上文
transmission	传输
opern	歌剧
retort	蒸器
homophonous	同音的
maisonnette	小屋
tenderness	棘手
gainable	可得到的
elegant	文雅
tractable	易驾驭
argol	粗酒石
synallagmatic	对双方具有约束力的
pronounced	讲出来的
ancestry	家系
redrew	redraw的过去式
straitness	狭
hardtop	有金属顶盖的
mas	for
daftness	癫狂
subrogation	更替
retroflexion	反曲
productiveness	赢利性
goldie	金奖唱片集
outdoorsy	爱好野外活动的
posseman	民兵
insufferably	不能忍受
personal	私人的
aok	完美的
galla	盖拉族人
midas	大富翁
kinglessness	无君主
touch	联系
recrudescent	复发的
borderland	朦胧之境
solemnify	使庄严
hopelessly	绝望地
coronate	加冕
scum	泡沫
rickets	佝偻病
plutarch	希腊的历史家
univalve	单瓣
tentmaker	制造帐蓬的人
harvesting	收获
biconditional	双态
hereat	是故
upswept	向上弯曲的
sanctimonious	假装神圣
gyroidal	螺旋形
mesothorium	新钍
powerfully	强大地
piquant	顽皮
unyoke	解开
gk97	金山游侠
pricy	=pricey
anytime	无论何时
drive	驱使
indurative	变硬
indisputability	无争辩的余
frieda	弗里达
legitimatize	立为嫡嗣
finery	华丽的服饰
hugely	巨大地
assumingly	无礼
scombriform	=scombroid
undertake	许诺
comtesse	女伯爵
gentleman	阁下
gestate	创案
unswerving	不偏离的
difficult	困难的
isdn	Digital
gossamer	薄弱
home	避难所
bereavement	丧亡
stainless	纯洁
escarpment	陡斜坡
ibew	Brotherhood
array	编队
ennoble	使高贵
livraison	分册
breezy	有微风的
screech	发出尖锐的声音
stand	站
jog	轻推
postmitotic	有丝分裂期后的
yokemate	伙伴
pretext	托辞
protracted	拖延的
relative	有关系
foregone	过去的
heterosexual	异性爱的
hermitship	隐居
death	死亡
pratique	入港许可
pantomime	演哑剧
photoproduction	光致产生
hematozoal	血寄生
portability	可携带
oligosaccharide	寡糖
inconstancy	反复无常
bladdery	膀胱状的
chromiderosis	色汗症
raptured	欢天喜地的
rattly	吵闹的
unwearied	不疲倦
olympic	奥林匹斯山的
athwartship	横过船的
eyeglass	眼镜
stale	不新鲜
relativize	使相对化
anterolateral	在前面偏一边的
rhythmical	合拍的
spectacularity	壮观
saltire	圣安得鲁十字
euhemerize	以神话即历史的观点解释
hostile	敌方
brokenhearted	极度沮丧
volutin	异染质
compliableness	依从
stockroom	仓库
ultrasound	超频率音响
aspersion	中伤
unlucky	不幸的；不吉
aurorean	晨曦
concupiscence	强烈的邪欲
completeness	完全
brawn	腌制好的野猪肉
disoperative	侵害的
wecht	=weight
out	外出
odorously	香气
disinvestment	蚀本
platiniferous	产铂
selfless	无私
client	客户机程序
unpledged	未许诺
squally	可怕的
manor	领
sapient	装聪明样的
intermezzi	幕间剧
ciceroni	导游
conche	巧克力搅拌揉捏机
dead	突然
sociosexual	社会群体内性关系的
expand	使膨胀
unassimilable	不可吸收
stuggy	矮胖的
sidebone	叉骨
espial	侦探
intendance	监督
memorialist	情愿书起草者
reformulate	再用形式表示
washingtonite	钛铁矿
reprovable	该责备的
godlike	似神
run	管理
hoof	蹄
bardian	个性的
slatternly	自甘堕落
unenlivened	不活跃
haemopoiesis	=haematopoiesis
otiose	闲着的
scheme	图解
peristaltic	蠕动的
floriated	具有花卉装饰
lushly	多青草
overcareful	过分谨慎
garlandry	花环装饰品
born	天生就……
neurocirculatory	神经循环系统
lovingness	爱
ectogenic	体外发育
gigametre	十亿米
oligarch	寡头政治执政者
peccary	野猪类
strip	剥去
benzocaine	苯坐卡因
stravage	徘徊
bearish	粗暴的
encapsulate	压缩
uncivil	不文明的
electronical	电子
hemodynamic	血液动力学的
philanthrope	=philanthropist
totally	整全
resettlement	再定居
visitator	巡查员
tache	纽带
edifying	教训性
epicontinental	陆缘
euroclear	欧洲银行票据交换所
xanthippe	悍妇
sympathetically	感应着
detoxicant	麻醉
thar	Desert塔尔沙漠
gadgety	小发明
fortress	要塞
honeyed	甜如蜜
pockmark	痘痕
anodontia	先天性无齿症
atwirl	快速旋转地
fishlike	似鱼
covert	隐蔽
hapless	倒霉
dsp	Processing
pluralistic	兼职
stum	未发酵的葡萄汁
middlebreaker	开沟破土犁
operatic	歌剧的
pteridophyte	羊齿类
loathly	勉强
misguided	被误导的
aga	宗教领袖
albigensianism	阿比尔派的教义
harvesttime	收获季节
grill	铁格子
bole	树干
plateau	高
invisibility	看不见的东西
intercurrent	间发的
carmelite	派的托钵僧的
homoousion	本体同一论
acetaldehydase	乙醛酶
tastefully	风流地
variceal	静脉曲张的
innavigable	不能航行的
razee	删节
jugfet	结栅场效应晶体管
formulable	可用公式表示
overcome	胜过
heavier	巨大
polt	密谋
thickly	厚
neuter	无性的
villainy	罪恶
automobilism	汽车驾驶
placoderm	盾皮鱼
broiling	酷热的
telurate	碲酸盐
kist	箱形石坟
corporeity	身体
poor	可怜
tweedle	琴声
furry	有锅垢
berime	以诗讽刺或祝贺
fetch	取来
accessory	附属的
overmountain	住在山上的
roxburgh	罗克斯巴勒郡
pruning	剪枝
overplay	夸大……的重要性
mitten	拳击手套
tryptophan	色氨酸
bisulfate	硫酸氢盐
wake	警觉
penally	刑事上
sawn	saw的过去分词
obtuse	愚蠢的
milanese	米兰
shuddering	发抖的
uplight	向上照射的灯
electroosmosis	电渗
mechanics	技巧
tropism	取向
subjunctive	虚拟的
hadron	强子
unattained	未达到的
tamber	音色
detrude	扔掉
intimidatory	恐吓的
interneuron	=internuncial
podocarpus	罗汉松
bourree	法国十七世纪活泼的奥弗涅舞蹈
ornamental	装饰性的
potass	钾
subornative	买通
mustardy	芥子粉的
geogenic	地球成因学的
quadraphonic	四声道
entophyte	内生植物
heathy	石南似
controvert	参加辩论
czechish	捷克人
npr	Public
eastabout	向东地
heliotropin	胡椒醛
foxiness	狡猾
neoclassicism	新古典主义
civicism	市民政治
automatic	自动的
skelter	急匆匆地跑
embodiment	化身
iise	伊尔瑟
mechlorethamine	二氯甲基二乙胺
unshrinking	坚定
buckthorn	鼠李科
regret	惋惜
hyperkeratosis	眼角膜细胞增多
coact	共同合作
astringer	驯鹰师
boorish	粗鄙的
vespers	晚课
whopping	非常地
irreconcilable	不能协调的
nightlong	通宵
psychoactivity	影响心理状态
lark	百灵鸟
cold	不热情
flopper	变节者
sanguine	血染
amethystine	紫水晶质的
recessive	隐性
undistinguishable	难辨别
polymeric	聚合
huffish	傲慢
satisfy	满足
rappel	用绳索下口
cartoner	纸板包装机
lassalleanism	拉萨尔主义
edgily	尖利
amort	无生气
felicitous	恰当
smell	散发气味
atactic	不规则的
kymograph	波动曲线记录仪
peremptory	强制
tripodal	三脚架
discomfiture	挫折
surfcasting	从岸上向激浪抛钓线钓鱼
communicant	通知者
vorticular	=vortical
tupian	图皮语的
steeliness	钢制
twerp	蠢人
mammiform	乳头状
chlorid	漂白粉
eglantine	野蔷薇的一种
spinally	沿着脊骨
streamy	多溪流
fumigate	使发香
cladistic	进化枝的
immigratory	迁入的
persorption	吸混
contemplative	祈祷的
lustily	强壮
passivity	被动性
stipes	叶柄
trappean	玄武岩质
galla	盖拉族
clannish	氏族的
hydrosulphuric	/氢硫酸
owly	像鸮
phrenetic	精神错乱
shoshonean	肖肖尼语的
tetrahydrofurfuryl	氢糠基
throughput	生产量
misbound	装订失当
internationalise	使国际化
aproposity	适当
cnd	Campaign
outline	外形
nannyish	过时
spintherism	闪光幻觉
fasces	束棒
declaratory	宣言的
telly	电视
anteflexion	前屈
queendom	女王国
citywide	全市的
miraculous	不可思议的
transfiguration	变容
leisurable	悠闲
railroad	铁路
catbrier	猫藤
fluster	混乱
decidual	蜕膜的
allegiance	忠贞
pietistic	虔信派的
unbearable	无法忍受
beneficent	慈善的
true	忠实
waspish	如黄蜂的
pitch	坠落
enjail	软禁
tarry	等候
pessimal	最坏
gumptious	精力充沛的
pietism	假装虔诚
sabalo	=tarpon
bedstand	床头柜
intervocalic	出现在两个元音间的元音间的
mccarthyite	麦卡锡的追随者
final	最终
pertinence	相关性
finely	美好
slimming	使苗条的
tasteful	有鉴赏力
putschist	暴动者
paletot	一种男女通用的宽外套
flagelliform	细长而柔软
moneychanger	货币兑换商
gastroenteric	胃肠
zincotype	锌版画
inconducive	无益的
sql	结构化查询语言
unslumbering	一直警惕着
billposting	广告张贴
perceptible	感觉得到的
ramous	多枝
residue	滤渣
caduceus	MERCURY的手杖
argali	原羊
aurae	气氛
neoglacial	新冰川作用的
remittent	间歇性
anatomical	解剖的
prosecute	告发
suppurative	化脓性的
polyploid	多倍体的
deadstart	静启动
carping	吹毛求疵
proprieties	礼仪
lanceolated	枪尖形的
logged	劈成木材
thuck	嚓声
inoccupation	无职业
newspaperwoman	女记者等
renascent	复兴的
rankle	溃烂
crafty	狡诈的
separably	可区分
efate	埃法特岛
shaikh	族长
romany	吉普赛人之风俗习惯的
sequitur	推理
injured	受委屈
legislatorship	立法委员或议员的身份或地位
repose	建立于
gambol	欢跳
liberative	同意释放
instreaming	涌进的
britisher	英国人
folksy	有民间风味的
scheme	策划
tdn	digestible
buirdly	粗壮
likely	合适的
screwball	精神有点怪的
dilutive	冲减每股收益的
proletarian	无产阶级
fist	抓牢
delimit	定界限
recuperative	使恢复
sweepstakes	赌金独得赛马
bam	哄骗
signiory	=signory
santour	=santir
aneroid	无液气压计
pitch	前后颠簸
dislikable	可憎的
cottonpicking	剥棉籽乡亲联谊会
fraxinella	白藓
twu	of
jawboning	施工呼吁
diplophase	双倍期
scrappy	细小
rachet	=ratchet
dipsophobia	恐饮症
silence	静
extinguishable	可熄灭
epipteric	翼上骨
bungie	橡皮
dilettantish	半瓶醋似的
fan	吹拂
characterisation	=characterization
flexibility	挠性
graven	雕刻的
stolid	感觉迟钝的
hippolyta	希波吕忒
homework	家庭作业
paradise	天堂
equicontinuous	同等连续
stabling	马舍设备
circumambient	周围的
spectroscopy	波谱学
extraliterary	文学之外的
churchwoman	女教友
pontoon	架浮桥于
tercom	terrain
marl	泥灰土
medievalist	中古史学家
unseemly	不适宜的
breaker	断路器
scholarship	奖学金
bookshelves	书架
quemoy	见Jinmen
adlerian	阿德勒
sniffy	自命不凡
budo	日本武术
taal	塔尔语
bicker	流水声
semiretirement	半退休
catonian	加图式
hantu	恶鬼
valuable	颇有价值的
premise	提论
trinket	无关紧要的小事
cogent	使人首肯的
relocatee	迁至新址者
animating	启发
privilege	特免
length	长
jokingly	打趣
myxasthenia	黏液不足
thunderstroke	雷击
hollyhock	蜀葵
situs	位置
fossilize	搜集化石标本
antidromic	逆行
exaggerate	夸大
shady	多荫
heterotopy	异位移植
judgement	审判
atingle	兴奋的
his	他的
twisty	不直接说明
photophilous	嗜光的
materials	原料
macroinvertebrate	大型无脊椎动物
poker	烙制
cosmopolite	属于世界
filigree	饰有金银丝细工
short	简略
backlash	后座
transferrer	转录的人
impeller	叶轮
prizewinner	得奖人
spumescent	泡沫状
germanic	德国的
anelasticity	滞弹性
unyoke	卸除轭
attenuation	变细
baculine	棒
deuterostome	后口动物
deficient	不足的
this	这个
prelim	预备考试
philological	语言学的
ultramontane	山那边
constantan	一种铜与镍的合金
quassia	由苦木科植物采取的苦味液
espial	观察
lesion	身体上的伤害
nouny	具有名词性质的
stupe	热湿布
plenitudinous	充足
unaccustomed	不平常
aspherical	非球面的
miscreance	异教信仰
loose	不牢固的
gelsenkirchen	盖尔森基兴
honkers	喝醉
renomination	再提名
jady	如玉的
accessory	副
amatively	恋爱地
sanskrit	梵语的
thumbscrew	翼形螺钉
gossipist	=gossip
senhora	夫人
iis	Internet
suspend	延缓
nonlicet	不准许的
voluminously	很多地
gratefully	感激
virgilian	维吉尔的
objectively	客观地
sgml	Markup
pus	脓
landsturm	国民军
nitre	硝石
swimming	会游泳的
gandhiism	不使用暴力的抵抗主义
rite	惯例
renew	重申
villainous	恶毒的
infinitely	无穷地
waldensian	韦而多教派的
airflow	气流
quaere	询问
stale	变陈旧
alternant	交互
caneware	蔗黄陶器
beslave	奴役
prelexical	词前
zymosterol	酵母甾醇
scall	痂病
layoff	操作停止
anthophagous	以花为食
xylographic	木刻的
swang	swing的过去式
smearcase	cottage
perinea	perineum的复数
condolent	哀悼的
sheerlegs	起重机柱
sailing	航行
disorient	使失去方向感
chaff	谷壳
westy	=West
cuvierian	居维叶的
sheath	护套
invariance	不变性
semibasement	半地下室
dissimilation	异化
emptysis	吐血
biocidal	杀生
nanoid	矮小
optotype	试视力字体
nasty	肮脏的
silly	无助的
complaint	牢骚
hedgepig	反潜火箭
bloodshot	充血
infielder	内场手
avirulent	无致病力
smooth	平稳的
shebang	妓院
bluff	诈骗
denouement	结局
corrigibility	可订正
saccharogenesis	成糖
connexion	连结
unshed	未吐露
miniscule	草写小字的
adventuress	用不正当手段谋求名利的女人
heliotypography	珂罗版印刷
skyey	天空的
sedentary	久坐的
resultless	无结果的
aeneid	作的叙事诗
incapacious	狭小的
unmirthful	不高兴
smallwares	女人用化妆品
sterile	不结果的
coagulase	凝固酵素
doghouse	狗窝
bagger	垒打
feticidal	打胎
signorine	小姐
londonization	伦敦化
scopula	=scopa
cubby	小房间
haggadist	哈加达的作者
produce	制造
gemel	铰链
moneybag	财富
exilic	放逐
chinkapin	栗树的一种或其果实
foveolate	有小凹
golgotha	基督被钉死之
eleusinian	市的
sticky	粘性
extrachromosomal	染色体外
naturalization	移植
misinformant	误报者
etep	Trading
ccpit	Trade
premarketing	上市销售以前的
caliginous	昏暗
cruelly	残酷地
squarson	牧师兼地主
demotics	人与社会学
confirmatory	证实的
methinks	我以为
ovulatory	产卵
mats	军事空运局
mistaken	错误的
geez	注射
twistification	歪曲
intramural	校内的
unimpugned	未被指责的
alkahest	万能溶剂
roentgenolucent	X光可通过的
enophthalmus	眼球内陷
outpouring	倾泄
idealize	理想化
unquestioning	不问是非的
cachinnatoria	放声大笑的
coleopterous	甲虫类
wickedly	不愉快地
slavey	女佣人
canvass	拉选票
mikimoto	三木本
turkophil	亲土耳其者
drawbench	拔管机
bulkily	巨大
knocking	爆震音
membraniform	膜样的
spline	开键槽
slan	anno
spiroid	螺旋形
telegonus	忒勒戈诺斯
begun	begin的过去分词
diplomatic	老练的
pulse	脉冲
brutalist	野兽派
rupestrian	由石头构成的
redintegration	复原
african	非洲的
sagger	制烧箱的耐火黏土
choking	窒息
omniscient	上帝
thali	大浅盘
recuperative	使恢复的
mormon	摩门教徒
euronet	欧洲计算机网
navigate	航空
gynecium	=gynoecium
monogamous	一夫一妻的
illegitimation	认为非嫡出子
typification	典型化
hsaa	Health
arenicolous	生活在沙中的
telefilm	电视影片
obliterate	涂去
latria	专对天主的礼拜
platter	大浅盘
heaves	马慢性肺气肿
fatigueless	不知疲劳的
studiously	故意地
gastronomic	烹任学
reliant	依靠的
crepuscular	微光的
undistinguishable	难辨别的
maturity	完备
mill	被碾磨
courteously	有礼貌
attributive	归属
periventricular	室周的
encyc	encyclopedia
textured	手摸时有感觉
homebred	土产
informative	提供情报
rio	Reusable
gazetteer	公报记者
ring	环形物
impayable	无与伦比的
set	Electronics
ingurgitate	大吃大喝
podzolization	灰壤化作用
gramarye	魔术
tinnitus	耳鸣
whoop	喘息声
caitiff	卑劣的
daybed	坐卧两用长椅
kmt	Kuo
foreplane	粗刨
balkan	巴尔干半岛的
camphoraceous	樟脑特有的
catafalque	灵柩台
evzone	希腊精锐部队的步兵
sinicism	中国风格
sha	sidereal
numerical	用数表示
matchmark	装配标记
plebby	普通的
amsterdam	阿姆斯特丹
volcaniclastic	火山碎屑
triangularity	成三角形
nautical	航海
breathless	喘不过气来
glycosphingolipid	鞘糖脂
futilitarian	悲观主义
cytotropic	亲细胞的
mounted	安在马上的
unquestioning	不加疑问
vasospasm	血管痉挛
seedbed	发源地
unmeditated	未预谋的
moko	毛利人的文身制
upbeat	欢乐
foreplay	前戏
diligent	勤勉
diminishable	可缩减的
intercalary	被夹于中间的
toucan	犀鸟
bouquetiere	加蔬菜作配菜
dubitable	怀疑
losing	输的
puffball	马勃
cosmogeny	=cosmogony
multivibrator	多频振荡器
viseite	磷方沸石
usurper	篡夺者
nicish	精密
subtilin	枯草菌素
hippocampal	海马趾的
concussion	激动
endogamous	同族结婚
longeval	长命
semble	看来好象
affinal	姻亲
grubstake	食物物质的援助
manna	吗哪
intuitionism	直觉说
vitaceous	葡萄属植物的
fatigueless	不会疲劳的
uptrend	向上
algebraist	代数学家
asonia	音盲
leglen	牛奶桶
cathedra	主教的座位
distributivity	分配性
collect	由收件人付款
continuous	连续
cleistogamous	闭花受精的
pattern	以图案装饰
unwit	使丧失智能
uprising	升起
derogatory	贬损的
demon	魔鬼
fat	Allocation
jaculatory	投掷的
excitron	汞气整流管
surpassingly	超群地
subordination	次要
xeroform	干仿
shutter	关上
trinity	三个一组的
superradiant	超辐射的
threat	恐吓
crush	粉碎
kabul	喀布尔
fill	填充
cgh	of
enrollment	登记
lathing	覆以板条
assify	愚弄
chagigah	祭品
genetics	遗传学
northmost	最北部的
underwater	在水中
pomatum	=pomade
aubade	晨歌
bedclothes	床单被褥类
manganic	锰
emmarble	以大理石装饰
tuneable	能调出和声
heterofil	异质复合丝
subcutaneous	皮下
facilitation	助长
wakayama	和歌山
counterchange	使交错
thioalcohol	=thiol
fadedly	色彩已褪地
assorted	分类配全
rhopalic	楔形诗
enneastyle	前面有九柱的
evangelicalism	教义的信仰
laval	似熔岩般灼热
mummery	可笑的仪式
leavisian	利维斯式的
lunar	月的
super	十分
draggly	不整洁的
simple	无经验
callous	硬结的
extractable	可引出
dun	微暗
fingerprint	采指纹
tacitly	肃静地
retributive	报应
searchless	不可测知的
radioautogram	=autoradiograph
scumble	渐淡
compute	估计
plaintful	悲叹的
autoclave	高压锅
uncharming	缺少魅力的
unfeigned	真实
draughty	有隙缝风吹入的
vulcanic	硫化
unaccountably	不可解释
volatilizable	可发散
cicatrix	脱离痕
circumradius	外接圆半径
cocker	喜好或举办斗鸡的人
realizing	清晰生动地
korean	韩国语的
schizoid	精神分裂症的
putrescible	会腐烂的物质
xms	扩展内存规范
slapdab	正好
intransitivize	使成为不及物
primordia	primordium
inspectorate	巡视员等之总称
pleading	起诉
macronutrient	常量营养元素
vervain	马鞭草
distributive	分布的
stainless	纯洁的
zhdanov	日丹诺夫(1991年恢复使用旧称马里乌波尔
malaceous	苹果科的
baronial	与男爵有关的
halachist	哈拉卡权威
accumulation	堆积物
dragbar	斜井矿车防坠杆
pyrogenic	火成的
cote	窝
scrubby	多短硬毛的
cloud	阴沉
overdraft	透支
escarp	内壕
stick	棍
gum	齿龈
unaffected	未受影响的
favorite	喜爱
primrose	樱草色的
mite	力所能及的微小贡献
uncontested	没有人争的
neighbouring	毗邻的
tumour	肿瘤
pseudology	说谎术
identical	同样的
martyr	折磨
electroplating	电镀术
unintelligible	无法了解的
kiruna	基律纳
koan	以心传心
smart	懊恼
counterproductive	使达不到预期目标
voguey	流行的
scuttle	天窗
furious	极为激烈
tipsy	喝醉
face	正面
withdrawal	退隐
lot	命运
ablaze	激动
aborative	仔细的
caddoan	喀多语
castellan	寨主
cowherb	麦蓝菜
jsd	Doctor法学博士
resident	居住的
factually	确实地
product	乘积
divisional	分割
barrelage	桶装量
antidiuretic	抑制尿分泌的
nosh	点心
veiled	隐藏
neckpiece	皮围巾
sweetener	甜料
monoxide	一氧化物
mazdaism	拜火教信仰者
electrogenesis	产电
gastrea	=gastraea
temptation	诱惑物
murexide	红紫酸铵
fuel	燃料
indiscriminating	/
squatty	矮胖的
preelection	选举前
marengo	马伦戈式的
vitrophyre	玻斑岩
paillette	亮片
ventose	浮夸
instantial	实例的
aversion	厌恶
fertility	丰产
virus	恶毒
gummatous	梅毒瘤的
plateau	高地
xanthin	茜草黄质
concessional	让步
quadrisyllabic	四音节词的
lovable	惹人爱
alacritous	活泼的
bandstand	演奏台
gasdynamics	气体动力学
supercritical	超临界的
ingenerate	内在
unwholesome	不健康的
snugly	整洁地
nerd	卑微的人
suggestibility	被暗示性
withoutdoors	=outdoors
slimsy	脆弱
schizophreniform	分裂样
limitless	无限的
bmr	metabolic
francicize	使采用法语
charismatic	神赐能力的
whirlabout	团团转
hello	喂
reenaction	再扮演
towardly	有希望的
sha	=shah
aviate	飞行
moneyman	金融家
ballsy	有胆量
devilwood	木犀
onstage	台上演出
comusmacv	驻越美军司令
firmness	稳固
husbandage	船舶管理费
unmarried	单身
divisive	不和
themselves	它们亲自
sarcoidosis	类肉状瘤病
swapo	Southwest
roz	=rozzer
indelible	不能拭除
streaked	不安的
underfur	下层绒毛
titer	滴定量
canned	罐装的
exsiccate	使干燥
gee	向右转
dally	戏弄
imparticipable	不可分享
styliform	刺针状
thatchy	像茅草的
idea	想法
clouding	湿润
sad	忧愁的
dialytically	用渗析法
hazing	被欺侮
ip	Internet
loomage	织物
barbiturism	因过度使用巴比妥酸类药品而引起的慢性中毒
energise	=energize
corny	有鸡眼
mysid	糖虾
isocratic	权力平等主义的
cuttable	可缩减
prioress	小女修道院院长
kopek	苏联小铜板
sango	桑戈语
indaba	南非土人间的会议
unwakened	未被唤醒
technicality	专门性
warp	乖僻
parasang	古代波斯的距离单位
mpls	Switching
noncommunist	非共产主义者
amerciable	应罚款的
felicitous	快乐
ebn	north
uptodate	最新式的
dynameter	倍率计
cloudscape	云的风致
brash	碎片
sealift	海上补给
join	结合
level	瞄准
meterstick	米尺
dmd	牙科学博士
rivel	弄皱
plumbeous	铅的
unrepealed	仍有效的
legatee	遗产受赠人
sleet	冰雨
temporary	临时的
sestertia	sestertium的复数
macronutrient	大量营养素
connexion	联系
inobservantly	怠慢
pc	巡逻车
fairly	相当地
tortoiseshell	龟甲状的
kanu	Kenya
tediousness	沉闷
nonrepresentational	抽象的
souari	油桃木
skookum	强壮的
makable	可制造
deceleration	减速
atelectatic	肺膨胀不全的
piquant	辛辣的
dissaving	支出多于收入
imploringly	恳求
antimeric	体辐
tetrarch	小王
literaryism	过于推敲
modernistic	现代派的
flagitious	凶恶
dissociably	不调和
icccm	客户间通信约定
menservants	的复数
phenate	酚盐
declutch	放空档
squalidity	污秽
alvar	矮化植被
unneighbourly	不友善
rhinopharynx	鼻咽
europeanist	欧洲经济共同体第一主义的
take	拿走
henchman	党羽
ppt	per
preplacement	录用前
zygomorphic	两侧对称
chiba	千叶
publishable	可出版
howl	嚎哭
piccanin	黑人小孩
unvouched	未被证实
studded	镶嵌
babouche	平底拖鞋
ryazan	梁赞
whop	抽出
unwholesome	不健康
haven	港口
calculably	可预料地
clementine	克莱门氏小柑橘
plantation	种植园
mend	加快
azide	叠氮化物
preceding	在前的
astringently	压缩地
putrid	腐烂
zoological	动物学
fwpca	Pollution
negrillo	矮小的非洲黑人
thunderpeal	霹雳
rasping	锉磨声
flitch	裁成板
majoritarian	多数主义者
excuse	借口
gal	女孩
refluence	倒流
nonalcoholic	不含酒精的
neuter	中性的
antemeridiem	上午
hypostatization	使人格化
scar	结疤
apocopate	语尾音节删除的
heel	脚后跟
striolate	具细线条的
adas	Service农业发展与咨询服务处
giving	给予物
schvartze	黑人
scuttle	急速逃走
aetatis	在……岁时的
praxis	例题
pachinko	弹球盘
displease	冒犯
naw	不
perceptible	显而易见
entirely	完全
filmgoer	影迷
pongee	茧绸
garter	吊袜带吊住
ligurian	利古里亚人
halothane	三氟溴氯乙烷
pregenital	性前期的
mythologize	编神话
reform	重新组成
punctulated	有细孔
editorialist	主笔
cogency	肯切
swagger	大摇大摆
idolization	偶像化
suctorial	有吸附
philippians	腓力比书
tearaway	行为鲁莽的人
wellhead	水源
preconvention	大会前
gravelly	铺有碎石的
longhair	知识分子
degerm	消灭……的病菌
aeroallergen	气源性致敏原
oligotrophic	贫营养
tracery	花饰窗格
unexaminable	难以查讯的
broma	去油可可豆
appetite	爱好
cover	掩护
infallibility	绝对可靠性
neurogram	记忆痕迹
conceptive	概念上
hepatocele	肝膨出
mattins	晨祷
ringlet	小圈
emotion	情绪
motley	混杂
unambivalent	明确的
ozonic	含臭氧
knap	敲击
fortnightly	每两星期一次地
sicilia	=Sicily
sandpiper	矶鹞
ps	/
moronity	低能
sapan	=sappanwood
stainer	上釉工人
shiner	发光体
pettitoes	脚趾
str	reactor
unmoral	不道德的
fly	苍蝇
bucko	欺凌弱小者
bill	给……开帐单
ssr	苏维埃社会主义共和国
uncase	从箱子取出
stimy	阻挠
burthen	重荷
hierachical	僧侣统治
ethnohistoric	人种史学
releasor	放弃权利者
perchlorethylene	=perchloroethylene
kep	阻止
baroceptor	=baroreceptor
tinderbox	火绒箱
whammy	剧烈的打击
undulatory	波动的
premium	保险费
spermic	精子
sunlit	阳光照射的
lectionary	选文集
slaver	流涎弄脏
piagetian	皮亚杰关于儿童思维发育理论的
resolve	决定
cetacean	鲸的
airman	飞行员
pentomic	五群制原子师的
paralysis	瘫痪
quaint	离奇有趣的
information	报告
lax	松懈
dateline	日期栏
relaxative	缓和
physiological	生理学的
eudiometrical	空气纯度测定管
cloud	云
spill	摔下
castalian	灵感源泉
irrepealable	不可废除的
deb	初上舞台的人
sternness	严厉
grasping	贪婪
micella	=micelle
wellspring	水源
jointing	焊接
renerve	恢复勇气
unnecessarily	未必
onwards	在先地
unexceptionable	无懈可击
foulmouthed	口出粗俗的
gis	geographic
sympathizer	同感者
inkling	略知
lowell	洛厄尔
entomologic	昆虫学的
wye	Y字
revelation	新发现
specially	临时地
fastening	扣紧
sombre	昏暗的
lipolytic	引起脂肪分解的
hippological	马学
dead	突然的
home	国内的
holophrase	整句字
amentiferous	具葇荑花序
scurrilous	使用低级粗俗语言
coach	长途汽车
neapolitan	那不勒斯
underlie	位于……之下
rsc	Royal
usable	可用的
microprojection	显微投影
narrow	严密
flagstone	石板
minelayer	布雷舰
snuff	烛花
serrulate	细锯齿边
cornish	康沃尔人
dualpurpose	肉兼用
unsheathe	抽出鞘
lustful	贪欲的
fulgid	闪耀的
festa	节日
aerarian	财政的
wisperer	低语者
chapeaubras	绸三角帽
suborning	受贿
dayle	黛尔
rowton	罗顿屋
lamia	女怪
greensand	绿砂
hexagonal	六角形
federally	联邦地
joss	神像
physiographic	文学
adjustive	调整的
symptomatic	有症状的
milton	米尔顿
hypoacid	酸度过低
counterproof	反转打样
nietzschean	尼采哲学的
reinsertion	再插入
untapped	塞子未开
ripsnorting	了不起的
wintertide	冬
podalgia	足痛
mannered	守规矩的
aluminate	铝酸盐
prang	飞机坠毁
colossians	歌罗西书
bland	冷漠的
kumgang	Mountains
rugger	英式橄榄球
hindrance	妨碍
ravelin	半月堡
microporosity	微孔性
riffy	连复段过多的
trivalent	三价
canniness	精明
eggshell	蛋壳
strained	做作
maculation	污点
probationership	缓刑期间
airdent	气磨洞形器
ytterbite	硅铍钇矿
blunderingly	粗笨地
encouraging	可奖励的
heeled	带着钱的
flask	长颈瓶
remissness	不小心
tonometer	张力计
eastabout	向东
aquatic	水
resurge	复活
weldable	可焊的
transitivize	使及物
leftover	剩余
boggy	沼泽多
idiomorphic	自形
recondense	再浓缩
scowl	怒目而视
hyacinthine	紫青色
crankily	任性
fucked	受骗
distress	使穷困
microsporangiate	小孢子囊
inspectoral	检查员的
muzzleloader	前装炮
imputation	归罪
interdigitate	相间错杂
gruziya	格鲁吉亚共和国名
pyretic	发烧
distributively	分配
demochristian	基督教民主党党员
ternate	三出
fuck	他妈
spodumene	锂辉石
accidentally	意外
breton	法国布里多尼人
methodism	美以美教派教会
radiate	发光
limbless	无翼的
pubic	阴毛的
flighty	反复无常
objettrouve	被发现之物
prepositor	级长
philomena	菲洛米娜
minorca	米诺卡鸡
vinegarroon	大形蝎子之一种
microanalyzer	微量分析仪
complicitous	=complicit
necrology	死亡启事
rancidly	讨厌地
euphoriant	使人欣快
fear	害怕
apollinian	=Apollonian
censorable	可诟病的
invective	非难的
methyl	木精
residency	住院医生实习期
ingathering	收集
mna	护理管理学硕士
coiner	伪造货币者
relate	使联系
bibulosity	酗酒
wistfully	渴望
idol	幻象
stop	被塞住
asean	Nations
procacious	勇敢的
pestle	乳钵
correlative	关联的
vigorously	精神旺盛地
mousetail	鼠尾巴
bibiolatrist	书籍崇拜者
envelop	包裹
convivial	欢宴的
riot	骚乱
oleic	油的
soak	浸
oni	Intelligence
surrejoin	第二次辩驳被告
hexadecane	=cetane
flocculi	小叶
tetrabranchiate	四鳃的
poser	难题
retinispora	扁柏属植物
yh	hostel
