bestead	裨益
sumption	信以为真
debilitated	操劳过度的
lull	使平静
theophagy	圣体领食
oddly	古怪
frailly	不坚实地
apostatize	放弃信仰
nyet	没有
timpanist	定音鼓手
biennially	二年一次地
dihydroergotamine	双氢麦角胺
coincidental	符合
mazu	马祖
recruit	新会员
paediatrist	儿科学家
teleonomy	目的性
merienda	傍晚小吃
fidget	烦躁
elector	竞选人
powder	搽粉于
karstology	喀斯特学
cashmere	开士米
countryseat	郡政府所在
transpiration	流逸
roily	生气
raggee	=ragee
amok	杀气腾腾地
sheepman	养羊人
extrality	治外法权
insusceptible	不易受影响的
ichthyolatry	鱼神崇拜
egotism	自尊自大
reversal	反向
discolored	污染
jagged	锯齿状的
maduro	色深味浓的
ovotestis	卵睾
vitalism	生机说
flaxen	亚麻的
confirmedly	坚定地
mikron	=micron
superradiance	超辐射
juggins	蠢货
histotomy	组织切开术
dodgery	诡计
unreflecting	无思虑的
nested	嵌套
hough	踝关节
inexhaustibility	无穷尽不知疲倦
aca	Accountants
serenade	唱小夜曲
ungimmicky	不骗人的
feverfew	菊科植物
austere	严峻的
reclame	臭名
piped	拷边
hystricomorphic	豪猪型亚目
goad	激励物
haemoid	像血
aerosphere	大气层
idiocratically	特性地
hematozoal	血内寄生
spermatocyte	精母细胞
dessiatine	俄国的地积单位
unimposing	没有威信
vibrissa	鼻毛
wipo	Organization
impeccant	无缺点
oily	油
pushily	一意孤行地
worked	处理过的
crake	秧鸡
annealing	退火
numismatics	钱币学
pelles	佩莱斯
carbonari	烧炭党人
vdc	Volunteer
deformalize	简化:
cespitose	丛生
geopolitician	地缘政治学者
leptonic	轻子的
backstair	间接
infuscated	略带褐色的
put	笨蛋
symbolistic	象征性
pharmacology	药理学
fire	放枪
uninspired	平凡的
metis	有八分之一黑人血统的混血儿
bugologist	昆虫学家
stump	砍成树桩
repose	休息
dehydrogenate	使脱氢
jaguar	英、法合作研制的超音速攻击机
equivocal	可疑
parament	祭台布
nondefense	非国防军用的
pavilion	搭帐蓬
sphygmometer	血压计
ramate	有分枝
hectometre	百米
decidophobia	决策恐惧
subadult	接近成年的人
ladykin	小女人
argyrol	含银液
hexasyllable	六音节
ratiocination	推论
wristwork	手腕动作
roentgenoscope	=fluoroscope
shift	移动
unslaked	未满足的
kanggye	江界
methadon	美沙酮
sacrament	沉默
nonconform	不遵照准则
enormous	极恶
dart	飞奔
tormentor	使苦恼之物
ethos	风气
eam	Ethniko
fantasize	梦想
inferior	下等的
stagger	交错的
intervertebral	椎间
scholastic	学校
tournois	图尔城铸造的
sackless	麻木的
chewy	不易嚼碎的
exalted	尊贵
punk	无用
autohypnosis	自我催眠
densify	使增加密度
lambeth	伦敦朗伯斯区
namierite	=Namierian
logged	笨拙
phototropism	向光性
scraping	擦
turgor	细胞的膨胀
laggardly	落后的
quantivalence	原子价
originate	发起
filarial	丝虫的
staph	=staphylococcus
hinterland	腹
oogenesis	成卵法
dobber	浮标
adagietto	更缓慢地
toneme	调素
simplification	简化
messianic	弥赛亚的
rumination	反刍
loop	使成环
somerville	萨默维尔
kiltie	苏格兰高地的兵士
kamaishi	釜石
heteropterous	半翅
newsmonger	饶舌者
antagonize	敌对
matripotestal	母权的
language	语言文学
tarragon	龙嵩叶
klischograph	电子刻版机
psammophile	适沙生物
hymenopteran	膜翅目的
pony	小型马
putridness	堕落
illume	点亮
sportfishing	从事垂钓
charily	节俭地
decorously	高雅地
present	当面的
dm	数据挖掘
restrainedly	有限制地
execute	制成
nervily	大胆地
gotcha	=got
parthenogenone	单性生殖生物
bisync	二进制同步通信
sponsor	发起人
exalted	尊贵的
unload	倾销
whomp	重击
pregnant	富有意义
abcd	and
elfish	小妖精
emotionalism	诉诸感情
waspish	腰细的
reradiative	再辐射
ariose	旋律
horatia	霍雷希亚
dower	天赋
bedlamite	疯狂
subside	平息
ignore	忽视
circumvent	智取
remittal	豁免
anthropotomy	人体解剖学
issueless	无结果的
sanctuary	避难所
incrust	生外皮
lausanne	洛桑
canonic	轮唱的
turbulence	紊乱
shoal	浅滩
presser	压榨技工
saginaw	萨吉诺
demonism	信仰魔鬼
mucopurulent	黏脓性
didactical	教训的
robbery	抢掠
empanada	肉馅卷饼
synthetist	合成者
doum	埃及姜果棕
pisciculture	养鱼业
scenic	景色优美
levity	不稳定
protectress	女性保护人
subcuticular	角质层下
unemployed	未被利用的
strangulation	勒杀
polak	波兰人
untimeous	=untimely
retrospective	回顾的
limnological	湖沼学的
bituminous	含沥青的
jacobinize	改信雅各宾党人的革命思想
antipathic	不相容
enate	母系的
aldermanship	高级市政官的职位
yap	狂吠
suffrutescent	半灌木状
respirable	可呼吸的
lithemia	结石性血
outer	外部的
bbb	bed
galipot	松脂之一种
rattling	很好
rotator	旋转者
taxless	免税的
faggoty	女性化的
privy	个人的
unbonnet	除去……的帽子
incurment	惹起
dengue	登革热
spatiography	空间物理学
channels	通道
diffused	普及的
crake	秧鸡的叫声
sigillography	印记学
antilyssic	预防狂犬病的
agonisingly	苦闷地
areocentric	以火星为中心的
grogram	丝或丝毛交织的粗松斜纹布
bagarre	骚动
frse	Edinburgh爱丁堡皇家学会会员
extremely	极端地
qumran	库姆兰会社
sculpture	雕刻品
allicin	蒜素
deflexed	向下弯曲
polymorphic	多形的
circumglobal	围绕地球旋转
playshoe	轻便鞋
insurrectionary	暴动者
forsworn	伪誓的
understrength	力量不足的
dews	system远程预警系统
underripe	不够成熟的
temperate	温和的
monohydroxy	一羟基
mantic	预言性
ladybug	瓢虫
effrontery	厚颜无耻
pouch	烟草袋
guttatim	逐滴
rummage	检查
denominational	dI9nCmI`neIFize/dI9nCmI`neIF)l/
katrina	卡特里娜
acidimeter	酸比重计
skidproof	防滑的
crockford	英国圣公会圣职者名册
syssarcosis	肌性骨联接
ascomycetous	子囊菌类的
sensitize	敏化
khuzistan	胡齐斯坦省
biolysis	死亡
pusher	推动器
desire	期望
tooth	牙齿
bussbar	bar
castrate	去掉最重要的部分
eclectic	折衷学派
expertise	专门技术
flakily	薄而易剥落
experimentation	实验
show	展览
telefoto	=telephoto
interprovincial	各省之间的
jd	Jurum
nectared	甘美
fardel	束
inquilinous	寄居动物
statutory	法定
antimonial	含锑的
gentle	温和的
rosedrop	酒糟鼻
ambiguously	引起歧异
super	充当跑龙套的角色
pleasurable	愉快的
counterelectrophoresis	对流电泳
multifont	多字体
alterative	改变
sensation	感情
proportional	相称
oviparity	卵生
navarin	洋葱马铃薯炖羊肉
nyctitropism	就眠性
templelike	似庙宇的
foretoken	预示
overmatch	打败
suprahepatic	肝上
pozzuolana	火山灰
implacability	不安静
foremastman	水手
amputate	切除
semihyaline	半透明
keystroke	键击
franchise	赋予特权
unequaled	无敌的
semiconsciously	半意识
invariably	总是
kanarese	卡纳拉人
bender	屈服者
responsible	可靠的
kroo	克鲁族人的
unregistered	未注册
noncombustible	不燃物
assimilative	同化力
beneficially	受益地
confoundedly	十分地
damaraland	达马拉兰
harmonically	和声
fragment	片段
floodometer	潮洪水位测量仪
obligatory	必须的
coaction	强迫
ethos	道义
seducer	诱惑者
acidly	心地不良
divisive	区分的
substitute	代用品
unconfessed	未认罪忏悔
asio	Stream
reservedly	客气
childie	小孩儿
orthodox	东正教
set	一套
underside	下腹
fluidise	=fluidize
orate	演说
dashy	浮华的
capsular	蒴状
liberian	利比里亚人
bubble	泡沫
bewigged	戴假发
crappy	讨厌
garrison	卫戍部队
presession	会议前的
bonbonniere	糖果盒
cembra	瑞士五针松
spinous	难弄
irreclaimable	不可恢复
cockcrow	破晓
villager	村民
outcast	流氓
antemortem	临死前的
frostbitten	受霜害的
xiphias	剑座
halation	白色模糊影像
poohed	疲倦
statuette	小雕像
rotisserie	电转烤肉架
deaccession	出售
flushing	使人脸红
aching	痛
local	当地的
unhallow	亵渎
grub	挖
aic	Chemists
vocative	呼格的
show	说明
contemptuously	轻蔑地
chorea	舞蹈病
regular	定期的
pseudo	假的
grieve	伤心
petrous	岩石般的
bioclimatic	有关生物与气候的
prolific	丰富的
foil	烘托
hydridic	带一个负电荷的
hyalographer	玻璃雕刻术
irenic	和平主义
shopman	小商人
paint	描绘
bayeux	贝叶挂毯
racerunner	鞭尾蜥
khanka	兴凯湖
unnoticed	不引人注意的
hypobenthos	深海生物
aurelian	昆虫采集家
bodleian	牛津大学图书馆
towardly	温顺
nccw	Council
oofy	有钱的
shift	转移
raven	狼吞虎咽
malaguena	其舞曲
ligate	绑
galpon	给农业工人使用的房子
incombustible	不燃性
tubercled	生有结节
current	流通的
audiology	听力学
laminated	层压
hominine	人的
unrepulsive	未被击退
erne	白尾鹫
misquote	错误地引用
lockpin	锁销
farcically	闹剧一般
perform	完成任务
pillared	成柱状
homochrome	=homochromatic
orins	Studies
derivatively	衍生
overpassed	已废除的
chalybeate	铁剂
thermochemistry	热化学
sloughy	脱落
rapturously	兴高采烈
finality	终结
megalomania	夸大狂
ssr	Socialist
gct	Time
fluctuant	变动
unsaddle	使坠马
epicondylar	上髁
mid	中部的
foozle	笨拙的人
whine	发牢骚
sisyphean	徒劳
boatage	小船运费
creditable	可信的
nonflammable	不燃烧的
malarky	空话
mosul	摩苏尔
occultism	神秘论
prearrange	预先安排
refractional	屈折
trouvere	叙事诗人
corporate	全体的
zi	of
panic	没有理由的
totty	发昏
burro	驴子
dcmg	Commander
oarswoman	女划桨能手
pajamas	睡衣
spate	大水
gerontogeous	旧世界
spoken	口语的
unmeaningful	意义
irbm	ballistic
phytocidal	杀死植物的
gotter	to
hyperphysically	超肉体
nagged	感到厌烦的
vaunting	吹嘘
piling	打桩工程
afforce	加强阵容
garrulous	啁啾的
fullmouthed	大声的
perispore	孢子周壁
sasin	印度羚
cristated	有冠
cormorant	贪婪
gam	社交
pyrethrin	除虫菊酯
improper	不合礼仪
loneness	孤寂
delegant	将债务转由第三者偿付的债务人
bant	节食减肥法
quittance	免除
dissidence	意见不同
mirthless	沉闷
invariable	永恒
vectorscope	矢量显示器
undeflected	不偏斜的
disneyland	迪斯尼乐园
insensate	没有感觉的
insufflation	注气法
patrol	出巡
lord	使成贵族
ignoramus	不学无术的人
posteriorly	其次地
druidess	女督伊德
wide	广阔的
roofage	屋面材料
rheogoniometer	流变测角计
counsel	商议
antipyrotic	消炎的
legazpi	=Legaspi
decubitus	褥疮
deceased	死者
subeconomic	不经济的
squawk	发出叫声
agamic	无性生殖
poud	=pood
dispersal	散布
bicoastal	大西洋和太平洋东西海岸
pachydermatous	厚皮类动物的
memoire	备忘录
schematic	示意性
strepitous	嘈杂
orthographic	拼字正确
extensibility	展开性
everyday	日常的
fian	=Fiann
overflew	的过去式
pulverulent	粉状的
maladjustive	不利于调节的
iteration	反复
course	经过
manila	马尼拉
auberge	小客栈
prosecute	起诉
intussuscept	摄取
exstrophy	外翻
coincide	一致
swabber	笨手笨脚的人
diametical	正相反
postnasal	鼻后的
zirconic	含锆的
evenings	在晚上
windcheater	一种户外穿的防风夹克
whitewash	白粉胶泥水
exsection	切去
emendation	校正
hyson	熙春茶
pregnable	易受攻击
mens	精神
bughouse	发狂的
limacine	似蛞蝓的
cumbersome	讨厌的
best	最佳状态或作品
iaaf	International
ours	pro
unspecific	非特定的
insectival	昆虫
feverous	发烧
pit	使凹下
undergo	遭受
duplicity	口是心非
alkyl	烃基
environmental	环境论
chloralose	氯醛缩葡萄糖
mirk	黝暗
phyletic	种族的
reticula	网状组织
streaked	有条斑纹
mailable	可邮寄
shunter	扳道员
soliflucted	因泥流作用而移动的
intravital	发生于活体内的
accuse	控告
terracotta	陶瓦
humilis	淡的
photoproduction	光生
toynbeean	汤因比风格的
samoyedic	撒摩耶人的
dynein	动力蛋白
mowburnt	因堆积发热而霉烂
surfacely	肤浅
exonerative	免除
imposturous	欺诈
nemoricoline	生长在树丛中
sacerdotal	祭司的
neolite	新石
vanadous	亚钒
connivence	纵容
livelihood	谋生
perissodactylate	奇蹄目的
granulation	有粒的表面
electrify	使充电
crudeness	不成熟
sherbet	冰冻果子露
herbary	药草园
clodhopper	乡巴佬
miliaria	栗疹
eyepatch	眼罩
trigoneutic	一年三抱
hurtling	飞奔的
aeromarine	海上飞行的
pretense	借口
embarment	阻遏
lox	液态氧
regretful	抱歉
dissected	分割
gluttonous	贪吃
brimstony	似硫黄的
wyswyg	所见即所
renown	传闻
wreathe	环绕盘旋
stemma	侧单眼
acyclic	脂肪族
scepticize	持怀疑论
plantaginaceous	车前科的
neurotomy	神经切断术
vertiginous	旋转的
olent	有气味的
stably	坚定
poesy	作诗法
ladder	阶梯
amie	爱人
dinothere	恐兽
mean	中间
quadrisyllabic	有四个音节的
intensification	激烈化
slipstream	起带动作用的助力
killick	石锚
noninflammable	=nonflammable
demodulate	使解调
mauritania	毛利塔尼亚
muckworm	粪蛆
woodenheaded	愚蠢的
wealthy	丰裕
endogenic	内营力的
easterly	从东方来
fallen	陷落
broad	宽阔部分
turfite	热衷于赛马的人
recentness	最近
tumultuously	喧闹地
patulin	棒曲霉素
avian	鸟
curling	苏格兰的冰上掷石游戏
shakily	不坚定
sterling	纯正
ambiguous	暧昧
pragmatize	使实际化
precipitantly	倒栽
clatter	喧闹的谈笑
exceed	超越
previous	早先
improbity	邪恶
underplay	使没有充分发挥作用
peacekeeping	执行停火协定
abbreviation	缩写
stringboard	楼梯斜梁侧板
iad	国际天体物理十年
pararescue	伞降救援
riverfront	河边陆
computerlike	计算机似的
try	试图
autumn	秋天
virion	病毒体
recognized	公认的
neurosyphilis	神经梅毒
augean	Augeas王
homologous	相应
knotless	没有结的
downright	率直的
nonadmission	不准进入
rurally	农村风味
colcannon	马铃薯卷心菜泥
tokonoma	床之间
azedarach	楝皮
dogged	顽强的
immunise	赋予免疫性
skice	匆匆而行
rifleman	步枪射手
photoinduction	光致引发
polygalaceous	远志科
broadcloth	一种精细棉布或人造丝织物
bioenergetics	生物能学
axonometric	轴测法
driftingly	漂流
mature	到期的
holyday	宗教节日
nop	not
mastfed	饲养
neogene	晚第三纪
greeneian	格林风格的
incondite	生硬
flocculent	羊毛状的
grubstake	资金
enate	母系亲戚
citify	使都市化
waterworks	喷水装置
organization	团体
overland	经过陆
plosive	爆破音的
homemaker	主妇
extraction	抽出
upward	向上的
headhunt	野蛮人猎取人头的出征
pixel	像素
fancied	空想的
si	硅
shat	拉屎
deformable	可变形
jamaica	牙买加甜酒
devour	毁灭
positivism	自信
anam	=Annam
plumb	用铅增加重量
retiary	结网的
crotcheteer	耽于幼想的人
disarm	回复平常的编制
floriferous	花盛开的
pyogenic	生脓
aesthetics	审美学
crispate	卷缩状的
manana	不久以后
digest	摘要
fimbria	伞
mean	低劣的
farmerly	像农人般
mithraic	密特拉教的
roily	焦急的
peacebreaker	破坏和平者
houseroom	家里的收容能量
displode	=explode
ever	不断
chrysophyte	金藻
arciform	拱状
kunashiri	国后岛
francicize	使改用法语
backroom	私下的
hydrometer	浮秤
working	抽搐
overtime	超时的
unaccountable	无责任的
lipogenous	产生脂肪
calvinism	加尔文教派
undistracted	不分心的
sabotage	妨害
pontifical	大祭司的
multiparty	包含多党党员
conglutinant	粘合
nasty	污秽
droning	发嗡嗡声的
poky	狭小
catamount	山猫
anastomosis	接合
foliature	=foliage
imponderability	失重
add	计算……总和
dentil	齿状装饰
backhouse	后面的小屋
gramineous	青草味的
expander	使身体健壮的强身器具
otary	海狮
repute	名誉
lymphatolysis	淋巴组织破坏
recopy	再复制
weasel	狡猾的人
excitation	刺激
reflectible	能反照
deerfly	鹿虻
midwinter	仲冬
worrying	烦恼的
worth	财产
fractional	小数
evaginable	外翻
trieste	的里雅斯特湾
helen	海伦
endothelioid	内皮状
polyandric	一妻多夫
annalistic	编年史
elimination	除去
unrevealed	未揭露
rightfully	正直地
tubicorn	有洞角的
agedly	老年人似地
infirmity	虚弱
corneous	角状的
heliotactic	向日性的
lerp	昆虫分泌出来的一种蜜
deign	屈尊
handcart	手推车
oink	呼噜声
somatotrophin	生长激素
contemplative	冥想
cozy	舒适的
cytophotometry	细胞光度测定法
fit	突然发作
nervine	神经
polyesterification	聚合
childish	幼稚
reviewal	校阅
fairyism	仙气
jo	爱人
coowner	共有者
gasless	不用气体
dispersal	分散
towhee	红眼雀
univocal	意义明确
voluminous	长篇的
proteide	含蛋白质
paean	赞美歌
horticultural	园艺的
tan	棕褐色
horologe	钟表
hyracoid	蹄兔的
pyaemic	脓血症的
rigor	严酷
daunomycin	道诺霉素
unliquidated	未清算的
prescript	命令
academe	研究院
intention	意图
usurper	篡位者
pit	陷阱
courtling	小朝臣
regulable	可控制的
natsopa	and
reflectingly	反映地
wusih	见Wuxi
imperturbed	镇静
pare	剥
bramble	悬钩子
gillion	十亿
septuagenarian	七十岁
duplicity	狡猾
preconference	预备会议
adagissimo	很慢地
proteolytic	蛋白水解的
countermine	对抗计划
tendential	=tendentious
divisible	可分的
foldout	插页
reprocess	再加工
cartelize	组成企业联盟
inertially	借助地
scholarly	学者气质的
muffle	蒙住
qmc	Quartermaster
metapolitics	抽象政治学
telecommunication	电ion
recantation	改变论调
teemless	贫瘠的
contralateral	对侧
laboursome	费力的
umbilicate	有肚脐的
rappen	分
mortal	临终
thermomotor	热发动机
publican	酒馆老板
thermophil	喜温
understandable	可懂
haussa	=Hausa
garp	Research
typeface	打字机字体
fleshpots	寻欢作乐的场所
polonize	使成波兰风格
hemmer	缝边器
foresight	远见
mindon	心灵感应粒子
ece	for
pumpable	可用泵抽吸
passim	到处
saturniid	天蚕蛾
revolted	厌恶的
grist	尤指磨成粉用谷物
pallidly	苍白无血色
ivr	交互式语音响应
initiatress	女创始者
gloss	上光于
racer	比赛者
gassy	空话连篇
leprosarium	麻疯病院
latex	乳胶
scatty	疯狂
scutellum	角质鳞片
iaa	indoleacetic
unhallowed	不圣洁
viborg	=Vyborg
typhlosole	纵褶
muscly	=muscular
applique	贴花的
battlesome	好争吵
porket	乳猪
sedately	镇静地
foraminiferal	有孔虫目
latinic	拉丁国家
vassalage	家臣身份
puree	浓汤
hardcore	没有限制的
macroglobulin	巨球蛋白
heartache	悲叹
standing	直立的
autism	孤独症
kavass	武装警察
computistical	统计计算
duodenary	十二的
partner	合伙人
flitch	背叛
fungi	由真菌引起
continuous	持续的
corresponsive	反应的
polytheism	多神论
irreconcilable	矛盾
athermanous	不传幅射热的
homebred	不懂世故的
hideously	非常讨厌
carline	老太婆
besprent	撒满的
coloring	色彩
paracetaldehyde	=paraldehyde
bicornuate	双角的
unveil	揭开
jutty	码头
couchy	茅草丛生的
duodecimal	十二分之一
incontestably	无讨论余地地
hypophoneme	下音位
rearmament	重整军备
undermost	最低的
reciprocate	酬答
schizogonia	=schizogony
resolved	断然
directorial	指挥
unseparated	不分离
stead	替代
unhinge	使失常
somatotonic	体力旺盛性格的
ruthenious	二价钌的
bazaari	店主
trust	盼望
convect	使热空气对流
driveller	说傻话的人
reticulated	网状的
sop	面包片
remorseful	懊悔
tactless	不老练的
propagandize	宣传
onionskin	薄的半透明纸
lubricant	滑润剂
fretsaw	圆锯
huzza	欢呼等的声音
negligent	粗心大意
fungistat	抑真菌剂
toneme	调位
embroil	牵连
quicksandy	多流沙的
sewer	缝具
equivocator	说话支吾的人
cariocan	里约热内卢之居民
nidnod	使点着头打盹
dispread	向四方张开
microvillus	指状突
grantor	让渡人
diphtheritic	白喉的
slow	减速
protective	给予保护
reverently	虔诚地
wove	布纹
leprous	患麻疯病的
yucca	丝兰
slip	串行线路接口协议
coagulator	凝结器
bonnily	快活地
cryoelectronics	低温电子学
quilled	羽毛状
burnout	烧光
roi	Oil
guidance	指导
powerword	金山词霸
quadrivial	四高级学科的
dasher	猛冲者
stockpot	杂烩锅
amyloid	淀粉体
infrasonic	次声所产生
unido	Nations
sentimentalise	=sentimentalize
unspent	仍有效的
lecherous	淫荡
labourious	需要劳力
hoot	猫头鹰叫
toilworn	工作疲劳的
administrivia	摘要等的处理工作
bussbar	=bus
velveteen	棉绒衣服
cornelia	科妮莉亚
undereducated	受教育不足的
override	不考虑
fictitious	假想的
loo	厕所
brimfull	盈满
undeniable	不可否认
ubication	场所
process	进行
weather	天气
abolitionist	废奴主义者
christless	违反基督精神
foxed	变酸的
potherb	熟食叶用菜野菜
jellify	成凝胶状
umpire	任裁判
chorten	圣骨冢
smokable	可以点燃抽吸的
performance	执行
scrubby	树丛繁盛的
homolog	相同器官
nitrosyl	亚硝酰基
authorise	=authorize
antisudorific	止汗
affiliation	从属关系
vestibulospinal	前庭脊髓束的
able	能够的
one	一个
pictograph	象形文字
barbary	北非伊斯兰教地区
rann	to
left	左侧
indecency	下流
angioma	血管肿
riverward	向河地
wader	跋涉者
bia	Internet
transit	经过
female	女性的
garnishment	扣押债权的通知
out	出局的
rewind	重绕
eprom	可擦可编程只读存储器
matin	晨歌的
corsican	科西嘉方言的
genappe	烧毛毛纱
microsporogenesis	小孢子发生
effective	有效的
confounded	糊涂的
incendivity	可燃性
pentagram	五角星形
pity	怜悯
health	健康
wring	扭动
suboceanic	洋底
chlorometer	氯量计
contempt	轻蔑
succinctness	简洁
microammeter	微安计
stalactiform	钟乳石状的
pinealectomize	为……作松果体切除术
upbraidingly	谴责地
candent	白热
rejectamenta	废弃物
untillable	不能耕种的
intermontane	亦作intermont或intermountain
fsf	Free
teacherless	无师自通的
punic	没有信义
vitally	生死攸关
martlet	无足鸟
hallmark	特点
sartorial	裁缝的
rowdyish	粗野的
childproof	能防止孩童瞎摸弄
phenolic	石碳酸的
percentum	百分比
careful	仔细的
perform	表演
dispart	分开
hithermost	最靠近的
trigon	三角形
brenner	Pass勃伦纳山口
dreamer	梦想家
rbe	biological
toehold	排除障碍的方法
dogmatical	教理
obstetric	产科的
starting	开始
underground	面下
rishon	里肖恩
daze	眼花缭乱
planetesimal	星子组成的
exoelectron	外激电子
siphonet	蜜管
nagged	经常遭责怪的
clean	干净
fox	使变酸
unfurl	展示
shavuot	=Shabuoth
crases	crasis的复数
cavortings	轻浮行为
phonographic	留声机
cheddite	谢德
cheliform	螯状
irruption	急速增加
atman	生命的本源
cultrate	锋利且尖锐的
quadrate	长方形的
retirement	退却
conciliative	安慰的
austerity	节俭
tolerant	容忍的
activation	活化
slavophil	亲斯拉夫人
planigale	扁头袋鼠
bingle	安打
lade	装载舀出
concutient	受到震荡性撞击的
hurst	小林
fauvism	野兽派
coring	去除中心部份
tough	强壮的
puncturable	可穿刺的
punitive	惩罚性
outshoot	长出
smart	轻快
kiangsi	江西
clathrate	窗格形
notion	观念
newsvendor	书报摊贩
propellant	推进
scatterometer	散射仪
conspue	唾弃
infatuated	昏头昏脑的
physiotherapy	物理疗法
delir	发狂
odontornithic	齿鸟类
submissiveness	柔顺
unpaid	未付款的
antiallergenic	抗变应性
zipless	短暂而猛烈的
clericate	牧师的职位
culpable	该责备的
gym	体育馆
apostatize	变节
autocephalous	自治
monopolistic	专利的
sprocket	链轮齿
hematoblast	血胚细胞
uninjured	未蒙损失
placentology	胎盘学
apologetically	辩解
pentalogy	互相关联五部分的组合体
gauziness	似薄纱的状态
sentimentally	富情感
titular	有名无实的
toque	无边女帽
circumplanetary	围绕行星
typo	排字工
squally	天气愈变愈坏
available	可利用
instructor	教师
antique	古时的
chromophile	染性
ashy	苍白
clavicular	锁骨
bumptious	盲目自大的
distressing	悲伤
cemental	白垩质的
somersault	翻筋斗
bionic	利用仿生学的
abrupt	生硬
moderatism	温和主义
uneffectual	=ineffectual
fearful	吓人
veronal	巴比妥
distractible	易于分心
slavophil	崇拜斯拉夫等者
encampment	营地
rattail	没毛的马尾巴
msj	in
superfluid	超流体
arithmancy	数字算命法
invariable	不变量
cms	color
rhizomatous	下茎
microslide	显微镜载片
decillion	100万的10次乘方
frowsy	不整洁的
armature	牙齿
hieland	易上当
oviduct	输卵管
schnozzle	鼻子
crackajack	杰出
femininely	女人似
talus	踝
spadework	基本研究
unleavened	未受激发
approbate	认可
prelimit	事先限定
plane	平面的
poikilothermic	变温的
sir	阁下
weltpolitik	国际事务
antipathetic	格格不入
traumatic	外伤的
stylistic	体裁上
fixup	固定
cisrhenane	莱茵河西岸的
bill	清单
tell	吩咐
drossy	浮渣一样
hairy	多毛的
gnarl	生节
hypercorrect	纠正过头
discursively	东拉西扯
carob	长豆角
beloid	前窄后宽的
cryptography	密码使用法
fool	白痴
tripper	旅行者
palm	棕榈
lexic	=lexical
ratine	珠皮大衣呢
fukuoka	福冈
suzerain	庄主
corpus	尸体
hesitatingly	踌躇
apriorism	先验论
triform	以三种形式存在的
slender	微薄的
nabobess	女财主
walker	徒步者
chancellery	大臣
slan	loco
redemptive	用于补偿
cornball	似乡巴佬的
grassiness	绿色
primary	主要
uncreased	未弄皱
forbearing	忍耐
sgi	美国图形工作站生产厂商
ukaea	联合王国原子能管理局
forfex	剪刀
human	人类的
unput	未放置的
record	履历
dolerite	粗粒玄武岩
lark	玩乐
diagnose	诊断
paperbacked	纸面
bulbaceous	=bulbous
sessioneer	=session
ripsnort	喧闹地行进
dump	倾倒
knapsack	背包
arenicolous	生长在沙中的
omnicompetent	有全权的
draught	拉
seizor	扣押者
photoheliograph	太阳
downfall	衰败
soloistic	独唱的
marblehearted	铁石心肠
serfage	农奴地位
philomel	夜莺
themselves	他们亲自
mauley	拳头
unineme	单线的
ruckle	起绉褶
samel	半烧
tiffin	吃午饭
lubricative	有润滑作用
arachnoid	蛛网状的
ideaistic	观念的
sauroid	蜥鱼亚目的鱼
screwball	怪僻的
screwy	扭曲
renascent	复活的
potboy	酒馆的侍者
peroxyacetyl	硝酸过氧化乙酰
morellian	莫雷利批评法的
unef	Nations
semifinal	半决赛
factoried	工厂林立的
osprey	白色的羽毛
kyack	驮袋
proteiform	多型的
oakley	Oakley
gasiform	气体状的
occultism	神秘学
cornetto	小铜喇叭
outeat	吃得比……多
kitty	Kitty
angelic	天使的
simple	简易
rodent	啮齿目的
choreographic	舞蹈术
disputability	有讨论余地
start	惊动
trophy	战利品
achaean	希腊的
lionlike	狮子般
prostration	俯卧
physostigmine	毒扁豆碱
gestate	孕育
retch	恶心
longshoreman	港口工人
tafia	塔非亚酒
corporealize	使形体化
several	单独
subcrust	地壳下地层
musjid	=mosque
unforested	未造林的
worry	使苦恼
slimly	微弱
budding	少壮
totem	标识
quantize	使量子化
hematopoietic	生血
bucketeer	股票投机行的老板
sleepless	失眠
radiophonics	无线电发出的声音
silverless	无银的
physicky	药物似
tap	选择
garnett	扯松
scrambling	不规则性
yafo	=Jaffa
glamor	魔法
indivisible	除不尽
conformism	盲目因袭的态度
postscript	后记
trot	疾走
nonmonetary	非货币的
numerical	数字
afterdeck	后甲板
alkyl	烷基
vmtp	多用报文处理协议
undersurface	下面
generalization	广义性
stumble	绊倒
fagot	束
waveless	平静
static	静力
cunctation	迟缓
compellent	有强烈吸引力
grim	严酷的
north	在北方
expeditiousness	快速
contubernal	亲密的
persevere	坚持
npcf	全国控制污染基金会
perigynous	周位
undersleeve	内袖
requiem	安灵祢撒
verjuiced	酸的
autolithograph	直接苀I/
tribal	部落
scale	数值范围
tridimensional	`traIdI9menFl/
crisis	历史上的紧要关头
turning	旋转
transitoriness	短暂
uncarpeted	未铺地毯
musingly	冥想地
hera	Explosive
vesical	膀胱的
demented	失去本性
hormuz	霍尔木兹海峡
apposite	适当
parameter	参量
rhinovirus	鼻病毒
unpoetic	无想象力的
gppm	Graphics
orismology	术语学
material	具体的
coding	译码
bonhomie	敦厚
minor	未成年的
rough	粗略叙述的
traductor	邮包吊放装置
gasdynamic	气体动力激光器
commy	共产党员
debut	开张
birch	桦树
merogony	卵片发育
thrust	强行推进
teaspoonful	一茶匙的量
ukase	谕旨
skunk	臭鼬皮
demagog	群众领导者
hakeem	学者
ragger	新闻记者
doloroso	感伤
oblong	椭园形
tournament	锦标赛
excusal	原谅
myxoedema	黏液水肿
weightily	重要地
galwegian	加罗韦人
directoire	执政内阁时代式
idyllist	田园诗人
dairy	鸡蛋等的商店
excess	额外
undetermined	未确定
umpire	作裁判
seat	场所
underpass	高架桥下通道
meanly	吝啬
golly	神
metathesis	交换
peradventure	疑惑
brachydactyl	短指
amniography	羊水照相术
cheesecake	半裸体或露出曲线美的女人照片
degrading	可耻的
siren	警报器
vertumnus	威耳廷努斯
quoth	说
knurly	多瘤的
vacuous	空洞的
forgivingly	慈悲
contretemps	不幸的
accessible	易接近的
garibaldian	加里波第的
lionlike	狮子般的
intercellular	在细胞间的
unreserved	不隐瞒
capacious	广阔
inherency	固有
remove	搬家
feature	特色
jointing	填料
raiser	酵母
plethoric	多血症
amniote	脊椎动物
hammam	澡堂
reassign	再指定
simplicity	直率
embus	装入大客车
aeronaval	海空的
disconnected	分离的
upturned	朝上的
mrs	炮口基准系统
bifid	两裂的
lickerish	讲究吃
unveracious	假的
parathyroid	副甲状腺
transmit	传播
decreasingly	渐渐减少
auditor	计员
intomb	安葬于墓中
dialyzate	=dialysate
whisht	默然的
dantesque	但丁式的
asturian	阿斯图里亚斯语
climate	思潮
increasable	可增加
gardner	加德纳
pumiceous	轻石的
helminthology	寄生虫学
rebarbative	令人讨厌的
discovery	发明的东西
hairsplitter	拘泥于琐事的人
vendible	可被普遍接受
quotable	可引用的
rhenic	含铼
seafarer	航海家
allopatrically	单独地发生地
synergic	协作
mystificatory	使人困惑不解
xvii	罗马数字
rbe	relative
radiophysics	无线电物理学
equivalent	相当的
tumidly	隆起
scorecard	记分卡
aeropause	适航大气界层
sbr	Styrene
cowish	胆怯的
revolution	革命
nobbily	华丽
noted	著名
ravel	使纠缠
alible	有营养的
flyer	传单
taffrail	船尾栏杆
compliably	屈从
threnode	葬歌
perthshire	佩思郡
adgb	Britain
flsa	Labor
vvip	very
suprarenalin	肾上腺素
polarizer	偏光器
intercity	城市间的
crossly	横
sneeshing	鼻烟
uncontested	无异议的
porterage	搬运业
temporal	世俗
ipsu	Utility
philanthropic	博爱
talon	魔爪
scurviness	无礼
omniscient	全知的
serve	服役
regrant	重新批准
plantigrade	跎行的
fetch	演绎出
peccancy	违章
possibly	或者
forbearing	宽容
squall	哇哇地叫嚷
contemporaneity	现代
unreasonably	不合理地
sleet	雨夹雪
whole	所有的
bmw	德国宝马汽车公司
sweated	低工资
filterable	可滤过的
ransom	勒索
overrun	泛滥
rally	重整旗鼓
thankless	不讨好的
bani	恶骂
psn	serial
santy	=Santa
wettable	可霑
stanch	忠实
baccate	浆果状的
trioxide	三氧化物
swat	猛击
superduty	超级耐高温的
galloot	愚笨的人
cathartic	导泻的
unthinking	不留心的
coasting	沿海贸易
auralize	在心灵深处听到
hotter	热
sheerhulk	人字起重架船
device	发明物
smear	涂污
inlook	内心省察
beelzebub	魔王
overmodest	过分谦虚
becloud	蒙蔽
fairyhood	小神仙
gallantly	漂亮
tornado	大雷雨
ingrained	根深蒂固的
mepacrine	麦帕克林
involvement	连累
equipotential	有相等潜力
